wave,hh_nct,nhh_nct,grp_nct,t_nct,date,pt_sex,pt_age,pt_age_grp,rp_nb
1,1,3,0,4,2020-05-02,Male,33,25-34,1
1,0,0,0,0,2020-05-01,Male,59,55-64,1
1,1,0,0,1,2020-05-04,Male,32,25-34,1
1,2,0,0,2,2020-05-01,Female,58,55-64,1
1,2,3,0,5,2020-05-02,Male,65,65-69,1
1,1,0,0,1,2020-05-01,Male,82,80-84,1
1,0,0,0,0,2020-05-01,Female,65,65-69,1
1,0,1,0,1,2020-05-01,Female,71,70-74,1
1,0,0,0,0,2020-05-01,Female,33,25-34,1
1,4,0,0,4,2020-05-06,Male,40,35-44,1
1,1,0,0,1,2020-05-01,Female,71,70-74,1
1,0,1,0,1,2020-05-03,Female,53,45-54,1
1,0,4,0,4,2020-05-01,Female,52,45-54,1
1,0,1,0,1,2020-05-01,Female,56,55-64,1
1,3,0,0,3,2020-05-04,Male,34,25-34,1
1,4,0,0,4,2020-05-02,Male,7,5-9,1
1,0,0,0,0,2020-05-01,Female,58,55-64,1
1,1,0,0,1,2020-05-05,Male,14,10-14,1
1,2,3,0,5,2020-05-03,Female,60,55-64,1
1,0,0,0,0,2020-05-01,Male,50,45-54,1
1,0,0,0,0,2020-05-01,Male,67,65-69,1
1,2,0,0,2,2020-05-03,Male,0,<1,1
1,4,0,0,4,2020-05-01,Female,57,55-64,1
1,2,0,0,2,2020-05-01,Female,12,10-14,1
1,0,0,0,0,2020-05-04,Male,32,25-34,1
1,2,0,0,2,2020-05-02,Male,66,65-69,1
1,2,0,0,2,2020-05-01,Male,62,55-64,1
1,4,0,0,4,2020-05-04,Male,14,10-14,1
1,1,0,0,1,2020-05-04,Female,22,20-24,1
1,2,6,0,8,2020-05-03,Female,42,35-44,1
1,2,1,0,3,2020-05-02,Male,16,15-19,1
1,2,0,0,2,2020-05-03,Male,58,55-64,1
1,2,0,0,2,2020-05-01,Female,70,70-74,1
1,1,2,0,3,2020-05-01,Male,67,65-69,1
1,1,3,0,4,2020-05-01,Female,65,65-69,1
1,0,0,0,0,2020-05-04,Male,56,55-64,1
1,2,0,0,2,2020-05-01,Female,68,65-69,1
1,0,2,0,2,2020-05-01,Male,41,35-44,1
1,1,0,0,1,2020-05-02,Female,29,25-34,1
1,2,1,0,3,2020-05-01,Male,58,55-64,1
1,0,3,0,3,2020-05-06,Female,59,55-64,1
1,1,1,0,2,2020-05-02,Female,56,55-64,1
1,1,1,0,2,2020-05-01,Male,24,20-24,1
1,2,0,0,2,2020-05-04,Female,21,20-24,1
1,2,0,0,2,2020-05-02,Male,51,45-54,1
1,0,0,0,0,2020-05-04,Male,85,85+,1
1,0,0,0,0,2020-05-01,Female,68,65-69,1
1,1,0,0,1,2020-05-04,Male,14,10-14,1
1,0,2,0,2,2020-05-04,Female,11,10-14,1
1,1,1,0,2,2020-05-01,Male,53,45-54,1
1,0,0,0,0,2020-05-01,Male,57,55-64,1
1,4,0,0,4,2020-05-01,Female,35,35-44,1
1,0,0,0,0,2020-05-01,Male,67,65-69,1
1,0,0,0,0,2020-05-04,Male,24,20-24,1
1,0,1,0,1,2020-05-01,Male,16,15-19,1
1,0,0,0,0,2020-05-01,Male,50,45-54,1
1,0,1,0,1,2020-05-01,Male,76,75-79,1
1,2,1,0,3,2020-05-01,Male,71,70-74,1
1,0,3,0,3,2020-05-01,Male,51,45-54,1
1,1,0,0,1,2020-05-01,Male,56,55-64,1
1,4,1,0,5,2020-05-05,Male,43,35-44,1
1,2,0,0,2,2020-05-04,Female,19,15-19,1
1,1,1,0,2,2020-05-04,Male,19,15-19,1
1,1,0,0,1,2020-05-04,Female,74,70-74,1
1,1,1,0,2,2020-05-01,Female,59,55-64,1
1,2,0,0,2,2020-05-01,Male,34,25-34,1
1,2,2,0,4,2020-05-02,Male,68,65-69,1
1,1,1,0,2,2020-05-01,Female,76,75-79,1
1,0,0,0,0,2020-05-06,Male,49,45-54,1
1,0,0,0,0,2020-05-01,Male,55,55-64,1
1,4,0,0,4,2020-05-01,Male,3,1-4,1
1,2,2,0,4,2020-05-01,Male,16,15-19,1
1,2,1,0,3,2020-05-02,Female,59,55-64,1
1,2,0,0,2,2020-05-02,Male,66,65-69,1
1,1,0,0,1,2020-04-30,Female,67,65-69,1
1,5,0,0,5,2020-05-02,Female,4,1-4,1
1,2,0,0,2,2020-05-01,Male,38,35-44,1
1,4,0,0,4,2020-05-01,Male,46,45-54,1
1,2,1,0,3,2020-05-01,Female,71,70-74,1
1,2,0,0,2,2020-05-01,Male,44,35-44,1
1,2,2,0,4,2020-05-01,Male,54,45-54,1
1,2,1,0,3,2020-05-01,Female,71,70-74,1
1,2,6,0,8,2020-05-01,Female,65,65-69,1
1,3,0,0,3,2020-05-01,Male,13,10-14,1
1,2,0,0,2,2020-05-04,Male,69,65-69,1
1,4,0,0,4,2020-05-03,Female,14,10-14,1
1,1,0,0,1,2020-05-01,Male,67,65-69,1
1,2,0,0,2,2020-05-02,Female,42,35-44,1
1,3,0,0,3,2020-05-01,Female,17,15-19,1
1,2,2,0,4,2020-05-06,Male,69,65-69,1
1,3,0,0,3,2020-05-01,Male,44,35-44,1
1,8,0,0,8,2020-05-01,Female,15,15-19,1
1,0,0,0,0,2020-05-04,Female,8,5-9,1
1,2,0,0,2,2020-05-01,Female,43,35-44,1
1,4,0,0,4,2020-05-04,Male,22,20-24,1
1,1,0,0,1,2020-05-01,Male,48,45-54,1
1,1,4,0,5,2020-05-04,Female,34,25-34,1
1,0,1,0,1,2020-05-06,Female,54,45-54,1
1,1,2,0,3,2020-05-01,Male,68,65-69,1
1,4,1,0,5,2020-05-01,Female,3,1-4,1
1,3,0,0,3,2020-05-01,Female,23,20-24,1
1,0,0,0,0,2020-05-03,Male,37,35-44,1
1,4,0,0,4,2020-05-05,Female,15,15-19,1
1,2,1,0,3,2020-05-01,Female,67,65-69,1
1,5,0,0,5,2020-05-01,Male,13,10-14,1
1,1,0,0,1,2020-05-04,Male,30,25-34,1
1,1,1,0,2,2020-05-01,Female,52,45-54,1
1,1,0,0,1,2020-05-04,Male,48,45-54,1
1,6,0,0,6,2020-05-04,Male,3,1-4,1
1,2,1,0,3,2020-05-02,Female,62,55-64,1
1,4,0,0,4,2020-05-01,Female,27,25-34,1
1,0,0,0,0,2020-05-01,Male,4,1-4,1
1,1,0,0,1,2020-05-01,Female,28,25-34,1
1,0,0,0,0,2020-05-01,Female,30,25-34,1
1,0,0,0,0,2020-05-01,Female,62,55-64,1
1,0,0,0,0,2020-05-01,Male,67,65-69,1
1,2,0,0,2,2020-05-01,Female,46,45-54,1
1,2,0,0,2,2020-05-01,Female,65,65-69,1
1,1,0,0,1,2020-05-01,Male,56,55-64,1
1,4,0,0,4,2020-05-01,Female,72,70-74,1
1,0,0,0,0,2020-05-01,Male,31,25-34,1
1,3,0,0,3,2020-05-05,Female,5,5-9,1
1,2,0,0,2,2020-05-01,Female,45,45-54,1
1,2,0,0,2,2020-05-03,Female,70,70-74,1
1,4,0,0,4,2020-05-01,Male,36,35-44,1
1,1,0,0,1,2020-05-01,Female,61,55-64,1
1,1,0,0,1,2020-04-30,Female,57,55-64,1
1,2,0,0,2,2020-05-01,Male,63,55-64,1
1,4,0,0,4,2020-05-03,Male,7,5-9,1
1,0,0,0,0,2020-05-01,Female,55,55-64,1
1,1,0,0,1,2020-05-04,Female,27,25-34,1
1,2,1,0,3,2020-05-04,Male,20,20-24,1
1,3,0,0,3,2020-05-01,Male,14,10-14,1
1,1,6,0,7,2020-05-01,Female,67,65-69,1
1,3,1,0,4,2020-05-03,Male,17,15-19,1
1,0,0,0,0,2020-05-02,Male,41,35-44,1
1,2,0,0,2,2020-05-01,Male,58,55-64,1
1,1,0,0,1,2020-05-01,Female,63,55-64,1
1,4,0,0,4,2020-05-01,Male,12,10-14,1
1,3,1,0,4,2020-05-01,Female,68,65-69,1
1,1,0,0,1,2020-05-01,Male,50,45-54,1
1,0,1,0,1,2020-05-03,Female,39,35-44,1
1,0,1,0,1,2020-05-02,Female,69,65-69,1
1,2,0,0,2,2020-05-01,Male,34,25-34,1
1,0,1,0,1,2020-05-02,Female,53,45-54,1
1,3,0,0,3,2020-05-06,Male,24,20-24,1
1,0,0,0,0,2020-04-30,Female,33,25-34,1
1,1,0,0,1,2020-05-01,Male,64,55-64,1
1,1,1,0,2,2020-05-01,Female,72,70-74,1
1,1,0,0,1,2020-05-01,Female,78,75-79,1
1,0,0,0,0,2020-05-04,Male,76,75-79,1
1,2,0,0,2,2020-05-02,Male,56,55-64,1
1,2,0,0,2,2020-05-01,Female,28,25-34,1
1,1,0,0,1,2020-05-01,Female,66,65-69,1
1,0,1,0,1,2020-05-01,Female,50,45-54,1
1,2,0,0,2,2020-05-04,Male,52,45-54,1
1,1,0,0,1,2020-05-03,Male,58,55-64,1
1,0,0,0,0,2020-05-04,Male,56,55-64,1
1,2,0,0,2,2020-05-01,Male,17,15-19,1
1,2,0,0,2,2020-05-01,Female,51,45-54,1
1,0,0,0,0,2020-05-04,Male,17,15-19,1
1,3,0,0,3,2020-05-02,Male,65,65-69,1
1,0,1,0,1,2020-05-01,Male,67,65-69,1
1,1,2,0,3,2020-05-01,Female,58,55-64,1
1,2,0,0,2,2020-05-03,Female,32,25-34,1
1,0,0,0,0,2020-05-01,Female,65,65-69,1
1,1,2,0,3,2020-05-01,Female,59,55-64,1
1,0,1,0,1,2020-05-01,Male,70,70-74,1
1,0,0,0,0,2020-05-01,Female,70,70-74,1
1,1,1,0,2,2020-05-01,Male,73,70-74,1
1,2,1,0,3,2020-05-01,Male,65,65-69,1
1,0,0,0,0,2020-05-04,Female,72,70-74,1
1,0,0,0,0,2020-05-01,Male,37,35-44,1
1,1,1,0,2,2020-05-01,Female,54,45-54,1
1,0,0,0,0,2020-05-01,Male,50,45-54,1
1,0,0,0,0,2020-05-01,Female,24,20-24,1
1,2,0,0,2,2020-05-06,Female,68,65-69,1
1,1,1,0,2,2020-05-01,Male,16,15-19,1
1,0,0,0,0,2020-05-02,Male,26,25-34,1
1,1,0,0,1,2020-05-06,Male,15,15-19,1
1,2,0,0,2,2020-05-01,Male,65,65-69,1
1,2,0,0,2,2020-05-03,Male,46,45-54,1
1,2,1,0,3,2020-05-01,Male,67,65-69,1
1,1,0,0,1,2020-05-01,Male,52,45-54,1
1,1,0,0,1,2020-05-01,Female,57,55-64,1
1,8,0,0,8,2020-05-02,Female,19,15-19,1
1,0,0,0,0,2020-05-02,Male,49,45-54,1
1,3,0,0,3,2020-05-01,Male,14,10-14,1
1,0,2,0,2,2020-05-01,Male,70,70-74,1
1,5,2,0,7,2020-05-01,Male,4,1-4,1
1,0,0,0,0,2020-05-01,Female,69,65-69,1
1,2,0,0,2,2020-05-02,Female,9,5-9,1
1,1,3,0,4,2020-05-02,Female,56,55-64,1
1,1,1,0,2,2020-05-01,Female,59,55-64,1
1,0,0,0,0,2020-05-01,Male,43,35-44,1
1,2,0,0,2,2020-05-04,Female,62,55-64,1
1,0,0,0,0,2020-05-04,Male,26,25-34,1
1,2,0,0,2,2020-05-04,Male,31,25-34,1
1,2,0,0,2,2020-05-01,Male,73,70-74,1
1,0,0,0,0,2020-05-01,Female,68,65-69,1
1,1,0,0,1,2020-05-01,Male,65,65-69,1
1,1,0,0,1,2020-05-04,Male,65,65-69,1
1,2,2,0,4,2020-05-01,Female,52,45-54,1
1,2,4,0,6,2020-05-01,Male,68,65-69,1
1,0,0,0,0,2020-05-04,Male,33,25-34,1
1,2,4,0,6,2020-05-04,Male,29,25-34,1
1,1,3,0,4,2020-05-01,Male,65,65-69,1
1,2,1,0,3,2020-05-01,Male,65,65-69,1
1,2,1,0,3,2020-05-01,Male,67,65-69,1
1,0,0,0,0,2020-05-04,Male,39,35-44,1
1,0,3,0,3,2020-05-01,Male,61,55-64,1
1,1,1,0,2,2020-05-01,Male,70,70-74,1
1,4,2,0,6,2020-05-02,Male,17,15-19,1
1,0,0,0,0,2020-05-01,Female,55,55-64,1
1,0,1,0,1,2020-05-01,Female,66,65-69,1
1,0,0,0,0,2020-05-01,Female,61,55-64,1
1,1,0,0,1,2020-05-05,Female,40,35-44,1
1,0,1,0,1,2020-05-04,Male,44,35-44,1
1,1,0,0,1,2020-05-01,Female,66,65-69,1
1,4,0,0,4,2020-05-02,Female,18,15-19,1
1,1,0,0,1,2020-05-01,Female,66,65-69,1
1,0,1,0,1,2020-05-02,Female,63,55-64,1
1,1,4,0,5,2020-05-01,Male,68,65-69,1
1,4,0,0,4,2020-05-01,Female,14,10-14,1
1,3,1,0,4,2020-05-01,Female,60,55-64,1
1,1,2,0,3,2020-05-06,Male,61,55-64,1
1,1,0,0,1,2020-05-03,Male,47,45-54,1
1,1,0,0,1,2020-04-30,Female,53,45-54,1
1,4,3,0,7,2020-05-01,Male,33,25-34,1
1,1,0,0,1,2020-05-06,Female,4,1-4,1
1,0,0,0,0,2020-05-01,Female,65,65-69,1
1,2,1,0,3,2020-05-04,Male,13,10-14,1
1,1,0,0,1,2020-05-01,Male,72,70-74,1
1,0,0,0,0,2020-05-04,Male,38,35-44,1
1,0,0,0,0,2020-05-01,Female,55,55-64,1
1,2,0,0,2,2020-05-01,Female,70,70-74,1
1,4,0,0,4,2020-05-01,Male,53,45-54,1
1,2,0,0,2,2020-05-01,Male,47,45-54,1
1,2,1,0,3,2020-05-01,Male,68,65-69,1
1,3,0,0,3,2020-05-01,Male,18,15-19,1
1,2,0,0,2,2020-05-02,Female,31,25-34,1
1,0,4,0,4,2020-05-01,Male,36,35-44,1
1,2,1,0,3,2020-05-02,Male,39,35-44,1
1,0,0,0,0,2020-05-01,Male,40,35-44,1
1,1,0,0,1,2020-05-03,Female,25,25-34,1
1,2,0,0,2,2020-05-01,Male,61,55-64,1
1,1,3,0,4,2020-05-01,Female,68,65-69,1
1,0,0,0,0,2020-05-01,Female,69,65-69,1
1,2,0,0,2,2020-05-04,Female,33,25-34,1
1,1,1,0,2,2020-05-01,Female,70,70-74,1
1,1,0,0,1,2020-05-01,Male,67,65-69,1
1,4,0,0,4,2020-05-04,Female,63,55-64,1
1,0,3,0,3,2020-04-30,Male,28,25-34,1
1,1,0,0,1,2020-05-02,Male,50,45-54,1
1,4,0,0,4,2020-05-01,Female,53,45-54,1
1,4,1,0,5,2020-05-01,Male,7,5-9,1
1,1,0,0,1,2020-05-01,Female,60,55-64,1
1,0,0,0,0,2020-05-05,Male,41,35-44,1
1,2,0,0,2,2020-05-01,Female,68,65-69,1
1,3,0,0,3,2020-05-01,Female,68,65-69,1
1,2,0,0,2,2020-05-01,Male,64,55-64,1
1,0,0,0,0,2020-05-02,Male,48,45-54,1
1,1,0,0,1,2020-05-02,Female,83,80-84,1
1,1,0,0,1,2020-05-01,Male,65,65-69,1
1,2,2,0,4,2020-05-01,Male,75,75-79,1
1,3,0,0,3,2020-05-01,Male,66,65-69,1
1,0,0,0,0,2020-05-01,Male,64,55-64,1
1,3,0,0,3,2020-05-01,Female,67,65-69,1
1,0,0,0,0,2020-05-01,Female,73,70-74,1
1,2,0,0,2,2020-05-04,Female,18,15-19,1
1,0,0,0,0,2020-05-01,Male,67,65-69,1
1,1,0,0,1,2020-04-30,Male,74,70-74,1
1,4,0,0,4,2020-05-05,Male,9,5-9,1
1,1,0,0,1,2020-05-01,Male,52,45-54,1
1,3,0,0,3,2020-05-01,Female,44,35-44,1
1,1,0,0,1,2020-05-02,Male,31,25-34,1
1,3,0,0,3,2020-05-01,Male,11,10-14,1
1,2,0,0,2,2020-05-01,Male,14,10-14,1
1,0,0,0,0,2020-05-01,Female,51,45-54,1
1,4,0,0,4,2020-05-01,Male,14,10-14,1
1,0,1,0,1,2020-05-01,Female,59,55-64,1
1,2,0,0,2,2020-05-01,Male,11,10-14,1
1,0,0,0,0,2020-05-03,Male,46,45-54,1
1,1,0,0,1,2020-05-06,Male,81,80-84,1
1,3,0,0,3,2020-05-06,Female,53,45-54,1
1,2,0,0,2,2020-05-01,Male,59,55-64,1
1,0,0,0,0,2020-05-01,Female,19,15-19,1
1,2,0,0,2,2020-05-01,Female,52,45-54,1
1,0,0,0,0,2020-05-01,Male,15,15-19,1
1,2,0,0,2,2020-05-01,Male,70,70-74,1
1,0,0,0,0,2020-05-02,Male,34,25-34,1
1,7,0,0,7,2020-05-06,Female,4,1-4,1
1,0,1,0,1,2020-05-01,Female,53,45-54,1
1,0,0,0,0,2020-05-02,Female,36,35-44,1
1,2,0,0,2,2020-05-06,Female,34,25-34,1
1,2,0,0,2,2020-05-01,Male,64,55-64,1
1,0,0,0,0,2020-05-01,Female,45,45-54,1
1,3,0,0,3,2020-05-01,Female,2,1-4,1
1,4,0,0,4,2020-05-01,Female,23,20-24,1
1,4,7,0,11,2020-05-01,Male,22,20-24,1
1,3,0,0,3,2020-05-01,Female,3,1-4,1
1,3,0,0,3,2020-05-02,Female,16,15-19,1
1,0,0,0,0,2020-05-03,Male,51,45-54,1
1,0,0,0,0,2020-05-01,Male,67,65-69,1
1,1,0,0,1,2020-05-01,Male,62,55-64,1
1,2,0,0,2,2020-05-01,Male,40,35-44,1
1,1,1,0,2,2020-05-01,Male,64,55-64,1
1,2,1,0,3,2020-05-01,Male,49,45-54,1
1,2,0,0,2,2020-05-01,Female,69,65-69,1
1,1,1,0,2,2020-05-01,Female,85,85+,1
1,0,0,0,0,2020-05-01,Male,58,55-64,1
1,1,0,0,1,2020-05-01,Male,50,45-54,1
1,3,4,0,7,2020-05-01,Female,66,65-69,1
1,2,3,0,5,2020-05-01,Male,75,75-79,1
1,1,3,0,4,2020-05-01,Male,78,75-79,1
1,0,0,0,0,2020-05-04,Male,32,25-34,1
1,2,0,0,2,2020-05-06,Male,77,75-79,1
1,1,1,0,2,2020-05-01,Male,51,45-54,1
1,0,6,0,6,2020-05-02,Female,66,65-69,1
1,2,0,0,2,2020-05-01,Male,54,45-54,1
1,0,0,0,0,2020-05-01,Female,25,25-34,1
1,0,0,0,0,2020-04-30,Female,68,65-69,1
1,2,2,0,4,2020-05-01,Female,77,75-79,1
1,0,0,0,0,2020-05-01,Male,23,20-24,1
1,2,4,0,6,2020-05-01,Male,68,65-69,1
1,3,0,0,3,2020-05-01,Male,47,45-54,1
1,1,0,0,1,2020-05-04,Female,33,25-34,1
1,3,0,0,3,2020-05-01,Male,53,45-54,1
1,1,0,0,1,2020-05-01,Male,58,55-64,1
1,2,1,0,3,2020-05-01,Female,14,10-14,1
1,0,0,0,0,2020-05-01,Male,37,35-44,1
1,4,0,0,4,2020-05-04,Female,19,15-19,1
1,0,0,0,0,2020-05-04,Male,29,25-34,1
1,0,0,0,0,2020-05-04,Male,53,45-54,1
1,0,0,0,0,2020-05-01,Female,71,70-74,1
1,4,0,0,4,2020-05-05,Female,9,5-9,1
1,2,4,0,6,2020-05-01,Female,52,45-54,1
1,0,0,0,0,2020-05-03,Female,66,65-69,1
1,2,0,0,2,2020-05-02,Female,65,65-69,1
1,2,0,0,2,2020-05-01,Female,78,75-79,1
1,1,0,0,1,2020-05-01,Female,66,65-69,1
1,0,1,0,1,2020-05-01,Male,53,45-54,1
1,2,0,0,2,2020-05-06,Female,29,25-34,1
1,0,0,0,0,2020-05-01,Male,65,65-69,1
1,3,0,0,3,2020-05-06,Female,2,1-4,1
1,0,0,0,0,2020-05-01,Female,69,65-69,1
1,0,0,0,0,2020-05-01,Female,75,75-79,1
1,1,0,0,1,2020-05-01,Male,70,70-74,1
1,0,0,0,0,2020-05-01,Male,19,15-19,1
1,4,0,0,4,2020-05-01,Male,11,10-14,1
1,2,0,0,2,2020-05-01,Male,60,55-64,1
1,1,0,0,1,2020-05-04,Male,31,25-34,1
1,1,0,0,1,2020-05-02,Female,50,45-54,1
1,0,1,0,1,2020-05-01,Female,54,45-54,1
1,2,0,0,2,2020-05-01,Female,70,70-74,1
1,0,1,0,1,2020-05-01,Female,19,15-19,1
1,1,1,0,2,2020-05-01,Male,68,65-69,1
1,1,0,0,1,2020-05-01,Female,39,35-44,1
1,0,1,0,1,2020-05-01,Female,60,55-64,1
1,0,4,0,4,2020-05-03,Female,65,65-69,1
1,0,0,0,0,2020-05-04,Male,51,45-54,1
1,1,0,0,1,2020-05-01,Female,49,45-54,1
1,2,0,0,2,2020-05-02,Male,65,65-69,1
1,0,0,0,0,2020-05-01,Male,73,70-74,1
1,4,0,0,4,2020-05-01,Female,18,15-19,1
1,0,0,0,0,2020-05-06,Male,36,35-44,1
1,0,0,0,0,2020-05-06,Male,66,65-69,1
1,2,0,0,2,2020-05-01,Female,11,10-14,1
1,1,2,0,3,2020-05-02,Male,5,5-9,1
1,0,0,0,0,2020-05-01,Female,69,65-69,1
1,0,0,0,0,2020-05-01,Female,58,55-64,1
1,1,0,0,1,2020-05-05,Female,26,25-34,1
1,2,1,0,3,2020-05-01,Male,75,75-79,1
1,1,0,0,1,2020-05-01,Female,52,45-54,1
1,1,7,0,8,2020-05-01,Male,73,70-74,1
1,2,0,0,2,2020-05-04,Male,51,45-54,1
1,1,1,0,2,2020-05-04,Female,9,5-9,1
1,0,0,0,0,2020-05-01,Female,20,20-24,1
1,2,0,0,2,2020-05-04,Female,22,20-24,1
1,4,1,0,5,2020-05-01,Male,62,55-64,1
1,2,0,0,2,2020-05-04,Male,28,25-34,1
1,0,5,0,5,2020-04-30,Male,52,45-54,1
1,1,0,0,1,2020-05-01,Female,52,45-54,1
1,1,0,0,1,2020-05-01,Male,66,65-69,1
1,2,0,0,2,2020-05-04,Male,54,45-54,1
1,3,0,0,3,2020-05-01,Female,6,5-9,1
1,0,0,0,0,2020-05-01,Female,65,65-69,1
1,2,0,0,2,2020-05-01,Male,64,55-64,1
1,2,0,0,2,2020-05-01,Female,52,45-54,1
1,0,0,0,0,2020-05-01,Male,85,85+,1
1,0,0,0,0,2020-04-30,Female,70,70-74,1
1,1,0,0,1,2020-05-06,Male,39,35-44,1
1,4,0,0,4,2020-05-01,Male,14,10-14,1
1,0,0,0,0,2020-05-01,Male,29,25-34,1
1,1,0,0,1,2020-05-01,Male,67,65-69,1
1,0,0,0,0,2020-05-01,Female,56,55-64,1
1,0,0,0,0,2020-05-01,Female,85,85+,1
1,0,0,0,0,2020-05-01,Female,69,65-69,1
1,2,2,0,4,2020-05-03,Male,4,1-4,1
1,0,0,0,0,2020-05-01,Male,51,45-54,1
1,0,1,0,1,2020-05-01,Male,54,45-54,1
1,1,1,0,2,2020-05-01,Female,9,5-9,1
1,2,1,0,3,2020-05-01,Male,66,65-69,1
1,1,0,0,1,2020-05-01,Male,50,45-54,1
1,3,0,0,3,2020-05-01,Female,4,1-4,1
1,0,3,0,3,2020-05-01,Male,45,45-54,1
1,4,1,0,5,2020-05-04,Female,1,1-4,1
1,1,0,0,1,2020-05-06,Female,43,35-44,1
1,0,5,0,5,2020-05-04,Male,37,35-44,1
1,3,0,0,3,2020-05-04,Male,49,45-54,1
1,1,0,0,1,2020-05-01,Male,59,55-64,1
1,2,0,0,2,2020-05-01,Male,14,10-14,1
1,1,2,0,3,2020-05-01,Female,57,55-64,1
1,0,0,0,0,2020-05-03,Male,3,1-4,1
1,2,0,0,2,2020-05-01,Male,63,55-64,1
1,1,0,0,1,2020-05-04,Female,52,45-54,1
1,2,0,0,2,2020-05-04,Female,45,45-54,1
1,2,0,0,2,2020-05-01,Male,7,5-9,1
1,3,0,0,3,2020-05-01,Male,59,55-64,1
1,4,0,0,4,2020-05-01,Female,5,5-9,1
1,0,1,0,1,2020-05-01,Female,49,45-54,1
1,0,0,0,0,2020-05-02,Male,65,65-69,1
1,0,0,0,0,2020-04-30,Male,57,55-64,1
1,1,1,0,2,2020-05-01,Female,65,65-69,1
1,2,0,0,2,2020-05-02,Female,29,25-34,1
1,2,0,0,2,2020-05-02,Male,1,1-4,1
1,1,0,0,1,2020-05-01,Male,51,45-54,1
1,4,0,0,4,2020-05-02,Female,1,1-4,1
1,4,0,0,4,2020-05-03,Male,13,10-14,1
1,3,0,0,3,2020-05-05,Female,24,20-24,1
1,4,0,0,4,2020-05-04,Male,12,10-14,1
1,2,5,0,7,2020-05-01,Male,50,45-54,1
1,1,2,0,3,2020-05-01,Female,65,65-69,1
1,1,0,0,1,2020-05-02,Male,45,45-54,1
1,0,0,0,0,2020-05-01,Male,73,70-74,1
1,2,0,0,2,2020-05-04,Male,54,45-54,1
1,0,0,0,0,2020-05-01,Female,68,65-69,1
1,1,1,0,2,2020-05-04,Female,78,75-79,1
1,1,0,0,1,2020-05-01,Male,67,65-69,1
1,3,0,0,3,2020-05-04,Male,17,15-19,1
1,0,0,0,0,2020-05-01,Male,77,75-79,1
1,1,0,0,1,2020-05-01,Male,85,85+,1
1,2,0,0,2,2020-05-03,Female,55,55-64,1
1,1,0,0,1,2020-05-01,Male,55,55-64,1
1,2,0,0,2,2020-05-06,Female,63,55-64,1
1,0,0,0,0,2020-05-01,Female,76,75-79,1
1,2,0,0,2,2020-05-01,Male,65,65-69,1
1,2,0,0,2,2020-05-01,Male,59,55-64,1
1,0,0,0,0,2020-05-04,Male,32,25-34,1
1,1,0,0,1,2020-05-04,Male,34,25-34,1
1,1,2,0,3,2020-05-01,Male,62,55-64,1
1,1,0,0,1,2020-05-01,Female,67,65-69,1
1,0,0,0,0,2020-05-01,Female,24,20-24,1
1,1,0,0,1,2020-05-06,Male,67,65-69,1
1,1,1,0,2,2020-05-01,Male,51,45-54,1
1,2,0,0,2,2020-05-01,Male,55,55-64,1
1,2,0,0,2,2020-05-04,Male,12,10-14,1
1,1,0,0,1,2020-05-04,Female,65,65-69,1
1,2,0,0,2,2020-05-01,Male,29,25-34,1
1,3,0,0,3,2020-05-04,Female,18,15-19,1
1,0,1,0,1,2020-05-01,Female,48,45-54,1
1,0,0,0,0,2020-05-01,Male,69,65-69,1
1,2,0,0,2,2020-05-01,Female,63,55-64,1
1,0,0,0,0,2020-05-04,Female,65,65-69,1
1,2,0,0,2,2020-05-06,Male,11,10-14,1
1,2,0,0,2,2020-05-01,Female,54,45-54,1
1,3,4,0,7,2020-05-01,Female,36,35-44,1
1,2,0,0,2,2020-05-01,Female,60,55-64,1
1,0,1,0,1,2020-05-04,Male,13,10-14,1
1,2,1,0,3,2020-05-01,Male,70,70-74,1
1,1,0,0,1,2020-05-01,Male,52,45-54,1
1,2,0,0,2,2020-05-01,Male,50,45-54,1
1,0,5,0,5,2020-05-01,Female,65,65-69,1
1,0,0,0,0,2020-05-01,Female,69,65-69,1
1,0,0,0,0,2020-05-01,Female,66,65-69,1
1,0,0,0,0,2020-05-04,Female,32,25-34,1
1,4,0,0,4,2020-05-02,Female,7,5-9,1
1,0,0,0,0,2020-05-01,Female,52,45-54,1
1,4,2,0,6,2020-04-30,Female,45,45-54,1
1,0,0,0,0,2020-05-04,Male,54,45-54,1
1,5,0,0,5,2020-05-04,Male,3,1-4,1
1,6,2,0,8,2020-05-01,Female,18,15-19,1
1,2,0,0,2,2020-05-01,Male,16,15-19,1
1,2,0,0,2,2020-05-01,Female,55,55-64,1
1,0,0,0,0,2020-05-01,Female,67,65-69,1
1,3,1,0,4,2020-05-01,Male,39,35-44,1
1,0,2,0,2,2020-05-03,Male,38,35-44,1
1,4,0,0,4,2020-05-04,Female,15,15-19,1
1,1,2,0,3,2020-05-01,Female,62,55-64,1
1,3,1,0,4,2020-05-01,Female,19,15-19,1
1,3,0,0,3,2020-05-02,Male,40,35-44,1
1,1,0,0,1,2020-05-01,Male,10,10-14,1
1,2,0,0,2,2020-05-01,Female,5,5-9,1
1,0,0,0,0,2020-05-01,Male,65,65-69,1
1,0,0,0,0,2020-05-04,Male,30,25-34,1
1,0,0,0,0,2020-05-01,Male,60,55-64,1
1,2,0,0,2,2020-05-04,Female,1,1-4,1
1,0,0,0,0,2020-05-01,Female,56,55-64,1
1,2,1,0,3,2020-05-01,Male,70,70-74,1
1,3,0,0,3,2020-05-04,Female,14,10-14,1
1,2,0,0,2,2020-05-01,Male,62,55-64,1
1,1,1,0,2,2020-05-01,Male,67,65-69,1
1,1,0,0,1,2020-05-01,Female,57,55-64,1
1,2,0,0,2,2020-05-01,Male,39,35-44,1
1,3,2,0,5,2020-05-01,Male,64,55-64,1
1,0,1,0,1,2020-05-01,Male,56,55-64,1
1,1,0,0,1,2020-05-01,Male,6,5-9,1
1,2,0,0,2,2020-05-02,Female,55,55-64,1
1,0,0,0,0,2020-05-03,Male,57,55-64,1
1,0,0,0,0,2020-05-02,Female,66,65-69,1
1,2,0,0,2,2020-05-05,Female,21,20-24,1
1,1,0,0,1,2020-05-01,Male,30,25-34,1
1,2,2,0,4,2020-05-01,Male,61,55-64,1
1,0,0,0,0,2020-05-01,Male,65,65-69,1
1,0,0,0,0,2020-05-01,Male,38,35-44,1
1,2,0,0,2,2020-05-02,Female,13,10-14,1
1,2,3,0,5,2020-05-01,Male,30,25-34,1
1,2,0,0,2,2020-05-04,Female,58,55-64,1
1,4,1,0,5,2020-05-04,Female,17,15-19,1
1,4,0,0,4,2020-05-01,Male,13,10-14,1
1,2,0,0,2,2020-05-01,Male,78,75-79,1
1,2,0,0,2,2020-05-04,Female,33,25-34,1
1,1,0,0,1,2020-05-01,Female,65,65-69,1
1,6,0,0,6,2020-05-01,Female,10,10-14,1
1,2,0,0,2,2020-05-01,Male,63,55-64,1
1,1,0,0,1,2020-05-04,Female,51,45-54,1
1,4,2,0,6,2020-04-30,Female,16,15-19,1
1,2,0,0,2,2020-05-01,Female,58,55-64,1
1,4,0,0,4,2020-05-04,Female,8,5-9,1
1,3,1,0,4,2020-05-01,Male,58,55-64,1
1,2,0,0,2,2020-05-06,Female,55,55-64,1
1,2,0,0,2,2020-05-05,Male,22,20-24,1
1,0,0,0,0,2020-05-01,Female,61,55-64,1
1,0,0,0,0,2020-05-01,Male,50,45-54,1
1,2,0,0,2,2020-05-02,Male,53,45-54,1
1,2,0,0,2,2020-05-04,Male,73,70-74,1
1,0,1,0,1,2020-05-03,Female,66,65-69,1
1,2,0,0,2,2020-05-01,Male,55,55-64,1
1,3,2,0,5,2020-05-01,Male,39,35-44,1
1,3,1,0,4,2020-05-04,Female,48,45-54,1
1,0,0,0,0,2020-05-01,Male,59,55-64,1
1,0,6,0,6,2020-04-30,Female,58,55-64,1
1,1,0,0,1,2020-05-01,Male,32,25-34,1
1,1,0,0,1,2020-05-01,Female,48,45-54,1
1,5,0,0,5,2020-05-02,Female,0,<1,1
1,1,1,0,2,2020-05-01,Male,48,45-54,1
1,0,0,0,0,2020-05-05,Female,23,20-24,1
1,2,0,0,2,2020-05-01,Male,27,25-34,1
1,1,0,0,1,2020-05-01,Male,47,45-54,1
1,3,5,0,8,2020-05-01,Female,52,45-54,1
1,0,0,0,0,2020-05-04,Female,49,45-54,1
1,0,0,0,0,2020-05-01,Female,8,5-9,1
1,1,0,0,1,2020-05-01,Female,40,35-44,1
1,1,1,0,2,2020-05-01,Male,72,70-74,1
1,0,0,0,0,2020-05-02,Male,54,45-54,1
1,2,0,0,2,2020-05-02,Female,56,55-64,1
1,2,0,0,2,2020-05-03,Male,32,25-34,1
1,2,0,0,2,2020-05-06,Female,50,45-54,1
1,0,0,0,0,2020-05-04,Female,30,25-34,1
1,2,3,0,5,2020-05-03,Male,62,55-64,1
1,0,0,0,0,2020-05-02,Male,48,45-54,1
1,0,0,0,0,2020-05-01,Male,51,45-54,1
1,0,0,0,0,2020-04-30,Male,35,35-44,1
1,0,3,0,3,2020-05-01,Female,72,70-74,1
1,1,0,0,1,2020-05-03,Female,54,45-54,1
1,0,2,0,2,2020-05-01,Male,68,65-69,1
1,2,0,0,2,2020-05-01,Male,70,70-74,1
1,1,1,0,2,2020-05-01,Male,58,55-64,1
1,0,0,0,0,2020-05-01,Male,46,45-54,1
1,0,3,0,3,2020-05-04,Female,30,25-34,1
1,0,3,0,3,2020-05-01,Male,60,55-64,1
1,1,2,0,3,2020-05-02,Female,68,65-69,1
1,2,1,0,3,2020-05-04,Male,23,20-24,1
1,1,1,0,2,2020-05-01,Male,67,65-69,1
1,1,0,0,1,2020-05-02,Male,15,15-19,1
1,2,0,0,2,2020-05-01,Male,34,25-34,1
1,3,0,0,3,2020-05-04,Female,4,1-4,1
1,2,0,0,2,2020-05-01,Male,64,55-64,1
1,1,0,0,1,2020-05-01,Female,22,20-24,1
1,4,0,0,4,2020-05-04,Male,26,25-34,1
1,0,0,0,0,2020-05-03,Female,40,35-44,1
1,0,1,0,1,2020-05-01,Male,58,55-64,1
1,1,0,0,1,2020-05-05,Male,36,35-44,1
1,3,0,0,3,2020-05-02,Female,53,45-54,1
1,1,8,0,9,2020-05-01,Female,42,35-44,1
1,1,3,0,4,2020-05-04,Female,33,25-34,1
1,2,0,0,2,2020-05-02,Female,31,25-34,1
1,0,0,0,0,2020-05-01,Female,52,45-54,1
1,0,0,0,0,2020-05-04,Female,45,45-54,1
1,0,0,0,0,2020-05-01,Male,49,45-54,1
1,1,0,0,1,2020-05-03,Female,27,25-34,1
1,2,1,0,3,2020-05-05,Female,12,10-14,1
1,1,3,0,4,2020-05-01,Male,54,45-54,1
1,2,1,0,3,2020-05-02,Female,68,65-69,1
1,2,0,0,2,2020-05-01,Female,51,45-54,1
1,0,1,0,1,2020-05-01,Female,69,65-69,1
1,6,0,0,6,2020-05-05,Male,4,1-4,1
1,2,0,0,2,2020-05-02,Male,50,45-54,1
1,4,0,0,4,2020-05-01,Male,19,15-19,1
1,1,1,0,2,2020-05-02,Male,57,55-64,1
1,0,0,0,0,2020-05-06,Female,19,15-19,1
1,4,0,0,4,2020-05-01,Female,59,55-64,1
1,2,0,0,2,2020-05-01,Male,30,25-34,1
1,3,0,0,3,2020-05-01,Female,50,45-54,1
1,0,0,0,0,2020-05-04,Male,21,20-24,1
1,1,0,0,1,2020-05-01,Female,28,25-34,1
1,5,1,0,6,2020-05-02,Female,18,15-19,1
1,3,1,0,4,2020-05-01,Female,55,55-64,1
1,3,0,0,3,2020-05-01,Female,66,65-69,1
1,1,0,0,1,2020-05-06,Male,53,45-54,1
1,0,0,0,0,2020-05-01,Male,51,45-54,1
1,1,0,0,1,2020-05-04,Female,61,55-64,1
1,2,0,0,2,2020-05-03,Female,58,55-64,1
1,1,2,0,3,2020-05-01,Male,64,55-64,1
1,1,1,0,2,2020-05-01,Female,49,45-54,1
1,1,0,0,1,2020-05-03,Female,50,45-54,1
1,0,0,0,0,2020-05-03,Male,59,55-64,1
1,1,0,0,1,2020-05-02,Male,59,55-64,1
1,0,0,0,0,2020-05-04,Male,35,35-44,1
1,3,1,0,4,2020-05-01,Male,8,5-9,1
1,1,0,0,1,2020-05-01,Female,68,65-69,1
1,2,1,0,3,2020-05-01,Male,54,45-54,1
1,0,0,0,0,2020-05-01,Female,25,25-34,1
1,3,0,0,3,2020-05-01,Female,54,45-54,1
1,1,0,0,1,2020-05-01,Female,59,55-64,1
1,3,0,0,3,2020-05-01,Male,31,25-34,1
1,0,1,0,1,2020-05-01,Male,65,65-69,1
1,1,0,0,1,2020-05-01,Female,39,35-44,1
1,0,0,0,0,2020-05-01,Female,65,65-69,1
1,0,0,0,0,2020-05-01,Female,75,75-79,1
1,2,1,0,3,2020-04-30,Male,69,65-69,1
1,1,0,0,1,2020-05-02,Male,33,25-34,1
1,2,1,0,3,2020-05-01,Male,61,55-64,1
1,0,0,0,0,2020-05-01,Female,59,55-64,1
1,1,0,0,1,2020-05-01,Female,61,55-64,1
1,4,0,0,4,2020-05-01,Male,25,25-34,1
1,3,2,0,5,2020-05-06,Female,65,65-69,1
1,1,1,0,2,2020-05-01,Male,78,75-79,1
1,0,0,0,0,2020-05-01,Male,67,65-69,1
1,0,0,0,0,2020-05-01,Female,64,55-64,1
1,0,1,0,1,2020-05-01,Female,59,55-64,1
1,1,0,0,1,2020-05-01,Male,58,55-64,1
1,0,0,0,0,2020-05-06,Male,69,65-69,1
1,1,0,0,1,2020-05-01,Male,68,65-69,1
1,1,1,0,2,2020-05-01,Male,69,65-69,1
1,2,0,0,2,2020-05-01,Male,50,45-54,1
1,0,0,0,0,2020-05-01,Male,66,65-69,1
1,3,0,0,3,2020-05-04,Male,8,5-9,1
1,2,0,0,2,2020-04-30,Male,71,70-74,1
1,3,0,0,3,2020-05-04,Female,70,70-74,1
1,2,0,0,2,2020-05-01,Female,77,75-79,1
1,2,0,0,2,2020-05-01,Male,71,70-74,1
1,3,0,0,3,2020-05-01,Female,17,15-19,1
1,3,0,0,3,2020-05-05,Male,37,35-44,1
1,2,2,0,4,2020-05-02,Female,38,35-44,1
1,2,0,0,2,2020-05-04,Female,57,55-64,1
1,2,0,0,2,2020-05-01,Male,55,55-64,1
1,4,0,0,4,2020-05-04,Male,15,15-19,1
1,0,0,0,0,2020-05-01,Male,29,25-34,1
1,0,0,0,0,2020-05-04,Male,39,35-44,1
1,1,1,0,2,2020-05-01,Male,77,75-79,1
1,0,0,0,0,2020-05-01,Female,68,65-69,1
1,0,0,0,0,2020-05-05,Male,22,20-24,1
1,2,0,0,2,2020-05-03,Male,66,65-69,1
1,0,0,0,0,2020-04-30,Female,28,25-34,1
1,3,0,0,3,2020-05-05,Female,31,25-34,1
1,2,0,0,2,2020-05-03,Female,48,45-54,1
1,0,0,0,0,2020-05-01,Female,67,65-69,1
1,2,0,0,2,2020-04-30,Female,49,45-54,1
1,1,0,0,1,2020-05-01,Male,61,55-64,1
1,5,1,0,6,2020-05-01,Female,15,15-19,1
1,0,0,0,0,2020-05-01,Male,22,20-24,1
1,2,0,0,2,2020-05-01,Male,59,55-64,1
1,2,1,0,3,2020-05-01,Male,25,25-34,1
1,2,1,0,3,2020-05-02,Female,67,65-69,1
1,1,0,0,1,2020-05-04,Male,47,45-54,1
1,0,0,0,0,2020-05-01,Male,69,65-69,1
1,5,0,0,5,2020-05-04,Female,7,5-9,1
1,0,9,0,9,2020-05-01,Male,59,55-64,1
1,2,1,0,3,2020-05-04,Male,43,35-44,1
1,3,1,0,4,2020-05-04,Male,30,25-34,1
1,0,0,0,0,2020-05-01,Female,60,55-64,1
1,0,0,0,0,2020-05-01,Male,52,45-54,1
1,2,0,0,2,2020-05-01,Female,33,25-34,1
1,4,0,0,4,2020-05-04,Female,0,<1,1
1,0,1,0,1,2020-05-01,Male,42,35-44,1
1,4,0,0,4,2020-05-01,Male,21,20-24,1
1,0,0,0,0,2020-05-04,Male,33,25-34,1
1,1,0,0,1,2020-05-04,Male,36,35-44,1
1,0,0,0,0,2020-05-03,Female,23,20-24,1
1,0,0,0,0,2020-05-01,Female,79,75-79,1
1,4,0,0,4,2020-05-02,Male,14,10-14,1
1,4,0,0,4,2020-05-04,Female,20,20-24,1
1,0,1,0,1,2020-05-02,Female,51,45-54,1
1,5,0,0,5,2020-05-01,Female,67,65-69,1
1,0,0,0,0,2020-05-02,Female,66,65-69,1
1,3,0,0,3,2020-05-01,Female,50,45-54,1
1,0,0,0,0,2020-05-01,Female,67,65-69,1
1,1,0,0,1,2020-05-01,Male,62,55-64,1
1,1,0,0,1,2020-05-01,Male,31,25-34,1
1,0,0,0,0,2020-05-04,Female,24,20-24,1
1,2,0,0,2,2020-05-01,Male,51,45-54,1
1,0,0,0,0,2020-05-01,Female,21,20-24,1
1,2,0,0,2,2020-05-01,Male,69,65-69,1
1,3,0,0,3,2020-05-01,Male,67,65-69,1
1,2,1,0,3,2020-05-01,Female,59,55-64,1
1,1,0,0,1,2020-05-03,Male,25,25-34,1
1,4,2,0,6,2020-05-06,Female,14,10-14,1
1,0,0,0,0,2020-05-01,Male,38,35-44,1
1,1,0,0,1,2020-05-01,Female,30,25-34,1
1,5,3,0,8,2020-05-04,Female,0,<1,1
1,0,1,0,1,2020-05-05,Male,32,25-34,1
1,1,0,0,1,2020-05-01,Male,67,65-69,1
1,0,1,0,1,2020-05-01,Male,46,45-54,1
1,1,0,0,1,2020-05-04,Female,54,45-54,1
1,0,3,0,3,2020-05-01,Female,65,65-69,1
1,1,1,0,2,2020-05-01,Female,68,65-69,1
1,2,0,0,2,2020-05-02,Female,24,20-24,1
1,0,0,0,0,2020-05-02,Female,67,65-69,1
1,2,1,0,3,2020-05-01,Male,45,45-54,1
1,0,0,0,0,2020-05-01,Female,65,65-69,1
1,1,0,0,1,2020-05-04,Male,65,65-69,1
1,3,0,0,3,2020-05-01,Male,18,15-19,1
1,4,0,0,4,2020-05-01,Male,10,10-14,1
1,1,0,0,1,2020-05-04,Female,22,20-24,1
1,3,0,0,3,2020-05-05,Male,27,25-34,1
1,4,0,0,4,2020-05-01,Female,19,15-19,1
1,2,3,0,5,2020-05-01,Male,15,15-19,1
1,2,0,0,2,2020-05-01,Male,12,10-14,1
1,1,0,0,1,2020-05-01,Female,45,45-54,1
1,0,0,0,0,2020-05-04,Female,21,20-24,1
1,1,0,0,1,2020-05-01,Male,46,45-54,1
1,1,0,0,1,2020-05-01,Male,73,70-74,1
1,2,0,0,2,2020-05-03,Male,59,55-64,1
1,3,0,0,3,2020-05-04,Female,57,55-64,1
1,2,0,0,2,2020-05-01,Female,29,25-34,1
1,3,0,0,3,2020-05-02,Male,34,25-34,1
1,1,0,0,1,2020-05-01,Female,73,70-74,1
1,0,0,0,0,2020-05-01,Male,23,20-24,1
1,6,2,0,8,2020-05-01,Male,15,15-19,1
1,2,0,0,2,2020-05-01,Male,75,75-79,1
1,1,7,0,8,2020-05-02,Male,31,25-34,1
1,0,0,0,0,2020-05-01,Male,68,65-69,1
1,2,1,0,3,2020-05-01,Male,57,55-64,1
1,2,0,0,2,2020-05-04,Male,26,25-34,1
1,3,0,0,3,2020-05-01,Female,19,15-19,1
1,2,0,0,2,2020-05-01,Female,66,65-69,1
1,2,1,0,3,2020-05-01,Female,67,65-69,1
1,1,0,0,1,2020-05-01,Female,69,65-69,1
1,2,0,0,2,2020-05-01,Male,50,45-54,1
1,2,9,0,11,2020-05-01,Female,67,65-69,1
1,0,0,0,0,2020-05-04,Female,22,20-24,1
1,1,0,0,1,2020-05-01,Male,71,70-74,1
1,2,0,0,2,2020-05-05,Male,18,15-19,1
1,1,0,0,1,2020-05-04,Male,65,65-69,1
1,1,0,0,1,2020-05-01,Female,62,55-64,1
1,0,0,0,0,2020-05-03,Female,23,20-24,1
1,0,0,0,0,2020-05-01,Male,65,65-69,1
1,0,0,0,0,2020-04-30,Male,70,70-74,1
1,1,0,0,1,2020-05-03,Female,26,25-34,1
1,0,0,0,0,2020-05-01,Male,65,65-69,1
1,2,0,0,2,2020-05-01,Male,62,55-64,1
1,0,0,0,0,2020-05-04,Female,35,35-44,1
1,0,0,0,0,2020-05-02,Female,68,65-69,1
1,2,0,0,2,2020-05-01,Female,68,65-69,1
1,0,0,0,0,2020-05-02,Female,26,25-34,1
1,1,0,0,1,2020-05-01,Male,71,70-74,1
1,0,12,0,12,2020-05-01,Female,62,55-64,1
1,1,0,0,1,2020-05-01,Female,35,35-44,1
1,6,0,0,6,2020-05-04,Female,16,15-19,1
1,4,0,0,4,2020-05-02,Male,1,1-4,1
1,2,3,0,5,2020-05-01,Female,64,55-64,1
1,0,0,0,0,2020-05-04,Female,61,55-64,1
1,0,0,0,0,2020-05-04,Male,54,45-54,1
1,4,1,0,5,2020-05-01,Male,54,45-54,1
1,0,0,0,0,2020-05-02,Male,69,65-69,1
1,0,0,0,0,2020-05-01,Female,66,65-69,1
1,0,0,0,0,2020-05-01,Male,17,15-19,1
1,1,1,0,2,2020-05-02,Female,29,25-34,1
1,2,0,0,2,2020-05-01,Female,59,55-64,1
1,0,0,0,0,2020-05-01,Male,36,35-44,1
1,1,0,0,1,2020-05-01,Female,65,65-69,1
1,3,2,0,5,2020-05-04,Female,24,20-24,1
1,0,0,0,0,2020-05-04,Female,30,25-34,1
1,0,0,0,0,2020-05-01,Female,63,55-64,1
1,0,1,0,1,2020-05-04,Female,46,45-54,1
1,0,0,0,0,2020-05-01,Male,60,55-64,1
1,3,0,0,3,2020-05-01,Male,56,55-64,1
1,0,0,0,0,2020-05-01,Male,30,25-34,1
1,4,1,0,5,2020-05-01,Female,11,10-14,1
1,1,10,0,11,2020-05-01,Male,42,35-44,1
1,0,0,0,0,2020-05-01,Male,48,45-54,1
1,2,0,0,2,2020-05-04,Male,65,65-69,1
1,0,0,0,0,2020-05-06,Female,39,35-44,1
1,0,1,0,1,2020-05-01,Female,63,55-64,1
1,5,0,0,5,2020-05-04,Male,13,10-14,1
1,1,0,0,1,2020-05-01,Female,66,65-69,1
1,3,2,0,5,2020-05-01,Female,60,55-64,1
1,0,0,0,0,2020-05-06,Male,44,35-44,1
1,0,0,0,0,2020-05-04,Female,55,55-64,1
1,2,0,0,2,2020-05-02,Female,30,25-34,1
1,0,0,0,0,2020-05-01,Female,61,55-64,1
1,2,0,0,2,2020-05-04,Male,43,35-44,1
1,2,2,0,4,2020-05-01,Male,59,55-64,1
1,1,3,0,4,2020-05-01,Female,67,65-69,1
1,1,0,0,1,2020-05-02,Female,55,55-64,1
1,0,0,0,0,2020-05-02,Female,67,65-69,1
1,0,0,0,0,2020-05-04,Male,50,45-54,1
1,2,2,0,4,2020-05-01,Male,38,35-44,1
1,1,0,0,1,2020-05-04,Male,22,20-24,1
1,1,0,0,1,2020-05-06,Female,70,70-74,1
1,2,0,0,2,2020-05-01,Male,66,65-69,1
1,2,0,0,2,2020-05-01,Male,56,55-64,1
1,0,1,0,1,2020-05-01,Female,54,45-54,1
1,0,0,0,0,2020-05-01,Female,19,15-19,1
1,0,0,0,0,2020-05-01,Male,73,70-74,1
1,0,0,0,0,2020-05-02,Female,33,25-34,1
1,2,0,0,2,2020-05-01,Male,52,45-54,1
1,2,0,0,2,2020-04-30,Male,67,65-69,1
1,0,0,0,0,2020-05-01,Male,33,25-34,1
1,0,2,0,2,2020-05-01,Female,37,35-44,1
1,2,0,0,2,2020-05-04,Male,16,15-19,1
1,2,0,0,2,2020-05-01,Male,56,55-64,1
1,4,0,0,4,2020-05-05,Male,3,1-4,1
1,0,0,0,0,2020-05-04,Male,23,20-24,1
1,0,0,0,0,2020-04-30,Male,62,55-64,1
1,2,0,0,2,2020-05-01,Female,55,55-64,1
1,3,0,0,3,2020-05-06,Male,34,25-34,1
1,1,1,0,2,2020-05-01,Male,75,75-79,1
1,2,0,0,2,2020-05-04,Female,22,20-24,1
1,0,2,0,2,2020-05-01,Female,33,25-34,1
1,0,2,0,2,2020-05-03,Male,56,55-64,1
1,1,0,0,1,2020-05-02,Female,25,25-34,1
1,3,5,0,8,2020-05-01,Female,37,35-44,1
1,0,0,0,0,2020-05-01,Female,32,25-34,1
1,2,0,0,2,2020-05-02,Female,69,65-69,1
1,0,0,0,0,2020-05-03,Male,36,35-44,1
1,3,0,0,3,2020-05-04,Female,42,35-44,1
1,2,0,0,2,2020-05-02,Female,70,70-74,1
1,1,1,0,2,2020-05-06,Female,54,45-54,1
1,1,2,0,3,2020-05-06,Female,23,20-24,1
1,0,0,0,0,2020-04-30,Female,68,65-69,1
1,3,0,0,3,2020-05-03,Female,36,35-44,1
1,2,1,0,3,2020-04-30,Male,69,65-69,1
1,2,0,0,2,2020-05-03,Male,70,70-74,1
1,3,3,0,6,2020-05-06,Female,50,45-54,1
1,4,3,0,7,2020-05-01,Male,37,35-44,1
1,3,0,0,3,2020-05-01,Male,53,45-54,1
1,1,0,0,1,2020-05-04,Female,10,10-14,1
1,5,1,0,6,2020-05-01,Female,7,5-9,1
1,0,1,0,1,2020-05-01,Male,54,45-54,1
1,1,0,0,1,2020-05-05,Male,31,25-34,1
1,1,0,0,1,2020-05-04,Female,31,25-34,1
1,3,0,0,3,2020-05-01,Female,5,5-9,1
1,1,0,0,1,2020-05-04,Male,21,20-24,1
1,0,0,0,0,2020-05-01,Male,44,35-44,1
1,0,0,0,0,2020-05-01,Female,67,65-69,1
1,1,0,0,1,2020-05-01,Female,58,55-64,1
1,0,1,0,1,2020-05-01,Female,53,45-54,1
1,3,0,0,3,2020-05-01,Male,69,65-69,1
1,4,2,0,6,2020-05-06,Female,3,1-4,1
1,2,0,0,2,2020-05-04,Female,56,55-64,1
1,0,0,0,0,2020-05-03,Female,40,35-44,1
1,3,0,0,3,2020-05-03,Female,15,15-19,1
1,0,0,0,0,2020-05-01,Female,63,55-64,1
1,4,0,0,4,2020-05-01,Female,10,10-14,1
1,3,0,0,3,2020-05-01,Male,39,35-44,1
1,2,0,0,2,2020-05-01,Female,69,65-69,1
1,4,0,0,4,2020-05-04,Female,19,15-19,1
1,0,0,0,0,2020-05-04,Male,22,20-24,1
1,2,0,0,2,2020-05-01,Male,57,55-64,1
1,0,0,0,0,2020-05-01,Male,22,20-24,1
1,0,0,0,0,2020-05-01,Male,81,80-84,1
1,2,0,0,2,2020-05-01,Male,63,55-64,1
1,2,0,0,2,2020-05-01,Female,68,65-69,1
1,3,0,0,3,2020-05-01,Female,52,45-54,1
1,0,0,0,0,2020-05-01,Male,37,35-44,1
1,1,0,0,1,2020-05-01,Male,78,75-79,1
1,3,0,0,3,2020-05-01,Female,42,35-44,1
1,1,1,0,2,2020-05-04,Male,49,45-54,1
1,2,0,0,2,2020-05-04,Male,50,45-54,1
1,0,1,0,1,2020-05-01,Male,77,75-79,1
1,3,0,0,3,2020-05-01,Male,66,65-69,1
1,2,0,0,2,2020-05-05,Male,33,25-34,1
1,2,3,0,5,2020-05-01,Female,66,65-69,1
1,4,1,0,5,2020-05-01,Female,55,55-64,1
1,1,0,0,1,2020-05-01,Male,36,35-44,1
1,3,0,0,3,2020-05-01,Female,13,10-14,1
1,2,0,0,2,2020-05-03,Female,37,35-44,1
1,2,5,0,7,2020-05-06,Male,7,5-9,1
1,0,0,0,0,2020-05-01,Male,47,45-54,1
1,2,3,0,5,2020-05-01,Male,17,15-19,1
1,2,6,0,8,2020-05-01,Female,18,15-19,1
1,1,1,0,2,2020-05-01,Female,67,65-69,1
1,0,0,0,0,2020-05-01,Male,39,35-44,1
1,1,3,0,4,2020-05-01,Female,65,65-69,1
1,0,0,0,0,2020-05-01,Male,37,35-44,1
1,0,0,0,0,2020-05-01,Female,39,35-44,1
1,2,0,0,2,2020-05-01,Male,73,70-74,1
1,2,0,0,2,2020-05-01,Female,65,65-69,1
1,0,0,0,0,2020-05-01,Male,15,15-19,1
1,1,0,0,1,2020-05-01,Female,67,65-69,1
1,4,0,0,4,2020-05-01,Female,6,5-9,1
1,3,0,0,3,2020-05-01,Male,15,15-19,1
1,3,0,0,3,2020-05-04,Male,11,10-14,1
1,2,0,0,2,2020-05-03,Male,24,20-24,1
1,0,6,0,6,2020-05-01,Female,65,65-69,1
1,3,0,0,3,2020-05-01,Male,74,70-74,1
1,0,0,0,0,2020-05-01,Male,57,55-64,1
1,0,2,0,2,2020-05-04,Male,40,35-44,1
1,0,2,0,2,2020-05-01,Male,44,35-44,1
1,1,0,0,1,2020-05-01,Female,19,15-19,1
1,4,1,0,5,2020-04-30,Male,1,1-4,1
1,4,0,0,4,2020-05-05,Female,17,15-19,1
1,4,3,0,7,2020-05-01,Male,61,55-64,1
1,2,0,0,2,2020-05-01,Female,14,10-14,1
1,2,1,0,3,2020-05-04,Male,66,65-69,1
1,0,0,0,0,2020-05-01,Female,58,55-64,1
1,2,1,0,3,2020-05-01,Female,51,45-54,1
1,2,0,0,2,2020-05-02,Female,57,55-64,1
1,1,2,0,3,2020-05-01,Male,71,70-74,1
1,2,0,0,2,2020-05-05,Male,39,35-44,1
1,2,0,0,2,2020-05-01,Female,59,55-64,1
1,3,0,0,3,2020-05-01,Male,11,10-14,1
1,1,0,0,1,2020-05-03,Female,61,55-64,1
1,2,0,0,2,2020-05-01,Female,18,15-19,1
1,2,0,0,2,2020-05-04,Male,54,45-54,1
1,1,0,0,1,2020-05-04,Female,49,45-54,1
1,2,7,0,9,2020-05-04,Female,54,45-54,1
1,3,0,0,3,2020-05-05,Female,12,10-14,1
1,0,0,0,0,2020-05-05,Male,42,35-44,1
1,0,0,0,0,2020-05-04,Female,69,65-69,1
1,0,0,0,0,2020-05-06,Male,55,55-64,1
1,0,0,0,0,2020-05-04,Female,25,25-34,1
1,1,0,0,1,2020-05-01,Female,69,65-69,1
1,3,0,0,3,2020-05-04,Female,24,20-24,1
1,3,0,0,3,2020-05-01,Female,5,5-9,1
1,0,0,0,0,2020-05-01,Male,65,65-69,1
1,0,1,0,1,2020-05-01,Female,53,45-54,1
1,4,1,0,5,2020-05-01,Male,18,15-19,1
1,2,0,0,2,2020-05-03,Male,65,65-69,1
1,3,0,0,3,2020-04-30,Male,18,15-19,1
1,2,1,0,3,2020-05-04,Male,30,25-34,1
1,1,0,0,1,2020-05-04,Female,12,10-14,1
1,0,0,0,0,2020-05-01,Female,65,65-69,1
1,2,0,0,2,2020-05-01,Male,41,35-44,1
1,2,1,0,3,2020-05-03,Female,54,45-54,1
1,1,0,0,1,2020-05-01,Male,52,45-54,1
1,2,0,0,2,2020-05-02,Male,32,25-34,1
1,0,4,0,4,2020-05-01,Male,52,45-54,1
1,1,0,0,1,2020-05-06,Female,40,35-44,1
1,2,0,0,2,2020-05-01,Female,58,55-64,1
1,1,0,0,1,2020-05-01,Male,56,55-64,1
1,2,3,0,5,2020-05-01,Male,65,65-69,1
1,2,1,0,3,2020-05-03,Male,66,65-69,1
1,0,0,0,0,2020-05-02,Male,60,55-64,1
1,2,0,0,2,2020-05-02,Male,62,55-64,1
1,1,0,0,1,2020-05-01,Male,39,35-44,1
1,2,0,0,2,2020-05-01,Female,61,55-64,1
1,1,0,0,1,2020-05-04,Female,28,25-34,1
1,4,0,0,4,2020-05-05,Male,15,15-19,1
1,2,1,0,3,2020-05-02,Female,70,70-74,1
1,3,0,0,3,2020-05-04,Female,54,45-54,1
1,2,5,0,7,2020-05-01,Male,53,45-54,1
1,0,0,0,0,2020-05-04,Male,27,25-34,1
1,2,0,0,2,2020-05-01,Male,69,65-69,1
1,2,0,0,2,2020-04-30,Male,72,70-74,1
1,0,0,0,0,2020-05-01,Male,57,55-64,1
1,1,0,0,1,2020-05-02,Male,61,55-64,1
1,4,0,0,4,2020-05-01,Female,8,5-9,1
1,0,0,0,0,2020-05-03,Male,22,20-24,1
1,4,0,0,4,2020-05-04,Male,60,55-64,1
1,2,2,0,4,2020-05-01,Male,68,65-69,1
1,1,1,0,2,2020-05-04,Male,54,45-54,1
1,2,1,0,3,2020-05-01,Male,18,15-19,1
1,2,2,0,4,2020-05-04,Male,18,15-19,1
1,3,0,0,3,2020-05-03,Female,12,10-14,1
1,2,0,0,2,2020-05-05,Male,30,25-34,1
1,2,2,0,4,2020-05-01,Female,68,65-69,1
1,1,0,0,1,2020-05-01,Female,62,55-64,1
1,0,0,0,0,2020-05-05,Male,23,20-24,1
1,1,2,0,3,2020-05-01,Female,67,65-69,1
1,1,0,0,1,2020-05-01,Male,54,45-54,1
1,1,0,0,1,2020-05-01,Female,61,55-64,1
1,0,2,0,2,2020-05-01,Male,66,65-69,1
1,2,1,0,3,2020-05-01,Female,61,55-64,1
1,2,0,0,2,2020-05-01,Male,52,45-54,1
1,0,0,0,0,2020-05-01,Female,65,65-69,1
1,0,2,0,2,2020-05-01,Female,48,45-54,1
1,4,1,0,5,2020-05-01,Female,45,45-54,1
1,5,0,0,5,2020-05-05,Male,11,10-14,1
1,3,0,0,3,2020-05-06,Male,9,5-9,1
1,2,0,0,2,2020-05-01,Female,59,55-64,1
1,1,1,0,2,2020-05-01,Male,65,65-69,1
1,1,1,0,2,2020-05-01,Female,67,65-69,1
1,2,0,0,2,2020-05-04,Female,12,10-14,1
1,1,0,0,1,2020-05-04,Female,62,55-64,1
1,2,0,0,2,2020-05-01,Male,32,25-34,1
1,2,7,0,9,2020-05-01,Male,55,55-64,1
1,0,0,0,0,2020-05-02,Female,51,45-54,1
1,2,0,0,2,2020-05-04,Male,31,25-34,1
1,1,0,0,1,2020-05-01,Male,66,65-69,1
1,0,3,0,3,2020-05-03,Male,28,25-34,1
1,1,0,0,1,2020-05-01,Male,57,55-64,1
1,1,0,0,1,2020-05-01,Male,70,70-74,1
1,4,0,0,4,2020-05-01,Female,43,35-44,1
1,2,0,0,2,2020-05-01,Male,21,20-24,1
1,2,1,0,3,2020-04-30,Female,67,65-69,1
1,4,0,0,4,2020-05-06,Female,15,15-19,1
1,0,1,0,1,2020-05-03,Female,63,55-64,1
1,2,2,0,4,2020-05-01,Male,71,70-74,1
1,2,0,0,2,2020-05-01,Female,35,35-44,1
1,1,1,0,2,2020-05-01,Male,57,55-64,1
1,2,0,0,2,2020-05-04,Male,1,1-4,1
1,1,0,0,1,2020-05-01,Male,61,55-64,1
1,2,0,0,2,2020-05-04,Female,58,55-64,1
1,3,0,0,3,2020-05-04,Male,18,15-19,1
1,0,0,0,0,2020-05-01,Male,49,45-54,1
1,1,0,0,1,2020-05-02,Female,70,70-74,1
1,0,1,0,1,2020-05-01,Male,69,65-69,1
1,0,0,0,0,2020-05-03,Male,56,55-64,1
1,3,10,0,13,2020-04-30,Female,25,25-34,1
1,3,1,0,4,2020-05-01,Male,29,25-34,1
1,1,0,0,1,2020-05-01,Female,69,65-69,1
1,1,0,0,1,2020-05-01,Male,66,65-69,1
1,0,0,0,0,2020-05-06,Male,61,55-64,1
1,3,0,0,3,2020-05-01,Female,8,5-9,1
1,1,0,0,1,2020-05-02,Female,65,65-69,1
1,1,0,0,1,2020-05-03,Male,65,65-69,1
1,1,1,0,2,2020-05-06,Male,53,45-54,1
1,2,0,0,2,2020-05-06,Female,73,70-74,1
1,0,0,0,0,2020-05-01,Male,40,35-44,1
1,2,0,0,2,2020-05-01,Female,16,15-19,1
1,2,0,0,2,2020-05-01,Male,54,45-54,1
1,1,1,0,2,2020-05-01,Male,67,65-69,1
1,5,0,0,5,2020-05-01,Male,2,1-4,1
1,1,0,0,1,2020-05-01,Male,64,55-64,1
1,2,2,0,4,2020-05-04,Female,25,25-34,1
1,5,0,0,5,2020-05-01,Female,2,1-4,1
1,2,0,0,2,2020-05-04,Male,42,35-44,1
1,3,0,0,3,2020-05-04,Female,2,1-4,1
1,1,1,0,2,2020-05-01,Female,68,65-69,1
1,2,4,0,6,2020-05-01,Male,60,55-64,1
1,2,0,0,2,2020-05-01,Male,64,55-64,1
1,2,2,0,4,2020-05-01,Female,61,55-64,1
1,0,0,0,0,2020-05-01,Male,55,55-64,1
1,0,0,0,0,2020-05-01,Male,51,45-54,1
1,2,0,0,2,2020-05-01,Male,65,65-69,1
1,3,1,0,4,2020-05-03,Female,11,10-14,1
1,2,0,0,2,2020-05-03,Male,0,<1,1
1,1,0,0,1,2020-05-04,Male,60,55-64,1
1,3,2,0,5,2020-05-02,Male,52,45-54,1
1,0,2,0,2,2020-05-01,Female,26,25-34,1
1,5,0,0,5,2020-05-01,Female,9,5-9,1
1,4,0,0,4,2020-05-04,Male,12,10-14,1
1,2,1,0,3,2020-05-01,Female,53,45-54,1
1,1,6,0,7,2020-05-04,Male,50,45-54,1
1,2,2,0,4,2020-05-01,Female,55,55-64,1
1,3,1,0,4,2020-05-05,Female,41,35-44,1
1,0,0,0,0,2020-05-02,Male,23,20-24,1
1,2,0,0,2,2020-05-01,Male,65,65-69,1
1,2,0,0,2,2020-05-01,Male,66,65-69,1
1,0,0,0,0,2020-05-04,Male,40,35-44,1
1,0,0,0,0,2020-05-01,Male,41,35-44,1
1,0,2,0,2,2020-05-03,Male,66,65-69,1
1,0,0,0,0,2020-05-01,Male,33,25-34,1
1,2,0,0,2,2020-05-02,Male,79,75-79,1
1,0,0,0,0,2020-05-04,Female,34,25-34,1
1,2,0,0,2,2020-05-01,Female,68,65-69,1
1,4,2,0,6,2020-04-30,Male,1,1-4,1
1,0,0,0,0,2020-04-30,Male,54,45-54,1
1,0,0,0,0,2020-05-04,Male,66,65-69,1
1,2,0,0,2,2020-05-02,Male,56,55-64,1
1,0,0,0,0,2020-05-01,Male,57,55-64,1
1,1,0,0,1,2020-05-03,Male,51,45-54,1
1,0,0,0,0,2020-05-01,Female,38,35-44,1
1,1,2,0,3,2020-05-01,Male,61,55-64,1
1,0,1,0,1,2020-05-01,Female,66,65-69,1
1,3,1,0,4,2020-05-01,Male,57,55-64,1
1,4,0,0,4,2020-05-04,Male,8,5-9,1
1,4,0,0,4,2020-05-04,Female,38,35-44,1
1,2,0,0,2,2020-05-01,Male,77,75-79,1
1,4,0,0,4,2020-05-01,Female,42,35-44,1
1,1,0,0,1,2020-05-04,Female,27,25-34,1
1,1,0,0,1,2020-05-01,Female,63,55-64,1
1,3,0,0,3,2020-05-01,Female,17,15-19,1
1,1,0,0,1,2020-05-01,Male,46,45-54,1
1,2,0,0,2,2020-05-03,Female,56,55-64,1
1,3,2,0,5,2020-04-30,Female,35,35-44,1
1,2,2,0,4,2020-05-01,Male,77,75-79,1
1,1,1,0,2,2020-05-06,Male,25,25-34,1
1,0,0,0,0,2020-05-02,Female,26,25-34,1
1,3,0,0,3,2020-05-04,Male,4,1-4,1
1,0,1,0,1,2020-05-04,Male,47,45-54,1
1,2,0,0,2,2020-05-01,Male,30,25-34,1
1,0,0,0,0,2020-04-30,Female,30,25-34,1
1,0,0,0,0,2020-05-01,Female,67,65-69,1
1,0,1,0,1,2020-04-30,Male,55,55-64,1
1,0,0,0,0,2020-05-01,Male,65,65-69,1
1,0,1,0,1,2020-05-01,Male,71,70-74,1
1,3,0,0,3,2020-05-01,Male,29,25-34,1
1,2,0,0,2,2020-05-01,Male,10,10-14,1
1,0,0,0,0,2020-05-06,Male,40,35-44,1
1,0,0,0,0,2020-05-01,Male,42,35-44,1
1,2,0,0,2,2020-05-01,Female,63,55-64,1
1,2,0,0,2,2020-05-01,Female,73,70-74,1
1,3,0,0,3,2020-05-01,Male,3,1-4,1
1,0,0,0,0,2020-05-01,Male,22,20-24,1
1,4,0,0,4,2020-05-01,Female,24,20-24,1
1,1,0,0,1,2020-05-01,Female,53,45-54,1
1,0,0,0,0,2020-05-05,Female,28,25-34,1
1,1,0,0,1,2020-05-04,Male,8,5-9,1
1,3,2,0,5,2020-05-02,Male,5,5-9,1
1,2,0,0,2,2020-05-01,Female,5,5-9,1
1,1,0,0,1,2020-05-01,Male,56,55-64,1
1,1,1,0,2,2020-05-01,Male,56,55-64,1
1,2,1,0,3,2020-05-01,Male,65,65-69,1
1,1,1,0,2,2020-05-06,Female,53,45-54,1
1,6,1,0,7,2020-05-02,Female,8,5-9,1
1,4,0,0,4,2020-05-01,Male,2,1-4,1
1,2,0,0,2,2020-04-30,Male,60,55-64,1
1,1,1,0,2,2020-05-01,Male,65,65-69,1
1,2,0,0,2,2020-05-01,Female,55,55-64,1
1,2,0,0,2,2020-05-04,Male,33,25-34,1
1,1,0,0,1,2020-05-01,Female,52,45-54,1
1,1,0,0,1,2020-05-01,Female,58,55-64,1
1,0,1,0,1,2020-05-01,Male,20,20-24,1
1,0,9,0,9,2020-05-04,Male,39,35-44,1
1,2,0,0,2,2020-05-01,Male,72,70-74,1
1,2,0,0,2,2020-05-02,Male,62,55-64,1
1,2,0,0,2,2020-05-02,Female,46,45-54,1
1,4,0,0,4,2020-05-02,Female,21,20-24,1
1,0,1,0,1,2020-05-01,Male,60,55-64,1
1,0,0,0,0,2020-05-01,Female,68,65-69,1
1,3,0,0,3,2020-05-01,Male,53,45-54,1
1,1,0,0,1,2020-05-01,Female,55,55-64,1
1,0,0,0,0,2020-05-01,Female,66,65-69,1
1,0,0,0,0,2020-05-01,Female,67,65-69,1
1,2,0,0,2,2020-05-01,Male,71,70-74,1
1,2,7,0,9,2020-05-01,Female,52,45-54,1
1,3,0,0,3,2020-05-01,Male,5,5-9,1
1,2,1,0,3,2020-05-01,Male,66,65-69,1
1,3,0,0,3,2020-05-02,Female,58,55-64,1
1,2,0,0,2,2020-05-06,Male,71,70-74,1
1,0,0,0,0,2020-05-01,Female,70,70-74,1
1,6,0,0,6,2020-05-05,Male,22,20-24,1
1,0,2,0,2,2020-05-01,Male,66,65-69,1
1,1,0,0,1,2020-05-04,Male,58,55-64,1
1,2,0,0,2,2020-05-02,Male,50,45-54,1
1,1,0,0,1,2020-05-01,Male,67,65-69,1
1,2,0,0,2,2020-05-03,Female,55,55-64,1
1,1,1,0,2,2020-05-01,Male,80,80-84,1
1,0,1,0,1,2020-05-04,Male,51,45-54,1
1,1,0,0,1,2020-05-01,Female,52,45-54,1
1,1,0,0,1,2020-05-01,Male,19,15-19,1
1,2,0,0,2,2020-05-01,Male,62,55-64,1
1,1,0,0,1,2020-04-30,Male,54,45-54,1
1,0,0,0,0,2020-05-01,Male,37,35-44,1
1,3,0,0,3,2020-04-30,Male,29,25-34,1
1,1,3,0,4,2020-05-04,Female,27,25-34,1
1,4,0,0,4,2020-05-01,Female,47,45-54,1
1,1,0,0,1,2020-05-01,Female,11,10-14,1
1,0,0,0,0,2020-05-01,Male,53,45-54,1
1,3,0,0,3,2020-05-01,Female,6,5-9,1
1,1,0,0,1,2020-05-03,Female,49,45-54,1
1,4,0,0,4,2020-05-01,Male,38,35-44,1
1,2,0,0,2,2020-05-01,Male,34,25-34,1
1,0,0,0,0,2020-05-03,Female,49,45-54,1
1,0,0,0,0,2020-05-01,Female,71,70-74,1
1,1,1,0,2,2020-05-01,Male,28,25-34,1
1,8,0,0,8,2020-05-01,Female,8,5-9,1
1,1,0,0,1,2020-05-01,Female,24,20-24,1
1,2,0,0,2,2020-05-02,Male,23,20-24,1
1,2,0,0,2,2020-05-01,Male,31,25-34,1
1,2,0,0,2,2020-05-01,Female,71,70-74,1
1,2,0,0,2,2020-05-04,Male,40,35-44,1
1,2,0,0,2,2020-05-04,Male,31,25-34,1
1,2,0,0,2,2020-05-01,Male,66,65-69,1
1,2,1,0,3,2020-05-05,Female,35,35-44,1
1,1,1,0,2,2020-05-01,Female,58,55-64,1
1,3,0,0,3,2020-05-01,Male,24,20-24,1
1,1,0,0,1,2020-05-01,Male,69,65-69,1
1,1,0,0,1,2020-04-30,Male,66,65-69,1
1,1,3,0,4,2020-05-01,Female,51,45-54,1
1,2,0,0,2,2020-05-01,Female,57,55-64,1
1,0,0,0,0,2020-05-01,Male,51,45-54,1
1,0,2,0,2,2020-05-01,Male,56,55-64,1
1,1,0,0,1,2020-05-02,Female,14,10-14,1
1,4,0,0,4,2020-05-01,Female,0,<1,1
1,1,1,0,2,2020-05-02,Male,24,20-24,1
1,3,0,0,3,2020-05-02,Male,17,15-19,1
1,3,0,0,3,2020-05-01,Female,63,55-64,1
1,3,1,0,4,2020-05-01,Male,19,15-19,1
1,1,2,0,3,2020-05-01,Male,50,45-54,1
1,4,0,0,4,2020-05-01,Female,16,15-19,1
1,0,1,0,1,2020-05-01,Male,74,70-74,1
1,0,1,0,1,2020-05-01,Female,44,35-44,1
1,2,0,0,2,2020-05-01,Female,54,45-54,1
1,0,0,0,0,2020-05-01,Male,73,70-74,1
1,0,0,0,0,2020-05-01,Female,65,65-69,1
1,0,4,0,4,2020-05-04,Female,53,45-54,1
1,0,0,0,0,2020-05-01,Female,62,55-64,1
1,1,1,0,2,2020-05-01,Male,73,70-74,1
1,1,6,0,7,2020-04-30,Female,70,70-74,1
1,0,0,0,0,2020-05-01,Female,62,55-64,1
1,2,0,0,2,2020-05-01,Male,31,25-34,1
1,2,0,0,2,2020-05-01,Male,26,25-34,1
1,1,0,0,1,2020-05-01,Male,27,25-34,1
1,0,0,0,0,2020-05-01,Male,30,25-34,1
1,0,0,0,0,2020-05-01,Female,64,55-64,1
1,2,0,0,2,2020-05-01,Male,41,35-44,1
1,0,0,0,0,2020-05-01,Male,70,70-74,1
1,2,0,0,2,2020-05-04,Female,61,55-64,1
1,1,0,0,1,2020-05-05,Male,33,25-34,1
1,0,1,0,1,2020-05-03,Male,65,65-69,1
1,0,0,0,0,2020-05-01,Female,68,65-69,1
1,0,0,0,0,2020-05-01,Female,72,70-74,1
1,2,3,0,5,2020-05-02,Male,72,70-74,1
1,0,1,0,1,2020-05-01,Male,65,65-69,1
1,3,0,0,3,2020-05-01,Female,17,15-19,1
1,0,1,0,1,2020-05-01,Male,68,65-69,1
1,2,0,0,2,2020-05-03,Male,67,65-69,1
1,2,0,0,2,2020-05-04,Male,50,45-54,1
1,2,0,0,2,2020-05-01,Female,66,65-69,1
1,2,0,0,2,2020-05-01,Male,68,65-69,1
1,1,3,0,4,2020-05-01,Male,61,55-64,1
1,0,4,0,4,2020-05-01,Female,55,55-64,1
1,1,3,0,4,2020-05-01,Female,60,55-64,1
1,3,1,0,4,2020-04-30,Female,52,45-54,1
1,3,0,0,3,2020-05-01,Female,3,1-4,1
1,0,0,0,0,2020-05-01,Male,60,55-64,1
1,2,0,0,2,2020-05-01,Male,55,55-64,1
1,0,0,0,0,2020-05-01,Female,62,55-64,1
1,3,0,0,3,2020-05-01,Female,33,25-34,1
1,0,0,0,0,2020-05-01,Female,61,55-64,1
1,2,1,0,3,2020-05-03,Female,59,55-64,1
1,1,0,0,1,2020-05-05,Female,30,25-34,1
1,5,1,0,6,2020-05-03,Female,18,15-19,1
1,1,7,0,8,2020-05-06,Male,41,35-44,1
1,0,1,0,1,2020-05-01,Female,59,55-64,1
1,2,1,0,3,2020-05-01,Male,59,55-64,1
1,0,0,0,0,2020-05-01,Male,69,65-69,1
1,5,0,0,5,2020-05-01,Male,47,45-54,1
1,0,0,0,0,2020-05-01,Female,54,45-54,1
1,0,0,0,0,2020-05-02,Male,32,25-34,1
1,2,2,0,4,2020-05-01,Male,65,65-69,1
1,3,0,0,3,2020-05-06,Female,51,45-54,1
1,2,1,0,3,2020-05-01,Male,71,70-74,1
1,0,0,0,0,2020-05-01,Female,67,65-69,1
1,2,2,0,4,2020-05-06,Female,66,65-69,1
1,1,0,0,1,2020-05-02,Male,69,65-69,1
1,0,0,0,0,2020-05-03,Female,44,35-44,1
1,0,0,0,0,2020-05-01,Male,51,45-54,1
1,4,0,0,4,2020-05-01,Female,17,15-19,1
1,2,1,0,3,2020-05-01,Female,64,55-64,1
1,5,0,0,5,2020-05-01,Female,16,15-19,1
1,2,0,0,2,2020-05-04,Female,37,35-44,1
1,1,0,0,1,2020-05-01,Female,23,20-24,1
1,2,0,0,2,2020-05-03,Male,33,25-34,1
1,0,0,0,0,2020-05-01,Male,57,55-64,1
1,0,1,0,1,2020-05-01,Male,66,65-69,1
1,0,0,0,0,2020-05-04,Female,25,25-34,1
1,0,0,0,0,2020-05-02,Female,49,45-54,1
1,1,0,0,1,2020-05-01,Female,60,55-64,1
1,0,1,0,1,2020-05-02,Male,36,35-44,1
1,1,1,0,2,2020-05-01,Female,34,25-34,1
1,3,0,0,3,2020-05-01,Female,52,45-54,1
1,0,0,0,0,2020-05-04,Female,51,45-54,1
1,3,0,0,3,2020-05-01,Female,51,45-54,1
1,1,3,0,4,2020-05-01,Female,32,25-34,1
1,4,0,0,4,2020-05-01,Male,13,10-14,1
1,1,0,0,1,2020-05-01,Female,54,45-54,1
1,1,0,0,1,2020-05-01,Male,54,45-54,1
1,3,0,0,3,2020-05-04,Female,50,45-54,1
1,0,0,0,0,2020-05-01,Male,26,25-34,1
1,2,0,0,2,2020-05-01,Female,52,45-54,1
1,2,0,0,2,2020-05-02,Female,51,45-54,1
1,2,2,0,4,2020-05-01,Female,64,55-64,1
1,0,0,0,0,2020-05-04,Male,78,75-79,1
1,1,1,0,2,2020-05-01,Female,21,20-24,1
1,3,3,0,6,2020-05-02,Male,15,15-19,1
1,1,1,0,2,2020-05-01,Female,60,55-64,1
1,4,1,0,5,2020-05-01,Male,13,10-14,1
1,2,0,0,2,2020-05-02,Male,19,15-19,1
1,1,0,0,1,2020-05-01,Female,42,35-44,1
1,0,0,0,0,2020-05-04,Male,21,20-24,1
1,3,0,0,3,2020-05-06,Male,32,25-34,1
1,0,0,0,0,2020-05-01,Female,65,65-69,1
1,2,0,0,2,2020-05-01,Male,67,65-69,1
1,0,0,0,0,2020-05-01,Male,37,35-44,1
1,0,0,0,0,2020-05-04,Male,60,55-64,1
1,1,1,0,2,2020-05-01,Female,63,55-64,1
1,0,0,0,0,2020-05-04,Male,36,35-44,1
1,0,0,0,0,2020-05-01,Female,67,65-69,1
1,2,0,0,2,2020-05-01,Male,76,75-79,1
1,2,0,0,2,2020-05-01,Female,39,35-44,1
1,2,0,0,2,2020-05-06,Male,55,55-64,1
1,0,0,0,0,2020-05-01,Female,67,65-69,1
1,3,0,0,3,2020-05-01,Male,32,25-34,1
1,1,1,0,2,2020-05-05,Female,37,35-44,1
1,0,0,0,0,2020-05-01,Female,40,35-44,1
1,1,3,0,4,2020-05-01,Female,33,25-34,1
1,0,0,0,0,2020-05-01,Male,66,65-69,1
1,1,0,0,1,2020-05-04,Female,51,45-54,1
1,0,0,0,0,2020-05-01,Female,23,20-24,1
1,1,0,0,1,2020-05-02,Female,50,45-54,1
1,0,0,0,0,2020-05-01,Female,66,65-69,1
1,1,0,0,1,2020-05-01,Female,72,70-74,1
1,0,0,0,0,2020-05-04,Male,69,65-69,1
1,0,0,0,0,2020-04-30,Male,57,55-64,1
1,2,1,0,3,2020-05-04,Female,23,20-24,1
1,2,2,0,4,2020-05-01,Female,10,10-14,1
1,0,0,0,0,2020-05-04,Female,23,20-24,1
1,3,1,0,4,2020-05-04,Female,16,15-19,1
1,1,1,0,2,2020-05-01,Male,78,75-79,1
1,0,0,0,0,2020-05-01,Female,19,15-19,1
1,2,0,0,2,2020-05-04,Female,52,45-54,1
1,2,0,0,2,2020-05-01,Male,68,65-69,1
1,2,0,0,2,2020-05-01,Female,55,55-64,1
1,2,2,0,4,2020-05-01,Male,60,55-64,1
1,1,2,0,3,2020-05-01,Male,63,55-64,1
1,2,0,0,2,2020-05-01,Male,72,70-74,1
1,3,0,0,3,2020-05-01,Female,22,20-24,1
1,2,0,0,2,2020-05-01,Female,64,55-64,1
1,0,0,0,0,2020-05-01,Female,66,65-69,1
1,0,0,0,0,2020-05-01,Female,30,25-34,1
1,0,0,0,0,2020-05-01,Female,73,70-74,1
1,0,3,0,3,2020-05-05,Female,33,25-34,1
1,1,0,0,1,2020-05-05,Female,37,35-44,1
1,0,1,0,1,2020-05-03,Female,71,70-74,1
1,2,0,0,2,2020-05-01,Female,71,70-74,1
1,4,12,0,16,2020-05-01,Female,23,20-24,1
1,1,0,0,1,2020-05-01,Female,49,45-54,1
1,4,0,0,4,2020-05-01,Female,58,55-64,1
1,3,0,0,3,2020-05-04,Male,55,55-64,1
1,0,0,0,0,2020-05-01,Male,30,25-34,1
1,0,0,0,0,2020-05-03,Male,39,35-44,1
1,2,0,0,2,2020-05-03,Female,50,45-54,1
1,0,0,0,0,2020-05-01,Female,40,35-44,1
1,3,0,0,3,2020-05-01,Male,21,20-24,1
1,1,0,0,1,2020-05-01,Male,35,35-44,1
1,0,0,0,0,2020-05-04,Male,54,45-54,1
1,1,2,0,3,2020-05-04,Female,36,35-44,1
1,3,0,0,3,2020-05-01,Female,8,5-9,1
1,0,0,0,0,2020-05-01,Female,73,70-74,1
1,2,1,0,3,2020-05-01,Male,61,55-64,1
1,1,0,0,1,2020-05-01,Male,39,35-44,1
1,2,0,0,2,2020-05-01,Female,67,65-69,1
1,1,1,0,2,2020-05-01,Female,13,10-14,1
1,4,0,0,4,2020-05-01,Female,14,10-14,1
1,0,0,0,0,2020-05-01,Female,70,70-74,1
1,2,2,0,4,2020-05-01,Male,73,70-74,1
1,2,0,0,2,2020-05-01,Female,65,65-69,1
1,3,0,0,3,2020-05-02,Female,33,25-34,1
1,3,1,0,4,2020-04-30,Male,11,10-14,1
1,1,1,0,2,2020-05-01,Male,72,70-74,1
1,0,0,0,0,2020-05-01,Male,34,25-34,1
1,3,3,0,6,2020-05-01,Female,24,20-24,1
1,0,0,0,0,2020-05-01,Male,66,65-69,1
1,1,0,0,1,2020-05-01,Male,67,65-69,1
1,1,0,0,1,2020-05-04,Female,54,45-54,1
1,1,5,0,6,2020-05-06,Male,66,65-69,1
1,1,0,0,1,2020-05-01,Female,60,55-64,1
1,2,2,0,4,2020-05-01,Female,65,65-69,1
1,2,2,0,4,2020-05-01,Male,66,65-69,1
1,2,0,0,2,2020-05-02,Male,58,55-64,1
1,4,0,0,4,2020-05-01,Female,12,10-14,1
1,2,0,0,2,2020-05-04,Male,65,65-69,1
1,2,0,0,2,2020-05-01,Female,10,10-14,1
1,0,0,0,0,2020-05-04,Female,50,45-54,1
1,0,2,0,2,2020-05-05,Male,21,20-24,1
1,1,0,0,1,2020-05-01,Male,56,55-64,1
1,3,0,0,3,2020-05-01,Female,0,<1,1
1,2,3,0,5,2020-04-30,Male,69,65-69,1
1,1,4,0,5,2020-05-01,Male,65,65-69,1
1,2,0,0,2,2020-05-03,Female,28,25-34,1
1,3,0,0,3,2020-05-01,Female,24,20-24,1
1,1,0,0,1,2020-05-01,Female,64,55-64,1
1,2,0,0,2,2020-05-02,Female,66,65-69,1
1,0,3,0,3,2020-05-01,Female,74,70-74,1
1,0,0,0,0,2020-05-03,Female,36,35-44,1
1,3,0,0,3,2020-05-02,Male,44,35-44,1
1,2,0,0,2,2020-05-01,Male,31,25-34,1
1,2,0,0,2,2020-05-06,Female,16,15-19,1
1,3,0,0,3,2020-05-01,Male,17,15-19,1
1,3,0,0,3,2020-05-01,Male,33,25-34,1
1,3,1,0,4,2020-05-01,Female,22,20-24,1
1,4,8,0,12,2020-05-04,Male,14,10-14,1
1,1,1,0,2,2020-05-01,Female,63,55-64,1
1,0,2,0,2,2020-05-01,Female,68,65-69,1
1,0,0,0,0,2020-05-04,Female,61,55-64,1
1,1,2,0,3,2020-05-01,Male,65,65-69,1
1,3,0,0,3,2020-05-01,Female,10,10-14,1
1,1,0,0,1,2020-05-01,Male,75,75-79,1
1,0,0,0,0,2020-05-01,Female,51,45-54,1
1,3,0,0,3,2020-05-06,Female,59,55-64,1
1,2,0,0,2,2020-05-01,Female,22,20-24,1
1,2,0,0,2,2020-05-01,Male,62,55-64,1
1,0,0,0,0,2020-05-04,Male,28,25-34,1
1,1,3,0,4,2020-05-01,Female,68,65-69,1
1,2,0,0,2,2020-05-01,Male,65,65-69,1
1,2,0,0,2,2020-05-02,Male,37,35-44,1
1,2,2,0,4,2020-05-01,Female,66,65-69,1
1,0,0,0,0,2020-05-04,Male,52,45-54,1
1,0,0,0,0,2020-05-01,Female,43,35-44,1
1,3,0,0,3,2020-05-04,Male,3,1-4,1
1,0,0,0,0,2020-05-01,Male,63,55-64,1
1,1,0,0,1,2020-05-01,Female,52,45-54,1
1,1,0,0,1,2020-05-04,Female,50,45-54,1
1,2,0,0,2,2020-05-01,Female,48,45-54,1
1,6,0,0,6,2020-05-02,Female,5,5-9,1
1,0,0,0,0,2020-05-06,Female,63,55-64,1
1,1,1,0,2,2020-05-02,Male,65,65-69,1
1,5,0,0,5,2020-05-03,Female,1,1-4,1
1,0,0,0,0,2020-05-02,Female,24,20-24,1
1,0,0,0,0,2020-05-01,Female,54,45-54,1
1,0,0,0,0,2020-05-04,Female,21,20-24,1
1,0,0,0,0,2020-05-01,Male,33,25-34,1
1,2,0,0,2,2020-05-01,Male,46,45-54,1
1,1,0,0,1,2020-05-02,Male,61,55-64,1
1,0,0,0,0,2020-05-01,Male,65,65-69,1
1,1,0,0,1,2020-05-01,Male,67,65-69,1
1,0,0,0,0,2020-05-01,Male,7,5-9,1
1,0,0,0,0,2020-05-01,Male,55,55-64,1
1,0,0,0,0,2020-05-01,Male,30,25-34,1
1,3,0,0,3,2020-05-01,Female,47,45-54,1
1,3,0,0,3,2020-05-01,Female,59,55-64,1
1,4,0,0,4,2020-05-01,Female,32,25-34,1
1,0,0,0,0,2020-05-01,Male,63,55-64,1
1,2,3,0,5,2020-05-01,Female,62,55-64,1
1,2,1,0,3,2020-05-01,Male,60,55-64,1
1,0,0,0,0,2020-05-01,Female,69,65-69,1
1,3,1,0,4,2020-05-03,Female,32,25-34,1
1,1,0,0,1,2020-05-02,Male,57,55-64,1
1,0,4,0,4,2020-05-03,Male,20,20-24,1
1,4,0,0,4,2020-05-01,Female,9,5-9,1
1,2,1,0,3,2020-05-01,Male,63,55-64,1
1,1,1,0,2,2020-05-01,Female,62,55-64,1
1,1,0,0,1,2020-05-04,Female,63,55-64,1
1,0,0,0,0,2020-05-04,Male,31,25-34,1
1,1,1,0,2,2020-05-02,Male,32,25-34,1
1,3,0,0,3,2020-05-04,Female,43,35-44,1
1,2,2,0,4,2020-05-01,Female,68,65-69,1
1,2,0,0,2,2020-04-30,Male,52,45-54,1
1,3,0,0,3,2020-05-04,Male,49,45-54,1
1,4,0,0,4,2020-05-04,Female,18,15-19,1
1,0,0,0,0,2020-05-01,Female,44,35-44,1
1,1,1,0,2,2020-04-30,Female,66,65-69,1
1,4,0,0,4,2020-05-01,Male,17,15-19,1
1,1,7,0,8,2020-05-01,Female,23,20-24,1
1,2,0,0,2,2020-05-01,Male,59,55-64,1
1,2,0,0,2,2020-05-01,Female,38,35-44,1
1,0,0,0,0,2020-05-04,Male,41,35-44,1
1,0,0,0,0,2020-04-30,Female,34,25-34,1
1,1,1,0,2,2020-05-01,Male,67,65-69,1
1,0,0,0,0,2020-05-02,Male,54,45-54,1
1,0,0,0,0,2020-04-30,Male,76,75-79,1
1,2,1,0,3,2020-05-01,Female,58,55-64,1
1,2,0,0,2,2020-05-02,Male,10,10-14,1
1,0,0,0,0,2020-05-04,Male,60,55-64,1
1,8,0,0,8,2020-05-01,Female,11,10-14,1
1,1,3,0,4,2020-05-01,Female,54,45-54,1
1,2,3,0,5,2020-05-03,Male,0,<1,1
1,1,1,0,2,2020-05-01,Female,67,65-69,1
1,1,0,0,1,2020-05-01,Female,20,20-24,1
1,0,2,0,2,2020-05-04,Male,29,25-34,1
1,5,0,0,5,2020-05-03,Male,12,10-14,1
1,1,0,0,1,2020-05-01,Female,29,25-34,1
1,0,1,0,1,2020-05-03,Female,39,35-44,1
1,0,0,0,0,2020-05-02,Male,49,45-54,1
1,0,0,0,0,2020-05-01,Female,33,25-34,1
1,0,2,0,2,2020-05-01,Female,67,65-69,1
1,1,1,0,2,2020-05-01,Female,65,65-69,1
1,0,0,0,0,2020-05-01,Female,75,75-79,1
1,3,0,0,3,2020-05-03,Female,19,15-19,1
1,0,0,0,0,2020-05-04,Male,70,70-74,1
1,1,0,0,1,2020-05-04,Female,27,25-34,1
1,1,1,0,2,2020-05-01,Female,73,70-74,1
1,0,0,0,0,2020-05-01,Male,11,10-14,1
1,0,1,0,1,2020-05-01,Female,66,65-69,1
1,0,0,0,0,2020-05-05,Male,43,35-44,1
1,3,1,0,4,2020-05-04,Female,25,25-34,1
1,0,2,0,2,2020-05-01,Female,68,65-69,1
1,4,2,0,6,2020-05-06,Female,15,15-19,1
1,0,3,0,3,2020-05-01,Male,54,45-54,1
1,0,0,0,0,2020-05-04,Male,23,20-24,1
1,4,0,0,4,2020-05-04,Male,9,5-9,1
1,2,1,0,3,2020-05-04,Female,30,25-34,1
1,4,0,0,4,2020-05-02,Male,12,10-14,1
1,5,0,0,5,2020-05-01,Male,18,15-19,1
1,0,3,0,3,2020-05-01,Female,27,25-34,1
1,2,0,0,2,2020-05-04,Male,47,45-54,1
1,2,0,0,2,2020-05-01,Female,52,45-54,1
1,2,0,0,2,2020-05-04,Female,68,65-69,1
1,0,0,0,0,2020-05-02,Female,37,35-44,1
1,0,0,0,0,2020-05-04,Male,53,45-54,1
1,1,0,0,1,2020-05-01,Male,67,65-69,1
1,2,0,0,2,2020-05-01,Female,72,70-74,1
1,2,0,0,2,2020-05-01,Female,24,20-24,1
1,4,2,0,6,2020-05-01,Female,22,20-24,1
1,2,0,0,2,2020-05-04,Male,49,45-54,1
1,1,0,0,1,2020-05-01,Female,49,45-54,1
1,2,6,0,8,2020-05-01,Female,68,65-69,1
1,3,0,0,3,2020-05-02,Female,5,5-9,1
1,4,0,0,4,2020-05-03,Male,66,65-69,1
1,2,0,0,2,2020-04-30,Male,67,65-69,1
1,2,3,0,5,2020-04-30,Female,47,45-54,1
1,4,0,0,4,2020-05-01,Female,15,15-19,1
1,3,0,0,3,2020-05-01,Male,84,80-84,1
1,1,0,0,1,2020-05-01,Female,51,45-54,1
1,1,0,0,1,2020-05-04,Female,31,25-34,1
1,0,0,0,0,2020-05-01,Female,53,45-54,1
1,3,0,0,3,2020-05-06,Male,14,10-14,1
1,2,2,0,4,2020-05-04,Female,19,15-19,1
1,3,1,0,4,2020-05-05,Female,38,35-44,1
1,0,0,0,0,2020-05-02,Male,47,45-54,1
1,2,0,0,2,2020-05-01,Female,32,25-34,1
1,1,0,0,1,2020-05-02,Female,66,65-69,1
1,0,3,0,3,2020-05-01,Male,49,45-54,1
1,0,0,0,0,2020-04-30,Male,0,<1,1
1,0,4,0,4,2020-05-01,Female,50,45-54,1
1,2,0,0,2,2020-05-01,Female,67,65-69,1
1,0,0,0,0,2020-05-05,Male,20,20-24,1
1,0,0,0,0,2020-05-04,Male,28,25-34,1
1,0,1,0,1,2020-05-02,Male,66,65-69,1
1,2,2,0,4,2020-05-04,Male,13,10-14,1
1,2,0,0,2,2020-05-05,Male,25,25-34,1
1,1,0,0,1,2020-05-01,Female,39,35-44,1
1,1,1,0,2,2020-05-04,Male,51,45-54,1
1,1,0,0,1,2020-04-30,Female,21,20-24,1
1,0,0,0,0,2020-05-02,Female,28,25-34,1
1,1,0,0,1,2020-05-01,Male,74,70-74,1
1,3,1,0,4,2020-05-01,Female,8,5-9,1
1,1,1,0,2,2020-05-04,Male,30,25-34,1
1,2,0,0,2,2020-05-01,Male,65,65-69,1
1,2,0,0,2,2020-05-06,Female,67,65-69,1
1,1,0,0,1,2020-04-30,Male,42,35-44,1
1,0,0,0,0,2020-05-05,Female,30,25-34,1
1,2,1,0,3,2020-05-02,Female,79,75-79,1
1,1,0,0,1,2020-05-04,Male,19,15-19,1
1,1,0,0,1,2020-04-30,Female,69,65-69,1
1,1,0,0,1,2020-04-30,Male,19,15-19,1
1,0,0,0,0,2020-04-30,Female,69,65-69,1
1,2,2,0,4,2020-05-01,Male,70,70-74,1
1,1,2,0,3,2020-05-05,Female,20,20-24,1
1,0,0,0,0,2020-05-04,Female,36,35-44,1
1,0,0,0,0,2020-05-05,Male,14,10-14,1
1,0,7,0,7,2020-05-01,Male,60,55-64,1
1,5,1,0,6,2020-05-04,Male,5,5-9,1
1,0,0,0,0,2020-05-02,Male,66,65-69,1
1,1,5,0,6,2020-05-01,Female,29,25-34,1
1,2,1,0,3,2020-05-01,Male,70,70-74,1
1,4,0,0,4,2020-05-01,Female,6,5-9,1
1,0,0,0,0,2020-05-04,Male,33,25-34,1
2,0,0,0,0,2020-05-15,Male,59,55-64,2
2,2,1,0,3,2020-05-21,Female,58,55-64,2
2,2,0,0,2,2020-05-17,Male,65,65-69,2
2,2,1,0,3,2020-05-15,Male,62,55-64,2
2,2,0,0,2,2020-05-14,Female,65,65-69,2
2,0,0,0,0,2020-05-15,Female,71,70-74,2
2,0,5,0,5,2020-05-15,Female,33,25-34,2
2,3,0,0,3,2020-05-15,Male,40,35-44,2
2,1,0,0,1,2020-05-15,Female,71,70-74,2
2,0,1,0,1,2020-05-19,Female,62,55-64,2
2,0,4,0,4,2020-05-17,Female,56,55-64,2
2,1,2,0,3,2020-05-15,Male,34,25-34,2
2,3,0,0,3,2020-05-15,Male,6,5-9,2
2,1,1,0,2,2020-05-15,Female,58,55-64,2
2,1,0,0,1,2020-05-15,Male,10,10-14,2
2,1,23,0,24,2020-05-20,Female,60,55-64,2
2,0,0,0,0,2020-05-17,Male,50,45-54,2
2,0,0,0,0,2020-05-15,Male,67,65-69,2
2,2,2,0,4,2020-05-20,Male,0,<1,2
2,4,1,0,5,2020-05-15,Female,57,55-64,2
2,2,3,0,5,2020-05-20,Male,33,25-34,1
2,2,0,0,2,2020-05-15,Female,7,5-9,2
2,1,0,0,1,2020-05-15,Male,32,25-34,2
2,0,1,0,1,2020-05-17,Male,66,65-69,2
2,1,1,0,2,2020-05-14,Male,62,55-64,2
2,4,0,0,4,2020-05-15,Male,10,10-14,2
2,0,1,0,1,2020-05-21,Female,49,45-54,1
2,1,0,0,1,2020-05-17,Female,22,20-24,2
2,2,5,0,7,2020-05-20,Female,42,35-44,2
2,2,1,0,3,2020-05-15,Male,16,15-19,2
2,2,0,0,2,2020-05-14,Male,58,55-64,2
2,1,1,0,2,2020-05-21,Male,27,25-34,1
2,2,0,0,2,2020-05-15,Female,70,70-74,2
2,1,2,0,3,2020-05-15,Male,67,65-69,2
2,0,3,0,3,2020-05-15,Male,56,55-64,2
2,2,2,0,4,2020-05-15,Female,68,65-69,2
2,0,4,0,4,2020-05-14,Male,41,35-44,2
2,2,1,0,3,2020-05-15,Male,58,55-64,2
2,1,0,0,1,2020-05-16,Female,56,55-64,2
2,1,1,0,2,2020-05-16,Male,24,20-24,2
2,2,2,0,4,2020-05-15,Female,21,20-24,2
2,2,0,0,2,2020-05-15,Male,51,45-54,2
2,0,0,0,0,2020-05-15,Male,85,85+,2
2,1,1,0,2,2020-05-15,Female,68,65-69,2
2,3,0,0,3,2020-05-19,Female,14,10-14,2
2,1,1,0,2,2020-05-15,Male,53,45-54,2
2,1,2,0,3,2020-05-15,Male,57,55-64,2
2,0,0,0,0,2020-05-15,Male,67,65-69,2
2,1,1,0,2,2020-05-18,Male,50,45-54,2
2,0,2,0,2,2020-05-15,Male,76,75-79,2
2,2,0,0,2,2020-05-14,Male,71,70-74,2
2,0,0,0,0,2020-05-15,Male,51,45-54,2
2,1,0,0,1,2020-05-18,Male,56,55-64,2
2,4,4,0,8,2020-05-15,Male,43,35-44,2
2,4,1,0,5,2020-05-20,Male,19,15-19,1
2,1,2,0,3,2020-05-15,Male,19,15-19,2
2,1,0,0,1,2020-05-15,Female,74,70-74,2
2,1,0,0,1,2020-05-16,Female,59,55-64,2
2,2,0,0,2,2020-05-20,Female,71,70-74,1
2,0,0,0,0,2020-05-14,Male,34,25-34,2
2,2,8,0,10,2020-05-19,Male,68,65-69,2
2,1,1,0,2,2020-05-16,Female,76,75-79,2
2,4,3,0,7,2020-05-14,Male,2,1-4,2
2,2,0,0,2,2020-05-15,Male,66,65-69,2
2,1,0,0,1,2020-05-18,Female,67,65-69,2
2,5,2,0,7,2020-05-14,Female,4,1-4,2
2,1,1,0,2,2020-05-14,Male,38,35-44,2
2,4,3,0,7,2020-05-15,Male,46,45-54,2
2,2,1,0,3,2020-05-15,Female,71,70-74,2
2,1,0,0,1,2020-05-14,Male,44,35-44,2
2,2,6,0,8,2020-05-14,Male,54,45-54,2
2,2,0,0,2,2020-05-16,Female,70,70-74,2
2,1,24,0,25,2020-05-14,Female,65,65-69,2
2,3,1,0,4,2020-05-17,Male,10,10-14,2
2,2,0,0,2,2020-05-15,Male,69,65-69,2
2,5,0,0,5,2020-05-20,Female,2,1-4,1
2,4,1,0,5,2020-05-17,Female,14,10-14,2
2,1,6,0,7,2020-05-15,Male,67,65-69,2
2,2,0,0,2,2020-05-15,Male,69,65-69,2
2,2,0,0,2,2020-05-20,Female,30,25-34,1
2,8,0,0,8,2020-05-15,Female,18,15-19,2
2,3,3,0,6,2020-05-16,Female,7,5-9,2
2,1,2,0,3,2020-05-20,Female,43,35-44,2
2,0,3,0,3,2020-05-15,Female,34,25-34,2
2,0,2,0,2,2020-05-20,Female,54,45-54,2
2,1,4,0,5,2020-05-15,Male,68,65-69,2
2,4,10,0,14,2020-05-15,Female,3,1-4,2
2,2,3,0,5,2020-05-15,Male,37,35-44,2
2,4,0,0,4,2020-05-15,Female,15,15-19,2
2,1,0,0,1,2020-05-14,Female,60,55-64,2
2,5,2,0,7,2020-05-18,Male,12,10-14,2
2,1,10,0,11,2020-05-15,Male,30,25-34,2
2,0,4,0,4,2020-05-15,Female,52,45-54,2
2,1,0,0,1,2020-05-15,Male,48,45-54,2
2,0,0,0,0,2020-05-20,Female,15,15-19,1
2,1,0,0,1,2020-05-20,Male,49,45-54,1
2,0,1,0,1,2020-05-16,Female,62,55-64,2
2,0,0,0,0,2020-05-14,Female,27,25-34,2
2,2,0,0,2,2020-05-20,Female,76,75-79,1
2,2,0,0,2,2020-05-15,Female,28,25-34,2
2,1,1,0,2,2020-05-16,Female,30,25-34,2
2,0,0,0,0,2020-05-15,Female,62,55-64,2
2,0,0,0,0,2020-05-15,Female,46,45-54,2
2,2,0,0,2,2020-05-18,Female,65,65-69,2
2,2,0,0,2,2020-05-15,Male,56,55-64,2
2,3,0,0,3,2020-05-19,Female,72,70-74,2
2,0,1,0,1,2020-05-14,Female,45,45-54,2
2,2,0,0,2,2020-05-18,Female,45,45-54,2
2,4,1,0,5,2020-05-16,Male,36,35-44,2
2,0,4,0,4,2020-05-14,Female,61,55-64,2
2,1,1,0,2,2020-05-21,Female,33,25-34,1
2,0,6,0,6,2020-05-15,Female,57,55-64,2
2,1,0,0,1,2020-05-17,Male,63,55-64,2
2,4,0,0,4,2020-05-19,Male,5,5-9,2
2,0,1,0,1,2020-05-20,Male,33,25-34,1
2,1,0,0,1,2020-05-16,Female,55,55-64,2
2,2,8,0,10,2020-05-15,Male,20,20-24,2
2,3,0,0,3,2020-05-15,Male,13,10-14,2
2,1,0,0,1,2020-05-19,Male,67,65-69,2
2,4,1,0,5,2020-05-16,Male,41,35-44,2
2,1,1,0,2,2020-05-15,Male,58,55-64,2
2,4,0,0,4,2020-05-15,Male,11,10-14,2
2,3,3,0,6,2020-05-18,Female,68,65-69,2
2,1,3,0,4,2020-05-15,Male,50,45-54,2
2,0,4,0,4,2020-05-15,Female,39,35-44,2
2,0,4,0,4,2020-05-15,Female,69,65-69,2
2,2,0,0,2,2020-05-15,Male,34,25-34,2
2,0,2,0,2,2020-05-16,Female,53,45-54,2
2,3,0,0,3,2020-05-15,Male,24,20-24,2
2,0,1,0,1,2020-05-18,Female,33,25-34,2
2,1,0,0,1,2020-05-15,Male,64,55-64,2
2,1,2,0,3,2020-05-18,Female,72,70-74,2
2,1,0,0,1,2020-05-16,Female,78,75-79,2
2,2,10,0,12,2020-05-16,Male,56,55-64,2
2,1,1,0,2,2020-05-14,Male,14,10-14,1
2,1,0,0,1,2020-05-18,Female,28,25-34,2
2,2,0,0,2,2020-05-20,Male,51,45-54,1
2,2,3,0,5,2020-05-14,Female,66,65-69,2
2,0,1,0,1,2020-05-15,Female,50,45-54,2
2,2,0,0,2,2020-05-16,Male,52,45-54,2
2,0,0,0,0,2020-05-15,Male,56,55-64,2
2,2,0,0,2,2020-05-15,Male,34,25-34,2
2,1,2,0,3,2020-05-14,Female,51,45-54,2
2,0,0,0,0,2020-05-18,Male,19,15-19,2
2,3,2,0,5,2020-05-14,Male,65,65-69,2
2,0,2,0,2,2020-05-15,Male,67,65-69,2
2,1,5,0,6,2020-05-15,Male,64,55-64,2
2,0,0,0,0,2020-05-15,Female,65,65-69,2
2,0,0,0,0,2020-05-15,Female,59,55-64,2
2,0,5,0,5,2020-05-15,Male,70,70-74,2
2,2,5,0,7,2020-05-21,Female,59,55-64,1
2,0,0,0,0,2020-05-15,Female,70,70-74,2
2,1,3,0,4,2020-05-15,Male,73,70-74,2
2,2,1,0,3,2020-05-19,Male,65,65-69,2
2,1,10,0,11,2020-05-15,Female,65,65-69,2
2,0,0,0,0,2020-05-15,Male,37,35-44,2
2,2,1,0,3,2020-05-15,Female,54,45-54,2
2,2,0,0,2,2020-05-16,Male,50,45-54,2
2,0,1,0,1,2020-05-17,Female,24,20-24,2
2,2,0,0,2,2020-05-21,Female,76,75-79,1
2,2,0,0,2,2020-05-15,Male,65,65-69,2
2,1,1,0,2,2020-05-15,Male,67,65-69,2
2,1,3,0,4,2020-05-18,Male,52,45-54,2
2,1,3,0,4,2020-05-15,Female,57,55-64,2
2,0,1,0,1,2020-05-19,Female,19,15-19,2
2,1,0,0,1,2020-05-20,Female,53,45-54,1
2,0,2,0,2,2020-05-15,Male,49,45-54,2
2,3,0,0,3,2020-05-15,Male,12,10-14,2
2,0,2,0,2,2020-05-15,Male,70,70-74,2
2,5,1,0,6,2020-05-16,Male,1,1-4,2
2,3,0,0,3,2020-05-15,Female,69,65-69,2
2,2,0,0,2,2020-05-16,Female,7,5-9,2
2,1,0,0,1,2020-05-15,Female,56,55-64,2
2,1,1,0,2,2020-05-14,Female,59,55-64,2
2,0,0,0,0,2020-05-14,Male,43,35-44,2
2,2,0,0,2,2020-05-14,Female,62,55-64,2
2,0,1,0,1,2020-05-14,Male,26,25-34,2
2,3,0,0,3,2020-05-14,Male,31,25-34,2
2,0,0,0,0,2020-05-15,Male,73,70-74,2
2,1,4,0,5,2020-05-16,Female,68,65-69,2
2,1,1,0,2,2020-05-15,Male,45,45-54,2
2,1,0,0,1,2020-05-18,Male,65,65-69,2
2,2,1,0,3,2020-05-14,Female,52,45-54,2
2,2,5,0,7,2020-05-15,Male,68,65-69,2
2,2,0,0,2,2020-05-15,Male,33,25-34,2
2,1,0,0,1,2020-05-14,Male,65,65-69,2
2,2,3,0,5,2020-05-15,Male,65,65-69,2
2,2,3,0,5,2020-05-15,Male,67,65-69,2
2,0,0,0,0,2020-05-18,Male,39,35-44,2
2,1,0,0,1,2020-05-21,Male,23,20-24,1
2,0,6,0,6,2020-05-19,Male,61,55-64,2
2,2,0,0,2,2020-05-18,Male,70,70-74,2
2,0,1,0,1,2020-05-15,Female,55,55-64,2
2,0,1,0,1,2020-05-14,Female,66,65-69,2
2,1,0,0,1,2020-05-15,Female,40,35-44,2
2,0,3,0,3,2020-05-15,Male,44,35-44,2
2,1,1,0,2,2020-05-15,Female,66,65-69,2
2,1,3,0,4,2020-05-15,Female,66,65-69,2
2,0,2,0,2,2020-05-16,Female,63,55-64,2
2,1,3,0,4,2020-05-19,Male,68,65-69,2
2,4,0,0,4,2020-05-16,Female,14,10-14,2
2,3,5,0,8,2020-05-14,Female,60,55-64,2
2,1,1,0,2,2020-05-14,Male,61,55-64,2
2,1,0,0,1,2020-05-14,Male,47,45-54,2
2,1,2,0,3,2020-05-15,Female,53,45-54,2
2,3,0,0,3,2020-05-14,Male,33,25-34,2
2,1,0,0,1,2020-05-15,Female,2,1-4,2
2,0,1,0,1,2020-05-14,Female,65,65-69,2
2,2,0,0,2,2020-05-14,Male,7,5-9,2
2,1,2,0,3,2020-05-15,Male,72,70-74,2
2,0,0,0,0,2020-05-19,Male,38,35-44,2
2,0,0,0,0,2020-05-15,Female,55,55-64,2
2,2,2,0,4,2020-05-15,Female,70,70-74,2
2,4,0,0,4,2020-05-15,Male,53,45-54,2
2,1,3,0,4,2020-05-14,Male,47,45-54,2
2,2,2,0,4,2020-05-15,Male,68,65-69,2
2,0,2,0,2,2020-05-16,Male,19,15-19,2
2,1,5,0,6,2020-05-18,Female,31,25-34,2
2,0,5,0,5,2020-05-15,Male,36,35-44,2
2,0,1,0,1,2020-05-15,Male,39,35-44,2
2,0,1,0,1,2020-05-14,Male,30,25-34,2
2,2,0,0,2,2020-05-15,Male,61,55-64,2
2,1,5,0,6,2020-05-15,Female,68,65-69,2
2,0,0,0,0,2020-05-14,Female,69,65-69,2
2,2,0,0,2,2020-05-19,Female,33,25-34,2
2,2,0,0,2,2020-05-18,Male,72,70-74,2
2,1,1,0,2,2020-05-15,Male,67,65-69,2
2,3,0,0,3,2020-05-20,Female,63,55-64,2
2,0,3,0,3,2020-05-14,Male,28,25-34,2
2,3,2,0,5,2020-05-15,Female,53,45-54,2
2,1,13,0,14,2020-05-18,Female,38,35-44,2
2,1,0,0,1,2020-05-15,Female,60,55-64,2
2,2,0,0,2,2020-05-17,Female,68,65-69,2
2,4,10,0,14,2020-05-15,Female,68,65-69,2
2,2,0,0,2,2020-05-19,Male,64,55-64,2
2,0,2,0,2,2020-05-15,Male,48,45-54,2
2,0,0,0,0,2020-05-16,Female,83,80-84,2
2,1,0,0,1,2020-05-18,Male,65,65-69,2
2,2,1,0,3,2020-05-18,Male,75,75-79,2
2,3,0,0,3,2020-05-14,Male,66,65-69,2
2,0,0,0,0,2020-05-14,Male,64,55-64,2
2,3,0,0,3,2020-05-18,Female,67,65-69,2
2,0,1,0,1,2020-05-15,Female,73,70-74,2
2,1,2,0,3,2020-05-15,Male,67,65-69,2
2,2,1,0,3,2020-05-14,Male,74,70-74,2
2,0,0,0,0,2020-05-18,Male,6,5-9,2
2,0,0,0,0,2020-05-15,Male,52,45-54,2
2,3,0,0,3,2020-05-19,Female,44,35-44,2
2,3,2,0,5,2020-05-16,Male,12,10-14,2
2,2,0,0,2,2020-05-14,Male,18,15-19,2
2,0,18,0,18,2020-05-21,Female,26,25-34,1
2,0,0,0,0,2020-05-15,Female,51,45-54,2
2,4,0,0,4,2020-05-16,Male,11,10-14,2
2,0,1,0,1,2020-05-18,Female,59,55-64,2
2,2,0,0,2,2020-05-15,Male,11,10-14,2
2,0,5,0,5,2020-05-17,Male,46,45-54,2
2,1,1,0,2,2020-05-18,Male,81,80-84,2
2,3,4,0,7,2020-05-17,Female,53,45-54,2
2,4,0,0,4,2020-05-20,Male,31,25-34,1
2,2,2,0,4,2020-05-15,Male,59,55-64,2
2,2,0,0,2,2020-05-15,Female,19,15-19,2
2,2,3,0,5,2020-05-16,Female,52,45-54,2
2,0,0,0,0,2020-05-17,Male,16,15-19,2
2,2,0,0,2,2020-05-15,Male,70,70-74,2
2,1,1,0,2,2020-05-15,Male,34,25-34,2
2,0,0,0,0,2020-05-18,Female,34,25-34,2
2,0,0,0,0,2020-05-15,Female,45,45-54,2
2,4,0,0,4,2020-05-15,Female,13,10-14,2
2,4,0,0,4,2020-05-15,Female,23,20-24,2
2,4,0,0,4,2020-05-19,Male,22,20-24,2
2,2,2,0,4,2020-05-20,Female,44,35-44,1
2,6,1,0,7,2020-05-15,Female,3,1-4,2
2,3,1,0,4,2020-05-16,Female,17,15-19,2
2,0,4,0,4,2020-05-18,Male,51,45-54,2
2,0,0,0,0,2020-05-15,Male,67,65-69,2
2,2,1,0,3,2020-05-14,Male,62,55-64,2
2,2,0,0,2,2020-05-14,Male,40,35-44,2
2,1,2,0,3,2020-05-15,Male,64,55-64,2
2,4,13,0,17,2020-05-16,Male,49,45-54,2
2,1,2,0,3,2020-05-15,Female,85,85+,2
2,0,0,0,0,2020-05-15,Male,58,55-64,2
2,0,1,0,1,2020-05-15,Male,50,45-54,2
2,3,4,0,7,2020-05-19,Female,66,65-69,2
2,0,4,0,4,2020-05-15,Male,75,75-79,2
2,1,4,0,5,2020-05-15,Male,78,75-79,2
2,0,0,0,0,2020-05-15,Male,32,25-34,2
2,2,0,0,2,2020-05-15,Male,53,45-54,2
2,1,3,0,4,2020-05-17,Male,51,45-54,2
2,0,7,0,7,2020-05-16,Female,66,65-69,2
2,0,1,0,1,2020-05-15,Female,25,25-34,2
2,1,3,0,4,2020-05-18,Female,68,65-69,2
2,0,1,0,1,2020-05-15,Female,77,75-79,2
2,0,0,0,0,2020-05-20,Male,23,20-24,2
2,2,2,0,4,2020-05-15,Male,68,65-69,2
2,1,2,0,3,2020-05-18,Female,33,25-34,2
2,3,0,0,3,2020-05-14,Male,53,45-54,2
2,1,0,0,1,2020-05-16,Male,58,55-64,2
2,2,0,0,2,2020-05-15,Female,13,10-14,2
2,1,2,0,3,2020-05-18,Male,37,35-44,2
2,0,1,0,1,2020-05-15,Male,29,25-34,2
2,0,3,0,3,2020-05-18,Male,53,45-54,2
2,0,2,0,2,2020-05-17,Female,71,70-74,2
2,4,0,0,4,2020-05-15,Female,8,5-9,2
2,0,1,0,1,2020-05-21,Female,69,65-69,1
2,0,0,0,0,2020-05-15,Male,60,55-64,2
2,2,8,0,10,2020-05-16,Female,65,65-69,2
2,2,1,0,3,2020-05-15,Female,78,75-79,2
2,0,1,0,1,2020-05-16,Male,53,45-54,2
2,0,0,0,0,2020-05-15,Male,65,65-69,2
2,3,2,0,5,2020-05-15,Female,1,1-4,2
2,2,0,0,2,2020-05-17,Female,69,65-69,2
2,0,1,0,1,2020-05-18,Female,75,75-79,2
2,0,0,0,0,2020-05-18,Male,18,15-19,2
2,4,0,0,4,2020-05-15,Male,14,10-14,2
2,2,7,0,9,2020-05-14,Male,60,55-64,2
2,1,0,0,1,2020-05-17,Male,31,25-34,2
2,3,0,0,3,2020-05-15,Female,50,45-54,2
2,0,1,0,1,2020-05-15,Female,54,45-54,2
2,1,1,0,2,2020-05-16,Male,68,65-69,2
2,0,6,0,6,2020-05-15,Female,39,35-44,2
2,0,0,0,0,2020-05-15,Female,60,55-64,2
2,0,2,0,2,2020-05-14,Female,65,65-69,2
2,2,0,0,2,2020-05-15,Female,37,35-44,1
2,1,3,0,4,2020-05-18,Male,51,45-54,2
2,2,0,0,2,2020-05-16,Female,49,45-54,2
2,2,0,0,2,2020-05-15,Male,71,70-74,2
2,0,2,0,2,2020-05-15,Male,73,70-74,2
2,4,3,0,7,2020-05-14,Female,18,15-19,2
2,2,0,0,2,2020-05-21,Male,66,65-69,2
2,4,0,0,4,2020-05-15,Female,14,10-14,2
2,1,5,0,6,2020-05-14,Male,8,5-9,2
2,0,3,0,3,2020-05-15,Female,69,65-69,2
2,1,0,0,1,2020-05-15,Female,26,25-34,2
2,2,2,0,4,2020-05-16,Male,75,75-79,2
2,1,2,0,3,2020-05-15,Female,52,45-54,2
2,1,5,0,6,2020-05-15,Male,73,70-74,2
2,2,2,0,4,2020-05-15,Male,51,45-54,2
2,3,0,0,3,2020-05-21,Male,39,35-44,1
2,0,1,0,1,2020-05-14,Female,20,20-24,2
2,0,0,0,0,2020-05-17,Female,22,20-24,2
2,4,0,0,4,2020-05-14,Male,62,55-64,2
2,2,1,0,3,2020-05-17,Male,28,25-34,2
2,0,3,0,3,2020-05-14,Male,52,45-54,2
2,2,1,0,3,2020-05-15,Male,54,45-54,2
2,3,0,0,3,2020-05-15,Female,6,5-9,2
2,1,1,0,2,2020-05-15,Female,65,65-69,2
2,2,0,0,2,2020-05-15,Male,64,55-64,2
2,2,1,0,3,2020-05-15,Female,52,45-54,2
2,0,9,0,9,2020-05-16,Male,85,85+,2
2,0,12,0,12,2020-05-15,Female,70,70-74,2
2,0,0,0,0,2020-05-15,Male,39,35-44,2
2,2,0,0,2,2020-05-17,Male,10,10-14,2
2,0,1,0,1,2020-05-17,Male,29,25-34,2
2,2,1,0,3,2020-05-15,Male,67,65-69,2
2,0,32,0,32,2020-05-16,Female,56,55-64,2
2,0,0,0,0,2020-05-18,Female,85,85+,2
2,1,0,0,1,2020-05-20,Female,69,65-69,2
2,0,0,0,0,2020-05-15,Male,51,45-54,2
2,0,1,0,1,2020-05-15,Male,54,45-54,2
2,4,1,0,5,2020-05-14,Female,6,5-9,2
2,1,0,0,1,2020-05-14,Male,66,65-69,2
2,1,0,0,1,2020-05-20,Male,50,45-54,2
2,3,6,0,9,2020-05-15,Female,3,1-4,2
2,0,0,0,0,2020-05-15,Male,45,45-54,2
2,0,0,0,0,2020-05-18,Male,43,35-44,2
2,0,4,0,4,2020-05-18,Male,37,35-44,2
2,3,4,0,7,2020-05-20,Male,36,35-44,1
2,1,4,0,5,2020-05-19,Male,59,55-64,2
2,0,0,0,0,2020-05-20,Male,1,1-4,2
2,2,1,0,3,2020-05-14,Male,63,55-64,2
2,0,3,0,3,2020-05-17,Female,52,45-54,2
2,2,0,0,2,2020-05-15,Male,9,5-9,2
2,3,10,0,13,2020-05-16,Male,59,55-64,2
2,4,2,0,6,2020-05-19,Female,6,5-9,2
2,1,1,0,2,2020-05-15,Female,49,45-54,2
2,0,12,0,12,2020-05-14,Male,65,65-69,2
2,1,0,0,1,2020-05-15,Male,57,55-64,2
2,1,1,0,2,2020-05-14,Female,65,65-69,2
2,2,0,0,2,2020-05-15,Male,2,1-4,2
2,2,0,0,2,2020-05-16,Male,51,45-54,2
2,3,0,0,3,2020-05-18,Female,3,1-4,2
2,2,3,0,5,2020-05-15,Female,24,20-24,2
2,4,0,0,4,2020-05-15,Male,12,10-14,2
2,2,5,0,7,2020-05-16,Male,50,45-54,2
2,1,0,0,1,2020-05-14,Female,65,65-69,2
2,0,0,0,0,2020-05-20,Female,51,45-54,1
2,1,1,0,2,2020-05-15,Male,73,70-74,2
2,2,2,0,4,2020-05-15,Male,54,45-54,2
2,0,1,0,1,2020-05-18,Female,68,65-69,2
2,1,2,0,3,2020-05-15,Female,78,75-79,2
2,2,5,0,7,2020-05-15,Male,67,65-69,2
2,3,0,0,3,2020-05-18,Male,19,15-19,2
2,0,2,0,2,2020-05-15,Male,77,75-79,2
2,1,3,0,4,2020-05-15,Male,85,85+,2
2,2,5,0,7,2020-05-15,Female,55,55-64,2
2,0,0,0,0,2020-05-15,Male,55,55-64,2
2,1,1,0,2,2020-05-15,Female,63,55-64,2
2,2,0,0,2,2020-05-16,Female,66,65-69,2
2,2,1,0,3,2020-05-15,Male,65,65-69,2
2,2,4,0,6,2020-05-16,Male,59,55-64,2
2,0,16,0,16,2020-05-20,Female,32,25-34,2
2,0,0,0,0,2020-05-15,Male,34,25-34,2
2,1,0,0,1,2020-05-18,Male,62,55-64,2
2,1,4,0,5,2020-05-15,Female,67,65-69,2
2,0,1,0,1,2020-05-15,Female,24,20-24,2
2,2,0,0,2,2020-05-20,Male,45,45-54,1
2,1,0,0,1,2020-05-14,Male,51,45-54,2
2,0,2,0,2,2020-05-20,Female,65,65-69,2
2,1,0,0,1,2020-05-14,Male,29,25-34,2
2,2,4,0,6,2020-05-21,Male,75,75-79,1
2,0,1,0,1,2020-05-15,Female,48,45-54,2
2,1,1,0,2,2020-05-15,Male,69,65-69,2
2,1,0,0,1,2020-05-14,Female,63,55-64,2
2,3,2,0,5,2020-05-14,Female,36,35-44,2
2,2,8,0,10,2020-05-15,Female,60,55-64,2
2,2,0,0,2,2020-05-15,Male,70,70-74,2
2,1,0,0,1,2020-05-15,Male,52,45-54,2
2,2,0,0,2,2020-05-15,Male,50,45-54,2
2,0,1,0,1,2020-05-18,Female,65,65-69,2
2,0,2,0,2,2020-05-18,Female,69,65-69,2
2,0,1,0,1,2020-05-15,Female,66,65-69,2
2,4,2,0,6,2020-05-16,Female,5,5-9,2
2,1,4,0,5,2020-05-15,Female,52,45-54,2
2,4,0,0,4,2020-05-15,Female,45,45-54,2
2,0,1,0,1,2020-05-15,Male,54,45-54,2
2,5,0,0,5,2020-05-17,Male,2,1-4,2
2,0,0,0,0,2020-05-20,Male,52,45-54,1
2,1,6,0,7,2020-05-15,Female,55,55-64,2
2,0,3,0,3,2020-05-15,Female,67,65-69,2
2,3,1,0,4,2020-05-15,Male,39,35-44,2
2,0,1,0,1,2020-05-15,Male,38,35-44,2
2,3,0,0,3,2020-05-15,Female,15,15-19,2
2,1,3,0,4,2020-05-20,Male,18,15-19,1
2,1,0,0,1,2020-05-15,Female,62,55-64,2
2,3,0,0,3,2020-05-15,Female,19,15-19,2
2,0,0,0,0,2020-05-15,Female,9,5-9,2
2,1,6,0,7,2020-05-14,Male,65,65-69,2
2,0,0,0,0,2020-05-15,Male,30,25-34,2
2,0,0,0,0,2020-05-15,Male,60,55-64,2
2,2,1,0,3,2020-05-15,Female,3,1-4,2
2,2,0,0,2,2020-05-15,Female,56,55-64,2
2,2,4,0,6,2020-05-15,Male,68,65-69,2
2,4,1,0,5,2020-05-15,Female,14,10-14,2
2,2,0,0,2,2020-05-14,Male,62,55-64,2
2,2,0,0,2,2020-05-15,Male,67,65-69,2
2,2,1,0,3,2020-05-15,Female,57,55-64,2
2,0,5,0,5,2020-05-16,Male,56,55-64,2
2,1,0,0,1,2020-05-16,Male,6,5-9,2
2,2,2,0,4,2020-05-14,Female,55,55-64,2
2,0,0,0,0,2020-05-19,Male,56,55-64,2
2,2,0,0,2,2020-05-14,Female,21,20-24,2
2,0,4,0,4,2020-05-15,Male,30,25-34,2
2,2,1,0,3,2020-05-14,Male,61,55-64,2
2,0,0,0,0,2020-05-14,Male,65,65-69,2
2,0,1,0,1,2020-05-17,Male,38,35-44,2
2,0,2,0,2,2020-05-15,Female,14,10-14,2
2,2,4,0,6,2020-05-14,Male,30,25-34,2
2,2,1,0,3,2020-05-18,Female,58,55-64,2
2,0,1,0,1,2020-05-14,Male,10,10-14,2
2,2,0,0,2,2020-05-15,Male,78,75-79,2
2,1,2,0,3,2020-05-14,Female,65,65-69,2
2,6,0,0,6,2020-05-14,Female,13,10-14,2
2,1,3,0,4,2020-05-14,Male,63,55-64,2
2,1,1,0,2,2020-05-15,Female,51,45-54,2
2,4,11,0,15,2020-05-15,Female,15,15-19,2
2,4,0,0,4,2020-05-15,Female,5,5-9,2
2,3,0,0,3,2020-05-15,Male,58,55-64,2
2,1,3,0,4,2020-05-17,Female,55,55-64,2
2,1,1,0,2,2020-05-14,Female,61,55-64,2
2,2,11,0,13,2020-05-20,Male,53,45-54,2
2,0,4,0,4,2020-05-21,Female,59,55-64,1
2,2,0,0,2,2020-05-15,Male,55,55-64,2
2,0,0,0,0,2020-05-15,Male,59,55-64,2
2,0,1,0,1,2020-05-15,Female,58,55-64,2
2,5,15,0,20,2020-05-20,Male,19,15-19,1
2,0,0,0,0,2020-05-15,Female,23,20-24,2
2,2,0,0,2,2020-05-14,Male,27,25-34,2
2,0,0,0,0,2020-05-15,Male,47,45-54,2
2,0,1,0,1,2020-05-18,Female,49,45-54,2
2,0,0,0,0,2020-05-14,Female,6,5-9,2
2,1,4,0,5,2020-05-14,Female,40,35-44,2
2,0,25,0,25,2020-05-15,Male,72,70-74,2
2,3,4,0,7,2020-05-20,Female,56,55-64,2
2,2,1,0,3,2020-05-14,Male,32,25-34,2
2,0,0,0,0,2020-05-18,Female,30,25-34,2
2,1,4,0,5,2020-05-14,Male,62,55-64,2
2,0,3,0,3,2020-05-15,Male,48,45-54,2
2,4,0,0,4,2020-05-20,Male,17,15-19,1
2,4,0,0,4,2020-05-21,Male,19,15-19,1
2,1,0,0,1,2020-05-15,Male,11,10-14,1
2,0,3,0,3,2020-05-15,Female,72,70-74,2
2,0,0,0,0,2020-05-20,Male,58,55-64,1
2,2,5,0,7,2020-05-14,Male,68,65-69,2
2,2,0,0,2,2020-05-16,Male,70,70-74,2
2,1,3,0,4,2020-05-15,Male,58,55-64,2
2,1,0,0,1,2020-05-14,Male,46,45-54,2
2,0,1,0,1,2020-05-15,Female,30,25-34,2
2,0,4,0,4,2020-05-14,Male,60,55-64,2
2,1,3,0,4,2020-05-15,Female,68,65-69,2
2,2,1,0,3,2020-05-18,Male,23,20-24,2
2,1,1,0,2,2020-05-15,Male,67,65-69,2
2,0,0,0,0,2020-05-15,Male,30,25-34,2
2,0,0,0,0,2020-05-15,Male,34,25-34,2
2,2,4,0,6,2020-05-20,Female,4,1-4,2
2,2,4,0,6,2020-05-14,Male,64,55-64,2
2,2,3,0,5,2020-05-18,Female,22,20-24,2
2,0,3,0,3,2020-05-15,Male,26,25-34,2
2,0,1,0,1,2020-05-18,Female,40,35-44,2
2,1,0,0,1,2020-05-21,Female,49,45-54,1
2,0,3,0,3,2020-05-15,Male,58,55-64,2
2,1,0,0,1,2020-05-18,Male,36,35-44,2
2,1,11,0,12,2020-05-15,Female,53,45-54,2
2,1,4,0,5,2020-05-15,Female,42,35-44,2
2,4,0,0,4,2020-05-20,Male,12,10-14,1
2,3,0,0,3,2020-05-19,Female,31,25-34,2
2,2,15,0,17,2020-05-21,Male,29,25-34,1
2,0,1,0,1,2020-05-15,Female,45,45-54,2
2,0,1,0,1,2020-05-15,Male,49,45-54,2
2,0,0,0,0,2020-05-19,Female,27,25-34,2
2,2,1,0,3,2020-05-14,Female,12,10-14,2
2,1,1,0,2,2020-05-15,Male,54,45-54,2
2,1,2,0,3,2020-05-14,Female,58,55-64,2
2,1,1,0,2,2020-05-15,Female,51,45-54,2
2,0,1,0,1,2020-05-20,Female,69,65-69,2
2,6,0,0,6,2020-05-15,Male,2,1-4,2
2,1,0,0,1,2020-05-15,Male,50,45-54,2
2,4,0,0,4,2020-05-16,Male,16,15-19,2
2,4,2,0,6,2020-05-15,Female,59,55-64,2
2,2,0,0,2,2020-05-18,Male,30,25-34,2
2,3,0,0,3,2020-05-16,Female,50,45-54,2
2,2,0,0,2,2020-05-21,Male,21,20-24,2
2,3,0,0,3,2020-05-15,Female,55,55-64,2
2,3,0,0,3,2020-05-16,Female,66,65-69,2
2,0,0,0,0,2020-05-15,Male,51,45-54,2
2,1,0,0,1,2020-05-18,Female,61,55-64,2
2,1,0,0,1,2020-05-21,Male,41,35-44,2
2,1,3,0,4,2020-05-14,Male,64,55-64,2
2,3,2,0,5,2020-05-14,Female,49,45-54,2
2,0,0,0,0,2020-05-19,Male,59,55-64,2
2,1,0,0,1,2020-05-14,Male,59,55-64,2
2,0,0,0,0,2020-05-14,Male,35,35-44,2
2,3,8,0,11,2020-05-15,Male,5,5-9,2
2,3,4,0,7,2020-05-20,Male,23,20-24,1
2,1,0,0,1,2020-05-15,Female,68,65-69,2
2,0,4,0,4,2020-05-14,Female,25,25-34,2
2,2,2,0,4,2020-05-18,Female,54,45-54,2
2,0,1,0,1,2020-05-15,Female,59,55-64,2
2,0,0,0,0,2020-05-20,Male,7,5-9,1
2,0,3,0,3,2020-05-14,Male,65,65-69,2
2,3,0,0,3,2020-05-20,Male,34,25-34,1
2,0,4,0,4,2020-05-15,Female,39,35-44,2
2,0,0,0,0,2020-05-14,Female,65,65-69,2
2,0,1,0,1,2020-05-15,Female,75,75-79,2
2,2,2,0,4,2020-05-15,Male,69,65-69,2
2,1,1,0,2,2020-05-19,Male,33,25-34,2
2,2,2,0,4,2020-05-14,Male,61,55-64,2
2,1,23,0,24,2020-05-19,Female,59,55-64,2
2,4,1,0,5,2020-05-19,Male,25,25-34,2
2,3,9,0,12,2020-05-15,Female,65,65-69,2
2,1,1,0,2,2020-05-15,Male,78,75-79,2
2,0,0,0,0,2020-05-15,Male,45,45-54,2
2,0,4,0,4,2020-05-21,Female,64,55-64,2
2,0,10,0,10,2020-05-19,Female,59,55-64,2
2,1,0,0,1,2020-05-15,Male,58,55-64,2
2,1,4,0,5,2020-05-15,Male,68,65-69,2
2,2,2,0,4,2020-05-15,Male,69,65-69,2
2,2,5,0,7,2020-05-15,Male,50,45-54,2
2,0,0,0,0,2020-05-14,Male,66,65-69,2
2,2,3,0,5,2020-05-21,Male,58,55-64,1
2,3,0,0,3,2020-05-18,Male,7,5-9,2
2,2,0,0,2,2020-05-18,Male,71,70-74,2
2,2,1,0,3,2020-05-20,Female,73,70-74,1
2,2,4,0,6,2020-05-15,Female,77,75-79,2
2,2,2,0,4,2020-05-15,Male,71,70-74,2
2,3,0,0,3,2020-05-15,Female,15,15-19,2
2,1,2,0,3,2020-05-15,Female,38,35-44,2
2,2,2,0,4,2020-05-15,Female,57,55-64,2
2,4,0,0,4,2020-05-15,Male,18,15-19,2
2,1,0,0,1,2020-05-14,Female,44,35-44,2
2,0,3,0,3,2020-05-16,Male,39,35-44,2
2,1,5,0,6,2020-05-15,Male,77,75-79,2
2,0,0,0,0,2020-05-16,Female,68,65-69,2
2,0,0,0,0,2020-05-16,Male,22,20-24,2
2,2,2,0,4,2020-05-16,Male,66,65-69,2
2,0,0,0,0,2020-05-15,Female,28,25-34,2
2,3,0,0,3,2020-05-15,Female,31,25-34,2
2,2,2,0,4,2020-05-17,Female,48,45-54,2
2,1,1,0,2,2020-05-15,Female,67,65-69,2
2,2,3,0,5,2020-05-15,Female,49,45-54,2
2,1,1,0,2,2020-05-14,Male,61,55-64,2
2,4,8,0,12,2020-05-14,Female,18,15-19,2
2,1,4,0,5,2020-05-19,Male,22,20-24,2
2,1,0,0,1,2020-05-15,Male,59,55-64,2
2,0,2,0,2,2020-05-15,Male,25,25-34,2
2,2,4,0,6,2020-05-16,Female,67,65-69,2
2,0,0,0,0,2020-05-18,Male,47,45-54,2
2,2,0,0,2,2020-05-15,Male,69,65-69,2
2,0,0,0,0,2020-05-18,Male,59,55-64,2
2,2,6,0,8,2020-05-18,Male,43,35-44,2
2,3,2,0,5,2020-05-15,Male,30,25-34,2
2,0,0,0,0,2020-05-17,Male,52,45-54,2
2,3,2,0,5,2020-05-15,Female,0,<1,2
2,0,0,0,0,2020-05-14,Male,42,35-44,2
2,1,1,0,2,2020-05-15,Male,33,25-34,2
2,2,0,0,2,2020-05-14,Male,36,35-44,2
2,0,0,0,0,2020-05-17,Female,23,20-24,2
2,0,1,0,1,2020-05-15,Male,56,55-64,2
2,3,0,0,3,2020-05-15,Male,13,10-14,2
2,0,0,0,0,2020-05-16,Female,51,45-54,2
2,5,0,0,5,2020-05-19,Female,67,65-69,2
2,2,7,0,9,2020-05-20,Female,12,10-14,1
2,3,2,0,5,2020-05-15,Male,50,45-54,2
2,0,0,0,0,2020-05-14,Female,67,65-69,2
2,1,0,0,1,2020-05-15,Male,49,45-54,2
2,1,0,0,1,2020-05-17,Male,31,25-34,2
2,0,4,0,4,2020-05-16,Female,24,20-24,2
2,2,2,0,4,2020-05-15,Male,51,45-54,2
2,2,0,0,2,2020-05-20,Male,69,65-69,2
2,1,0,0,1,2020-05-18,Male,67,65-69,2
2,2,3,0,5,2020-05-14,Female,59,55-64,2
2,4,0,0,4,2020-05-20,Male,19,15-19,1
2,0,0,0,0,2020-05-15,Male,38,35-44,2
2,1,0,0,1,2020-05-15,Female,30,25-34,2
2,5,4,0,9,2020-05-17,Female,0,<1,2
2,0,0,0,0,2020-05-15,Male,32,25-34,2
2,1,0,0,1,2020-05-18,Male,67,65-69,2
2,0,12,0,12,2020-05-15,Male,46,45-54,2
2,1,1,0,2,2020-05-16,Female,54,45-54,2
2,0,1,0,1,2020-05-14,Female,65,65-69,2
2,1,1,0,2,2020-05-15,Female,68,65-69,2
2,2,1,0,3,2020-05-15,Male,45,45-54,2
2,2,0,0,2,2020-05-17,Female,55,55-64,2
2,1,0,0,1,2020-05-18,Male,65,65-69,2
2,0,0,0,0,2020-05-15,Male,17,15-19,2
2,0,0,0,0,2020-05-14,Male,13,10-14,2
2,3,0,0,3,2020-05-15,Male,27,25-34,2
2,4,0,0,4,2020-05-17,Female,18,15-19,2
2,2,2,0,4,2020-05-14,Male,15,15-19,2
2,2,0,0,2,2020-05-14,Male,11,10-14,2
2,2,0,0,2,2020-05-16,Female,45,45-54,2
2,0,0,0,0,2020-05-17,Female,21,20-24,2
2,0,0,0,0,2020-05-21,Male,46,45-54,2
2,1,2,0,3,2020-05-15,Male,73,70-74,2
2,1,10,0,11,2020-05-15,Male,59,55-64,2
2,3,1,0,4,2020-05-16,Female,57,55-64,2
2,0,0,0,0,2020-05-15,Female,29,25-34,2
2,3,1,0,4,2020-05-15,Male,34,25-34,2
2,5,0,0,5,2020-05-15,Male,16,15-19,2
2,2,0,0,2,2020-05-15,Male,75,75-79,2
2,1,7,0,8,2020-05-16,Male,31,25-34,2
2,1,1,0,2,2020-05-15,Male,68,65-69,2
2,1,1,0,2,2020-05-20,Male,57,55-64,2
2,0,3,0,3,2020-05-20,Male,41,35-44,1
2,0,1,0,1,2020-05-15,Male,17,15-19,2
2,1,0,0,1,2020-05-14,Female,66,65-69,2
2,0,3,0,3,2020-05-16,Female,67,65-69,2
2,1,1,0,2,2020-05-15,Female,69,65-69,2
2,2,1,0,3,2020-05-20,Female,21,20-24,1
2,2,0,0,2,2020-05-15,Male,50,45-54,2
2,2,3,0,5,2020-05-18,Female,62,55-64,2
2,1,3,0,4,2020-05-15,Male,71,70-74,2
2,2,0,0,2,2020-05-15,Male,18,15-19,2
2,1,6,0,7,2020-05-15,Male,65,65-69,2
2,0,0,0,0,2020-05-14,Female,62,55-64,2
2,0,0,0,0,2020-05-14,Male,65,65-69,2
2,1,2,0,3,2020-05-15,Male,70,70-74,2
2,0,0,0,0,2020-05-14,Male,65,65-69,2
2,1,1,0,2,2020-05-14,Male,62,55-64,2
2,0,4,0,4,2020-05-15,Female,35,35-44,2
2,0,0,0,0,2020-05-15,Female,68,65-69,2
2,2,1,0,3,2020-05-15,Female,68,65-69,2
2,1,0,0,1,2020-05-18,Male,71,70-74,2
2,0,0,0,0,2020-05-14,Female,62,55-64,2
2,1,7,0,8,2020-05-15,Female,35,35-44,2
2,2,0,0,2,2020-05-20,Female,44,35-44,2
2,3,0,0,3,2020-05-14,Female,64,55-64,2
2,0,1,0,1,2020-05-14,Female,61,55-64,2
2,0,0,0,0,2020-05-15,Male,54,45-54,2
2,4,0,0,4,2020-05-15,Male,54,45-54,2
2,0,42,0,42,2020-05-15,Female,66,65-69,2
2,0,1,0,1,2020-05-19,Male,19,15-19,2
2,2,2,0,4,2020-05-14,Female,59,55-64,2
2,1,2,0,3,2020-05-20,Female,33,25-34,1
2,0,1,0,1,2020-05-14,Female,65,65-69,2
2,0,13,0,13,2020-05-15,Female,30,25-34,2
2,0,2,0,2,2020-05-15,Female,63,55-64,2
2,1,100,0,101,2020-05-17,Female,46,45-54,2
2,0,0,0,0,2020-05-14,Male,60,55-64,2
2,2,11,0,13,2020-05-15,Male,56,55-64,2
2,1,0,0,1,2020-05-14,Male,30,25-34,2
2,4,3,0,7,2020-05-15,Female,11,10-14,2
2,1,5,0,6,2020-05-16,Male,42,35-44,2
2,0,0,0,0,2020-05-18,Male,48,45-54,2
2,0,3,0,3,2020-05-18,Male,65,65-69,2
2,1,0,0,1,2020-05-19,Female,39,35-44,2
2,0,2,0,2,2020-05-14,Female,63,55-64,2
2,5,1,0,6,2020-05-15,Male,12,10-14,2
2,1,4,0,5,2020-05-15,Female,66,65-69,2
2,3,5,0,8,2020-05-14,Female,60,55-64,2
2,2,100,0,102,2020-05-20,Female,53,45-54,1
2,0,4,0,4,2020-05-14,Female,61,55-64,2
2,1,6,0,7,2020-05-20,Female,36,35-44,1
2,2,0,0,2,2020-05-15,Male,43,35-44,2
2,2,0,0,2,2020-05-15,Male,59,55-64,2
2,1,5,0,6,2020-05-16,Female,67,65-69,2
2,0,1,0,1,2020-05-15,Female,55,55-64,2
2,0,2,0,2,2020-05-15,Female,67,65-69,2
2,0,1,0,1,2020-05-16,Male,50,45-54,2
2,2,1,0,3,2020-05-15,Male,38,35-44,2
2,1,4,0,5,2020-05-20,Male,54,45-54,1
2,1,1,0,2,2020-05-15,Male,22,20-24,2
2,2,1,0,3,2020-05-19,Female,70,70-74,2
2,2,0,0,2,2020-05-15,Male,66,65-69,2
2,0,1,0,1,2020-05-20,Female,57,55-64,1
2,2,10,0,12,2020-05-14,Male,56,55-64,2
2,0,3,0,3,2020-05-15,Female,54,45-54,2
2,0,0,0,0,2020-05-15,Male,73,70-74,2
2,0,3,0,3,2020-05-15,Female,33,25-34,2
2,2,2,0,4,2020-05-15,Male,52,45-54,2
2,2,0,0,2,2020-05-14,Male,67,65-69,2
2,0,3,0,3,2020-05-15,Male,33,25-34,2
2,2,2,0,4,2020-05-20,Male,52,45-54,1
2,0,1,0,1,2020-05-17,Female,37,35-44,2
2,2,0,0,2,2020-05-20,Male,19,15-19,2
2,2,2,0,4,2020-05-14,Male,56,55-64,2
2,4,0,0,4,2020-05-16,Male,2,1-4,2
2,0,0,0,0,2020-05-15,Female,58,55-64,2
2,1,6,0,7,2020-05-19,Female,55,55-64,2
2,1,1,0,2,2020-05-18,Male,75,75-79,2
2,2,0,0,2,2020-05-16,Female,22,20-24,2
2,0,2,0,2,2020-05-15,Male,56,55-64,2
2,0,7,0,7,2020-05-15,Female,25,25-34,2
2,0,0,0,0,2020-05-16,Female,32,25-34,2
2,0,0,0,0,2020-05-20,Male,51,45-54,1
2,2,2,0,4,2020-05-20,Male,69,65-69,1
2,3,5,0,8,2020-05-15,Female,42,35-44,2
2,3,0,0,3,2020-05-15,Female,70,70-74,2
2,1,0,0,1,2020-05-15,Female,23,20-24,2
2,0,3,0,3,2020-05-15,Female,68,65-69,2
2,2,2,0,4,2020-05-17,Female,36,35-44,2
2,2,0,0,2,2020-05-15,Male,69,65-69,2
2,2,3,0,5,2020-05-20,Male,70,70-74,2
2,3,2,0,5,2020-05-14,Female,50,45-54,2
2,3,3,0,6,2020-05-16,Male,53,45-54,2
2,1,1,0,2,2020-05-16,Male,34,25-34,2
2,5,2,0,7,2020-05-15,Female,14,10-14,2
2,0,1,0,1,2020-05-14,Male,31,25-34,2
2,1,0,0,1,2020-05-15,Female,31,25-34,2
2,3,0,0,3,2020-05-15,Female,2,1-4,2
2,2,1,0,3,2020-05-14,Male,21,20-24,2
2,1,0,0,1,2020-05-18,Male,44,35-44,2
2,0,2,0,2,2020-05-15,Female,67,65-69,2
2,1,1,0,2,2020-05-15,Female,58,55-64,2
2,0,0,0,0,2020-05-15,Female,53,45-54,2
2,3,1,0,4,2020-05-18,Male,69,65-69,2
2,0,0,0,0,2020-05-18,Female,40,35-44,2
2,3,1,0,4,2020-05-17,Female,22,20-24,2
2,0,1,0,1,2020-05-15,Female,63,55-64,2
2,3,4,0,7,2020-05-16,Male,39,35-44,2
2,2,0,0,2,2020-05-15,Female,69,65-69,2
2,4,2,0,6,2020-05-14,Female,16,15-19,2
2,0,1,0,1,2020-05-14,Male,22,20-24,2
2,2,1,0,3,2020-05-15,Male,57,55-64,2
2,0,0,0,0,2020-05-15,Male,22,20-24,2
2,0,0,0,0,2020-05-15,Male,81,80-84,2
2,2,1,0,3,2020-05-15,Male,63,55-64,2
2,3,0,0,3,2020-05-15,Female,52,45-54,2
2,2,0,0,2,2020-05-15,Male,26,25-34,2
2,3,0,0,3,2020-05-20,Male,4,1-4,1
2,1,3,0,4,2020-05-16,Male,78,75-79,2
2,3,0,0,3,2020-05-15,Female,42,35-44,2
2,0,0,0,0,2020-05-15,Male,49,45-54,2
2,2,0,0,2,2020-05-18,Male,50,45-54,2
2,0,0,0,0,2020-05-15,Male,77,75-79,2
2,2,1,0,3,2020-05-14,Male,66,65-69,2
2,1,1,0,2,2020-05-14,Male,33,25-34,2
2,2,7,0,9,2020-05-14,Female,66,65-69,2
2,1,4,0,5,2020-05-15,Male,36,35-44,2
2,3,0,0,3,2020-05-18,Female,14,10-14,2
2,2,2,0,4,2020-05-15,Male,9,5-9,2
2,0,0,0,0,2020-05-14,Male,47,45-54,2
2,2,5,0,7,2020-05-17,Male,15,15-19,2
2,2,10,0,12,2020-05-19,Female,67,65-69,2
2,1,3,0,4,2020-05-15,Male,39,35-44,2
2,1,6,0,7,2020-05-17,Female,65,65-69,2
2,0,1,0,1,2020-05-15,Male,37,35-44,2
2,0,0,0,0,2020-05-15,Female,39,35-44,2
2,2,1,0,3,2020-05-17,Male,63,55-64,2
2,2,1,0,3,2020-05-15,Female,65,65-69,2
2,0,0,0,0,2020-05-14,Male,11,10-14,2
2,1,32,0,33,2020-05-15,Female,67,65-69,2
2,4,0,0,4,2020-05-15,Female,6,5-9,2
2,3,1,0,4,2020-05-17,Male,13,10-14,2
2,3,1,0,4,2020-05-15,Male,39,35-44,2
2,2,3,0,5,2020-05-20,Female,32,25-34,1
2,0,0,0,0,2020-05-15,Male,57,55-64,2
2,0,0,0,0,2020-05-15,Male,40,35-44,2
2,3,0,0,3,2020-05-21,Male,56,55-64,1
2,0,3,0,3,2020-05-15,Male,44,35-44,2
2,1,5,0,6,2020-05-15,Female,19,15-19,2
2,4,3,0,7,2020-05-14,Male,1,1-4,2
2,2,1,0,3,2020-05-14,Female,13,10-14,2
2,2,2,0,4,2020-05-21,Male,66,65-69,2
2,2,0,0,2,2020-05-15,Female,58,55-64,2
2,2,4,0,6,2020-05-15,Female,51,45-54,2
2,3,10,0,13,2020-05-16,Female,57,55-64,2
2,2,0,0,2,2020-05-14,Female,59,55-64,2
2,2,2,0,4,2020-05-15,Male,10,10-14,2
2,1,9,0,10,2020-05-18,Female,61,55-64,2
2,2,0,0,2,2020-05-15,Female,19,15-19,2
2,2,0,0,2,2020-05-19,Male,54,45-54,2
2,1,1,0,2,2020-05-15,Female,49,45-54,2
2,2,4,0,6,2020-05-15,Female,54,45-54,2
2,0,0,0,0,2020-05-16,Female,11,10-14,2
2,0,2,0,2,2020-05-16,Male,42,35-44,2
2,2,2,0,4,2020-05-16,Female,68,65-69,2
2,0,1,0,1,2020-05-14,Female,24,20-24,2
2,3,1,0,4,2020-05-20,Male,19,15-19,1
2,3,0,0,3,2020-05-15,Female,6,5-9,2
2,1,0,0,1,2020-05-15,Male,33,25-34,2
2,1,0,0,1,2020-05-20,Male,44,35-44,1
2,0,2,0,2,2020-05-15,Male,53,45-54,2
2,4,0,0,4,2020-05-18,Male,17,15-19,2
2,2,3,0,5,2020-05-21,Male,65,65-69,2
2,2,0,0,2,2020-05-15,Female,12,10-14,2
2,1,1,0,2,2020-05-19,Female,65,65-69,2
2,2,0,0,2,2020-05-15,Male,42,35-44,2
2,1,1,0,2,2020-05-16,Female,54,45-54,2
2,1,2,0,3,2020-05-14,Male,52,45-54,2
2,0,6,0,6,2020-05-15,Male,52,45-54,2
2,1,0,0,1,2020-05-18,Female,40,35-44,2
2,2,2,0,4,2020-05-19,Female,58,55-64,2
2,1,3,0,4,2020-05-14,Male,56,55-64,2
2,1,2,0,3,2020-05-19,Male,65,65-69,2
2,2,4,0,6,2020-05-18,Male,66,65-69,2
2,2,0,0,2,2020-05-21,Male,62,55-64,2
2,1,0,0,1,2020-05-16,Male,39,35-44,2
2,2,0,0,2,2020-05-15,Female,61,55-64,2
2,1,2,0,3,2020-05-14,Female,28,25-34,2
2,3,0,0,3,2020-05-14,Female,12,10-14,2
2,1,1,0,2,2020-05-17,Female,70,70-74,2
2,2,0,0,2,2020-05-18,Male,53,45-54,2
2,0,0,0,0,2020-05-18,Male,27,25-34,2
2,2,2,0,4,2020-05-14,Male,72,70-74,2
2,1,3,0,4,2020-05-20,Male,57,55-64,2
2,1,2,0,3,2020-05-15,Male,61,55-64,2
2,4,5,0,9,2020-05-18,Female,8,5-9,2
2,2,0,0,2,2020-05-15,Male,22,20-24,2
2,5,2,0,7,2020-05-19,Male,6,5-9,1
2,2,0,0,2,2020-05-15,Male,68,65-69,2
2,1,10,0,11,2020-05-16,Male,54,45-54,2
2,2,0,0,2,2020-05-15,Male,15,15-19,2
2,2,10,0,12,2020-05-19,Male,18,15-19,2
2,2,0,0,2,2020-05-14,Male,30,25-34,2
2,2,5,0,7,2020-05-16,Female,68,65-69,2
2,2,0,0,2,2020-05-17,Female,62,55-64,2
2,2,31,0,33,2020-05-15,Female,67,65-69,2
2,1,3,0,4,2020-05-15,Male,54,45-54,2
2,1,0,0,1,2020-05-14,Female,61,55-64,2
2,0,1,0,1,2020-05-15,Male,66,65-69,2
2,1,2,0,3,2020-05-21,Female,79,75-79,1
2,2,0,0,2,2020-05-14,Female,61,55-64,2
2,1,3,0,4,2020-05-15,Male,52,45-54,2
2,0,2,0,2,2020-05-15,Female,65,65-69,2
2,0,2,0,2,2020-05-18,Female,48,45-54,2
2,4,1,0,5,2020-05-18,Female,45,45-54,2
2,4,1,0,5,2020-05-19,Male,10,10-14,2
2,0,6,0,6,2020-05-15,Female,59,55-64,2
2,1,0,0,1,2020-05-14,Male,65,65-69,2
2,0,11,0,11,2020-05-15,Female,67,65-69,2
2,3,0,0,3,2020-05-15,Female,12,10-14,2
2,1,10,0,11,2020-05-16,Female,62,55-64,2
2,2,0,0,2,2020-05-15,Male,32,25-34,2
2,2,0,0,2,2020-05-15,Male,50,45-54,2
2,0,1,0,1,2020-05-14,Female,51,45-54,2
2,2,2,0,4,2020-05-16,Male,31,25-34,2
2,3,0,0,3,2020-05-20,Male,44,35-44,1
2,1,0,0,1,2020-05-15,Male,66,65-69,2
2,0,0,0,0,2020-05-15,Male,28,25-34,2
2,0,2,0,2,2020-05-14,Male,57,55-64,2
2,1,4,0,5,2020-05-15,Male,59,55-64,2
2,4,1,0,5,2020-05-14,Female,43,35-44,2
2,2,0,0,2,2020-05-15,Male,21,20-24,2
2,0,1,0,1,2020-05-15,Female,67,65-69,2
2,0,1,0,1,2020-05-14,Female,63,55-64,2
2,2,10,0,12,2020-05-19,Male,74,70-74,2
2,2,1,0,3,2020-05-15,Female,35,35-44,2
2,3,1,0,4,2020-05-20,Male,44,35-44,1
2,1,33,0,34,2020-05-15,Male,57,55-64,2
2,4,3,0,7,2020-05-15,Male,3,1-4,2
2,1,0,0,1,2020-05-19,Female,58,55-64,2
2,0,0,0,0,2020-05-15,Male,15,15-19,2
2,0,1,0,1,2020-05-15,Male,49,45-54,2
2,0,0,0,0,2020-05-21,Male,69,65-69,2
2,0,4,0,4,2020-05-17,Male,56,55-64,2
2,2,4,0,6,2020-05-14,Female,25,25-34,2
2,0,0,0,0,2020-05-14,Male,29,25-34,2
2,2,3,0,5,2020-05-15,Female,69,65-69,2
2,1,3,0,4,2020-05-15,Male,66,65-69,2
2,2,0,0,2,2020-05-20,Male,68,65-69,1
2,2,0,0,2,2020-05-15,Female,6,5-9,2
2,2,0,0,2,2020-05-18,Female,65,65-69,2
2,0,0,0,0,2020-05-14,Male,40,35-44,2
2,2,0,0,2,2020-05-15,Female,15,15-19,2
2,2,10,0,12,2020-05-15,Male,54,45-54,2
2,1,1,0,2,2020-05-15,Male,67,65-69,2
2,5,0,0,5,2020-05-15,Male,4,1-4,2
2,1,0,0,1,2020-05-15,Male,64,55-64,2
2,2,0,0,2,2020-05-17,Male,42,35-44,2
2,3,2,0,5,2020-05-14,Female,1,1-4,2
2,1,5,0,6,2020-05-14,Female,68,65-69,2
2,2,0,0,2,2020-05-14,Male,60,55-64,2
2,1,0,0,1,2020-05-14,Male,64,55-64,2
2,0,0,0,0,2020-05-14,Female,61,55-64,2
2,1,0,0,1,2020-05-15,Male,55,55-64,2
2,0,1,0,1,2020-05-15,Male,51,45-54,2
2,2,0,0,2,2020-05-18,Male,65,65-69,2
2,3,0,0,3,2020-05-18,Female,14,10-14,2
2,0,8,0,8,2020-05-15,Male,60,55-64,2
2,2,0,0,2,2020-05-15,Male,52,45-54,2
2,0,1,0,1,2020-05-18,Female,26,25-34,2
2,5,0,0,5,2020-05-15,Female,9,5-9,2
2,4,0,0,4,2020-05-15,Male,11,10-14,2
2,1,7,0,8,2020-05-14,Female,55,55-64,2
2,3,2,0,5,2020-05-21,Female,41,35-44,2
2,2,0,0,2,2020-05-14,Male,65,65-69,2
2,2,0,0,2,2020-05-14,Male,66,65-69,2
2,0,0,0,0,2020-05-15,Male,40,35-44,2
2,0,3,0,3,2020-05-14,Male,41,35-44,2
2,0,0,0,0,2020-05-15,Male,66,65-69,2
2,0,2,0,2,2020-05-15,Male,33,25-34,2
2,0,1,0,1,2020-05-15,Female,34,25-34,2
2,2,1,0,3,2020-05-15,Female,68,65-69,2
2,4,1,0,5,2020-05-14,Male,3,1-4,2
2,0,0,0,0,2020-05-15,Male,54,45-54,2
2,0,0,0,0,2020-05-19,Male,66,65-69,2
2,0,1,0,1,2020-05-16,Male,57,55-64,2
2,1,6,0,7,2020-05-15,Male,51,45-54,2
2,2,5,0,7,2020-05-16,Female,38,35-44,2
2,1,0,0,1,2020-05-14,Male,61,55-64,2
2,0,3,0,3,2020-05-14,Female,66,65-69,2
2,3,2,0,5,2020-05-15,Male,57,55-64,2
2,4,1,0,5,2020-05-15,Male,9,5-9,2
2,4,0,0,4,2020-05-15,Female,38,35-44,2
2,0,0,0,0,2020-05-15,Male,77,75-79,2
2,4,0,0,4,2020-05-15,Female,37,35-44,2
2,1,0,0,1,2020-05-15,Female,63,55-64,2
2,3,4,0,7,2020-05-21,Female,19,15-19,2
2,1,0,0,1,2020-05-16,Male,46,45-54,2
2,0,0,0,0,2020-05-20,Female,58,55-64,1
2,0,4,0,4,2020-05-15,Male,25,25-34,2
2,4,0,0,4,2020-05-19,Male,4,1-4,2
2,0,1,0,1,2020-05-17,Male,47,45-54,2
2,1,1,0,2,2020-05-17,Male,30,25-34,2
2,0,1,0,1,2020-05-16,Female,67,65-69,2
2,0,0,0,0,2020-05-14,Male,65,65-69,2
2,1,2,0,3,2020-05-15,Male,71,70-74,2
2,2,0,0,2,2020-05-18,Male,10,10-14,2
2,0,0,0,0,2020-05-15,Male,42,35-44,2
2,2,2,0,4,2020-05-14,Female,63,55-64,2
2,0,0,0,0,2020-05-17,Female,48,45-54,2
2,0,0,0,0,2020-05-20,Male,76,75-79,1
2,3,1,0,4,2020-05-15,Male,2,1-4,2
2,0,1,0,1,2020-05-14,Male,22,20-24,2
2,1,2,0,3,2020-05-15,Female,45,45-54,2
2,1,0,0,1,2020-05-14,Male,9,5-9,2
2,2,15,0,17,2020-05-16,Female,7,5-9,2
2,2,0,0,2,2020-05-15,Male,56,55-64,2
2,1,0,0,1,2020-05-15,Male,56,55-64,2
2,0,0,0,0,2020-05-14,Male,65,65-69,2
2,1,1,0,2,2020-05-15,Female,53,45-54,2
2,6,2,0,8,2020-05-15,Female,5,5-9,2
2,2,0,0,2,2020-05-15,Male,2,1-4,2
2,2,40,0,42,2020-05-14,Male,60,55-64,2
2,1,1,0,2,2020-05-14,Male,65,65-69,2
2,1,0,0,1,2020-05-20,Female,24,20-24,1
2,2,0,0,2,2020-05-21,Female,55,55-64,2
2,2,0,0,2,2020-05-15,Male,33,25-34,2
2,1,1,0,2,2020-05-18,Female,52,45-54,2
2,1,0,0,1,2020-05-15,Female,58,55-64,2
2,0,1,0,1,2020-05-14,Male,20,20-24,2
2,0,1,0,1,2020-05-18,Male,39,35-44,2
2,2,1,0,3,2020-05-15,Male,72,70-74,2
2,2,1,0,3,2020-05-18,Male,62,55-64,2
2,2,0,0,2,2020-05-15,Female,46,45-54,2
2,0,0,0,0,2020-05-14,Female,21,20-24,2
2,1,0,0,1,2020-05-18,Female,68,65-69,2
2,2,0,0,2,2020-05-15,Male,53,45-54,2
2,1,1,0,2,2020-05-15,Female,55,55-64,2
2,0,4,0,4,2020-05-15,Female,66,65-69,2
2,0,0,0,0,2020-05-15,Female,67,65-69,2
2,2,1,0,3,2020-05-20,Male,71,70-74,2
2,2,1,0,3,2020-05-15,Female,52,45-54,2
2,3,2,0,5,2020-05-15,Male,6,5-9,2
2,2,2,0,4,2020-05-18,Male,66,65-69,2
2,3,0,0,3,2020-05-16,Female,58,55-64,2
2,2,0,0,2,2020-05-15,Male,71,70-74,2
2,0,1,0,1,2020-05-15,Female,70,70-74,2
2,0,0,0,0,2020-05-14,Male,66,65-69,2
2,1,0,0,1,2020-05-15,Male,50,45-54,2
2,1,0,0,1,2020-05-20,Male,67,65-69,2
2,0,1,0,1,2020-05-18,Female,55,55-64,2
2,1,0,0,1,2020-05-15,Male,80,80-84,2
2,1,0,0,1,2020-05-19,Female,52,45-54,2
2,1,0,0,1,2020-05-18,Male,19,15-19,2
2,2,2,0,4,2020-05-14,Male,62,55-64,2
2,0,1,0,1,2020-05-15,Male,37,35-44,2
2,1,0,0,1,2020-05-15,Female,27,25-34,2
2,4,0,0,4,2020-05-20,Female,47,45-54,2
2,0,0,0,0,2020-05-15,Female,11,10-14,2
2,0,0,0,0,2020-05-21,Male,53,45-54,2
2,2,4,0,6,2020-05-16,Male,2,1-4,2
2,2,1,0,3,2020-05-14,Male,34,25-34,2
2,0,1,0,1,2020-05-15,Female,71,70-74,2
2,8,0,0,8,2020-05-16,Female,5,5-9,2
2,1,2,0,3,2020-05-15,Female,24,20-24,2
2,2,0,0,2,2020-05-15,Male,31,25-34,2
2,2,2,0,4,2020-05-16,Female,71,70-74,2
2,2,31,0,33,2020-05-14,Male,40,35-44,2
2,2,1,0,3,2020-05-14,Male,31,25-34,2
2,2,1,0,3,2020-05-15,Male,57,55-64,2
2,2,2,0,4,2020-05-15,Female,35,35-44,2
2,1,3,0,4,2020-05-14,Female,58,55-64,2
2,1,92,0,93,2020-05-15,Male,69,65-69,2
2,1,0,0,1,2020-05-14,Male,66,65-69,2
2,0,4,0,4,2020-05-15,Female,51,45-54,2
2,2,1,0,3,2020-05-15,Female,57,55-64,2
2,0,0,0,0,2020-05-15,Male,51,45-54,2
2,0,21,0,21,2020-05-21,Male,56,55-64,2
2,1,0,0,1,2020-05-15,Female,0,<1,2
2,2,2,0,4,2020-05-15,Male,24,20-24,2
2,2,0,0,2,2020-05-14,Female,63,55-64,2
2,3,10,0,13,2020-05-16,Male,16,15-19,2
2,0,3,0,3,2020-05-15,Male,50,45-54,2
2,4,1,0,5,2020-05-14,Female,16,15-19,2
2,0,6,0,6,2020-05-14,Male,74,70-74,2
2,0,0,0,0,2020-05-15,Female,44,35-44,2
2,0,11,0,11,2020-05-16,Male,73,70-74,2
2,0,0,0,0,2020-05-15,Female,65,65-69,2
2,0,0,0,0,2020-05-18,Female,53,45-54,2
2,0,0,0,0,2020-05-15,Female,62,55-64,2
2,2,1,0,3,2020-05-15,Male,73,70-74,2
2,2,1,0,3,2020-05-15,Female,70,70-74,2
2,2,4,0,6,2020-05-14,Female,62,55-64,2
2,0,0,0,0,2020-05-20,Male,78,75-79,1
2,0,0,0,0,2020-05-21,Female,76,75-79,1
2,2,1,0,3,2020-05-16,Male,31,25-34,2
2,2,0,0,2,2020-05-15,Male,26,25-34,2
2,1,1,0,2,2020-05-14,Male,27,25-34,2
2,0,0,0,0,2020-05-14,Male,30,25-34,2
2,0,0,0,0,2020-05-15,Female,64,55-64,2
2,3,0,0,3,2020-05-15,Male,41,35-44,2
2,0,1,0,1,2020-05-15,Male,70,70-74,2
2,1,4,0,5,2020-05-14,Male,33,25-34,2
2,0,0,0,0,2020-05-14,Male,65,65-69,2
2,1,3,0,4,2020-05-15,Female,68,65-69,2
2,0,0,0,0,2020-05-15,Female,62,55-64,2
2,2,0,0,2,2020-05-19,Male,72,70-74,2
2,0,1,0,1,2020-05-15,Male,65,65-69,2
2,0,1,0,1,2020-05-15,Male,68,65-69,2
2,2,1,0,3,2020-05-17,Male,67,65-69,2
2,2,0,0,2,2020-05-15,Female,66,65-69,2
2,2,3,0,5,2020-05-15,Male,68,65-69,2
2,1,2,0,3,2020-05-15,Male,61,55-64,2
2,0,0,0,0,2020-05-15,Female,55,55-64,2
2,0,4,0,4,2020-05-15,Female,60,55-64,2
2,2,1,0,3,2020-05-18,Female,52,45-54,2
2,3,0,0,3,2020-05-15,Female,2,1-4,2
2,1,0,0,1,2020-05-15,Male,55,55-64,2
2,0,1,0,1,2020-05-14,Female,62,55-64,2
2,3,2,0,5,2020-05-15,Female,33,25-34,2
2,0,1,0,1,2020-05-14,Female,61,55-64,2
2,2,1,0,3,2020-05-19,Female,59,55-64,2
2,1,2,0,3,2020-05-18,Female,30,25-34,2
2,0,1,0,1,2020-05-15,Female,18,15-19,2
2,1,0,0,1,2020-05-21,Male,41,35-44,2
2,2,5,0,7,2020-05-14,Female,59,55-64,2
2,2,2,0,4,2020-05-15,Male,59,55-64,2
2,0,1,0,1,2020-05-15,Male,69,65-69,2
2,2,30,0,32,2020-05-15,Male,47,45-54,2
2,0,11,0,11,2020-05-19,Female,54,45-54,2
2,1,0,0,1,2020-05-17,Male,32,25-34,2
2,2,12,0,14,2020-05-21,Male,65,65-69,2
2,2,0,0,2,2020-05-16,Female,51,45-54,2
2,2,2,0,4,2020-05-20,Male,71,70-74,2
2,0,0,0,0,2020-05-16,Female,67,65-69,2
2,1,0,0,1,2020-05-21,Female,24,20-24,1
2,2,0,0,2,2020-05-19,Female,66,65-69,2
2,1,2,0,3,2020-05-15,Male,69,65-69,2
2,1,0,0,1,2020-05-15,Male,51,45-54,2
2,4,1,0,5,2020-05-20,Female,16,15-19,2
2,2,0,0,2,2020-05-14,Female,64,55-64,2
2,5,3,0,8,2020-05-18,Female,16,15-19,2
2,2,0,0,2,2020-05-14,Female,37,35-44,2
2,1,7,0,8,2020-05-19,Female,23,20-24,2
2,0,3,0,3,2020-05-18,Male,57,55-64,2
2,1,0,0,1,2020-05-21,Female,73,70-74,1
2,0,5,0,5,2020-05-15,Male,66,65-69,2
2,3,4,0,7,2020-05-17,Female,25,25-34,2
2,0,0,0,0,2020-05-16,Female,49,45-54,2
2,0,2,0,2,2020-05-14,Female,60,55-64,2
2,0,1,0,1,2020-05-17,Male,36,35-44,2
2,1,3,0,4,2020-05-14,Female,34,25-34,2
2,2,6,0,8,2020-05-15,Female,52,45-54,2
2,3,1,0,4,2020-05-17,Female,51,45-54,2
2,1,3,0,4,2020-05-18,Female,32,25-34,2
2,4,1,0,5,2020-05-14,Male,12,10-14,2
2,1,0,0,1,2020-05-17,Female,54,45-54,2
2,2,0,0,2,2020-05-16,Female,52,45-54,2
2,2,8,0,10,2020-05-14,Female,64,55-64,2
2,0,0,0,0,2020-05-15,Male,78,75-79,2
2,0,1,0,1,2020-05-20,Female,21,20-24,2
2,3,3,0,6,2020-05-15,Male,17,15-19,2
2,1,12,0,13,2020-05-14,Female,60,55-64,2
2,3,0,0,3,2020-05-15,Male,10,10-14,2
2,2,0,0,2,2020-05-15,Male,16,15-19,2
2,0,0,0,0,2020-05-17,Female,42,35-44,2
2,1,1,0,2,2020-05-21,Male,30,25-34,1
2,3,13,0,16,2020-05-15,Male,32,25-34,2
2,0,3,0,3,2020-05-14,Female,65,65-69,2
2,3,0,0,3,2020-05-17,Male,67,65-69,2
2,1,2,0,3,2020-05-15,Male,37,35-44,2
2,2,3,0,5,2020-05-20,Male,69,65-69,1
2,0,0,0,0,2020-05-14,Male,60,55-64,2
2,1,1,0,2,2020-05-14,Female,63,55-64,2
2,0,4,0,4,2020-05-15,Male,36,35-44,2
2,0,0,0,0,2020-05-15,Female,67,65-69,2
2,2,3,0,5,2020-05-18,Female,39,35-44,2
2,1,4,0,5,2020-05-15,Female,67,65-69,2
2,1,0,0,1,2020-05-15,Male,22,20-24,2
2,2,0,0,2,2020-05-16,Female,37,35-44,2
2,0,1,0,1,2020-05-20,Male,18,15-19,1
2,0,1,0,1,2020-05-15,Female,40,35-44,2
2,1,0,0,1,2020-05-15,Female,33,25-34,2
2,0,2,0,2,2020-05-14,Male,66,65-69,2
2,2,2,0,4,2020-05-18,Female,51,45-54,2
2,1,1,0,2,2020-05-14,Female,23,20-24,2
2,0,3,0,3,2020-05-16,Female,50,45-54,2
2,0,0,0,0,2020-05-18,Female,66,65-69,2
2,1,0,0,1,2020-05-15,Female,72,70-74,2
2,1,0,0,1,2020-05-20,Male,29,25-34,1
2,0,1,0,1,2020-05-16,Male,58,55-64,2
2,2,4,0,6,2020-05-15,Female,11,10-14,2
2,0,8,0,8,2020-05-15,Female,23,20-24,2
2,2,0,0,2,2020-05-15,Female,19,15-19,2
2,1,0,0,1,2020-05-15,Female,66,65-69,2
2,2,0,0,2,2020-05-18,Female,52,45-54,2
2,2,0,0,2,2020-05-15,Male,68,65-69,2
2,2,13,0,15,2020-05-15,Female,55,55-64,2
2,2,0,0,2,2020-05-14,Male,63,55-64,2
2,2,0,0,2,2020-05-15,Male,72,70-74,2
2,3,0,0,3,2020-05-15,Female,22,20-24,2
2,1,0,0,1,2020-05-14,Female,64,55-64,2
2,0,1,0,1,2020-05-14,Female,66,65-69,2
2,0,0,0,0,2020-05-14,Female,30,25-34,2
2,0,0,0,0,2020-05-14,Female,37,35-44,2
2,0,0,0,0,2020-05-18,Female,71,70-74,2
2,2,0,0,2,2020-05-15,Female,71,70-74,2
2,1,0,0,1,2020-05-14,Female,49,45-54,2
2,4,0,0,4,2020-05-14,Female,58,55-64,2
2,2,2,0,4,2020-05-15,Female,50,45-54,2
2,0,1,0,1,2020-05-15,Female,40,35-44,2
2,3,0,0,3,2020-05-15,Male,21,20-24,2
2,0,0,0,0,2020-05-14,Male,35,35-44,2
2,0,1,0,1,2020-05-15,Male,54,45-54,2
2,1,0,0,1,2020-05-15,Female,36,35-44,2
2,3,2,0,5,2020-05-19,Female,9,5-9,2
2,2,1,0,3,2020-05-14,Male,61,55-64,2
2,1,0,0,1,2020-05-15,Male,39,35-44,2
2,2,0,0,2,2020-05-15,Female,67,65-69,2
2,4,1,0,5,2020-05-16,Male,14,10-14,2
2,0,0,0,0,2020-05-15,Female,70,70-74,2
2,2,2,0,4,2020-05-15,Male,73,70-74,2
2,2,1,0,3,2020-05-19,Female,65,65-69,2
2,0,0,0,0,2020-05-17,Female,33,25-34,2
2,3,1,0,4,2020-05-15,Male,14,10-14,2
2,1,2,0,3,2020-05-15,Male,72,70-74,2
2,0,0,0,0,2020-05-15,Male,34,25-34,2
2,3,1,0,4,2020-05-15,Male,24,20-24,2
2,1,0,0,1,2020-05-18,Male,66,65-69,2
2,0,1,0,1,2020-05-19,Male,67,65-69,2
2,1,0,0,1,2020-05-15,Male,66,65-69,2
2,1,0,0,1,2020-05-14,Female,60,55-64,2
2,2,2,0,4,2020-05-18,Female,65,65-69,2
2,2,2,0,4,2020-05-14,Male,66,65-69,2
2,3,0,0,3,2020-05-15,Female,13,10-14,2
2,0,1,0,1,2020-05-15,Female,50,45-54,2
2,0,0,0,0,2020-05-17,Male,21,20-24,2
2,3,1,0,4,2020-05-15,Female,1,1-4,2
2,2,6,0,8,2020-05-15,Male,69,65-69,2
2,1,30,0,31,2020-05-15,Male,65,65-69,2
2,0,3,0,3,2020-05-14,Female,28,25-34,2
2,1,7,0,8,2020-05-16,Female,24,20-24,2
2,3,1,0,4,2020-05-15,Female,64,55-64,2
2,2,2,0,4,2020-05-15,Female,66,65-69,2
2,1,3,0,4,2020-05-15,Female,74,70-74,2
2,0,0,0,0,2020-05-20,Female,36,35-44,2
2,2,0,0,2,2020-05-18,Male,31,25-34,2
2,2,1,0,3,2020-05-14,Female,16,15-19,2
2,3,0,0,3,2020-05-15,Male,15,15-19,2
2,3,2,0,5,2020-05-14,Male,33,25-34,2
2,2,3,0,5,2020-05-17,Female,22,20-24,2
2,1,0,0,1,2020-05-14,Female,63,55-64,2
2,0,1,0,1,2020-05-21,Female,68,65-69,2
2,1,0,0,1,2020-05-14,Male,65,65-69,2
2,3,0,0,3,2020-05-15,Female,10,10-14,2
2,1,1,0,2,2020-05-18,Male,53,45-54,2
2,0,1,0,1,2020-05-14,Female,51,45-54,2
2,2,3,0,5,2020-05-21,Female,30,25-34,1
2,2,0,0,2,2020-05-14,Male,62,55-64,2
2,0,0,0,0,2020-05-14,Male,28,25-34,2
2,2,3,0,5,2020-05-21,Female,63,55-64,1
2,2,2,0,4,2020-05-14,Male,65,65-69,2
2,0,2,0,2,2020-05-16,Male,37,35-44,2
2,2,6,0,8,2020-05-17,Female,66,65-69,2
2,0,1,0,1,2020-05-15,Male,52,45-54,2
2,0,0,0,0,2020-05-15,Female,43,35-44,2
2,0,5,0,5,2020-05-14,Male,63,55-64,2
2,0,2,0,2,2020-05-15,Female,52,45-54,2
2,2,0,0,2,2020-05-15,Female,48,45-54,2
2,0,0,0,0,2020-05-14,Female,14,10-14,2
2,0,2,0,2,2020-05-14,Female,63,55-64,2
2,2,3,0,5,2020-05-20,Female,52,45-54,1
2,1,1,0,2,2020-05-15,Male,65,65-69,2
2,0,1,0,1,2020-05-14,Female,25,25-34,2
2,0,1,0,1,2020-05-18,Female,54,45-54,2
2,0,0,0,0,2020-05-15,Female,21,20-24,2
2,2,0,0,2,2020-05-21,Male,64,55-64,1
2,0,0,0,0,2020-05-14,Male,33,25-34,2
2,2,1,0,3,2020-05-15,Male,46,45-54,2
2,1,1,0,2,2020-05-14,Male,61,55-64,2
2,0,1,0,1,2020-05-14,Male,65,65-69,2
2,1,1,0,2,2020-05-15,Male,67,65-69,2
2,3,0,0,3,2020-05-15,Male,6,5-9,2
2,0,0,0,0,2020-05-18,Male,55,55-64,2
2,0,0,0,0,2020-05-15,Male,30,25-34,2
2,0,2,0,2,2020-05-15,Female,47,45-54,2
2,3,1,0,4,2020-05-17,Female,59,55-64,2
2,4,0,0,4,2020-05-15,Female,32,25-34,2
2,4,3,0,7,2020-05-20,Female,45,45-54,1
2,2,1,0,3,2020-05-14,Male,63,55-64,2
2,2,0,0,2,2020-05-15,Female,57,55-64,2
2,0,6,0,6,2020-05-16,Female,69,65-69,2
2,3,3,0,6,2020-05-15,Female,32,25-34,2
2,1,0,0,1,2020-05-15,Male,57,55-64,2
2,2,2,0,4,2020-05-14,Male,63,55-64,2
2,1,6,0,7,2020-05-19,Female,62,55-64,2
2,1,1,0,2,2020-05-15,Female,63,55-64,2
2,3,3,0,6,2020-05-15,Female,43,35-44,2
2,2,3,0,5,2020-05-15,Female,68,65-69,2
2,2,0,0,2,2020-05-16,Male,52,45-54,2
2,3,10,0,13,2020-05-15,Male,49,45-54,2
2,3,1,0,4,2020-05-15,Female,16,15-19,2
2,3,10,0,13,2020-05-20,Male,40,35-44,1
2,1,0,0,1,2020-05-14,Female,67,65-69,2
2,0,0,0,0,2020-05-15,Male,15,15-19,2
2,1,8,0,9,2020-05-15,Female,23,20-24,2
2,1,0,0,1,2020-05-15,Male,59,55-64,2
2,2,0,0,2,2020-05-16,Female,38,35-44,2
2,0,0,0,0,2020-05-16,Male,41,35-44,2
2,2,2,0,4,2020-05-15,Male,67,65-69,2
2,1,5,0,6,2020-05-20,Female,69,65-69,1
2,2,2,0,4,2020-05-15,Male,76,75-79,2
2,1,0,0,1,2020-05-14,Female,58,55-64,2
2,0,0,0,0,2020-05-18,Male,60,55-64,2
2,0,0,0,0,2020-05-16,Female,12,10-14,2
2,1,0,0,1,2020-05-14,Female,54,45-54,2
2,0,2,0,2,2020-05-15,Female,67,65-69,2
2,0,3,0,3,2020-05-17,Male,29,25-34,2
2,4,0,0,4,2020-05-15,Male,12,10-14,2
2,1,0,0,1,2020-05-15,Female,29,25-34,2
2,0,1,0,1,2020-05-16,Female,39,35-44,2
2,0,0,0,0,2020-05-15,Female,33,25-34,2
2,0,1,0,1,2020-05-19,Female,67,65-69,2
2,0,7,0,7,2020-05-20,Female,30,25-34,1
2,2,7,0,9,2020-05-21,Female,76,75-79,1
2,1,3,0,4,2020-05-14,Female,65,65-69,2
2,0,1,0,1,2020-05-15,Female,75,75-79,2
2,3,2,0,5,2020-05-18,Female,17,15-19,2
2,0,0,0,0,2020-05-15,Male,70,70-74,2
2,1,2,0,3,2020-05-15,Female,27,25-34,2
2,1,2,0,3,2020-05-15,Male,73,70-74,2
2,0,2,0,2,2020-05-18,Male,12,10-14,2
2,0,1,0,1,2020-05-15,Female,66,65-69,2
2,0,0,0,0,2020-05-14,Male,43,35-44,2
2,0,1,0,1,2020-05-15,Female,68,65-69,2
2,4,2,0,6,2020-05-15,Female,18,15-19,2
2,0,21,0,21,2020-05-18,Male,54,45-54,2
2,4,1,0,5,2020-05-15,Male,7,5-9,2
2,1,0,0,1,2020-05-18,Female,30,25-34,2
2,4,4,0,8,2020-05-15,Male,10,10-14,2
2,0,7,0,7,2020-05-15,Female,27,25-34,2
2,2,0,0,2,2020-05-15,Male,47,45-54,2
2,2,3,0,5,2020-05-16,Female,52,45-54,2
2,1,1,0,2,2020-05-15,Female,68,65-69,2
2,0,2,0,2,2020-05-15,Female,37,35-44,2
2,1,1,0,2,2020-05-15,Male,53,45-54,2
2,1,1,0,2,2020-05-14,Male,67,65-69,2
2,2,0,0,2,2020-05-18,Female,72,70-74,2
2,1,4,0,5,2020-05-18,Female,24,20-24,2
2,1,3,0,4,2020-05-15,Female,22,20-24,2
2,0,0,0,0,2020-05-15,Male,49,45-54,2
2,1,0,0,1,2020-05-14,Female,49,45-54,2
2,2,4,0,6,2020-05-16,Female,68,65-69,2
2,3,3,0,6,2020-05-16,Female,7,5-9,2
2,2,1,0,3,2020-05-16,Male,68,65-69,2
2,2,13,0,15,2020-05-16,Female,47,45-54,2
2,4,3,0,7,2020-05-14,Female,18,15-19,2
2,3,0,0,3,2020-05-15,Male,84,80-84,2
2,1,1,0,2,2020-05-17,Female,51,45-54,2
2,1,0,0,1,2020-05-15,Female,31,25-34,2
2,1,5,0,6,2020-05-14,Female,53,45-54,2
2,2,0,0,2,2020-05-21,Male,11,10-14,2
2,2,1,0,3,2020-05-19,Female,19,15-19,2
2,0,4,0,4,2020-05-16,Male,47,45-54,2
2,0,1,0,1,2020-05-15,Female,32,25-34,2
2,2,1,0,3,2020-05-15,Female,66,65-69,2
2,0,1,0,1,2020-05-20,Female,34,25-34,1
2,0,1,0,1,2020-05-15,Male,49,45-54,2
2,0,0,0,0,2020-05-18,Male,3,1-4,2
2,0,0,0,0,2020-05-21,Male,44,35-44,1
2,1,3,0,4,2020-05-15,Female,50,45-54,2
2,2,2,0,4,2020-05-19,Female,67,65-69,2
2,2,0,0,2,2020-05-15,Male,31,25-34,2
2,0,1,0,1,2020-05-15,Male,66,65-69,2
2,1,0,0,1,2020-05-18,Male,12,10-14,2
2,2,2,0,4,2020-05-15,Male,25,25-34,2
2,1,0,0,1,2020-05-18,Female,39,35-44,2
2,0,4,0,4,2020-05-19,Female,21,20-24,2
2,0,6,0,6,2020-05-16,Female,28,25-34,2
2,1,4,0,5,2020-05-15,Male,54,45-54,2
2,2,2,0,4,2020-05-16,Female,6,5-9,2
2,1,10,0,11,2020-05-20,Male,30,25-34,2
2,2,1,0,3,2020-05-15,Male,65,65-69,2
2,2,0,0,2,2020-05-18,Female,67,65-69,2
2,0,2,0,2,2020-05-14,Male,42,35-44,2
2,0,1,0,1,2020-05-15,Female,30,25-34,2
2,1,19,0,20,2020-05-21,Male,22,20-24,1
2,3,0,0,3,2020-05-20,Female,4,1-4,1
2,2,3,0,5,2020-05-15,Female,79,75-79,2
2,1,1,0,2,2020-05-15,Female,69,65-69,2
2,2,0,0,2,2020-05-14,Male,19,15-19,2
2,0,4,0,4,2020-05-15,Female,69,65-69,2
2,2,1,0,3,2020-05-15,Male,70,70-74,2
2,0,1,0,1,2020-05-18,Female,36,35-44,2
2,1,0,0,1,2020-05-21,Male,60,55-64,1
2,0,0,0,0,2020-05-14,Male,12,10-14,2
2,0,9,0,9,2020-05-14,Male,60,55-64,2
2,5,2,0,7,2020-05-19,Male,5,5-9,2
2,0,1,0,1,2020-05-15,Male,66,65-69,2
2,1,1,0,2,2020-05-15,Female,29,25-34,2
2,4,0,0,4,2020-05-15,Female,5,5-9,2
2,0,1,0,1,2020-05-15,Male,33,25-34,2
3,0,0,11,11,2020-05-29,Male,59,55-64,3
3,0,0,0,0,2020-06-03,Female,51,45-54,1
3,1,0,0,1,2020-06-04,Female,33,25-34,1
3,1,2,0,3,2020-05-30,Female,58,55-64,3
3,2,6,20,28,2020-06-02,Male,66,65-69,3
3,2,0,0,2,2020-06-02,Female,65,65-69,3
3,0,1,0,1,2020-05-29,Female,33,25-34,3
3,1,1,0,2,2020-05-29,Female,71,70-74,3
3,0,0,0,0,2020-06-03,Female,32,25-34,1
3,0,1,0,1,2020-05-31,Female,62,55-64,3
3,0,10,0,10,2020-06-03,Male,57,55-64,1
3,0,1,0,1,2020-05-29,Female,56,55-64,3
3,2,1,0,3,2020-05-29,Male,34,25-34,3
3,3,0,0,3,2020-05-31,Male,6,5-9,3
3,1,8,0,9,2020-05-29,Female,58,55-64,3
3,0,0,0,0,2020-06-02,Male,50,45-54,3
3,0,2,0,2,2020-05-28,Male,67,65-69,3
3,1,0,1,2,2020-05-29,Female,57,55-64,3
3,3,0,0,3,2020-05-30,Female,9,5-9,3
3,0,0,0,0,2020-05-29,Male,32,25-34,3
3,2,2,0,4,2020-05-31,Male,66,65-69,3
3,2,0,0,2,2020-05-29,Male,62,55-64,3
3,4,0,0,4,2020-05-29,Male,10,10-14,3
3,1,1,0,2,2020-05-29,Male,18,15-19,3
3,3,0,0,3,2020-06-03,Male,61,55-64,1
3,2,0,0,2,2020-05-29,Female,70,70-74,3
3,1,5,0,6,2020-05-29,Male,67,65-69,3
3,0,4,0,4,2020-05-29,Male,56,55-64,3
3,2,2,0,4,2020-05-29,Female,68,65-69,3
3,0,0,0,0,2020-05-29,Male,41,35-44,3
3,2,1,0,3,2020-05-29,Male,58,55-64,3
3,0,0,0,0,2020-06-03,Female,69,65-69,1
3,1,3,0,4,2020-05-29,Female,56,55-64,3
3,1,11,1,13,2020-06-03,Male,69,65-69,1
3,2,1,0,3,2020-05-29,Female,21,20-24,3
3,2,0,1,3,2020-05-29,Male,51,45-54,3
3,0,2,0,2,2020-05-29,Male,85,85+,3
3,0,2,0,2,2020-05-29,Female,68,65-69,3
3,0,1,0,1,2020-05-30,Male,53,45-54,3
3,1,2,0,3,2020-05-29,Male,57,55-64,3
3,0,1,0,1,2020-05-29,Male,67,65-69,3
3,1,4,0,5,2020-05-30,Male,50,45-54,3
3,0,3,0,3,2020-06-02,Male,76,75-79,3
3,2,1,0,3,2020-05-29,Male,71,70-74,3
3,0,0,0,0,2020-05-31,Male,51,45-54,3
3,0,4,0,4,2020-06-03,Female,50,45-54,1
3,4,7,5,16,2020-06-04,Female,18,15-19,1
3,3,4,0,7,2020-05-29,Male,43,35-44,3
3,1,0,0,1,2020-05-29,Female,74,70-74,3
3,1,0,0,1,2020-05-29,Female,59,55-64,3
3,2,0,0,2,2020-05-29,Male,34,25-34,3
3,0,1,0,1,2020-05-29,Female,76,75-79,3
3,4,0,14,18,2020-05-29,Male,1,1-4,3
3,2,0,0,2,2020-05-31,Male,66,65-69,3
3,0,8,0,8,2020-06-03,Female,47,45-54,1
3,1,1,0,2,2020-05-29,Male,38,35-44,3
3,0,1,0,1,2020-06-03,Male,70,70-74,1
3,1,1,0,2,2020-05-29,Female,71,70-74,3
3,1,0,0,1,2020-06-02,Male,44,35-44,3
3,2,2,0,4,2020-05-29,Male,54,45-54,3
3,2,0,0,2,2020-06-03,Female,70,70-74,3
3,1,6,2,9,2020-05-28,Female,65,65-69,3
3,2,0,1,3,2020-06-02,Male,69,65-69,3
3,1,2,0,3,2020-06-02,Male,67,65-69,3
3,0,0,0,0,2020-06-02,Female,5,5-9,3
3,0,7,0,7,2020-05-29,Female,34,25-34,3
3,1,5,0,6,2020-05-29,Male,68,65-69,3
3,2,0,0,2,2020-05-29,Female,60,55-64,3
3,5,0,0,5,2020-06-01,Male,12,10-14,3
3,0,3,0,3,2020-05-29,Female,52,45-54,3
3,0,0,0,0,2020-05-29,Male,48,45-54,3
3,1,0,2,3,2020-06-04,Female,65,65-69,1
3,1,5,0,6,2020-05-29,Female,62,55-64,3
3,3,0,0,3,2020-06-04,Male,16,15-19,1
3,4,30,0,34,2020-06-01,Female,27,25-34,3
3,1,17,0,18,2020-06-03,Female,49,45-54,1
3,0,1,0,1,2020-05-29,Female,30,25-34,3
3,1,0,0,1,2020-05-29,Female,62,55-64,3
3,2,0,0,2,2020-05-29,Female,46,45-54,3
3,2,0,0,2,2020-05-28,Female,65,65-69,3
3,3,0,0,3,2020-06-03,Female,72,70-74,3
3,0,0,0,0,2020-05-29,Male,32,25-34,3
3,4,0,0,4,2020-05-29,Male,36,35-44,3
3,0,3,0,3,2020-05-29,Female,57,55-64,3
3,0,0,0,0,2020-05-29,Male,63,55-64,3
3,1,1,0,2,2020-05-28,Male,20,20-24,3
3,3,0,0,3,2020-05-29,Male,10,10-14,3
3,1,0,0,1,2020-06-01,Female,67,65-69,3
3,2,0,0,2,2020-05-29,Male,58,55-64,3
3,1,3,0,4,2020-06-02,Male,50,45-54,3
3,0,0,3,3,2020-05-30,Female,69,65-69,3
3,2,0,0,2,2020-05-30,Male,34,25-34,3
3,0,2,0,2,2020-05-31,Female,53,45-54,3
3,3,0,0,3,2020-06-03,Female,27,25-34,1
3,1,0,0,1,2020-05-31,Male,64,55-64,3
3,1,1,0,2,2020-05-29,Female,78,75-79,3
3,2,0,0,2,2020-06-04,Male,48,45-54,1
3,2,4,0,6,2020-05-30,Male,56,55-64,3
3,1,0,0,1,2020-06-02,Female,28,25-34,3
3,2,0,0,2,2020-05-29,Male,52,45-54,3
3,0,0,0,0,2020-06-02,Male,56,55-64,3
3,2,6,0,8,2020-05-29,Male,24,20-24,3
3,1,0,0,1,2020-05-29,Female,51,45-54,3
3,0,1,0,1,2020-05-29,Male,64,55-64,3
3,2,0,0,2,2020-06-03,Female,57,55-64,1
3,0,3,0,3,2020-05-30,Female,65,65-69,3
3,1,3,0,4,2020-05-29,Female,59,55-64,3
3,0,2,0,2,2020-05-29,Male,70,70-74,3
3,0,5,0,5,2020-05-30,Female,70,70-74,3
3,1,0,1,2,2020-05-29,Male,73,70-74,3
3,7,1,19,27,2020-06-03,Male,5,5-9,1
3,2,1,0,3,2020-05-28,Male,65,65-69,3
3,2,1,0,3,2020-05-29,Female,65,65-69,3
3,0,0,0,0,2020-05-29,Male,37,35-44,3
3,0,0,0,0,2020-05-29,Female,54,45-54,3
3,1,0,0,1,2020-05-31,Male,50,45-54,3
3,0,0,2,2,2020-06-03,Female,64,55-64,1
3,2,0,0,2,2020-05-28,Male,65,65-69,3
3,2,1,0,3,2020-05-29,Male,67,65-69,3
3,1,0,0,1,2020-05-29,Male,52,45-54,3
3,1,1,0,2,2020-06-01,Female,57,55-64,3
3,2,1,0,3,2020-06-04,Male,71,70-74,1
3,0,1,0,1,2020-05-29,Male,49,45-54,3
3,3,0,45,48,2020-05-29,Male,12,10-14,3
3,0,2,0,2,2020-05-29,Male,70,70-74,3
3,2,5,6,13,2020-06-03,Male,73,70-74,1
3,1,2,0,3,2020-06-03,Female,51,45-54,1
3,3,0,1,4,2020-05-29,Female,69,65-69,3
3,1,1,0,2,2020-05-29,Female,56,55-64,3
3,1,0,0,1,2020-06-02,Female,59,55-64,3
3,0,0,0,0,2020-05-29,Male,43,35-44,3
3,2,0,0,2,2020-06-01,Female,62,55-64,3
3,0,1,0,1,2020-06-02,Male,26,25-34,3
3,3,0,0,3,2020-05-29,Male,31,25-34,3
3,2,0,0,2,2020-05-29,Male,73,70-74,3
3,0,2,0,2,2020-06-01,Female,68,65-69,3
3,1,0,0,1,2020-05-29,Male,53,45-54,3
3,2,7,0,9,2020-05-29,Female,52,45-54,3
3,2,0,7,9,2020-05-29,Male,68,65-69,3
3,1,0,0,1,2020-06-03,Male,72,70-74,1
3,2,0,0,2,2020-05-30,Male,33,25-34,3
3,2,0,0,2,2020-05-30,Male,65,65-69,3
3,3,0,0,3,2020-06-03,Female,31,25-34,1
3,2,2,0,4,2020-05-29,Male,67,65-69,3
3,0,3,4,7,2020-05-30,Male,61,55-64,3
3,2,0,0,2,2020-05-30,Male,70,70-74,3
3,0,1,0,1,2020-06-03,Male,62,55-64,1
3,0,10,0,10,2020-05-29,Female,55,55-64,3
3,0,2,0,2,2020-05-28,Female,66,65-69,3
3,0,0,0,0,2020-06-02,Female,40,35-44,3
3,0,0,0,0,2020-05-29,Male,44,35-44,3
3,1,1,0,2,2020-06-03,Female,66,65-69,3
3,0,0,0,0,2020-06-03,Female,42,35-44,1
3,4,0,0,4,2020-05-29,Female,13,10-14,3
3,3,2,0,5,2020-05-29,Female,60,55-64,3
3,1,4,0,5,2020-05-29,Male,61,55-64,3
3,0,0,0,0,2020-05-29,Male,47,45-54,3
3,1,2,0,3,2020-05-29,Female,53,45-54,3
3,2,11,0,13,2020-05-30,Female,2,1-4,3
3,0,0,0,0,2020-06-02,Female,65,65-69,3
3,1,2,0,3,2020-05-29,Male,72,70-74,3
3,2,1,0,3,2020-05-29,Female,55,55-64,3
3,0,0,11,11,2020-05-29,Male,53,45-54,3
3,1,1,0,2,2020-05-29,Male,68,65-69,3
3,2,3,0,5,2020-06-01,Male,18,15-19,3
3,0,4,0,4,2020-05-29,Male,36,35-44,3
3,2,0,0,2,2020-05-29,Male,39,35-44,3
3,0,2,0,2,2020-06-03,Female,53,45-54,1
3,2,0,0,2,2020-05-29,Male,61,55-64,3
3,1,5,0,6,2020-05-29,Female,68,65-69,3
3,2,5,0,7,2020-06-03,Female,60,55-64,1
3,1,3,0,4,2020-05-29,Female,69,65-69,3
3,2,1,0,3,2020-05-31,Female,33,25-34,3
3,0,0,0,0,2020-05-28,Male,67,65-69,3
3,0,0,0,0,2020-05-29,Male,28,25-34,3
3,0,1,0,1,2020-05-29,Female,53,45-54,3
3,2,16,0,18,2020-05-29,Female,41,35-44,3
3,0,3,0,3,2020-06-01,Female,60,55-64,3
3,4,10,0,14,2020-05-29,Female,68,65-69,3
3,0,2,0,2,2020-05-29,Male,48,45-54,3
3,0,0,1,1,2020-05-30,Female,46,45-54,3
3,1,1,0,2,2020-06-03,Male,65,65-69,3
3,2,5,0,7,2020-05-29,Male,75,75-79,3
3,2,0,0,2,2020-06-03,Female,54,45-54,1
3,2,0,0,2,2020-05-28,Male,66,65-69,3
3,0,2,0,2,2020-06-02,Male,64,55-64,3
3,3,4,0,7,2020-05-30,Female,67,65-69,3
3,0,4,0,4,2020-05-29,Female,73,70-74,3
3,0,0,0,0,2020-05-29,Male,67,65-69,3
3,1,0,0,1,2020-06-03,Female,38,35-44,1
3,2,1,0,3,2020-05-29,Male,74,70-74,3
3,4,0,0,4,2020-06-02,Male,5,5-9,3
3,0,4,0,4,2020-06-03,Male,70,70-74,1
3,0,0,0,0,2020-05-29,Male,52,45-54,3
3,3,0,0,3,2020-05-30,Female,44,35-44,3
3,3,1,0,4,2020-05-30,Male,14,10-14,3
3,0,0,0,0,2020-06-02,Female,51,45-54,3
3,4,0,0,4,2020-05-30,Male,11,10-14,3
3,0,1,0,1,2020-05-31,Female,59,55-64,3
3,2,0,0,2,2020-06-04,Female,44,35-44,1
3,0,0,0,0,2020-05-29,Male,13,10-14,3
3,1,1,0,2,2020-05-30,Male,81,80-84,3
3,3,2,0,5,2020-05-31,Female,53,45-54,3
3,0,0,0,0,2020-05-29,Female,45,45-54,3
3,2,0,0,2,2020-05-31,Female,52,45-54,3
3,6,0,0,6,2020-06-03,Female,1,1-4,1
3,0,0,0,0,2020-05-31,Male,16,15-19,3
3,2,0,0,2,2020-05-30,Male,70,70-74,3
3,1,0,0,1,2020-05-29,Male,34,25-34,3
3,3,0,0,3,2020-06-04,Female,65,65-69,1
3,0,0,0,0,2020-06-03,Female,34,25-34,3
3,4,11,0,15,2020-06-03,Female,51,45-54,1
3,4,0,0,4,2020-05-29,Female,23,20-24,3
3,0,0,0,0,2020-05-31,Male,22,20-24,3
3,1,0,1,2,2020-06-02,Female,2,1-4,3
3,3,0,0,3,2020-05-31,Female,17,15-19,3
3,0,0,0,0,2020-05-29,Male,67,65-69,3
3,2,0,0,2,2020-05-29,Male,40,35-44,3
3,1,6,0,7,2020-06-02,Male,65,65-69,3
3,4,5,0,9,2020-05-29,Male,49,45-54,3
3,1,0,0,1,2020-05-30,Female,85,85+,3
3,2,2,0,4,2020-06-04,Male,15,15-19,1
3,1,2,0,3,2020-05-29,Male,75,75-79,3
3,1,3,0,4,2020-05-29,Male,78,75-79,3
3,2,0,0,2,2020-05-29,Male,53,45-54,3
3,0,2,0,2,2020-05-29,Male,51,45-54,3
3,0,3,0,3,2020-06-02,Female,66,65-69,3
3,1,1,0,2,2020-06-04,Female,64,55-64,1
3,0,0,0,0,2020-05-29,Female,25,25-34,3
3,0,1,0,1,2020-06-02,Female,68,65-69,3
3,1,4,0,5,2020-06-04,Male,30,25-34,1
3,0,0,2,2,2020-05-29,Female,77,75-79,3
3,2,4,0,6,2020-05-29,Male,68,65-69,3
3,1,1,0,2,2020-06-02,Female,33,25-34,3
3,0,1,1,2,2020-05-29,Male,58,55-64,3
3,2,0,0,2,2020-06-02,Female,33,25-34,3
3,1,2,0,3,2020-06-02,Male,37,35-44,3
3,1,0,0,1,2020-06-03,Male,74,70-74,1
3,0,1,0,1,2020-06-03,Male,29,25-34,3
3,4,0,0,4,2020-05-29,Female,8,5-9,3
3,2,2,0,4,2020-05-31,Male,60,55-64,3
3,2,0,0,2,2020-05-31,Female,65,65-69,3
3,2,1,0,3,2020-06-04,Female,59,55-64,1
3,0,0,0,0,2020-05-30,Female,78,75-79,3
3,0,2,0,2,2020-05-30,Male,53,45-54,3
3,0,3,0,3,2020-05-29,Male,65,65-69,3
3,2,0,0,2,2020-06-01,Female,2,1-4,3
3,2,0,0,2,2020-05-29,Female,69,65-69,3
3,0,1,0,1,2020-05-29,Female,75,75-79,3
3,4,0,0,4,2020-05-29,Male,11,10-14,3
3,0,0,2,2,2020-05-30,Female,54,45-54,3
3,2,1,0,3,2020-06-03,Male,67,65-69,1
3,1,0,0,1,2020-05-30,Male,68,65-69,3
3,2,1,0,3,2020-06-03,Female,64,55-64,1
3,1,0,0,1,2020-06-01,Female,39,35-44,3
3,0,5,0,5,2020-06-02,Female,65,65-69,3
3,0,0,0,0,2020-05-30,Female,49,45-54,3
3,3,9,0,12,2020-06-03,Female,18,15-19,1
3,0,0,0,0,2020-05-29,Male,73,70-74,3
3,2,3,0,5,2020-05-31,Female,18,15-19,3
3,0,0,0,0,2020-06-01,Male,66,65-69,3
3,4,0,0,4,2020-05-29,Female,14,10-14,3
3,1,5,0,6,2020-05-30,Female,69,65-69,3
3,1,1,0,2,2020-05-29,Female,26,25-34,3
3,2,1,0,3,2020-05-30,Male,75,75-79,3
3,0,0,0,0,2020-05-29,Female,52,45-54,3
3,5,4,0,9,2020-06-04,Male,14,10-14,1
3,1,1,0,2,2020-05-29,Male,73,70-74,3
3,1,8,0,9,2020-06-02,Female,9,5-9,2
3,0,1,0,1,2020-05-28,Female,20,20-24,3
3,4,10,0,14,2020-05-29,Male,62,55-64,3
3,2,6,0,8,2020-05-29,Male,28,25-34,3
3,2,1,0,3,2020-05-29,Male,54,45-54,3
3,2,7,0,9,2020-06-04,Female,52,45-54,1
3,1,3,0,4,2020-05-29,Female,65,65-69,3
3,2,0,0,2,2020-05-29,Male,64,55-64,3
3,2,10,0,12,2020-05-29,Female,52,45-54,3
3,0,10,0,10,2020-05-29,Female,70,70-74,3
3,3,0,0,3,2020-05-31,Male,14,10-14,3
3,0,1,4,5,2020-06-01,Male,29,25-34,3
3,1,0,0,1,2020-05-29,Male,67,65-69,3
3,0,8,1,9,2020-05-29,Female,56,55-64,3
3,0,0,0,0,2020-06-01,Female,85,85+,3
3,0,0,0,0,2020-05-29,Male,51,45-54,3
3,0,2,0,2,2020-05-29,Male,54,45-54,3
3,1,1,7,9,2020-06-02,Female,5,5-9,3
3,2,1,0,3,2020-06-02,Male,65,65-69,3
3,2,0,0,2,2020-06-03,Male,50,45-54,3
3,0,0,0,0,2020-05-30,Male,45,45-54,3
3,1,1,1,3,2020-06-02,Male,43,35-44,3
3,0,5,0,5,2020-06-02,Male,37,35-44,3
3,2,0,0,2,2020-06-02,Male,4,1-4,3
3,2,0,0,2,2020-05-29,Male,63,55-64,3
3,0,0,0,0,2020-05-31,Female,52,45-54,3
3,2,0,0,2,2020-05-30,Male,5,5-9,3
3,3,4,0,7,2020-05-29,Male,59,55-64,3
3,4,1,0,5,2020-05-29,Female,11,10-14,3
3,1,10,2,13,2020-06-03,Female,33,25-34,1
3,0,2,0,2,2020-05-29,Female,49,45-54,3
3,1,31,23,55,2020-05-29,Male,57,55-64,3
3,2,0,0,2,2020-05-29,Female,65,65-69,3
3,2,0,0,2,2020-05-29,Male,51,45-54,3
3,4,0,0,4,2020-06-03,Female,4,1-4,3
3,2,12,0,14,2020-05-29,Female,24,20-24,3
3,4,0,0,4,2020-05-29,Male,10,10-14,3
3,2,2,0,4,2020-05-30,Male,50,45-54,3
3,0,0,0,0,2020-05-31,Female,65,65-69,3
3,0,6,0,6,2020-05-30,Female,51,45-54,2
3,1,2,0,3,2020-05-30,Male,73,70-74,3
3,1,2,0,3,2020-06-04,Female,29,25-34,1
3,2,0,0,2,2020-05-29,Male,54,45-54,3
3,0,0,0,0,2020-05-29,Female,68,65-69,3
3,0,2,0,2,2020-05-31,Female,78,75-79,3
3,0,1,0,1,2020-05-29,Male,77,75-79,3
3,1,3,3,7,2020-05-29,Male,85,85+,3
3,2,1,0,3,2020-06-01,Female,55,55-64,3
3,1,0,0,1,2020-05-30,Male,55,55-64,3
3,2,1,0,3,2020-05-29,Male,59,55-64,3
3,0,5,100,105,2020-05-30,Female,32,25-34,3
3,1,3,0,4,2020-05-28,Female,67,65-69,3
3,2,4,6,12,2020-06-03,Female,73,70-74,1
3,0,0,0,0,2020-05-29,Female,24,20-24,3
3,0,1,0,1,2020-05-30,Male,51,45-54,3
3,2,6,30,38,2020-06-04,Male,58,55-64,1
3,2,6,0,8,2020-06-03,Female,64,55-64,1
3,1,0,0,1,2020-05-29,Male,29,25-34,3
3,2,1,0,3,2020-06-03,Male,66,65-69,1
3,0,4,0,4,2020-06-03,Male,70,70-74,1
3,0,4,2,6,2020-05-29,Female,48,45-54,3
3,0,1,0,1,2020-05-30,Male,69,65-69,3
3,2,0,0,2,2020-05-29,Female,63,55-64,3
3,2,3,0,5,2020-05-29,Female,36,35-44,3
3,2,5,0,7,2020-05-29,Female,60,55-64,3
3,2,0,0,2,2020-05-29,Male,70,70-74,3
3,1,0,0,1,2020-05-29,Male,52,45-54,3
3,0,2,0,2,2020-05-29,Female,65,65-69,3
3,0,2,0,2,2020-05-28,Female,66,65-69,3
3,0,0,3,3,2020-05-30,Female,52,45-54,3
3,4,4,0,8,2020-05-29,Female,45,45-54,3
3,0,0,3,3,2020-05-29,Male,54,45-54,3
3,1,0,0,1,2020-06-04,Female,51,45-54,1
3,1,3,0,4,2020-05-30,Female,55,55-64,3
3,0,0,0,0,2020-05-29,Female,67,65-69,3
3,3,0,0,3,2020-05-31,Male,39,35-44,3
3,1,4,0,5,2020-05-29,Female,62,55-64,3
3,0,0,0,0,2020-06-03,Female,58,55-64,1
3,2,1,0,3,2020-05-30,Female,6,5-9,3
3,0,0,0,0,2020-05-28,Male,65,65-69,3
3,0,0,3,3,2020-06-02,Male,30,25-34,3
3,0,1,0,1,2020-05-29,Male,60,55-64,3
3,2,9,0,11,2020-05-29,Female,2,1-4,3
3,1,0,2,3,2020-05-29,Female,56,55-64,3
3,2,1,2,5,2020-05-29,Male,70,70-74,3
3,0,1,0,1,2020-05-29,Female,10,10-14,3
3,2,0,0,2,2020-05-29,Male,62,55-64,3
3,1,0,0,1,2020-05-28,Male,67,65-69,3
3,2,0,0,2,2020-05-29,Female,57,55-64,3
3,0,1,0,1,2020-05-30,Male,56,55-64,3
3,4,1,0,5,2020-05-29,Male,7,5-9,3
3,2,5,0,7,2020-05-29,Female,55,55-64,3
3,0,6,0,6,2020-06-03,Male,57,55-64,3
3,0,2,0,2,2020-05-29,Male,30,25-34,3
3,2,2,0,4,2020-06-02,Male,62,55-64,3
3,0,0,0,0,2020-05-30,Male,38,35-44,3
3,3,1,0,4,2020-05-29,Female,38,35-44,3
3,2,1,0,3,2020-06-02,Female,58,55-64,3
3,1,0,0,1,2020-05-29,Female,65,65-69,3
3,6,0,0,6,2020-05-29,Female,13,10-14,3
3,2,0,0,2,2020-05-29,Male,63,55-64,3
3,0,0,0,0,2020-05-29,Female,51,45-54,3
3,4,2,7,13,2020-05-29,Female,17,15-19,3
3,4,0,0,4,2020-05-29,Female,6,5-9,3
3,0,1,0,1,2020-05-29,Male,61,55-64,3
3,2,1,0,3,2020-05-30,Male,53,45-54,3
3,0,1,0,1,2020-05-29,Female,59,55-64,2
3,2,10,0,12,2020-05-29,Male,55,55-64,3
3,0,0,1,1,2020-05-29,Male,59,55-64,3
3,0,2,0,2,2020-06-01,Female,58,55-64,3
3,0,3,0,3,2020-06-03,Female,29,25-34,1
3,2,11,0,13,2020-06-03,Female,33,25-34,1
3,0,1,0,1,2020-05-29,Male,27,25-34,3
3,0,0,0,0,2020-05-30,Male,47,45-54,3
3,2,0,0,2,2020-06-03,Female,62,55-64,1
3,0,0,0,0,2020-06-02,Female,49,45-54,3
3,0,0,0,0,2020-06-02,Female,7,5-9,3
3,1,0,50,51,2020-05-29,Female,40,35-44,3
3,0,0,2,2,2020-05-29,Female,30,25-34,3
3,1,6,0,7,2020-05-29,Male,62,55-64,3
3,0,0,0,0,2020-05-29,Male,48,45-54,3
3,3,0,0,3,2020-06-02,Female,3,1-4,2
3,3,0,0,3,2020-06-03,Female,14,10-14,1
3,0,2,2,4,2020-05-31,Female,72,70-74,3
3,0,0,0,0,2020-05-30,Male,58,55-64,2
3,2,21,0,23,2020-05-29,Male,68,65-69,3
3,2,2,0,4,2020-06-02,Male,70,70-74,3
3,1,0,1,2,2020-06-03,Male,67,65-69,1
3,0,0,0,0,2020-05-29,Male,46,45-54,3
3,3,1,0,4,2020-06-02,Female,30,25-34,3
3,0,4,0,4,2020-05-29,Male,60,55-64,3
3,1,6,0,7,2020-05-30,Female,68,65-69,3
3,1,2,0,3,2020-05-28,Male,67,65-69,3
3,1,0,0,1,2020-06-03,Male,43,35-44,1
3,2,0,0,2,2020-05-31,Female,22,20-24,3
3,3,1,0,4,2020-05-29,Male,26,25-34,3
3,0,0,5,5,2020-05-30,Female,40,35-44,3
3,0,2,0,2,2020-05-29,Male,58,55-64,3
3,1,0,0,1,2020-05-29,Male,36,35-44,3
3,2,0,0,2,2020-06-04,Female,59,55-64,1
3,2,0,0,2,2020-05-29,Female,45,45-54,3
3,1,0,0,1,2020-06-02,Male,54,45-54,3
3,2,0,0,2,2020-05-31,Female,69,65-69,3
3,4,0,0,4,2020-05-29,Male,16,15-19,3
3,4,0,0,4,2020-06-03,Male,19,15-19,1
3,4,1,0,5,2020-06-02,Female,59,55-64,3
3,3,0,0,3,2020-05-30,Female,55,55-64,3
3,3,2,0,5,2020-05-30,Female,66,65-69,3
3,0,31,0,31,2020-06-04,Male,57,55-64,1
3,2,1,0,3,2020-05-29,Male,51,45-54,3
3,0,0,0,0,2020-06-03,Female,61,55-64,3
3,0,3,0,3,2020-05-30,Male,64,55-64,3
3,0,0,1,1,2020-05-29,Male,59,55-64,3
3,0,0,0,0,2020-05-29,Male,35,35-44,3
3,1,1,13,15,2020-05-29,Male,6,5-9,3
3,1,0,0,1,2020-06-03,Female,68,65-69,3
3,0,0,0,0,2020-06-04,Female,61,55-64,1
3,1,0,0,1,2020-06-02,Female,59,55-64,3
3,1,8,0,9,2020-06-03,Female,75,75-79,1
3,0,2,0,2,2020-05-29,Male,65,65-69,3
3,2,2,0,4,2020-06-03,Male,75,75-79,1
3,0,1,0,1,2020-05-29,Female,65,65-69,3
3,0,0,0,0,2020-05-29,Female,75,75-79,3
3,2,26,22,50,2020-05-29,Male,69,65-69,3
3,2,2,0,4,2020-05-31,Male,61,55-64,3
3,0,1,0,1,2020-06-03,Male,63,55-64,1
3,1,2,0,3,2020-05-29,Male,78,75-79,3
3,0,0,1,1,2020-05-29,Male,45,45-54,3
3,1,1,0,2,2020-06-03,Female,72,70-74,1
3,0,0,0,0,2020-05-29,Female,64,55-64,3
3,0,10,0,10,2020-05-29,Female,59,55-64,3
3,1,0,0,1,2020-05-29,Male,58,55-64,3
3,1,3,0,4,2020-05-29,Male,68,65-69,3
3,2,1,0,3,2020-05-29,Male,69,65-69,3
3,1,0,0,1,2020-05-29,Male,50,45-54,3
3,0,0,0,0,2020-06-02,Male,66,65-69,3
3,1,3,0,4,2020-05-29,Male,71,70-74,3
3,2,3,0,5,2020-05-29,Female,77,75-79,3
3,2,0,0,2,2020-05-29,Male,71,70-74,3
3,3,1,0,4,2020-05-29,Female,19,15-19,3
3,1,5,0,6,2020-05-29,Female,38,35-44,3
3,2,0,0,2,2020-05-29,Female,57,55-64,3
3,4,10,2,16,2020-05-29,Male,16,15-19,3
3,0,2,0,2,2020-05-29,Male,39,35-44,3
3,1,0,0,1,2020-05-29,Female,68,65-69,3
3,0,1,0,1,2020-05-30,Male,22,20-24,3
3,0,0,0,0,2020-05-29,Female,28,25-34,3
3,2,0,0,2,2020-06-02,Female,48,45-54,3
3,1,5,0,6,2020-05-31,Female,67,65-69,3
3,3,1,0,4,2020-05-29,Female,17,15-19,3
3,0,0,0,0,2020-06-04,Male,56,55-64,1
3,1,12,0,13,2020-05-29,Male,59,55-64,3
3,4,0,0,4,2020-06-03,Male,4,1-4,1
3,2,2,0,4,2020-05-31,Male,25,25-34,3
3,2,0,0,2,2020-05-29,Male,69,65-69,3
3,0,6,0,6,2020-05-29,Male,59,55-64,3
3,2,2,0,4,2020-06-02,Male,43,35-44,3
3,3,12,10,25,2020-06-02,Male,30,25-34,3
3,0,1,0,1,2020-06-03,Female,53,45-54,1
3,0,2,0,2,2020-05-29,Male,52,45-54,3
3,3,6,0,9,2020-06-03,Female,0,<1,3
3,2,2,0,4,2020-06-03,Female,61,55-64,1
3,1,1,0,2,2020-06-04,Female,61,55-64,1
3,0,0,0,0,2020-05-30,Male,42,35-44,3
3,0,0,0,0,2020-06-03,Male,77,75-79,1
3,0,0,0,0,2020-06-04,Male,48,45-54,1
3,0,0,0,0,2020-06-02,Male,56,55-64,3
3,3,0,1,4,2020-05-30,Male,11,10-14,3
3,0,4,0,4,2020-05-29,Female,51,45-54,3
3,1,0,0,1,2020-05-29,Male,62,55-64,3
3,0,0,24,24,2020-05-30,Male,31,25-34,3
3,0,1,0,1,2020-05-30,Female,24,20-24,3
3,2,1,0,3,2020-05-29,Male,51,45-54,3
3,2,10,0,12,2020-06-03,Male,17,15-19,1
3,0,0,0,0,2020-05-29,Male,69,65-69,3
3,2,0,0,2,2020-06-02,Male,67,65-69,3
3,2,2,0,4,2020-05-29,Female,59,55-64,3
3,1,2,0,3,2020-05-29,Female,30,25-34,3
3,2,0,0,2,2020-06-03,Female,32,25-34,1
3,0,0,0,0,2020-05-29,Male,32,25-34,3
3,1,0,0,1,2020-06-03,Male,68,65-69,3
3,1,0,0,1,2020-06-02,Female,54,45-54,3
3,0,0,0,0,2020-05-28,Female,65,65-69,3
3,1,0,0,1,2020-05-29,Female,68,65-69,3
3,2,1,0,3,2020-05-29,Male,45,45-54,3
3,0,0,0,0,2020-05-29,Female,55,55-64,3
3,1,1,0,2,2020-06-03,Female,72,70-74,1
3,0,0,0,0,2020-06-04,Female,70,70-74,1
3,0,4,10,14,2020-06-04,Male,61,55-64,1
3,3,0,0,3,2020-05-29,Male,18,15-19,3
3,3,0,0,3,2020-05-29,Male,7,5-9,3
3,3,0,0,3,2020-06-01,Female,17,15-19,3
3,2,1,20,23,2020-05-30,Male,18,15-19,3
3,2,1,0,3,2020-05-29,Male,11,10-14,3
3,1,0,0,1,2020-06-03,Female,57,55-64,1
3,1,2,0,3,2020-05-29,Male,73,70-74,3
3,1,1,0,2,2020-05-31,Male,59,55-64,3
3,3,10,0,13,2020-05-29,Female,57,55-64,3
3,2,0,0,2,2020-05-29,Female,29,25-34,3
3,1,0,0,1,2020-05-29,Male,34,25-34,3
3,2,2,0,4,2020-05-30,Male,75,75-79,3
3,1,0,0,1,2020-05-29,Male,31,25-34,3
3,0,0,0,0,2020-05-30,Male,68,65-69,3
3,0,2,0,2,2020-05-29,Male,41,35-44,2
3,0,0,0,0,2020-06-04,Male,56,55-64,1
3,0,0,0,0,2020-05-30,Male,19,15-19,3
3,1,2,0,3,2020-06-02,Female,66,65-69,3
3,2,0,0,2,2020-05-31,Female,67,65-69,3
3,1,2,0,3,2020-05-29,Female,69,65-69,3
3,3,0,0,3,2020-06-03,Male,18,15-19,1
3,2,2,90,94,2020-06-01,Female,67,65-69,3
3,1,3,0,4,2020-05-30,Male,71,70-74,3
3,1,0,0,1,2020-05-29,Female,62,55-64,3
3,0,0,0,0,2020-05-29,Male,65,65-69,3
3,0,0,0,0,2020-05-29,Male,65,65-69,3
3,1,1,0,2,2020-05-29,Male,62,55-64,3
3,0,5,0,5,2020-05-31,Female,68,65-69,3
3,2,1,0,3,2020-05-29,Female,68,65-69,3
3,1,0,0,1,2020-05-30,Male,71,70-74,3
3,0,8,0,8,2020-05-29,Female,62,55-64,3
3,0,0,3,3,2020-05-29,Female,35,35-44,3
3,3,4,0,7,2020-05-29,Female,64,55-64,3
3,0,0,0,0,2020-05-29,Female,61,55-64,3
3,4,0,5,9,2020-05-30,Male,54,45-54,3
3,0,42,0,42,2020-06-02,Female,66,65-69,3
3,2,0,0,2,2020-05-29,Female,59,55-64,3
3,0,0,0,0,2020-05-29,Female,65,65-69,3
3,0,0,5,5,2020-05-29,Female,29,25-34,3
3,0,0,0,0,2020-05-29,Female,63,55-64,3
3,1,0,55,56,2020-05-29,Female,46,45-54,3
3,0,0,0,0,2020-06-02,Male,60,55-64,3
3,2,0,0,2,2020-06-02,Male,56,55-64,3
3,4,2,0,6,2020-05-29,Female,10,10-14,3
3,1,9,0,10,2020-05-29,Male,42,35-44,3
3,0,0,1,1,2020-05-30,Male,48,45-54,3
3,2,0,0,2,2020-05-29,Male,65,65-69,3
3,0,0,0,0,2020-05-29,Female,63,55-64,3
3,5,0,0,5,2020-05-28,Male,13,10-14,3
3,1,3,0,4,2020-06-02,Female,66,65-69,3
3,3,11,32,46,2020-05-30,Female,60,55-64,3
3,0,2,0,2,2020-05-29,Female,61,55-64,3
3,1,1,0,2,2020-06-02,Male,44,35-44,3
3,3,0,0,3,2020-06-03,Female,1,1-4,1
3,1,0,0,1,2020-06-01,Male,59,55-64,3
3,0,3,0,3,2020-05-29,Female,67,65-69,3
3,0,0,0,0,2020-06-02,Female,55,55-64,3
3,0,0,0,0,2020-05-30,Female,67,65-69,3
3,2,2,0,4,2020-05-29,Female,70,70-74,3
3,0,2,0,2,2020-05-30,Female,57,55-64,2
3,2,5,0,7,2020-05-30,Male,56,55-64,3
3,0,1,2,3,2020-05-29,Male,73,70-74,3
3,0,0,0,0,2020-06-02,Female,33,25-34,3
3,2,0,0,2,2020-05-29,Male,52,45-54,3
3,2,1,0,3,2020-06-02,Male,67,65-69,3
3,0,2,0,2,2020-06-02,Male,33,25-34,3
3,0,3,0,3,2020-05-29,Female,37,35-44,3
3,2,0,0,2,2020-05-29,Male,19,15-19,3
3,1,0,0,1,2020-06-03,Female,53,45-54,1
3,0,1,0,1,2020-06-02,Male,23,20-24,3
3,1,3,3,7,2020-05-29,Male,75,75-79,3
3,2,3,0,5,2020-05-29,Female,22,20-24,3
3,0,0,0,0,2020-05-30,Female,32,25-34,3
3,0,6,0,6,2020-05-29,Male,51,45-54,2
3,3,5,0,8,2020-05-29,Female,42,35-44,3
3,2,0,0,2,2020-05-29,Female,70,70-74,3
3,1,0,0,1,2020-05-29,Female,23,20-24,3
3,0,1,0,1,2020-06-02,Female,68,65-69,3
3,2,0,0,2,2020-06-01,Male,70,70-74,3
3,3,2,0,5,2020-05-30,Female,50,45-54,3
3,3,1,0,4,2020-05-29,Male,53,45-54,3
3,5,2,0,7,2020-05-29,Female,12,10-14,3
3,3,0,0,3,2020-05-29,Female,3,1-4,3
3,0,0,0,0,2020-05-29,Male,44,35-44,3
3,0,1,1,2,2020-05-30,Female,67,65-69,3
3,1,1,0,2,2020-05-29,Female,58,55-64,3
3,0,0,0,0,2020-05-30,Female,53,45-54,3
3,3,0,0,3,2020-05-29,Male,69,65-69,3
3,0,0,2,2,2020-06-03,Female,40,35-44,3
3,1,5,0,6,2020-06-03,Female,62,55-64,1
3,0,0,0,0,2020-05-29,Female,63,55-64,3
3,3,0,0,3,2020-05-29,Male,39,35-44,3
3,0,1,0,1,2020-05-31,Male,22,20-24,3
3,2,0,0,2,2020-06-02,Male,58,55-64,3
3,0,0,0,0,2020-05-29,Male,81,80-84,3
3,2,1,0,3,2020-06-02,Male,63,55-64,3
3,3,0,0,3,2020-05-29,Female,52,45-54,3
3,2,1,0,3,2020-05-31,Male,26,25-34,3
3,1,1,0,2,2020-06-02,Male,78,75-79,3
3,1,1,0,2,2020-06-04,Male,62,55-64,1
3,0,11,0,11,2020-05-29,Female,42,35-44,3
3,0,2,2,4,2020-06-02,Male,49,45-54,3
3,0,0,0,0,2020-05-29,Male,77,75-79,3
3,3,0,0,3,2020-05-28,Male,66,65-69,3
3,2,3,0,5,2020-05-28,Female,66,65-69,3
3,5,4,0,9,2020-06-03,Male,12,10-14,1
3,1,2,0,3,2020-05-29,Male,36,35-44,3
3,1,0,0,1,2020-06-03,Female,51,45-54,1
3,1,4,0,5,2020-06-03,Female,74,70-74,1
3,2,7,0,9,2020-06-02,Male,5,5-9,3
3,0,0,0,0,2020-05-29,Male,47,45-54,3
3,2,0,0,2,2020-06-01,Male,16,15-19,3
3,0,1,4,5,2020-06-02,Male,39,35-44,3
3,1,0,0,1,2020-06-04,Male,61,55-64,1
3,1,4,0,5,2020-06-02,Female,65,65-69,3
3,0,0,0,0,2020-05-29,Male,37,35-44,3
3,0,1,0,1,2020-05-29,Female,39,35-44,3
3,2,2,0,4,2020-05-30,Male,73,70-74,3
3,2,2,0,4,2020-06-03,Male,70,70-74,1
3,2,0,0,2,2020-06-03,Female,65,65-69,3
3,0,1,0,1,2020-06-03,Male,18,15-19,3
3,3,0,0,3,2020-05-30,Female,8,5-9,3
3,3,3,0,6,2020-05-29,Male,39,35-44,3
3,0,0,1,1,2020-05-29,Male,57,55-64,3
3,0,0,0,0,2020-05-31,Male,44,35-44,3
3,0,2,11,13,2020-06-02,Female,19,15-19,3
3,2,1,0,3,2020-05-29,Female,12,10-14,3
3,0,0,0,0,2020-05-29,Female,58,55-64,3
3,2,34,0,36,2020-05-29,Female,51,45-54,3
3,1,0,0,1,2020-05-31,Female,57,55-64,3
3,2,0,0,2,2020-06-04,Male,67,65-69,1
3,2,2,0,4,2020-05-29,Female,59,55-64,3
3,2,0,0,2,2020-05-29,Male,14,10-14,3
3,2,0,1,3,2020-05-29,Female,19,15-19,3
3,2,0,0,2,2020-06-02,Male,54,45-54,3
3,1,3,0,4,2020-05-29,Female,49,45-54,3
3,2,0,0,2,2020-06-01,Female,54,45-54,3
3,0,0,0,0,2020-05-30,Male,42,35-44,3
3,2,1,0,3,2020-06-02,Female,69,65-69,3
3,0,0,0,0,2020-05-29,Female,53,45-54,3
3,0,0,0,0,2020-06-03,Female,60,55-64,1
3,1,1,0,2,2020-05-31,Male,65,65-69,3
3,1,0,0,1,2020-06-01,Female,65,65-69,3
3,0,2,0,2,2020-05-29,Male,52,45-54,3
3,2,2,0,4,2020-06-03,Female,63,55-64,1
3,2,3,0,5,2020-05-29,Male,56,55-64,3
3,4,21,0,25,2020-06-03,Male,9,5-9,1
3,2,5,0,7,2020-05-30,Male,66,65-69,3
3,1,0,0,1,2020-05-29,Male,62,55-64,3
3,2,0,0,2,2020-05-29,Female,61,55-64,3
3,1,0,0,1,2020-06-02,Female,28,25-34,3
3,0,0,1,1,2020-05-28,Female,13,10-14,3
3,0,2,0,2,2020-05-30,Male,27,25-34,3
3,2,2,0,4,2020-05-29,Male,72,70-74,3
3,0,4,0,4,2020-05-29,Male,57,55-64,3
3,1,2,0,3,2020-05-31,Male,61,55-64,3
3,4,0,0,4,2020-05-31,Female,9,5-9,3
3,2,4,0,6,2020-06-03,Male,68,65-69,1
3,0,0,0,0,2020-06-02,Male,22,20-24,3
3,3,1,0,4,2020-05-30,Female,46,45-54,2
3,2,0,1,3,2020-06-02,Male,68,65-69,3
3,2,1,0,3,2020-05-29,Male,16,15-19,3
3,0,1,0,1,2020-05-30,Male,18,15-19,3
3,1,2,0,3,2020-05-29,Female,68,65-69,3
3,3,2,0,5,2020-05-29,Female,62,55-64,3
3,2,7,0,9,2020-06-04,Female,60,55-64,1
3,1,0,20,21,2020-05-29,Female,67,65-69,3
3,1,3,0,4,2020-06-03,Female,53,45-54,1
3,1,0,0,1,2020-05-29,Male,54,45-54,3
3,1,0,0,1,2020-06-02,Female,61,55-64,3
3,0,2,87,89,2020-05-28,Male,66,65-69,3
3,2,0,0,2,2020-05-29,Female,61,55-64,3
3,1,1,0,2,2020-06-02,Male,52,45-54,3
3,0,1,0,1,2020-06-03,Female,65,65-69,3
3,0,2,0,2,2020-06-03,Male,43,35-44,1
3,4,1,0,5,2020-05-29,Female,45,45-54,3
3,2,0,0,2,2020-05-30,Female,59,55-64,3
3,1,0,0,1,2020-05-29,Male,65,65-69,3
3,2,5,0,7,2020-06-04,Female,23,20-24,1
3,0,0,0,0,2020-05-29,Female,67,65-69,3
3,1,1,0,2,2020-05-29,Female,12,10-14,3
3,1,2,0,3,2020-05-29,Female,62,55-64,3
3,2,0,0,2,2020-05-29,Male,32,25-34,3
3,2,0,0,2,2020-05-29,Male,50,45-54,3
3,0,1,0,1,2020-05-31,Female,51,45-54,3
3,1,1,0,2,2020-06-02,Male,66,65-69,3
3,0,1,0,1,2020-05-31,Male,28,25-34,3
3,1,7,0,8,2020-05-29,Male,59,55-64,3
3,3,0,0,3,2020-05-29,Female,43,35-44,3
3,2,4,0,6,2020-05-28,Female,67,65-69,3
3,2,9,0,11,2020-05-29,Male,70,70-74,3
3,0,3,0,3,2020-05-29,Male,57,55-64,3
3,4,0,0,4,2020-06-03,Male,16,15-19,1
3,0,0,0,0,2020-06-02,Male,19,15-19,3
3,0,0,0,0,2020-06-02,Male,49,45-54,3
3,0,0,0,0,2020-06-03,Female,60,55-64,1
3,2,1,29,32,2020-06-04,Male,28,25-34,1
3,2,2,0,4,2020-06-02,Female,25,25-34,3
3,3,0,0,3,2020-05-29,Male,29,25-34,3
3,0,3,0,3,2020-06-03,Female,54,45-54,1
3,2,0,0,2,2020-05-29,Female,65,65-69,3
3,4,0,0,4,2020-06-04,Male,11,10-14,1
3,6,0,0,6,2020-06-03,Female,0,<1,1
3,0,0,0,0,2020-05-29,Male,40,35-44,3
3,1,2,0,3,2020-06-03,Female,53,45-54,1
3,0,2,0,2,2020-06-04,Male,64,55-64,1
3,2,0,0,2,2020-05-29,Female,15,15-19,3
3,0,11,0,11,2020-06-03,Female,60,55-64,1
3,1,0,0,1,2020-06-02,Male,54,45-54,3
3,1,3,0,4,2020-06-02,Male,67,65-69,3
3,5,0,0,5,2020-05-29,Male,2,1-4,3
3,0,0,0,0,2020-05-29,Male,64,55-64,3
3,0,4,0,4,2020-06-03,Female,65,65-69,1
3,0,10,0,10,2020-05-29,Male,60,55-64,3
3,1,0,0,1,2020-05-29,Male,64,55-64,3
3,0,0,0,0,2020-06-02,Female,61,55-64,3
3,0,1,0,1,2020-05-30,Male,55,55-64,3
3,0,2,0,2,2020-05-29,Male,51,45-54,3
3,2,0,0,2,2020-05-29,Male,65,65-69,3
3,2,2,0,4,2020-06-03,Female,69,65-69,1
3,1,0,1,2,2020-06-04,Male,57,55-64,1
3,0,0,0,0,2020-06-02,Male,60,55-64,3
3,2,0,0,2,2020-05-29,Male,25,25-34,3
3,1,1,2,4,2020-06-03,Female,64,55-64,1
3,0,0,0,0,2020-05-30,Female,26,25-34,3
3,5,0,0,5,2020-05-29,Female,7,5-9,3
3,2,1,0,3,2020-05-31,Male,14,10-14,3
3,1,6,0,7,2020-05-31,Female,55,55-64,3
3,3,1,0,4,2020-06-02,Female,41,35-44,3
3,2,0,0,2,2020-06-02,Male,66,65-69,3
3,2,0,0,2,2020-05-28,Male,66,65-69,3
3,0,0,9,9,2020-05-29,Male,40,35-44,3
3,0,0,0,0,2020-06-03,Female,19,15-19,1
3,0,5,0,5,2020-05-29,Male,41,35-44,3
3,0,0,0,0,2020-05-28,Male,66,65-69,3
3,0,0,0,0,2020-05-29,Male,33,25-34,3
3,0,1,0,1,2020-06-04,Female,60,55-64,1
3,0,1,1,2,2020-05-29,Female,34,25-34,3
3,2,0,0,2,2020-05-29,Female,68,65-69,3
3,4,1,15,20,2020-06-02,Male,2,1-4,3
3,0,0,0,0,2020-06-01,Male,54,45-54,3
3,0,0,0,0,2020-05-29,Male,57,55-64,3
3,2,0,0,2,2020-06-03,Female,44,35-44,1
3,1,0,0,1,2020-05-29,Male,51,45-54,3
3,4,0,0,4,2020-06-03,Female,13,10-14,1
3,1,0,0,1,2020-05-29,Male,61,55-64,3
3,0,3,0,3,2020-05-28,Female,66,65-69,3
3,3,5,0,8,2020-05-30,Male,6,5-9,3
3,2,0,0,2,2020-06-03,Female,57,55-64,1
3,1,0,0,1,2020-05-30,Female,38,35-44,3
3,2,2,0,4,2020-05-29,Male,77,75-79,3
3,4,0,0,4,2020-05-31,Female,37,35-44,3
3,3,0,0,3,2020-06-02,Female,18,15-19,3
3,0,0,0,0,2020-05-30,Male,46,45-54,3
3,0,10,5,15,2020-06-03,Female,51,45-54,1
3,0,1,0,1,2020-06-01,Male,47,45-54,3
3,0,12,0,12,2020-06-03,Female,52,45-54,1
3,0,2,0,2,2020-05-30,Female,67,65-69,3
3,2,6,0,8,2020-06-03,Male,72,70-74,1
3,2,0,0,2,2020-06-03,Male,10,10-14,3
3,0,5,100,105,2020-05-30,Male,42,35-44,3
3,2,2,0,4,2020-05-29,Female,63,55-64,3
3,1,2,0,3,2020-05-29,Female,48,45-54,3
3,0,0,0,0,2020-05-30,Male,22,20-24,3
3,0,1,0,1,2020-05-29,Female,53,45-54,3
3,2,1,0,3,2020-05-29,Male,5,5-9,3
3,2,1,0,3,2020-05-29,Female,8,5-9,3
3,1,0,0,1,2020-06-04,Male,50,45-54,1
3,3,4,0,7,2020-06-03,Female,33,25-34,1
3,2,0,0,2,2020-05-30,Male,65,65-69,3
3,4,0,1,5,2020-05-29,Male,4,1-4,3
3,2,3,0,5,2020-05-29,Male,60,55-64,3
3,1,0,0,1,2020-06-01,Male,65,65-69,3
3,0,0,0,0,2020-05-29,Male,33,25-34,3
3,3,0,0,3,2020-06-03,Female,7,5-9,1
3,1,1,0,2,2020-05-30,Female,52,45-54,3
3,1,0,0,1,2020-05-29,Female,58,55-64,3
3,0,4,22,26,2020-06-01,Male,39,35-44,3
3,2,7,0,9,2020-05-30,Male,62,55-64,3
3,0,0,0,0,2020-06-03,Female,24,20-24,3
3,0,1,0,1,2020-05-30,Female,68,65-69,3
3,2,0,0,2,2020-05-30,Male,53,45-54,3
3,1,0,0,1,2020-05-30,Female,55,55-64,3
3,0,5,0,5,2020-05-28,Female,66,65-69,3
3,0,1,0,1,2020-06-02,Female,67,65-69,3
3,2,0,0,2,2020-05-29,Male,71,70-74,3
3,2,0,1,3,2020-05-29,Female,52,45-54,3
3,2,0,8,10,2020-06-02,Male,66,65-69,3
3,0,0,0,0,2020-05-30,Female,58,55-64,3
3,0,3,1,4,2020-06-04,Female,56,55-64,1
3,1,0,0,1,2020-05-31,Female,70,70-74,3
3,0,0,0,0,2020-06-02,Male,66,65-69,3
3,1,0,0,1,2020-05-29,Male,50,45-54,3
3,2,2,1,5,2020-06-03,Male,58,55-64,1
3,1,0,0,1,2020-06-02,Female,53,45-54,3
3,1,1,0,2,2020-06-02,Male,62,55-64,3
3,0,0,0,0,2020-05-29,Male,36,35-44,3
3,1,3,0,4,2020-05-29,Female,27,25-34,3
3,0,1,1,2,2020-06-01,Female,14,10-14,3
3,0,1,0,1,2020-05-29,Male,53,45-54,3
3,1,1,2,4,2020-06-03,Female,60,55-64,1
3,2,3,4,9,2020-05-30,Female,6,5-9,3
3,2,0,0,2,2020-05-29,Male,34,25-34,3
3,0,1,0,1,2020-05-30,Female,71,70-74,3
3,4,2,0,6,2020-06-04,Female,36,35-44,1
3,7,2,0,9,2020-05-30,Female,7,5-9,3
3,1,2,0,3,2020-05-29,Female,24,20-24,3
3,1,0,0,1,2020-06-02,Male,32,25-34,3
3,2,3,0,5,2020-05-29,Female,71,70-74,3
3,2,1,0,3,2020-06-01,Male,40,35-44,3
3,3,2,0,5,2020-05-29,Female,35,35-44,3
3,1,31,40,72,2020-05-29,Female,58,55-64,3
3,1,100,0,101,2020-05-29,Male,69,65-69,3
3,1,0,2,3,2020-05-28,Male,66,65-69,3
3,3,0,60,63,2020-06-04,Male,14,10-14,1
3,1,3,0,4,2020-05-30,Female,57,55-64,3
3,2,0,0,2,2020-06-02,Male,51,45-54,3
3,0,0,0,0,2020-05-29,Male,56,55-64,3
3,2,0,0,2,2020-06-03,Male,4,1-4,1
3,3,0,0,3,2020-05-31,Male,19,15-19,3
3,0,1,0,1,2020-05-29,Male,50,45-54,3
3,4,1,0,5,2020-05-29,Female,18,15-19,3
3,0,0,0,0,2020-06-03,Female,58,55-64,1
3,0,2,0,2,2020-05-29,Male,74,70-74,3
3,0,1,0,1,2020-06-02,Female,45,45-54,3
3,0,2,0,2,2020-05-29,Male,73,70-74,3
3,0,0,0,0,2020-05-29,Female,65,65-69,3
3,0,2,0,2,2020-06-01,Female,53,45-54,3
3,0,0,0,0,2020-05-29,Female,62,55-64,3
3,2,0,0,2,2020-05-29,Male,73,70-74,3
3,2,1,0,3,2020-05-29,Female,70,70-74,3
3,2,4,6,12,2020-05-30,Female,62,55-64,3
3,0,0,18,18,2020-05-30,Male,26,25-34,3
3,1,1,0,2,2020-05-29,Male,27,25-34,3
3,0,2,0,2,2020-05-30,Female,64,55-64,3
3,2,7,0,9,2020-06-03,Female,52,45-54,1
3,1,0,0,1,2020-05-29,Male,41,35-44,3
3,0,2,0,2,2020-05-29,Male,70,70-74,3
3,0,3,0,3,2020-05-28,Male,65,65-69,3
3,1,24,0,25,2020-05-29,Female,68,65-69,3
3,0,0,0,0,2020-05-31,Female,62,55-64,3
3,2,1,0,3,2020-05-29,Male,72,70-74,3
3,0,2,0,2,2020-06-01,Male,65,65-69,3
3,1,2,0,3,2020-05-29,Male,68,65-69,3
3,2,0,0,2,2020-06-02,Female,66,65-69,3
3,2,6,0,8,2020-05-30,Male,68,65-69,3
3,0,3,0,3,2020-05-29,Female,55,55-64,3
3,0,5,0,5,2020-05-29,Female,60,55-64,3
3,2,1,0,3,2020-06-03,Male,42,35-44,1
3,3,1,0,4,2020-05-30,Female,52,45-54,3
3,3,1,0,4,2020-05-29,Female,3,1-4,3
3,1,0,0,1,2020-06-02,Male,55,55-64,3
3,0,1,0,1,2020-05-29,Female,62,55-64,3
3,2,4,3,9,2020-05-30,Female,33,25-34,3
3,0,0,0,0,2020-05-29,Female,59,55-64,3
3,2,10,0,12,2020-05-29,Female,59,55-64,3
3,1,4,0,5,2020-05-30,Male,41,35-44,3
3,2,2,0,4,2020-05-30,Female,59,55-64,3
3,3,1,0,4,2020-05-29,Male,59,55-64,3
3,0,1,0,1,2020-05-29,Male,69,65-69,3
3,1,2,0,3,2020-06-03,Male,60,55-64,1
3,1,0,0,1,2020-05-30,Male,32,25-34,3
3,0,1,0,1,2020-06-04,Male,67,65-69,1
3,2,1,0,3,2020-05-31,Female,51,45-54,3
3,2,2,0,4,2020-05-29,Male,71,70-74,3
3,1,1,0,2,2020-05-31,Male,69,65-69,3
3,0,1,1,2,2020-05-29,Male,51,45-54,3
3,3,0,0,3,2020-05-31,Female,19,15-19,3
3,2,2,0,4,2020-05-29,Female,64,55-64,3
3,0,2,0,2,2020-06-04,Male,35,35-44,1
3,0,3,1,4,2020-05-29,Male,57,55-64,3
3,0,6,0,6,2020-05-28,Male,66,65-69,3
3,2,0,0,2,2020-06-04,Female,50,45-54,1
3,0,17,0,17,2020-05-29,Female,49,45-54,3
3,0,2,12,14,2020-05-30,Female,60,55-64,3
3,0,1,0,1,2020-05-30,Male,36,35-44,3
3,0,1,0,1,2020-06-03,Male,73,70-74,1
3,2,2,0,4,2020-05-29,Female,51,45-54,3
3,1,3,0,4,2020-05-29,Female,32,25-34,3
3,4,0,0,4,2020-06-02,Male,10,10-14,3
3,0,1,0,1,2020-06-04,Female,63,55-64,1
3,2,0,0,2,2020-05-29,Female,64,55-64,3
3,1,0,0,1,2020-06-04,Female,54,45-54,1
3,3,2,0,5,2020-05-29,Male,19,15-19,3
3,1,1,0,2,2020-05-29,Female,60,55-64,3
3,0,0,100,100,2020-05-30,Male,10,10-14,3
3,2,1,0,3,2020-05-29,Male,17,15-19,3
3,2,3,0,5,2020-06-03,Male,63,55-64,1
3,0,0,0,0,2020-06-04,Female,28,25-34,1
3,1,0,0,1,2020-05-29,Female,65,65-69,3
3,2,0,0,2,2020-06-03,Male,67,65-69,3
3,0,10,0,10,2020-06-02,Male,37,35-44,3
3,0,0,0,0,2020-05-29,Male,60,55-64,3
3,1,0,0,1,2020-05-30,Female,67,65-69,3
3,1,4,0,5,2020-06-03,Male,71,70-74,1
3,2,1,0,3,2020-06-02,Female,39,35-44,3
3,1,1,0,2,2020-05-30,Female,67,65-69,3
3,1,0,0,1,2020-06-02,Female,37,35-44,3
3,1,1,0,2,2020-05-29,Female,33,25-34,3
3,0,1,6,7,2020-06-02,Male,66,65-69,3
3,1,1,0,2,2020-06-02,Female,51,45-54,3
3,0,0,0,0,2020-05-29,Female,23,20-24,3
3,2,5,0,7,2020-06-04,Female,47,45-54,1
3,5,0,1,6,2020-06-03,Female,11,10-14,1
3,1,0,0,1,2020-05-28,Female,66,65-69,3
3,1,0,0,1,2020-05-31,Female,72,70-74,3
3,0,0,0,0,2020-05-29,Male,58,55-64,3
3,2,0,0,2,2020-05-29,Female,12,10-14,3
3,2,0,0,2,2020-06-02,Female,17,15-19,3
3,0,3,0,3,2020-06-03,Female,56,55-64,1
3,1,0,0,1,2020-05-29,Male,78,75-79,3
3,1,0,0,1,2020-06-02,Female,52,45-54,3
3,2,3,0,5,2020-05-29,Male,68,65-69,3
3,2,44,90,136,2020-05-29,Female,55,55-64,3
3,1,1,0,2,2020-05-29,Male,63,55-64,3
3,2,4,0,6,2020-05-30,Male,72,70-74,3
3,1,0,0,1,2020-05-30,Female,64,55-64,3
3,0,0,0,0,2020-06-02,Female,66,65-69,3
3,3,2,0,5,2020-06-04,Female,23,20-24,1
3,0,0,0,0,2020-05-31,Female,37,35-44,3
3,0,5,0,5,2020-06-01,Female,71,70-74,3
3,2,0,0,2,2020-05-31,Female,71,70-74,3
3,1,0,0,1,2020-05-30,Female,49,45-54,3
3,4,0,0,4,2020-05-30,Female,58,55-64,3
3,1,1,0,2,2020-06-04,Female,55,55-64,1
3,0,1,0,1,2020-06-03,Female,74,70-74,1
3,0,0,0,0,2020-06-02,Female,40,35-44,3
3,3,1,0,4,2020-06-02,Male,21,20-24,3
3,0,0,15,15,2020-05-29,Male,35,35-44,3
3,0,0,1,1,2020-06-03,Male,54,45-54,3
3,0,0,76,76,2020-06-01,Female,36,35-44,3
3,3,1,0,4,2020-05-29,Female,8,5-9,3
3,2,1,0,3,2020-05-30,Male,61,55-64,3
3,1,0,0,1,2020-05-29,Male,39,35-44,3
3,0,0,0,0,2020-06-02,Female,67,65-69,3
3,0,1,0,1,2020-05-29,Female,70,70-74,3
3,2,5,0,7,2020-05-30,Male,73,70-74,3
3,2,0,0,2,2020-06-03,Female,65,65-69,3
3,0,3,0,3,2020-05-31,Female,33,25-34,3
3,3,1,0,4,2020-05-29,Male,12,10-14,3
3,1,3,0,4,2020-05-29,Male,72,70-74,3
3,1,0,0,1,2020-06-02,Male,66,65-69,3
3,1,0,0,1,2020-06-04,Male,45,45-54,1
3,1,2,0,3,2020-05-31,Male,67,65-69,3
3,0,7,0,7,2020-05-29,Male,66,65-69,3
3,1,0,0,1,2020-05-29,Female,60,55-64,3
3,2,0,0,2,2020-05-30,Female,65,65-69,3
3,2,3,0,5,2020-05-28,Male,66,65-69,3
3,2,2,0,4,2020-06-03,Female,11,10-14,3
3,0,1,0,1,2020-05-29,Female,1,1-4,3
3,2,6,0,8,2020-05-29,Male,69,65-69,3
3,1,14,0,15,2020-05-29,Male,65,65-69,3
3,3,1,0,4,2020-06-03,Female,18,15-19,1
3,1,31,0,32,2020-06-03,Male,77,75-79,1
3,3,1,0,4,2020-05-31,Female,64,55-64,3
3,0,2,0,2,2020-05-29,Female,66,65-69,3
3,1,5,0,6,2020-05-31,Female,74,70-74,3
3,0,0,0,0,2020-05-31,Female,36,35-44,3
3,2,0,0,2,2020-05-31,Male,31,25-34,3
3,3,0,0,3,2020-05-30,Male,18,15-19,3
3,2,2,0,4,2020-06-03,Female,59,55-64,1
3,1,0,0,1,2020-06-03,Female,58,55-64,1
3,2,25,0,27,2020-05-30,Female,22,20-24,3
3,0,1,0,1,2020-06-03,Male,70,70-74,1
3,1,1,0,2,2020-05-30,Female,63,55-64,3
3,3,4,0,7,2020-05-29,Female,37,35-44,3
3,2,0,0,2,2020-06-02,Male,53,45-54,3
3,0,2,0,2,2020-06-04,Male,77,75-79,1
3,0,1,1,2,2020-05-31,Female,51,45-54,3
3,1,0,0,1,2020-05-29,Male,62,55-64,3
3,2,3,0,5,2020-05-29,Male,65,65-69,3
3,2,0,0,2,2020-05-31,Male,37,35-44,3
3,2,5,0,7,2020-05-29,Female,66,65-69,3
3,0,3,9,12,2020-06-02,Male,52,45-54,3
3,0,0,0,0,2020-06-02,Female,43,35-44,3
3,0,2,0,2,2020-05-29,Male,63,55-64,3
3,0,0,0,0,2020-05-30,Female,52,45-54,3
3,2,0,0,2,2020-05-29,Female,48,45-54,3
3,0,0,0,0,2020-05-28,Female,12,10-14,3
3,0,0,0,0,2020-05-29,Female,63,55-64,3
3,1,0,0,1,2020-05-30,Male,65,65-69,3
3,0,1,0,1,2020-05-30,Female,25,25-34,3
3,0,1,0,1,2020-06-04,Female,30,25-34,1
3,0,0,15,15,2020-05-29,Female,21,20-24,3
3,0,0,0,0,2020-05-29,Male,33,25-34,3
3,2,0,5,7,2020-05-29,Male,46,45-54,3
3,1,1,0,2,2020-05-29,Male,61,55-64,3
3,0,9,0,9,2020-06-02,Male,66,65-69,3
3,1,0,0,1,2020-05-29,Male,67,65-69,3
3,0,0,0,0,2020-05-29,Male,5,5-9,3
3,0,0,2,2,2020-05-31,Male,55,55-64,3
3,3,1,0,4,2020-05-29,Female,47,45-54,3
3,3,0,0,3,2020-05-29,Female,59,55-64,3
3,2,1,0,3,2020-05-29,Male,63,55-64,3
3,2,41,0,43,2020-05-29,Male,57,55-64,3
3,3,1,0,4,2020-06-01,Female,32,25-34,3
3,1,0,4,5,2020-05-29,Male,57,55-64,3
3,2,0,0,2,2020-05-29,Male,63,55-64,3
3,1,0,0,1,2020-06-03,Male,71,70-74,1
3,1,2,0,3,2020-05-29,Female,62,55-64,3
3,1,1,0,2,2020-06-02,Female,63,55-64,3
3,0,0,0,0,2020-06-03,Female,60,55-64,1
3,3,0,0,3,2020-05-29,Female,43,35-44,3
3,2,2,0,4,2020-05-29,Female,68,65-69,3
3,1,1,0,2,2020-05-29,Male,52,45-54,3
3,3,2,0,5,2020-06-01,Male,49,45-54,3
3,3,0,0,3,2020-05-29,Female,18,15-19,3
3,3,0,0,3,2020-05-29,Male,15,15-19,3
3,2,2,0,4,2020-05-29,Male,59,55-64,3
3,1,2,0,3,2020-06-04,Female,67,65-69,1
3,3,0,0,3,2020-06-03,Female,53,45-54,1
3,0,0,0,0,2020-05-30,Male,41,35-44,3
3,1,6,0,7,2020-05-31,Male,67,65-69,3
3,2,0,0,2,2020-05-29,Male,76,75-79,3
3,1,2,0,3,2020-05-29,Female,58,55-64,3
3,0,0,2,2,2020-05-29,Male,60,55-64,3
3,2,5,0,7,2020-06-03,Female,47,45-54,1
3,0,0,0,0,2020-05-30,Female,13,10-14,3
3,2,0,0,2,2020-06-03,Male,69,65-69,1
3,0,6,0,6,2020-05-29,Female,54,45-54,3
3,0,1,0,1,2020-06-04,Female,29,25-34,1
3,0,6,0,6,2020-06-01,Male,29,25-34,3
3,4,0,0,4,2020-05-29,Male,12,10-14,3
3,1,0,0,1,2020-06-02,Female,29,25-34,3
3,0,5,0,5,2020-06-01,Female,39,35-44,3
3,0,0,0,0,2020-05-29,Female,33,25-34,3
3,2,0,2,4,2020-06-03,Male,14,10-14,1
3,1,1,0,2,2020-06-03,Male,62,55-64,1
3,0,8,0,8,2020-06-03,Female,65,65-69,3
3,2,1,0,3,2020-05-29,Female,75,75-79,3
3,0,3,0,3,2020-05-29,Male,70,70-74,3
3,0,0,0,0,2020-06-03,Female,57,55-64,1
3,1,1,0,2,2020-05-29,Female,73,70-74,3
3,0,3,0,3,2020-05-29,Female,66,65-69,3
3,0,0,0,0,2020-05-29,Male,43,35-44,3
3,0,0,0,0,2020-05-31,Female,68,65-69,3
3,0,1,0,1,2020-06-02,Male,54,45-54,3
3,0,0,0,0,2020-06-03,Male,19,15-19,1
3,4,10,0,14,2020-05-30,Male,13,10-14,3
3,0,2,0,2,2020-05-31,Female,27,25-34,3
3,2,0,0,2,2020-06-02,Male,47,45-54,3
3,0,0,12,12,2020-05-29,Female,52,45-54,3
3,1,2,0,3,2020-05-29,Female,68,65-69,3
3,0,1,0,1,2020-05-29,Female,37,35-44,3
3,0,0,0,0,2020-05-29,Male,53,45-54,3
3,2,2,0,4,2020-05-29,Male,67,65-69,3
3,2,0,0,2,2020-05-29,Female,72,70-74,3
3,1,2,0,3,2020-06-03,Female,24,20-24,3
3,1,5,0,6,2020-06-02,Female,22,20-24,3
3,2,0,0,2,2020-06-02,Male,49,45-54,3
3,0,3,1,4,2020-05-29,Female,49,45-54,3
3,1,5,0,6,2020-05-30,Female,68,65-69,3
3,0,4,0,4,2020-06-03,Female,42,35-44,1
3,2,0,0,2,2020-05-29,Male,68,65-69,3
3,2,6,18,26,2020-05-29,Female,47,45-54,3
3,4,11,15,30,2020-06-02,Female,23,20-24,3
3,3,0,0,3,2020-05-29,Male,84,80-84,3
3,1,0,0,1,2020-05-29,Female,31,25-34,3
3,1,13,6,20,2020-06-03,Female,3,1-4,1
3,1,32,0,33,2020-05-31,Female,53,45-54,3
3,2,2,0,4,2020-06-02,Female,19,15-19,3
3,0,4,0,4,2020-05-29,Male,47,45-54,3
3,0,0,0,0,2020-05-29,Male,49,45-54,3
3,0,0,0,0,2020-05-29,Female,50,45-54,3
3,2,0,0,2,2020-06-02,Male,31,25-34,3
3,0,1,0,1,2020-05-29,Male,65,65-69,3
3,2,0,0,2,2020-06-02,Male,25,25-34,3
3,2,0,0,2,2020-05-29,Male,54,45-54,3
3,2,0,0,2,2020-06-03,Male,65,65-69,3
3,2,1,0,3,2020-05-29,Female,67,65-69,3
3,0,0,0,0,2020-05-29,Male,42,35-44,3
3,2,7,0,9,2020-06-04,Female,54,45-54,1
3,0,0,0,0,2020-05-29,Female,30,25-34,3
3,2,4,0,6,2020-05-30,Female,79,75-79,3
3,1,1,0,2,2020-05-29,Female,69,65-69,3
3,0,3,0,3,2020-05-29,Female,69,65-69,3
3,2,2,0,4,2020-05-29,Male,70,70-74,3
3,0,1,0,1,2020-06-02,Male,10,10-14,3
3,0,3,0,3,2020-05-29,Male,60,55-64,3
3,4,1,7,12,2020-06-02,Male,9,5-9,3
3,1,12,0,13,2020-05-29,Female,29,25-34,3
3,4,1,0,5,2020-05-30,Female,9,5-9,3
3,0,1,0,1,2020-05-29,Male,33,25-34,3
4,0,0,0,0,2020-06-13,Female,51,45-54,2
4,2,1,0,3,2020-06-16,Male,67,65-69,1
4,0,1,0,1,2020-06-14,Female,33,25-34,2
4,1,0,0,1,2020-06-16,Female,69,65-69,1
4,0,0,0,0,2020-06-15,Male,66,65-69,4
4,2,1,0,3,2020-06-16,Female,18,15-19,1
4,2,0,0,2,2020-06-12,Female,65,65-69,4
4,0,0,0,0,2020-06-17,Female,18,15-19,1
4,0,0,0,0,2020-06-16,Female,33,25-34,4
4,1,0,0,1,2020-06-19,Female,50,45-54,1
4,1,1,0,2,2020-06-12,Female,71,70-74,4
4,0,0,0,0,2020-06-15,Female,32,25-34,2
4,0,1,0,1,2020-06-16,Male,29,25-34,1
4,0,0,0,0,2020-06-16,Female,53,45-54,1
4,0,9,0,9,2020-06-13,Male,57,55-64,2
4,0,3,1,4,2020-06-17,Female,67,65-69,1
4,0,0,0,0,2020-06-15,Female,56,55-64,4
4,2,0,0,2,2020-06-15,Male,34,25-34,4
4,3,0,0,3,2020-06-15,Male,9,5-9,4
4,0,0,0,0,2020-06-22,Female,59,55-64,4
4,0,0,0,0,2020-06-12,Male,67,65-69,4
4,1,0,0,1,2020-06-16,Male,50,45-54,1
4,3,5,0,8,2020-06-16,Female,34,25-34,1
4,3,0,0,3,2020-06-12,Female,57,55-64,4
4,2,3,0,5,2020-06-19,Female,21,20-24,1
4,2,0,0,2,2020-06-15,Female,13,10-14,4
4,3,0,15,18,2020-06-17,Female,2,1-4,1
4,1,0,9,10,2020-06-16,Male,42,35-44,1
4,1,3,0,4,2020-06-17,Male,66,65-69,1
4,1,3,2,6,2020-06-12,Male,62,55-64,4
4,0,0,0,0,2020-06-20,Male,34,25-34,1
4,3,2,0,5,2020-06-22,Male,13,10-14,1
4,1,1,1,3,2020-06-12,Male,19,15-19,4
4,0,1,0,1,2020-06-18,Male,48,45-54,1
4,1,12,0,13,2020-06-19,Male,34,25-34,1
4,0,1,0,1,2020-06-18,Male,52,45-54,1
4,0,0,0,0,2020-06-12,Male,61,55-64,2
4,2,2,0,4,2020-06-12,Female,70,70-74,4
4,1,0,0,1,2020-06-13,Male,67,65-69,4
4,4,0,0,4,2020-06-18,Male,20,20-24,1
4,0,2,0,2,2020-06-12,Male,56,55-64,4
4,2,0,0,2,2020-06-16,Female,52,45-54,1
4,2,1,0,3,2020-06-14,Female,68,65-69,4
4,0,2,0,2,2020-06-15,Male,41,35-44,4
4,1,0,0,1,2020-06-13,Male,58,55-64,4
4,0,0,0,0,2020-06-13,Female,69,65-69,2
4,1,0,0,1,2020-06-15,Female,56,55-64,4
4,0,3,4,7,2020-06-12,Male,69,65-69,2
4,2,0,0,2,2020-06-13,Female,21,20-24,4
4,2,0,0,2,2020-06-11,Male,51,45-54,4
4,0,0,0,0,2020-06-12,Male,85,85+,4
4,0,2,0,2,2020-06-16,Female,65,65-69,1
4,0,0,48,48,2020-06-18,Male,22,20-24,1
4,2,0,0,2,2020-06-19,Male,0,<1,1
4,3,0,0,3,2020-06-16,Female,6,5-9,1
4,0,0,0,0,2020-06-13,Male,53,45-54,4
4,4,0,100,104,2020-06-22,Male,15,15-19,1
4,1,0,0,1,2020-06-11,Male,57,55-64,4
4,0,0,0,0,2020-06-12,Male,67,65-69,4
4,0,1,0,1,2020-06-16,Female,22,20-24,1
4,0,0,0,0,2020-06-16,Male,57,55-64,1
4,2,0,0,2,2020-06-17,Male,71,70-74,1
4,0,2,0,2,2020-06-12,Male,76,75-79,4
4,2,0,0,2,2020-06-15,Male,71,70-74,4
4,0,5,0,5,2020-06-16,Male,43,35-44,1
4,0,0,0,0,2020-06-15,Male,51,45-54,4
4,0,0,0,0,2020-06-16,Male,36,35-44,1
4,0,0,0,0,2020-06-16,Male,52,45-54,1
4,1,0,0,1,2020-06-18,Male,43,35-44,1
4,0,10,10,20,2020-06-13,Female,51,45-54,2
4,3,3,0,6,2020-06-17,Male,43,35-44,4
4,1,0,19,20,2020-06-17,Male,3,1-4,1
4,0,0,0,0,2020-06-13,Female,74,70-74,4
4,1,0,0,1,2020-06-13,Female,59,55-64,4
4,1,0,1,2,2020-06-17,Male,0,<1,1
4,0,0,0,0,2020-06-17,Female,13,10-14,1
4,2,0,0,2,2020-06-14,Male,34,25-34,4
4,1,7,0,8,2020-06-16,Male,38,35-44,1
4,0,1,0,1,2020-06-14,Female,76,75-79,4
4,2,1,0,3,2020-06-16,Female,55,55-64,1
4,1,0,0,1,2020-06-17,Male,3,1-4,1
4,2,2,0,4,2020-06-22,Female,24,20-24,1
4,0,6,0,6,2020-06-17,Female,51,45-54,1
4,0,7,0,7,2020-06-18,Female,47,45-54,2
4,1,1,0,2,2020-06-16,Male,67,65-69,1
4,3,7,0,10,2020-06-17,Female,12,10-14,1
4,0,0,0,0,2020-06-16,Male,71,70-74,1
4,0,2,0,2,2020-06-17,Male,37,35-44,1
4,0,0,0,0,2020-06-12,Male,70,70-74,2
4,0,0,0,0,2020-06-16,Male,85,85+,1
4,2,1,0,3,2020-06-12,Female,71,70-74,4
4,2,0,0,2,2020-06-16,Female,38,35-44,1
4,0,2,0,2,2020-06-17,Female,33,25-34,1
4,1,5,0,6,2020-06-17,Male,44,35-44,4
4,3,4,0,7,2020-06-16,Male,23,20-24,1
4,2,4,2,8,2020-06-15,Male,54,45-54,4
4,0,2,0,2,2020-06-17,Male,31,25-34,1
4,1,0,0,1,2020-06-16,Male,70,70-74,1
4,2,3,0,5,2020-06-17,Male,66,65-69,1
4,1,2,0,3,2020-06-12,Female,65,65-69,4
4,2,0,1,3,2020-06-12,Male,69,65-69,4
4,2,0,0,2,2020-06-16,Male,68,65-69,1
4,2,0,0,2,2020-06-16,Male,33,25-34,1
4,1,0,0,1,2020-06-16,Male,40,35-44,1
4,0,2,0,2,2020-06-22,Female,34,25-34,1
4,3,1,0,4,2020-06-16,Female,25,25-34,1
4,1,0,0,1,2020-06-16,Male,42,35-44,1
4,1,1,0,2,2020-06-22,Female,73,70-74,1
4,4,2,0,6,2020-06-18,Male,16,15-19,1
4,0,0,0,0,2020-06-16,Male,69,65-69,1
4,1,5,0,6,2020-06-12,Male,69,65-69,4
4,1,2,0,3,2020-06-16,Male,76,75-79,1
4,2,0,0,2,2020-06-15,Female,60,55-64,4
4,0,1,0,1,2020-06-14,Female,52,45-54,4
4,0,0,0,0,2020-06-12,Male,48,45-54,4
4,1,2,0,3,2020-06-16,Male,21,20-24,1
4,0,2,0,2,2020-06-16,Male,69,65-69,1
4,0,5,0,5,2020-06-16,Male,36,35-44,1
4,1,2,0,3,2020-06-17,Male,65,65-69,1
4,0,0,0,0,2020-06-12,Female,65,65-69,2
4,1,0,0,1,2020-06-17,Female,66,65-69,1
4,2,1,0,3,2020-06-18,Female,26,25-34,1
4,0,0,0,0,2020-06-14,Female,52,45-54,2
4,0,40,75,115,2020-06-15,Female,49,45-54,2
4,1,1,0,2,2020-06-16,Female,1,1-4,1
4,1,4,0,5,2020-06-19,Female,23,20-24,1
4,0,2,0,2,2020-06-22,Male,74,70-74,1
4,1,1,0,2,2020-06-15,Female,30,25-34,4
4,2,4,0,6,2020-06-16,Female,67,65-69,1
4,2,3,0,5,2020-06-17,Male,18,15-19,1
4,4,0,4,8,2020-06-16,Male,19,15-19,1
4,2,0,0,2,2020-06-15,Female,46,45-54,4
4,2,0,20,22,2020-06-17,Male,67,65-69,1
4,1,0,0,1,2020-06-18,Female,57,55-64,1
4,0,1,0,1,2020-06-17,Male,54,45-54,1
4,2,0,0,2,2020-06-12,Female,65,65-69,4
4,2,0,0,2,2020-06-16,Male,33,25-34,1
4,2,1,0,3,2020-06-18,Male,29,25-34,1
4,0,0,0,0,2020-06-16,Male,4,1-4,1
4,3,0,0,3,2020-06-13,Female,72,70-74,4
4,0,0,0,0,2020-06-15,Male,32,25-34,4
4,0,0,0,0,2020-06-17,Male,65,65-69,1
4,1,6,0,7,2020-06-21,Male,27,25-34,1
4,0,0,0,0,2020-06-16,Female,30,25-34,1
4,0,2,0,2,2020-06-16,Male,34,25-34,1
4,2,3,0,5,2020-06-17,Female,66,65-69,1
4,2,0,0,2,2020-06-16,Male,28,25-34,1
4,1,0,0,1,2020-06-18,Female,9,5-9,1
4,0,5,0,5,2020-06-20,Female,32,25-34,1
4,0,1,0,1,2020-06-17,Female,57,55-64,4
4,1,0,0,1,2020-06-17,Male,65,65-69,1
4,0,0,0,0,2020-06-13,Male,63,55-64,4
4,1,0,5,6,2020-06-16,Male,29,25-34,1
4,3,6,0,9,2020-06-18,Female,25,25-34,1
4,0,1,0,1,2020-06-16,Male,68,65-69,1
4,1,0,0,1,2020-06-12,Female,67,65-69,4
4,2,0,0,2,2020-06-12,Male,58,55-64,4
4,1,1,0,2,2020-06-18,Male,25,25-34,1
4,2,0,0,2,2020-06-16,Female,41,35-44,1
4,1,1,0,2,2020-06-16,Female,62,55-64,1
4,0,3,0,3,2020-06-13,Male,50,45-54,4
4,1,3,0,4,2020-06-16,Male,69,65-69,1
4,3,0,0,3,2020-06-18,Male,31,25-34,1
4,0,0,0,0,2020-06-16,Female,53,45-54,4
4,2,0,1,3,2020-06-16,Male,69,65-69,1
4,5,0,0,5,2020-06-16,Male,19,15-19,1
4,3,0,0,3,2020-06-16,Female,13,10-14,1
4,0,30,0,30,2020-06-12,Female,27,25-34,2
4,1,2,0,3,2020-06-17,Female,69,65-69,1
4,1,0,0,1,2020-06-12,Female,78,75-79,4
4,0,4,0,4,2020-06-22,Female,66,65-69,1
4,2,2,0,4,2020-06-14,Male,56,55-64,4
4,2,2,0,4,2020-06-16,Male,60,55-64,1
4,4,0,0,4,2020-06-16,Male,22,20-24,1
4,2,2,0,4,2020-06-16,Female,56,55-64,1
4,3,2,0,5,2020-06-22,Female,23,20-24,1
4,2,0,0,2,2020-06-14,Male,52,45-54,4
4,0,0,0,0,2020-06-16,Male,52,45-54,1
4,1,1,0,2,2020-06-17,Male,27,25-34,1
4,0,0,0,0,2020-06-15,Male,56,55-64,4
4,1,1,0,2,2020-06-17,Female,37,35-44,1
4,2,1,2,5,2020-06-16,Male,70,70-74,1
4,2,5,0,7,2020-06-12,Male,18,15-19,4
4,1,0,0,1,2020-06-12,Female,51,45-54,4
4,4,0,0,4,2020-06-16,Male,28,25-34,1
4,3,1,12,16,2020-06-22,Male,0,<1,1
4,4,0,0,4,2020-06-17,Male,8,5-9,1
4,0,0,0,0,2020-06-12,Male,67,65-69,4
4,0,0,0,0,2020-06-15,Female,57,55-64,2
4,2,3,0,5,2020-06-20,Female,23,20-24,1
4,0,5,0,5,2020-06-13,Female,65,65-69,4
4,1,1,0,2,2020-06-18,Female,41,35-44,1
4,1,1,0,2,2020-06-13,Female,59,55-64,4
4,0,1,0,1,2020-06-16,Female,65,65-69,1
4,0,1,0,1,2020-06-15,Male,70,70-74,4
4,2,1,0,3,2020-06-22,Male,16,15-19,1
4,0,3,0,3,2020-06-14,Female,71,70-74,4
4,1,0,0,1,2020-06-12,Male,73,70-74,4
4,1,1,0,2,2020-06-18,Female,24,20-24,1
4,0,1,9,10,2020-06-13,Female,33,25-34,2
4,2,1,0,3,2020-06-12,Female,65,65-69,4
4,0,1,0,1,2020-06-16,Male,50,45-54,1
4,3,0,0,3,2020-06-18,Female,30,25-34,1
4,0,0,0,0,2020-06-15,Male,38,35-44,4
4,1,0,0,1,2020-06-12,Female,54,45-54,4
4,4,1,1,6,2020-06-16,Female,20,20-24,1
4,1,0,0,1,2020-06-17,Male,33,25-34,1
4,0,0,0,0,2020-06-16,Male,53,45-54,1
4,1,0,0,1,2020-06-13,Male,50,45-54,4
4,0,0,0,0,2020-06-13,Female,64,55-64,2
4,1,0,0,1,2020-06-17,Male,67,65-69,1
4,1,0,92,93,2020-06-18,Female,49,45-54,1
4,2,2,0,4,2020-06-17,Male,24,20-24,1
4,0,0,0,0,2020-06-19,Female,21,20-24,1
4,1,2,0,3,2020-06-18,Female,60,55-64,1
4,0,0,0,0,2020-06-16,Female,28,25-34,1
4,2,0,0,2,2020-06-16,Male,6,5-9,1
4,2,37,71,110,2020-06-16,Male,14,10-14,1
4,2,4,0,6,2020-06-16,Female,68,65-69,1
4,2,0,0,2,2020-06-12,Male,65,65-69,4
4,1,0,0,1,2020-06-22,Male,64,55-64,1
4,2,1,0,3,2020-06-12,Male,68,65-69,4
4,1,0,0,1,2020-06-15,Male,52,45-54,4
4,0,1,0,1,2020-06-15,Male,71,70-74,2
4,1,1,0,2,2020-06-16,Male,53,45-54,1
4,0,0,0,0,2020-06-12,Male,50,45-54,4
4,3,0,0,3,2020-06-15,Male,10,10-14,4
4,1,2,0,3,2020-06-16,Female,58,55-64,1
4,0,1,0,1,2020-06-16,Female,25,25-34,1
4,0,0,0,0,2020-06-12,Male,70,70-74,4
4,0,0,1,1,2020-06-13,Male,73,70-74,2
4,1,0,0,1,2020-06-16,Male,39,35-44,1
4,0,0,0,0,2020-06-15,Female,51,45-54,2
4,2,0,0,2,2020-06-12,Female,69,65-69,4
4,0,4,0,4,2020-06-17,Male,37,35-44,1
4,2,1,0,3,2020-06-17,Female,34,25-34,1
4,3,0,0,3,2020-06-20,Male,19,15-19,1
4,2,0,0,2,2020-06-16,Female,72,70-74,1
4,1,2,0,3,2020-06-16,Male,51,45-54,1
4,1,1,0,2,2020-06-11,Female,56,55-64,4
4,1,0,0,1,2020-06-12,Female,59,55-64,4
4,0,0,0,0,2020-06-11,Male,43,35-44,4
4,2,3,0,5,2020-06-16,Male,62,55-64,1
4,2,1,0,3,2020-06-12,Female,62,55-64,4
4,0,2,0,2,2020-06-22,Female,22,20-24,1
4,2,0,0,2,2020-06-12,Male,73,70-74,4
4,0,11,0,11,2020-06-12,Female,68,65-69,4
4,0,0,0,0,2020-06-12,Male,34,25-34,4
4,2,1,0,3,2020-06-12,Male,68,65-69,4
4,3,0,0,3,2020-06-16,Male,10,10-14,1
4,1,0,1,2,2020-06-17,Male,47,45-54,1
4,3,0,0,3,2020-06-16,Male,69,65-69,1
4,2,1,1,4,2020-06-13,Male,65,65-69,4
4,0,3,0,3,2020-06-12,Female,31,25-34,2
4,3,9,0,12,2020-06-16,Male,5,5-9,1
4,2,5,0,7,2020-06-12,Male,67,65-69,4
4,4,0,7,11,2020-06-17,Female,4,1-4,1
4,0,1,0,1,2020-06-16,Male,61,55-64,4
4,1,0,40,41,2020-06-18,Male,32,25-34,1
4,3,5,0,8,2020-06-16,Female,16,15-19,1
4,0,2,0,2,2020-06-12,Male,62,55-64,2
4,0,1,0,1,2020-06-17,Male,43,35-44,1
4,1,0,0,1,2020-06-17,Female,58,55-64,1
4,0,1,0,1,2020-06-12,Female,66,65-69,4
4,1,83,10,94,2020-06-16,Male,22,20-24,1
4,0,0,0,0,2020-06-15,Female,40,35-44,4
4,0,0,0,0,2020-06-15,Male,44,35-44,4
4,1,2,0,3,2020-06-13,Female,66,65-69,4
4,1,8,0,9,2020-06-17,Female,24,20-24,1
4,2,37,0,39,2020-06-18,Male,18,15-19,1
4,3,1,2,6,2020-06-13,Female,13,10-14,4
4,3,1,0,4,2020-06-12,Female,60,55-64,4
4,1,1,0,2,2020-06-16,Male,34,25-34,1
4,0,0,0,0,2020-06-15,Male,47,45-54,4
4,1,0,0,1,2020-06-16,Male,60,55-64,1
4,0,3,0,3,2020-06-16,Male,15,15-19,1
4,1,0,0,1,2020-06-13,Female,53,45-54,4
4,0,2,0,2,2020-06-16,Male,55,55-64,1
4,1,2,0,3,2020-06-16,Female,37,35-44,1
4,0,0,0,0,2020-06-12,Female,65,65-69,4
4,0,0,0,0,2020-06-13,Male,72,70-74,4
4,1,4,0,5,2020-06-18,Female,21,20-24,1
4,4,1,0,5,2020-06-16,Female,7,5-9,1
4,3,0,0,3,2020-06-17,Male,6,5-9,1
4,2,0,0,2,2020-06-16,Male,78,75-79,1
4,0,5,0,5,2020-06-16,Female,66,65-69,1
4,3,0,0,3,2020-06-16,Female,17,15-19,1
4,0,0,0,0,2020-06-15,Female,55,55-64,4
4,0,0,0,0,2020-06-15,Male,53,45-54,4
4,1,0,0,1,2020-06-12,Male,68,65-69,4
4,0,2,0,2,2020-06-15,Male,36,35-44,4
4,3,2,3,8,2020-06-16,Female,49,45-54,1
4,2,0,1,3,2020-06-16,Male,65,65-69,1
4,2,1,0,3,2020-06-15,Male,38,35-44,4
4,2,1,0,3,2020-06-16,Female,70,70-74,1
4,0,2,0,2,2020-06-13,Female,53,45-54,2
4,2,2,0,4,2020-06-16,Female,66,65-69,1
4,1,0,64,65,2020-06-17,Male,18,15-19,1
4,2,0,0,2,2020-06-13,Male,61,55-64,4
4,1,3,0,4,2020-06-12,Female,68,65-69,4
4,0,5,0,5,2020-06-12,Female,60,55-64,2
4,4,1,0,5,2020-06-19,Female,23,20-24,1
4,0,4,0,4,2020-06-12,Female,69,65-69,4
4,2,9,0,11,2020-06-17,Male,67,65-69,1
4,0,1,2,3,2020-06-22,Male,9,5-9,1
4,0,0,0,0,2020-06-13,Male,68,65-69,4
4,0,0,0,0,2020-06-16,Male,36,35-44,1
4,0,2,0,2,2020-06-14,Male,28,25-34,4
4,4,0,0,4,2020-06-12,Female,53,45-54,4
4,3,2,83,88,2020-06-20,Male,18,15-19,1
4,0,0,0,0,2020-06-16,Male,9,5-9,1
4,0,0,0,0,2020-06-16,Male,76,75-79,1
4,0,0,0,0,2020-06-16,Male,46,45-54,1
4,1,5,0,6,2020-06-16,Male,52,45-54,1
4,0,0,0,0,2020-06-16,Female,70,70-74,1
4,2,1,0,3,2020-06-17,Male,32,25-34,1
4,3,0,0,3,2020-06-17,Male,69,65-69,1
4,4,0,0,4,2020-06-12,Female,68,65-69,4
4,3,2,0,5,2020-06-17,Male,15,15-19,1
4,0,0,0,0,2020-06-17,Male,64,55-64,1
4,0,1,0,1,2020-06-12,Male,49,45-54,4
4,2,0,0,2,2020-06-16,Female,66,65-69,1
4,2,1,0,3,2020-06-15,Male,75,75-79,4
4,1,0,0,1,2020-06-17,Male,50,45-54,1
4,1,0,0,1,2020-06-16,Male,52,45-54,1
4,0,3,0,3,2020-06-16,Female,60,55-64,1
4,3,0,0,3,2020-06-16,Male,17,15-19,1
4,1,0,0,1,2020-06-16,Female,64,55-64,1
4,4,5,0,9,2020-06-18,Male,21,20-24,1
4,0,0,0,0,2020-06-12,Female,54,45-54,2
4,1,1,0,2,2020-06-12,Male,66,65-69,4
4,0,0,0,0,2020-06-12,Male,64,55-64,4
4,2,4,0,6,2020-06-12,Female,67,65-69,4
4,0,1,0,1,2020-06-15,Female,73,70-74,4
4,1,2,0,3,2020-06-12,Male,67,65-69,4
4,0,0,0,0,2020-06-17,Male,40,35-44,1
4,1,1,0,2,2020-06-12,Male,74,70-74,4
4,4,3,2,9,2020-06-18,Female,8,5-9,1
4,0,3,0,3,2020-06-16,Male,65,65-69,1
4,1,3,0,4,2020-06-16,Female,43,35-44,1
4,3,1,0,4,2020-06-17,Male,3,1-4,1
4,0,1,0,1,2020-06-13,Male,52,45-54,4
4,2,2,0,4,2020-06-16,Male,69,65-69,1
4,3,0,0,3,2020-06-16,Female,15,15-19,1
4,0,0,0,0,2020-06-22,Female,46,45-54,1
4,1,4,0,5,2020-06-16,Female,60,55-64,1
4,3,1,0,4,2020-06-12,Male,14,10-14,4
4,2,1,0,3,2020-06-16,Male,52,45-54,1
4,0,0,0,0,2020-06-13,Female,51,45-54,4
4,1,1,0,2,2020-06-16,Female,46,45-54,1
4,4,0,0,4,2020-06-13,Male,11,10-14,4
4,0,0,0,0,2020-06-16,Male,27,25-34,1
4,0,1,0,1,2020-06-13,Female,59,55-64,4
4,0,0,0,0,2020-06-15,Female,44,35-44,2
4,0,0,0,0,2020-06-12,Male,11,10-14,4
4,4,4,0,8,2020-06-16,Female,1,1-4,1
4,0,4,0,4,2020-06-12,Male,81,80-84,4
4,3,2,0,5,2020-06-16,Female,26,25-34,1
4,2,2,0,4,2020-06-18,Female,58,55-64,1
4,4,1,4,9,2020-06-16,Female,6,5-9,1
4,0,0,0,0,2020-06-12,Female,52,45-54,4
4,0,0,0,0,2020-06-14,Female,52,45-54,4
4,0,1,0,1,2020-06-17,Female,28,25-34,1
4,0,2,0,2,2020-06-18,Male,24,20-24,1
4,2,1,0,3,2020-06-18,Male,18,15-19,1
4,2,2,0,4,2020-06-13,Male,70,70-74,4
4,0,0,0,0,2020-06-12,Male,34,25-34,4
4,2,11,3,16,2020-06-22,Female,31,25-34,1
4,0,3,0,3,2020-06-17,Male,27,25-34,1
4,3,1,0,4,2020-06-16,Female,21,20-24,1
4,0,0,0,0,2020-06-12,Female,65,65-69,2
4,0,1,0,1,2020-06-13,Female,51,45-54,2
4,0,1,0,1,2020-06-14,Female,23,20-24,4
4,1,0,0,1,2020-06-16,Female,66,65-69,1
4,0,0,0,0,2020-06-15,Male,23,20-24,4
4,2,0,0,2,2020-06-17,Female,67,65-69,1
4,0,0,0,0,2020-06-12,Male,67,65-69,4
4,2,1,0,3,2020-06-18,Male,21,20-24,1
4,2,0,0,2,2020-06-11,Male,41,35-44,4
4,1,0,0,1,2020-06-15,Male,65,65-69,4
4,2,3,0,5,2020-06-22,Female,29,25-34,1
4,4,2,0,6,2020-06-14,Male,49,45-54,4
4,2,12,0,14,2020-06-16,Female,24,20-24,1
4,0,3,0,3,2020-06-16,Male,70,70-74,1
4,0,2,0,2,2020-06-11,Female,39,35-44,2
4,1,0,0,1,2020-06-20,Male,32,25-34,1
4,2,3,0,5,2020-06-13,Male,75,75-79,4
4,1,3,0,4,2020-06-12,Male,79,75-79,4
4,2,0,0,2,2020-06-12,Male,53,45-54,4
4,0,2,0,2,2020-06-15,Male,51,45-54,4
4,0,8,9,17,2020-06-11,Male,67,65-69,1
4,2,3,0,5,2020-06-16,Female,68,65-69,1
4,3,0,0,3,2020-06-16,Male,64,55-64,1
4,1,1,1,3,2020-06-17,Male,63,55-64,1
4,0,3,0,3,2020-06-12,Female,66,65-69,4
4,3,0,0,3,2020-06-16,Male,12,10-14,1
4,0,0,0,0,2020-06-15,Female,25,25-34,4
4,1,0,0,1,2020-06-17,Male,30,25-34,1
4,0,0,0,0,2020-06-22,Male,27,25-34,1
4,2,3,0,5,2020-06-12,Female,77,75-79,4
4,2,3,4,9,2020-06-16,Female,66,65-69,1
4,0,3,0,3,2020-06-16,Male,67,65-69,1
4,0,4,60,64,2020-06-16,Female,63,55-64,1
4,1,4,0,5,2020-06-12,Male,68,65-69,4
4,4,4,20,28,2020-06-17,Male,12,10-14,1
4,1,31,0,32,2020-06-16,Female,68,65-69,1
4,1,0,0,1,2020-06-12,Male,37,35-44,4
4,0,1,0,1,2020-06-15,Male,74,70-74,2
4,0,1,0,1,2020-06-13,Male,29,25-34,4
4,3,3,0,6,2020-06-17,Female,52,45-54,1
4,2,2,0,4,2020-06-12,Male,60,55-64,4
4,0,1,0,1,2020-06-16,Female,19,15-19,1
4,2,0,0,2,2020-06-13,Female,65,65-69,4
4,0,2,0,2,2020-06-12,Female,59,55-64,2
4,2,1,0,3,2020-06-13,Female,78,75-79,4
4,2,0,0,2,2020-06-17,Female,27,25-34,1
4,0,1,0,1,2020-06-12,Male,53,45-54,4
4,0,1,17,18,2020-06-12,Male,65,65-69,4
4,2,0,0,2,2020-06-11,Female,1,1-4,4
4,0,0,0,0,2020-06-12,Female,69,65-69,4
4,0,0,0,0,2020-06-12,Female,75,75-79,4
4,4,0,0,4,2020-06-16,Male,36,35-44,1
4,2,10,0,12,2020-06-16,Male,43,35-44,1
4,0,0,0,0,2020-06-12,Female,54,45-54,4
4,4,0,0,4,2020-06-16,Male,14,10-14,1
4,0,5,0,5,2020-06-12,Male,67,65-69,2
4,1,3,0,4,2020-06-18,Male,51,45-54,1
4,1,0,0,1,2020-06-13,Male,68,65-69,4
4,1,1,1,3,2020-06-17,Male,56,55-64,1
4,1,3,0,4,2020-06-17,Female,54,45-54,1
4,2,2,0,4,2020-06-16,Male,61,55-64,1
4,1,0,0,1,2020-06-16,Female,25,25-34,1
4,0,1,0,1,2020-06-17,Female,65,65-69,1
4,1,0,1,2,2020-06-18,Female,32,25-34,1
4,0,1,0,1,2020-06-12,Female,65,65-69,4
4,1,0,0,1,2020-06-16,Female,60,55-64,1
4,0,0,0,0,2020-06-14,Female,49,45-54,4
4,1,11,0,12,2020-06-20,Male,26,25-34,1
4,2,2,1,5,2020-06-18,Male,4,1-4,1
4,1,2,0,3,2020-06-17,Male,65,65-69,1
4,4,4,0,8,2020-06-16,Female,19,15-19,4
4,0,0,7,7,2020-06-14,Male,66,65-69,4
4,1,2,0,3,2020-06-13,Female,69,65-69,4
4,0,2,0,2,2020-06-17,Female,80,80-84,1
4,1,0,10,11,2020-06-16,Male,42,35-44,1
4,0,0,4,4,2020-06-18,Male,16,15-19,1
4,3,2,0,5,2020-06-16,Female,13,10-14,1
4,0,0,0,0,2020-06-16,Female,65,65-69,1
4,1,0,0,1,2020-06-12,Female,26,25-34,4
4,2,0,0,2,2020-06-15,Male,75,75-79,4
4,1,0,0,1,2020-06-12,Female,52,45-54,4
4,0,3,0,3,2020-06-17,Female,39,35-44,2
4,1,2,0,3,2020-06-12,Male,73,70-74,4
4,0,7,0,7,2020-06-17,Male,37,35-44,1
4,0,1,10,11,2020-06-16,Male,30,25-34,1
4,3,14,0,17,2020-06-17,Female,29,25-34,1
4,1,1,0,2,2020-06-15,Female,6,5-9,3
4,4,10,0,14,2020-06-13,Male,62,55-64,4
4,2,0,0,2,2020-06-15,Male,29,25-34,4
4,3,2,13,18,2020-06-17,Female,54,45-54,1
4,0,15,0,15,2020-06-16,Male,56,55-64,1
4,1,1,0,2,2020-06-16,Male,63,55-64,1
4,4,1,0,5,2020-06-16,Female,10,10-14,1
4,5,8,0,13,2020-06-17,Male,19,15-19,1
4,2,0,0,2,2020-06-12,Male,54,45-54,4
4,0,1,0,1,2020-06-15,Female,52,45-54,2
4,0,1,0,1,2020-06-17,Male,60,55-64,1
4,0,1,0,1,2020-06-12,Female,65,65-69,4
4,2,0,1,3,2020-06-16,Male,72,70-74,1
4,2,0,1,3,2020-06-16,Male,72,70-74,1
4,2,0,0,2,2020-06-12,Male,65,65-69,4
4,2,0,0,2,2020-06-15,Female,52,45-54,4
4,4,0,0,4,2020-06-19,Male,16,15-19,1
4,5,1,13,19,2020-06-21,Male,11,10-14,1
4,0,1,0,1,2020-06-15,Female,71,70-74,4
4,3,0,0,3,2020-06-16,Female,16,15-19,1
4,5,0,15,20,2020-06-16,Male,1,1-4,1
4,2,0,0,2,2020-06-15,Male,67,65-69,4
4,0,1,0,1,2020-06-12,Female,56,55-64,4
4,0,1,2,3,2020-06-16,Male,67,65-69,1
4,0,0,0,0,2020-06-13,Female,85,85+,4
4,0,1,0,1,2020-06-12,Male,54,45-54,4
4,3,1,47,51,2020-06-16,Male,4,1-4,1
4,2,3,0,5,2020-06-12,Male,66,65-69,4
4,0,8,0,8,2020-06-17,Female,68,65-69,1
4,1,2,0,3,2020-06-16,Female,69,65-69,1
4,0,0,9,9,2020-06-18,Female,29,25-34,1
4,0,3,0,3,2020-06-16,Male,37,35-44,4
4,2,0,0,2,2020-06-16,Female,68,65-69,1
4,0,2,5,7,2020-06-17,Female,38,35-44,1
4,1,0,0,1,2020-06-16,Male,54,45-54,1
4,1,2,30,33,2020-06-16,Female,24,20-24,1
4,2,8,0,10,2020-06-16,Female,47,45-54,1
4,2,0,0,2,2020-06-16,Male,1,1-4,4
4,2,3,0,5,2020-06-12,Male,63,55-64,4
4,2,14,0,16,2020-06-16,Male,65,65-69,1
4,0,2,0,2,2020-06-18,Female,19,15-19,1
4,0,0,0,0,2020-06-18,Male,24,20-24,1
4,3,1,0,4,2020-06-13,Male,59,55-64,4
4,0,1,0,1,2020-06-12,Female,49,45-54,4
4,0,6,40,46,2020-06-12,Male,57,55-64,4
4,2,0,0,2,2020-06-11,Female,65,65-69,4
4,2,1,0,3,2020-06-18,Female,52,45-54,1
4,4,0,0,4,2020-06-15,Female,2,1-4,4
4,3,16,0,19,2020-06-16,Female,11,10-14,1
4,2,0,0,2,2020-06-17,Female,71,70-74,1
4,2,19,0,21,2020-06-18,Female,24,20-24,4
4,4,2,0,6,2020-06-13,Male,11,10-14,4
4,2,7,0,9,2020-06-14,Male,50,45-54,4
4,0,0,0,0,2020-06-13,Female,65,65-69,4
4,0,4,0,4,2020-06-13,Female,51,45-54,3
4,0,2,0,2,2020-06-12,Male,73,70-74,4
4,3,2,0,5,2020-06-22,Male,23,20-24,1
4,0,0,3,3,2020-06-16,Female,66,65-69,1
4,0,0,0,0,2020-06-16,Male,70,70-74,1
4,0,1,0,1,2020-06-16,Female,68,65-69,4
4,0,1,0,1,2020-06-12,Female,78,75-79,4
4,1,1,2,4,2020-06-12,Male,85,85+,4
4,0,0,0,0,2020-06-16,Male,21,20-24,1
4,0,15,1,16,2020-06-13,Male,55,55-64,4
4,0,0,0,0,2020-06-16,Female,6,5-9,1
4,1,11,0,12,2020-06-17,Female,43,35-44,1
4,2,0,0,2,2020-06-12,Male,59,55-64,4
4,1,0,1,2,2020-06-16,Male,54,45-54,1
4,0,1,0,1,2020-06-15,Female,32,25-34,4
4,1,0,0,1,2020-06-14,Female,68,65-69,4
4,0,2,19,21,2020-06-14,Female,73,70-74,2
4,0,1,0,1,2020-06-18,Female,53,45-54,1
4,0,0,0,0,2020-06-18,Male,51,45-54,1
4,0,0,0,0,2020-06-16,Female,24,20-24,4
4,0,0,0,0,2020-06-16,Male,34,25-34,1
4,1,1,0,2,2020-06-13,Male,51,45-54,4
4,0,4,11,15,2020-06-17,Male,58,55-64,2
4,0,1,0,1,2020-06-12,Female,64,55-64,2
4,1,3,0,4,2020-06-17,Male,44,35-44,1
4,1,0,6,7,2020-06-11,Male,29,25-34,4
4,1,11,1,13,2020-06-16,Female,32,25-34,1
4,3,0,0,3,2020-06-16,Female,2,1-4,1
4,0,14,0,14,2020-06-16,Female,23,20-24,1
4,0,6,0,6,2020-06-12,Male,70,70-74,2
4,1,0,0,1,2020-06-18,Male,33,25-34,1
4,0,1,0,1,2020-06-11,Female,48,45-54,4
4,3,3,0,6,2020-06-16,Male,9,5-9,1
4,0,4,0,4,2020-06-17,Male,39,35-44,1
4,0,1,0,1,2020-06-13,Male,69,65-69,4
4,2,2,0,4,2020-06-12,Female,63,55-64,4
4,1,4,0,5,2020-06-16,Male,63,55-64,1
4,4,1,0,5,2020-06-20,Female,2,1-4,1
4,3,2,0,5,2020-06-18,Male,7,5-9,1
4,1,0,0,1,2020-06-16,Female,47,45-54,1
4,2,4,0,6,2020-06-14,Female,60,55-64,4
4,0,1,0,1,2020-06-12,Male,70,70-74,4
4,2,4,0,6,2020-06-16,Female,56,55-64,1
4,0,1,0,1,2020-06-17,Female,21,20-24,1
4,0,0,0,0,2020-06-16,Male,32,25-34,1
4,1,0,9,10,2020-06-12,Male,52,45-54,4
4,0,4,1,5,2020-06-12,Female,65,65-69,4
4,1,3,0,4,2020-06-16,Male,35,35-44,1
4,0,1,0,1,2020-06-13,Female,66,65-69,4
4,0,3,13,16,2020-06-16,Female,69,65-69,1
4,0,1,0,1,2020-06-17,Male,71,70-74,1
4,1,7,6,14,2020-06-12,Female,52,45-54,4
4,2,6,0,8,2020-06-16,Female,32,25-34,1
4,0,5,0,5,2020-06-16,Male,53,45-54,1
4,1,9,0,10,2020-06-19,Female,39,35-44,1
4,4,2,0,6,2020-06-15,Female,45,45-54,4
4,0,2,0,2,2020-06-12,Male,54,45-54,4
4,0,0,0,0,2020-06-18,Male,41,35-44,1
4,2,1,0,3,2020-06-16,Male,65,65-69,1
4,3,3,15,21,2020-06-16,Male,57,55-64,1
4,1,2,0,3,2020-06-17,Female,55,55-64,4
4,0,0,0,0,2020-06-12,Female,67,65-69,4
4,2,0,100,102,2020-06-16,Male,39,35-44,4
4,0,1,0,1,2020-06-16,Male,39,35-44,1
4,3,1,0,4,2020-06-16,Male,42,35-44,1
4,1,0,0,1,2020-06-22,Female,44,35-44,1
4,4,1,0,5,2020-06-16,Female,20,20-24,1
4,1,6,0,7,2020-06-16,Male,24,20-24,1
4,1,2,0,3,2020-06-12,Female,62,55-64,4
4,0,0,0,0,2020-06-13,Female,58,55-64,2
4,2,1,5,8,2020-06-17,Female,56,55-64,1
4,2,0,0,2,2020-06-11,Female,5,5-9,4
4,2,0,0,2,2020-06-16,Male,39,35-44,1
4,0,0,0,0,2020-06-12,Male,65,65-69,4
4,0,0,0,0,2020-06-14,Male,60,55-64,4
4,2,3,2,7,2020-06-17,Male,63,55-64,1
4,4,3,0,7,2020-06-17,Male,68,65-69,1
4,1,3,1,5,2020-06-16,Female,63,55-64,1
4,0,0,0,0,2020-06-16,Male,72,70-74,1
4,3,6,0,9,2020-06-22,Female,25,25-34,1
4,1,17,0,18,2020-06-17,Female,32,25-34,1
4,2,0,0,2,2020-06-17,Male,29,25-34,1
4,0,0,0,0,2020-06-12,Female,56,55-64,4
4,4,2,0,6,2020-06-16,Male,16,15-19,1
4,1,0,0,1,2020-06-16,Female,78,75-79,1
4,2,1,0,3,2020-06-13,Male,68,65-69,4
4,0,0,0,0,2020-06-15,Female,16,15-19,4
4,2,0,0,2,2020-06-14,Male,62,55-64,4
4,1,1,0,2,2020-06-11,Male,67,65-69,4
4,0,2,8,10,2020-06-16,Male,64,55-64,1
4,1,0,3,4,2020-06-12,Female,57,55-64,4
4,2,5,10,17,2020-06-17,Male,76,75-79,1
4,0,1,0,1,2020-06-12,Male,57,55-64,4
4,1,5,0,6,2020-06-17,Female,70,70-74,1
4,0,1,25,26,2020-06-22,Male,51,45-54,1
4,0,10,0,10,2020-06-18,Female,59,55-64,1
4,4,0,0,4,2020-06-13,Male,6,5-9,4
4,2,12,0,14,2020-06-14,Female,55,55-64,4
4,0,0,0,0,2020-06-21,Female,26,25-34,1
4,3,5,0,8,2020-06-16,Female,8,5-9,1
4,2,2,0,4,2020-06-16,Male,52,45-54,1
4,2,1,0,3,2020-06-16,Female,66,65-69,1
4,0,0,0,0,2020-06-16,Female,35,35-44,1
4,2,32,0,34,2020-06-16,Male,55,55-64,1
4,0,3,0,3,2020-06-16,Male,30,25-34,4
4,0,5,0,5,2020-06-19,Male,26,25-34,1
4,0,0,0,0,2020-06-11,Male,38,35-44,4
4,1,3,0,4,2020-06-16,Female,9,5-9,1
4,0,0,0,0,2020-06-15,Female,13,10-14,4
4,1,1,1,3,2020-06-16,Male,53,45-54,1
4,2,1,0,3,2020-06-15,Female,58,55-64,4
4,1,1,0,2,2020-06-16,Female,72,70-74,1
4,2,0,0,2,2020-06-22,Female,23,20-24,1
4,3,1,4,8,2020-06-19,Male,12,10-14,1
4,6,0,0,6,2020-06-15,Female,12,10-14,4
4,2,0,0,2,2020-06-12,Male,64,55-64,4
4,1,3,0,4,2020-06-13,Female,51,45-54,4
4,0,0,0,0,2020-06-18,Male,55,55-64,1
4,4,10,0,14,2020-06-12,Female,15,15-19,4
4,1,1,0,2,2020-06-16,Female,72,70-74,1
4,0,0,0,0,2020-06-12,Female,61,55-64,4
4,1,3,0,4,2020-06-20,Female,25,25-34,1
4,1,0,0,1,2020-06-14,Male,53,45-54,4
4,0,1,0,1,2020-06-12,Female,59,55-64,3
4,5,5,0,10,2020-06-17,Female,7,5-9,1
4,2,3,0,5,2020-06-12,Male,55,55-64,4
4,0,2,0,2,2020-06-16,Female,21,20-24,1
4,2,3,0,5,2020-06-18,Female,54,45-54,1
4,1,4,0,5,2020-06-17,Male,56,55-64,1
4,0,0,0,0,2020-06-12,Male,59,55-64,4
4,0,3,0,3,2020-06-12,Female,58,55-64,4
4,0,3,0,3,2020-06-16,Female,19,15-19,1
4,0,1,0,1,2020-06-13,Female,29,25-34,2
4,0,2,0,2,2020-06-17,Female,66,65-69,1
4,1,4,0,5,2020-06-17,Female,31,25-34,1
4,0,2,0,2,2020-06-22,Female,23,20-24,1
4,1,5,0,6,2020-06-17,Male,23,20-24,1
4,0,1,0,1,2020-06-20,Male,31,25-34,1
4,3,8,0,11,2020-06-16,Male,58,55-64,1
4,0,1,0,1,2020-06-18,Male,47,45-54,4
4,0,3,0,3,2020-06-11,Female,62,55-64,2
4,0,0,0,0,2020-06-16,Male,0,<1,1
4,2,2,0,4,2020-06-16,Female,67,65-69,1
4,0,0,14,14,2020-06-16,Female,28,25-34,4
4,1,0,0,1,2020-06-15,Female,40,35-44,4
4,1,1,0,2,2020-06-16,Male,68,65-69,1
4,2,0,0,2,2020-06-16,Female,26,25-34,1
4,2,3,0,5,2020-06-17,Female,73,70-74,1
4,0,0,0,0,2020-06-16,Male,30,25-34,1
4,4,1,0,5,2020-06-16,Male,10,10-14,1
4,2,2,50,54,2020-06-16,Male,65,65-69,1
4,2,6,0,8,2020-06-16,Female,61,55-64,1
4,3,1,0,4,2020-06-17,Female,65,65-69,1
4,2,2,0,4,2020-06-18,Female,27,25-34,1
4,0,0,0,0,2020-06-16,Male,68,65-69,1
4,0,0,0,0,2020-06-22,Female,30,25-34,4
4,1,4,15,20,2020-06-18,Male,12,10-14,1
4,1,0,0,1,2020-06-15,Male,62,55-64,4
4,0,0,0,0,2020-06-16,Male,48,45-54,4
4,2,3,0,5,2020-06-19,Male,22,20-24,1
4,0,1,0,1,2020-06-16,Female,56,55-64,1
4,0,0,0,0,2020-06-12,Female,56,55-64,2
4,0,2,0,2,2020-06-13,Female,72,70-74,4
4,0,0,0,0,2020-06-12,Male,58,55-64,3
4,1,3,0,4,2020-06-18,Female,51,45-54,1
4,1,2,0,3,2020-06-17,Male,42,35-44,1
4,1,0,0,1,2020-06-11,Male,68,65-69,4
4,0,0,0,0,2020-06-21,Female,23,20-24,1
4,3,0,0,3,2020-06-22,Female,59,55-64,1
4,1,0,0,1,2020-06-16,Male,78,75-79,1
4,2,0,0,2,2020-06-12,Male,70,70-74,4
4,0,0,0,0,2020-06-22,Male,35,35-44,1
4,0,1,0,1,2020-06-16,Male,59,55-64,1
4,2,1,24,27,2020-06-16,Male,66,65-69,1
4,0,10,0,10,2020-06-21,Male,34,25-34,1
4,0,0,0,0,2020-06-11,Male,46,45-54,4
4,0,0,0,0,2020-06-16,Female,53,45-54,1
4,0,5,0,5,2020-06-18,Male,28,25-34,1
4,0,4,0,4,2020-06-16,Male,50,45-54,1
4,2,12,15,29,2020-06-16,Male,19,15-19,1
4,4,0,0,4,2020-06-16,Male,2,1-4,1
4,0,3,0,3,2020-06-13,Male,60,55-64,4
4,1,2,0,3,2020-06-13,Female,69,65-69,4
4,1,1,0,2,2020-06-12,Male,67,65-69,4
4,2,0,2,4,2020-06-16,Male,46,45-54,1
4,2,6,0,8,2020-06-16,Male,76,75-79,1
4,3,2,0,5,2020-06-16,Female,65,65-69,1
4,1,9,0,10,2020-06-22,Female,59,55-64,1
4,2,2,0,4,2020-06-16,Male,75,75-79,1
4,2,0,0,2,2020-06-22,Female,21,20-24,1
4,1,14,0,15,2020-06-16,Male,68,65-69,1
4,0,0,0,0,2020-06-11,Male,43,35-44,2
4,0,0,0,0,2020-06-17,Female,68,65-69,1
4,0,0,0,0,2020-06-17,Female,16,15-19,1
4,0,0,0,0,2020-06-15,Female,41,35-44,4
4,0,2,0,2,2020-06-12,Male,58,55-64,4
4,0,0,0,0,2020-06-12,Male,36,35-44,4
4,0,2,0,2,2020-06-12,Female,59,55-64,2
4,1,4,0,5,2020-06-16,Female,49,45-54,1
4,1,0,0,1,2020-06-16,Male,7,5-9,1
4,0,0,0,0,2020-06-22,Male,51,45-54,1
4,2,0,0,2,2020-06-17,Male,9,5-9,1
4,2,0,0,2,2020-06-18,Female,49,45-54,1
4,2,0,0,2,2020-06-15,Female,45,45-54,4
4,2,0,2,4,2020-06-16,Male,67,65-69,1
4,0,0,0,0,2020-06-16,Male,49,45-54,1
4,3,2,0,5,2020-06-16,Male,68,65-69,1
4,0,0,0,0,2020-06-18,Male,41,35-44,1
4,1,1,0,2,2020-06-16,Male,51,45-54,1
4,0,1,0,1,2020-06-17,Male,62,55-64,1
4,1,0,0,1,2020-06-11,Male,54,45-54,4
4,1,3,0,4,2020-06-21,Female,41,35-44,1
4,2,4,0,6,2020-06-13,Female,70,70-74,4
4,2,0,0,2,2020-06-16,Female,65,65-69,1
4,4,0,0,4,2020-06-14,Male,19,15-19,4
4,0,0,0,0,2020-06-15,Male,69,65-69,2
4,1,8,0,9,2020-06-16,Male,54,45-54,1
4,4,0,0,4,2020-06-16,Male,18,15-19,1
4,4,0,0,4,2020-06-12,Female,59,55-64,4
4,1,0,1,2,2020-06-16,Female,35,35-44,1
4,0,2,0,2,2020-06-16,Male,59,55-64,1
4,0,0,0,0,2020-06-16,Male,30,25-34,1
4,1,1,0,2,2020-06-16,Female,20,20-24,1
4,1,2,3,6,2020-06-16,Male,41,35-44,1
4,3,0,0,3,2020-06-15,Female,55,55-64,4
4,3,0,0,3,2020-06-13,Female,66,65-69,4
4,0,0,8,8,2020-06-16,Female,69,65-69,1
4,0,0,0,0,2020-06-16,Female,20,20-24,1
4,0,0,0,0,2020-06-12,Male,57,55-64,2
4,0,0,0,0,2020-06-13,Male,51,45-54,4
4,0,2,0,2,2020-06-13,Male,64,55-64,4
4,2,0,0,2,2020-06-16,Male,63,55-64,1
4,1,0,0,1,2020-06-16,Male,48,45-54,1
4,0,0,0,0,2020-06-11,Male,59,55-64,4
4,1,1,0,2,2020-06-16,Male,69,65-69,1
4,0,3,5,8,2020-06-16,Male,30,25-34,1
4,0,1,0,1,2020-06-17,Male,35,35-44,4
4,1,0,0,1,2020-06-17,Female,29,25-34,1
4,1,0,0,1,2020-06-12,Female,68,65-69,4
4,0,0,0,0,2020-06-14,Female,61,55-64,2
4,2,5,7,14,2020-06-17,Female,56,55-64,1
4,4,2,0,6,2020-06-16,Female,27,25-34,1
4,1,0,0,1,2020-06-12,Female,59,55-64,4
4,1,32,60,93,2020-06-16,Male,3,1-4,1
4,0,1,0,1,2020-06-11,Male,65,65-69,4
4,1,14,0,15,2020-06-17,Male,52,45-54,1
4,0,0,0,0,2020-06-16,Male,69,65-69,1
4,1,0,0,1,2020-06-16,Male,56,55-64,1
4,1,1,0,2,2020-06-18,Female,23,20-24,1
4,0,3,0,3,2020-06-16,Female,47,45-54,1
4,0,0,0,0,2020-06-12,Female,65,65-69,4
4,0,1,0,1,2020-06-12,Female,76,75-79,4
4,1,2,100,103,2020-06-12,Male,69,65-69,4
4,1,2,0,3,2020-06-17,Female,70,70-74,1
4,1,2,0,3,2020-06-17,Male,70,70-74,1
4,2,3,0,5,2020-06-14,Male,61,55-64,4
4,0,0,0,0,2020-06-16,Male,45,45-54,1
4,0,2,0,2,2020-06-16,Female,65,65-69,1
4,0,1,0,1,2020-06-12,Male,63,55-64,2
4,1,3,0,4,2020-06-17,Female,55,55-64,1
4,1,3,29,33,2020-06-16,Male,71,70-74,1
4,0,0,88,88,2020-06-18,Male,19,15-19,1
4,2,30,0,32,2020-06-16,Female,67,65-69,1
4,0,1,0,1,2020-06-15,Female,64,55-64,4
4,0,10,0,10,2020-06-13,Female,59,55-64,4
4,1,0,0,1,2020-06-15,Male,58,55-64,4
4,1,4,0,5,2020-06-17,Male,68,65-69,4
4,2,2,0,4,2020-06-12,Male,69,65-69,4
4,0,0,0,0,2020-06-15,Male,50,45-54,4
4,0,0,0,0,2020-06-12,Male,66,65-69,4
4,1,1,0,2,2020-06-13,Male,71,70-74,4
4,0,4,0,4,2020-06-16,Female,72,70-74,1
4,2,4,0,6,2020-06-12,Female,77,75-79,4
4,1,2,0,3,2020-06-16,Female,52,45-54,1
4,1,1,0,2,2020-06-16,Female,63,55-64,1
4,2,7,0,9,2020-06-17,Female,50,45-54,1
4,0,1,0,1,2020-06-12,Female,16,15-19,4
4,0,0,0,0,2020-06-20,Male,21,20-24,1
4,1,0,0,1,2020-06-17,Male,0,<1,1
4,1,6,0,7,2020-06-13,Female,38,35-44,4
4,0,0,0,0,2020-06-15,Female,57,55-64,4
4,1,2,0,3,2020-06-16,Female,65,65-69,1
4,2,0,0,2,2020-06-16,Male,77,75-79,1
4,2,0,0,2,2020-06-12,Male,15,15-19,4
4,0,0,0,0,2020-06-15,Male,39,35-44,4
4,0,5,100,105,2020-06-16,Male,66,65-69,1
4,1,3,0,4,2020-06-16,Female,66,65-69,1
4,0,0,0,0,2020-06-18,Male,23,20-24,4
4,3,0,1,4,2020-06-16,Female,18,15-19,1
4,0,0,0,0,2020-06-11,Female,28,25-34,4
4,1,1,0,2,2020-06-16,Female,63,55-64,1
4,3,1,0,4,2020-06-21,Female,20,20-24,1
4,0,10,0,10,2020-06-16,Female,32,25-34,1
4,2,3,0,5,2020-06-18,Male,17,15-19,1
4,1,0,1,2,2020-06-16,Female,46,45-54,1
4,0,0,11,11,2020-06-16,Male,32,25-34,1
4,1,0,1,2,2020-06-16,Male,65,65-69,1
4,0,1,0,1,2020-06-12,Female,67,65-69,4
4,4,11,0,15,2020-06-16,Female,19,15-19,1
4,0,1,0,1,2020-06-16,Female,17,15-19,4
4,0,1,1,2,2020-06-17,Male,59,55-64,1
4,0,1,1,2,2020-06-19,Male,42,35-44,1
4,0,0,0,0,2020-06-12,Male,56,55-64,2
4,1,2,0,3,2020-06-14,Male,59,55-64,4
4,1,2,0,3,2020-06-22,Female,59,55-64,1
4,0,2,0,2,2020-06-22,Female,40,35-44,2
4,0,2,0,2,2020-06-18,Male,31,25-34,1
4,2,0,0,2,2020-06-15,Male,25,25-34,4
4,2,0,0,2,2020-06-18,Male,56,55-64,1
4,2,3,0,5,2020-06-16,Male,69,65-69,1
4,0,6,10,16,2020-06-18,Female,52,45-54,1
4,0,0,12,12,2020-06-20,Male,29,25-34,1
4,4,0,0,4,2020-06-16,Male,63,55-64,1
4,2,0,0,2,2020-06-12,Male,43,35-44,4
4,0,0,0,0,2020-06-16,Male,51,45-54,1
4,3,2,25,30,2020-06-16,Male,30,25-34,4
4,4,12,0,16,2020-06-18,Female,4,1-4,1
4,3,3,0,6,2020-06-17,Male,21,20-24,1
4,0,2,0,2,2020-06-15,Male,52,45-54,4
4,3,0,0,3,2020-06-16,Female,0,<1,4
4,0,3,0,3,2020-06-13,Female,61,55-64,2
4,0,1,0,1,2020-06-15,Female,61,55-64,2
4,2,0,0,2,2020-06-16,Female,63,55-64,1
4,0,1,0,1,2020-06-15,Male,42,35-44,4
4,0,4,0,4,2020-06-13,Male,77,75-79,2
4,2,3,0,5,2020-06-17,Male,4,1-4,1
4,2,1,5,8,2020-06-17,Female,66,65-69,1
4,2,0,0,2,2020-06-17,Male,51,45-54,1
4,2,0,2,4,2020-06-16,Male,57,55-64,1
4,2,2,0,4,2020-06-16,Male,29,25-34,1
4,0,0,0,0,2020-06-15,Male,48,45-54,2
4,0,0,0,0,2020-06-12,Male,56,55-64,4
4,3,0,0,3,2020-06-13,Male,11,10-14,4
4,3,2,0,5,2020-06-18,Female,8,5-9,1
4,2,0,0,2,2020-06-16,Male,24,20-24,1
4,1,0,0,1,2020-06-13,Male,49,45-54,4
4,2,11,0,13,2020-06-13,Male,51,45-54,4
4,0,0,0,0,2020-06-16,Female,55,55-64,1
4,0,10,0,10,2020-06-15,Female,41,35-44,2
4,0,7,40,47,2020-06-16,Female,25,25-34,1
4,0,0,0,0,2020-06-12,Male,70,70-74,4
4,1,0,0,1,2020-06-12,Male,67,65-69,4
4,3,0,0,3,2020-06-16,Male,5,5-9,1
4,2,0,0,2,2020-06-14,Female,59,55-64,4
4,1,1,0,2,2020-06-18,Male,40,35-44,1
4,0,0,0,0,2020-06-11,Female,38,35-44,3
4,0,0,0,0,2020-06-16,Male,53,45-54,1
4,1,0,0,1,2020-06-14,Female,30,25-34,4
4,0,0,0,0,2020-06-11,Female,32,25-34,2
4,0,0,0,0,2020-06-15,Male,32,25-34,4
4,2,3,1,6,2020-06-17,Male,13,10-14,1
4,1,0,0,1,2020-06-13,Female,54,45-54,4
4,2,2,0,4,2020-06-19,Female,12,10-14,1
4,0,2,0,2,2020-06-16,Female,67,65-69,1
4,0,0,0,0,2020-06-16,Female,69,65-69,1
4,2,1,0,3,2020-06-15,Male,45,45-54,4
4,2,2,0,4,2020-06-22,Female,59,55-64,1
4,4,1,0,5,2020-06-18,Female,29,25-34,1
4,0,0,0,0,2020-06-12,Female,55,55-64,4
4,0,3,0,3,2020-06-13,Female,72,70-74,2
4,2,1,0,3,2020-06-16,Male,2,1-4,1
4,2,0,0,2,2020-06-20,Female,28,25-34,1
4,1,0,0,1,2020-06-18,Male,29,25-34,1
4,0,0,0,0,2020-06-12,Female,70,70-74,2
4,2,1,0,3,2020-06-21,Male,22,20-24,1
4,1,0,0,1,2020-06-22,Male,59,55-64,1
4,0,0,0,0,2020-06-13,Male,61,55-64,2
4,0,4,0,4,2020-06-18,Male,39,35-44,1
4,1,3,0,4,2020-06-16,Male,67,65-69,1
4,4,0,0,4,2020-06-13,Male,12,10-14,4
4,0,0,0,0,2020-06-18,Male,28,25-34,1
4,3,0,0,3,2020-06-17,Female,54,45-54,1
4,0,32,0,32,2020-06-16,Male,23,20-24,1
4,3,0,0,3,2020-06-14,Female,16,15-19,4
4,2,2,0,4,2020-06-16,Male,78,75-79,1
4,2,0,19,21,2020-06-13,Male,19,15-19,4
4,2,0,0,2,2020-06-15,Male,14,10-14,4
4,2,1,0,3,2020-06-16,Male,67,65-69,1
4,0,2,0,2,2020-06-15,Female,57,55-64,2
4,1,6,0,7,2020-06-12,Male,73,70-74,4
4,4,1,2,7,2020-06-17,Female,17,15-19,1
4,5,18,0,23,2020-06-20,Male,7,5-9,1
4,2,0,0,2,2020-06-16,Female,65,65-69,1
4,2,2,0,4,2020-06-13,Female,57,55-64,4
4,2,1,0,3,2020-06-13,Male,75,75-79,4
4,1,0,0,1,2020-06-18,Male,14,10-14,1
4,2,1,0,3,2020-06-17,Female,67,65-69,1
4,2,0,0,2,2020-06-18,Female,28,25-34,1
4,0,2,0,2,2020-06-15,Male,41,35-44,3
4,0,0,4,4,2020-06-22,Female,27,25-34,1
4,1,4,5,10,2020-06-17,Female,23,20-24,1
4,5,0,0,5,2020-06-17,Female,3,1-4,1
4,0,0,0,0,2020-06-15,Male,56,55-64,2
4,2,0,0,2,2020-06-22,Male,63,55-64,1
4,3,0,0,3,2020-06-17,Male,13,10-14,1
4,4,0,0,4,2020-06-16,Male,14,10-14,1
4,0,0,0,0,2020-06-22,Female,33,25-34,1
4,0,1,0,1,2020-06-17,Male,52,45-54,1
4,2,1,0,3,2020-06-16,Male,64,55-64,1
4,1,1,0,2,2020-06-12,Female,66,65-69,4
4,2,0,0,2,2020-06-13,Female,67,65-69,4
4,0,0,0,0,2020-06-12,Female,69,65-69,4
4,0,0,0,0,2020-06-15,Female,53,45-54,2
4,2,1,0,3,2020-06-16,Male,80,80-84,1
4,0,1,0,1,2020-06-20,Female,20,20-24,1
4,1,2,0,3,2020-06-17,Female,53,45-54,1
4,2,4,1,7,2020-06-13,Female,62,55-64,4
4,0,3,4,7,2020-06-16,Female,47,45-54,1
4,1,1,0,2,2020-06-16,Male,48,45-54,1
4,0,30,100,130,2020-06-16,Female,29,25-34,1
4,0,0,0,0,2020-06-16,Female,2,1-4,1
4,3,6,0,9,2020-06-16,Male,27,25-34,1
4,0,2,0,2,2020-06-16,Female,64,55-64,1
4,3,0,0,3,2020-06-20,Female,14,10-14,1
4,2,1,0,3,2020-06-17,Female,69,65-69,1
4,1,1,0,2,2020-06-16,Female,52,45-54,1
4,0,0,0,0,2020-06-12,Male,65,65-69,4
4,1,1,0,2,2020-06-16,Male,75,75-79,1
4,0,0,0,0,2020-06-15,Male,65,65-69,4
4,1,0,0,1,2020-06-12,Male,63,55-64,4
4,0,0,0,0,2020-06-17,Female,68,65-69,4
4,1,4,0,5,2020-06-16,Male,30,25-34,1
4,2,0,0,2,2020-06-16,Female,27,25-34,1
4,1,0,0,1,2020-06-15,Male,71,70-74,4
4,2,2,0,4,2020-06-16,Female,45,45-54,1
4,0,0,0,0,2020-06-15,Female,35,35-44,4
4,5,1,23,29,2020-06-16,Female,4,1-4,1
4,0,8,0,8,2020-06-16,Male,44,35-44,1
4,2,2,0,4,2020-06-16,Male,70,70-74,1
4,0,1,0,1,2020-06-16,Male,40,35-44,1
4,5,0,7,12,2020-06-16,Male,11,10-14,1
4,3,5,0,8,2020-06-12,Female,64,55-64,4
4,0,2,0,2,2020-06-13,Female,61,55-64,4
4,0,6,0,6,2020-06-18,Female,31,25-34,1
4,0,1,0,1,2020-06-18,Male,26,25-34,1
4,3,0,0,3,2020-06-15,Male,54,45-54,4
4,2,5,0,7,2020-06-18,Male,54,45-54,1
4,0,0,1,1,2020-06-22,Female,42,35-44,1
4,0,43,0,43,2020-06-15,Female,66,65-69,4
4,0,0,0,0,2020-06-12,Female,59,55-64,4
4,0,4,0,4,2020-06-12,Female,65,65-69,4
4,1,0,0,1,2020-06-20,Female,22,20-24,1
4,2,4,0,6,2020-06-16,Male,55,55-64,1
4,0,1,0,1,2020-06-13,Female,63,55-64,4
4,0,100,38,138,2020-06-13,Female,46,45-54,4
4,1,0,0,1,2020-06-16,Male,53,45-54,1
4,0,0,0,0,2020-06-15,Male,60,55-64,4
4,5,0,8,13,2020-06-17,Female,28,25-34,1
4,2,1,0,3,2020-06-12,Male,56,55-64,4
4,1,4,0,5,2020-06-16,Male,39,35-44,1
4,4,2,0,6,2020-06-15,Female,10,10-14,4
4,2,4,19,25,2020-06-18,Female,21,20-24,1
4,2,0,0,2,2020-06-17,Female,50,45-54,1
4,2,4,0,6,2020-06-16,Male,40,35-44,1
4,4,2,0,6,2020-06-16,Male,17,15-19,1
4,0,0,0,0,2020-06-16,Female,63,55-64,4
4,5,0,0,5,2020-06-16,Male,14,10-14,4
4,3,33,0,36,2020-06-12,Female,60,55-64,4
4,0,1,0,1,2020-06-16,Male,60,55-64,1
4,0,0,0,0,2020-06-15,Female,61,55-64,4
4,0,0,0,0,2020-06-16,Male,50,45-54,1
4,1,0,0,1,2020-06-15,Male,44,35-44,4
4,0,2,0,2,2020-06-15,Female,43,35-44,2
4,1,0,0,1,2020-06-15,Male,59,55-64,4
4,4,3,0,7,2020-06-16,Male,6,5-9,1
4,2,4,0,6,2020-06-16,Male,15,15-19,1
4,1,1,0,2,2020-06-16,Male,70,70-74,1
4,0,0,0,0,2020-06-12,Female,67,65-69,4
4,0,4,0,4,2020-06-16,Female,67,65-69,1
4,1,0,0,1,2020-06-16,Male,33,25-34,1
4,0,0,0,0,2020-06-13,Female,67,65-69,4
4,0,1,0,1,2020-06-16,Male,69,65-69,1
4,3,2,0,5,2020-06-22,Male,21,20-24,1
4,0,2,0,2,2020-06-22,Male,16,15-19,1
4,3,5,0,8,2020-06-16,Male,6,5-9,1
4,3,5,0,8,2020-06-16,Male,59,55-64,1
4,2,0,0,2,2020-06-12,Female,70,70-74,4
4,0,0,0,0,2020-06-17,Male,5,5-9,1
4,2,2,0,4,2020-06-16,Male,66,65-69,1
4,0,1,0,1,2020-06-14,Female,57,55-64,3
4,2,0,0,2,2020-06-12,Male,56,55-64,4
4,0,2,0,2,2020-06-16,Male,69,65-69,1
4,1,12,20,33,2020-06-18,Female,33,25-34,1
4,0,0,0,0,2020-06-16,Male,41,35-44,1
4,0,3,0,3,2020-06-13,Male,73,70-74,4
4,0,0,0,0,2020-06-14,Female,33,25-34,4
4,0,0,14,14,2020-06-16,Male,20,20-24,1
4,0,0,2,2,2020-06-15,Male,52,45-54,4
4,2,0,0,2,2020-06-12,Male,67,65-69,4
4,0,0,0,0,2020-06-15,Male,33,25-34,4
4,0,42,0,42,2020-06-13,Female,37,35-44,4
4,0,1,1,2,2020-06-17,Female,52,45-54,1
4,1,0,0,1,2020-06-16,Male,29,25-34,1
4,2,3,0,5,2020-06-16,Male,78,75-79,1
4,2,2,0,4,2020-06-17,Male,30,25-34,1
4,4,3,0,7,2020-06-17,Female,12,10-14,1
4,1,1,0,2,2020-06-16,Male,68,65-69,1
4,0,3,0,3,2020-06-13,Female,53,45-54,2
4,0,0,0,0,2020-06-16,Male,15,15-19,1
4,2,0,0,2,2020-06-16,Female,13,10-14,1
4,4,2,0,6,2020-06-16,Female,6,5-9,1
4,0,2,0,2,2020-06-18,Male,41,35-44,1
4,4,7,0,11,2020-06-16,Female,7,5-9,1
4,0,0,29,29,2020-06-16,Female,13,10-14,1
4,4,0,0,4,2020-06-16,Male,13,10-14,1
4,2,4,0,6,2020-06-16,Female,61,55-64,1
4,4,1,0,5,2020-06-16,Male,41,35-44,1
4,1,2,0,3,2020-06-16,Female,35,35-44,1
4,1,5,0,6,2020-06-14,Male,75,75-79,4
4,2,1,0,3,2020-06-12,Female,22,20-24,4
4,3,5,0,8,2020-06-17,Male,78,75-79,1
4,0,2,0,2,2020-06-16,Male,52,45-54,1
4,1,10,8,19,2020-06-18,Female,33,25-34,1
4,2,0,0,2,2020-06-17,Female,47,45-54,1
4,3,4,0,7,2020-06-16,Male,8,5-9,1
4,2,1,0,3,2020-06-16,Male,66,65-69,1
4,1,0,0,1,2020-06-16,Male,51,45-54,1
4,0,1,0,1,2020-06-16,Female,52,45-54,1
4,0,13,0,13,2020-06-16,Male,24,20-24,1
4,1,3,0,4,2020-06-14,Female,70,70-74,4
4,1,2,0,3,2020-06-16,Female,65,65-69,1
4,1,0,0,1,2020-06-15,Female,23,20-24,4
4,0,4,0,4,2020-06-16,Female,71,70-74,1
4,0,4,0,4,2020-06-16,Male,31,25-34,1
4,0,3,0,3,2020-06-15,Female,67,65-69,4
4,0,1,0,1,2020-06-16,Male,59,55-64,1
4,2,2,0,4,2020-06-16,Male,14,10-14,1
4,1,1,0,2,2020-06-17,Female,71,70-74,1
4,1,0,0,1,2020-06-16,Female,33,25-34,1
4,2,0,0,2,2020-06-16,Female,50,45-54,4
4,0,7,0,7,2020-06-16,Female,69,65-69,1
4,2,0,0,2,2020-06-16,Male,32,25-34,1
4,3,0,3,6,2020-06-20,Female,0,<1,1
4,2,3,7,12,2020-06-17,Male,59,55-64,1
4,1,2,0,3,2020-06-16,Male,38,35-44,1
4,0,0,0,0,2020-06-13,Female,67,65-69,4
4,1,0,0,1,2020-06-12,Female,58,55-64,4
4,0,3,0,3,2020-06-16,Female,66,65-69,1
4,0,1,0,1,2020-06-12,Female,54,45-54,4
4,3,0,6,9,2020-06-12,Male,69,65-69,4
4,4,2,0,6,2020-06-16,Male,7,5-9,1
4,4,27,0,31,2020-06-17,Male,8,5-9,1
4,3,33,1,37,2020-06-16,Female,26,25-34,1
4,0,0,2,2,2020-06-17,Female,57,55-64,1
4,0,0,0,0,2020-06-13,Female,40,35-44,4
4,0,0,0,0,2020-06-22,Female,23,20-24,1
4,0,3,0,3,2020-06-12,Female,62,55-64,2
4,1,0,0,1,2020-06-16,Male,33,25-34,1
4,4,1,0,5,2020-06-22,Male,19,15-19,1
4,0,1,0,1,2020-06-13,Female,63,55-64,4
4,0,1,0,1,2020-06-12,Male,22,20-24,4
4,2,2,0,4,2020-06-12,Male,58,55-64,4
4,0,0,0,0,2020-06-12,Male,81,80-84,4
4,3,0,0,3,2020-06-11,Female,52,45-54,4
4,0,6,0,6,2020-06-16,Male,39,35-44,1
4,0,3,0,3,2020-06-12,Male,62,55-64,2
4,0,1,0,1,2020-06-16,Male,49,45-54,4
4,0,1,1,2,2020-06-16,Male,35,35-44,1
4,4,0,45,49,2020-06-16,Male,18,15-19,1
4,0,2,0,2,2020-06-12,Male,77,75-79,4
4,1,0,0,1,2020-06-16,Male,43,35-44,1
4,2,0,0,2,2020-06-12,Male,66,65-69,4
4,0,1,0,1,2020-06-19,Female,28,25-34,1
4,2,4,0,6,2020-06-11,Female,66,65-69,4
4,0,1,0,1,2020-06-15,Male,18,15-19,2
4,0,0,0,0,2020-06-17,Female,65,65-69,1
4,0,0,0,0,2020-06-15,Male,36,35-44,4
4,0,0,0,0,2020-06-12,Female,51,45-54,2
4,3,1,4,8,2020-06-16,Male,1,1-4,1
4,0,0,0,0,2020-06-15,Male,47,45-54,4
4,2,3,0,5,2020-06-12,Male,17,15-19,4
4,1,3,0,4,2020-06-16,Male,65,65-69,1
4,0,0,0,0,2020-06-12,Male,61,55-64,2
4,1,5,0,6,2020-06-15,Female,65,65-69,4
4,0,0,0,0,2020-06-15,Male,37,35-44,4
4,2,0,2,4,2020-06-13,Male,74,70-74,4
4,0,0,0,0,2020-06-13,Male,70,70-74,2
4,0,0,0,0,2020-06-18,Male,30,25-34,1
4,2,0,0,2,2020-06-16,Female,65,65-69,4
4,0,0,0,0,2020-06-12,Male,18,15-19,4
4,2,2,0,4,2020-06-16,Male,72,70-74,1
4,0,0,0,0,2020-06-16,Female,53,45-54,1
4,2,5,0,7,2020-06-16,Male,67,65-69,1
4,3,0,0,3,2020-06-17,Female,37,35-44,1
4,3,0,0,3,2020-06-13,Female,8,5-9,4
4,0,0,0,0,2020-06-12,Male,39,35-44,4
4,0,2,0,2,2020-06-17,Female,37,35-44,1
4,2,1,0,3,2020-06-16,Male,63,55-64,1
4,0,0,0,0,2020-06-12,Male,57,55-64,4
4,2,5,0,7,2020-06-18,Male,59,55-64,1
4,0,2,0,2,2020-06-19,Male,44,35-44,4
4,0,0,0,0,2020-06-17,Male,21,20-24,1
4,0,0,0,0,2020-06-16,Male,34,25-34,1
4,3,1,1,5,2020-06-16,Male,68,65-69,1
4,2,1,0,3,2020-06-12,Female,40,35-44,4
4,0,0,0,0,2020-06-12,Female,58,55-64,4
4,2,1,0,3,2020-06-13,Female,52,45-54,4
4,1,0,0,1,2020-06-16,Female,34,25-34,1
4,2,0,0,2,2020-06-14,Female,57,55-64,4
4,0,0,0,0,2020-06-14,Female,59,55-64,4
4,0,3,0,3,2020-06-16,Male,59,55-64,1
4,2,0,0,2,2020-06-12,Male,13,10-14,4
4,2,1,2,5,2020-06-16,Male,19,15-19,1
4,2,0,0,2,2020-06-16,Male,65,65-69,1
4,1,3,0,4,2020-06-12,Female,49,45-54,4
4,0,3,0,3,2020-06-20,Male,23,20-24,1
4,4,0,0,4,2020-06-16,Female,17,15-19,1
4,0,0,0,0,2020-06-18,Female,21,20-24,1
4,4,0,0,4,2020-06-22,Female,13,10-14,1
4,0,1,0,1,2020-06-20,Male,42,35-44,4
4,4,3,0,7,2020-06-17,Female,18,15-19,1
4,2,0,0,2,2020-06-22,Female,21,20-24,1
4,2,2,15,19,2020-06-16,Female,10,10-14,1
4,1,1,0,2,2020-06-17,Female,67,65-69,1
4,0,3,0,3,2020-06-13,Female,53,45-54,4
4,1,2,0,3,2020-06-17,Male,74,70-74,1
4,0,0,0,0,2020-06-16,Male,38,35-44,1
4,0,0,0,0,2020-06-16,Male,35,35-44,1
4,0,4,0,4,2020-06-16,Male,35,35-44,1
4,1,2,3,6,2020-06-17,Male,67,65-69,1
4,3,0,0,3,2020-06-18,Female,15,15-19,1
4,1,13,0,14,2020-06-13,Male,65,65-69,4
4,3,0,0,3,2020-06-16,Female,2,1-4,1
4,2,0,32,34,2020-06-16,Male,13,10-14,1
4,1,12,0,13,2020-06-13,Female,65,65-69,4
4,0,7,0,7,2020-06-16,Female,13,10-14,1
4,1,0,1,2,2020-06-16,Female,65,65-69,1
4,0,7,0,7,2020-06-17,Male,77,75-79,1
4,2,0,0,2,2020-06-16,Male,6,5-9,1
4,5,4,0,9,2020-06-19,Male,32,25-34,1
4,1,0,0,1,2020-06-16,Female,67,65-69,1
4,0,5,0,5,2020-06-13,Male,52,45-54,4
4,0,11,0,11,2020-06-12,Female,63,55-64,2
4,1,1,0,2,2020-06-18,Male,29,25-34,1
4,0,3,0,3,2020-06-16,Female,30,25-34,1
4,0,3,0,3,2020-06-16,Female,45,45-54,2
4,2,5,0,7,2020-06-14,Male,66,65-69,4
4,1,0,0,1,2020-06-16,Female,75,75-79,1
4,3,2,10,15,2020-06-16,Female,5,5-9,1
4,2,0,0,2,2020-06-13,Male,62,55-64,4
4,0,0,0,0,2020-06-12,Female,61,55-64,4
4,3,0,0,3,2020-06-17,Male,8,5-9,1
4,1,0,0,1,2020-06-12,Female,28,25-34,4
4,4,2,0,6,2020-06-16,Female,15,15-19,1
4,0,7,0,7,2020-06-16,Female,27,25-34,1
4,3,2,0,5,2020-06-20,Male,20,20-24,1
4,1,0,1,2,2020-06-16,Female,68,65-69,1
4,0,0,0,0,2020-06-15,Male,27,25-34,4
4,2,0,0,2,2020-06-17,Female,55,55-64,1
4,1,0,0,1,2020-06-14,Male,61,55-64,4
4,4,4,0,8,2020-06-18,Female,8,5-9,4
4,0,4,0,4,2020-06-12,Male,68,65-69,2
4,0,2,0,2,2020-06-16,Male,62,55-64,1
4,4,1,0,5,2020-06-16,Male,18,15-19,1
4,0,1,7,8,2020-06-18,Male,30,25-34,1
4,2,0,0,2,2020-06-12,Male,68,65-69,4
4,0,2,0,2,2020-06-19,Female,28,25-34,1
4,1,2,0,3,2020-06-16,Male,23,20-24,1
4,0,6,0,6,2020-06-16,Male,44,35-44,1
4,1,0,0,1,2020-06-16,Female,29,25-34,1
4,2,0,0,2,2020-06-11,Male,18,15-19,4
4,2,3,0,5,2020-06-13,Female,69,65-69,4
4,2,2,0,4,2020-06-15,Female,62,55-64,4
4,1,1,0,2,2020-06-17,Female,73,70-74,1
4,1,0,0,1,2020-06-12,Female,67,65-69,4
4,0,2,0,2,2020-06-12,Female,53,45-54,2
4,1,0,0,1,2020-06-12,Male,54,45-54,4
4,1,0,0,1,2020-06-12,Female,61,55-64,4
4,1,1,0,2,2020-06-14,Male,66,65-69,4
4,4,0,3,7,2020-06-20,Female,2,1-4,1
4,1,0,0,1,2020-06-16,Male,54,45-54,1
4,2,1,0,3,2020-06-12,Female,61,55-64,4
4,2,0,0,2,2020-06-16,Female,71,70-74,1
4,0,7,7,14,2020-06-13,Female,65,65-69,4
4,0,0,0,0,2020-06-15,Male,43,35-44,2
4,3,1,0,4,2020-06-15,Female,45,45-54,4
4,0,0,0,0,2020-06-16,Male,65,65-69,1
4,1,0,0,1,2020-06-12,Male,65,65-69,4
4,0,5,0,5,2020-06-11,Female,23,20-24,2
4,0,0,0,0,2020-06-12,Female,68,65-69,4
4,0,1,0,1,2020-06-15,Female,12,10-14,4
4,3,0,0,3,2020-06-16,Male,12,10-14,1
4,1,0,0,1,2020-06-13,Female,62,55-64,4
4,0,1,0,1,2020-06-15,Female,51,45-54,4
4,2,0,9,11,2020-06-22,Female,9,5-9,1
4,2,4,0,6,2020-06-16,Female,65,65-69,1
4,2,10,13,25,2020-06-17,Female,52,45-54,1
4,3,1,0,4,2020-06-16,Female,47,45-54,1
4,1,0,0,1,2020-06-13,Male,66,65-69,4
4,0,0,0,0,2020-06-16,Female,67,65-69,1
4,0,2,0,2,2020-06-11,Male,28,25-34,4
4,1,3,0,4,2020-06-12,Male,59,55-64,4
4,4,0,2,6,2020-06-15,Female,44,35-44,4
4,1,1,0,2,2020-06-16,Male,71,70-74,1
4,2,0,0,2,2020-06-12,Female,67,65-69,4
4,2,4,0,6,2020-06-12,Male,69,65-69,4
4,3,0,5,8,2020-06-17,Male,15,15-19,1
4,2,0,0,2,2020-06-16,Female,66,65-69,1
4,1,2,0,3,2020-06-15,Male,57,55-64,4
4,0,0,0,0,2020-06-15,Female,46,45-54,2
4,2,2,0,4,2020-06-16,Male,66,65-69,1
4,2,0,0,2,2020-06-17,Male,13,10-14,1
4,0,0,0,0,2020-06-17,Male,34,25-34,1
4,0,1,0,1,2020-06-14,Male,49,45-54,4
4,0,0,0,0,2020-06-12,Female,60,55-64,2
4,0,0,0,0,2020-06-18,Female,52,45-54,1
4,1,0,0,1,2020-06-22,Male,67,65-69,1
4,0,1,0,1,2020-06-11,Male,28,25-34,2
4,0,10,5,15,2020-06-14,Female,25,25-34,4
4,2,0,0,2,2020-06-16,Male,29,25-34,4
4,0,0,0,0,2020-06-17,Male,33,25-34,1
4,0,0,0,0,2020-06-15,Female,54,45-54,2
4,2,1,0,3,2020-06-16,Male,71,70-74,1
4,3,6,0,9,2020-06-17,Female,8,5-9,1
4,0,4,0,4,2020-06-17,Male,64,55-64,1
4,1,3,0,4,2020-06-16,Male,66,65-69,1
4,1,2,0,3,2020-06-17,Female,48,45-54,1
4,2,0,0,2,2020-06-16,Female,67,65-69,1
4,0,1,0,1,2020-06-16,Male,35,35-44,1
4,1,4,0,5,2020-06-13,Female,65,65-69,4
4,1,0,0,1,2020-06-17,Female,49,45-54,1
4,3,0,12,15,2020-06-21,Male,41,35-44,1
4,1,0,2,3,2020-06-16,Female,76,75-79,1
4,3,0,20,23,2020-06-17,Female,4,1-4,1
4,4,0,0,4,2020-06-16,Female,44,35-44,2
4,0,1,0,1,2020-06-15,Female,34,25-34,2
4,0,0,0,0,2020-06-16,Male,40,35-44,4
4,0,0,0,0,2020-06-16,Male,41,35-44,1
4,2,1,0,3,2020-06-16,Female,61,55-64,1
4,0,0,0,0,2020-06-16,Female,53,45-54,2
4,0,5,0,5,2020-06-13,Male,64,55-64,2
4,2,0,0,2,2020-06-12,Female,18,15-19,4
4,2,0,0,2,2020-06-16,Male,29,25-34,1
4,0,10,0,10,2020-06-12,Female,60,55-64,2
4,2,0,0,2,2020-06-12,Male,54,45-54,4
4,4,0,0,4,2020-06-15,Male,2,1-4,4
4,0,0,0,0,2020-06-13,Male,64,55-64,4
4,4,3,0,7,2020-06-17,Male,22,20-24,1
4,3,1,0,4,2020-06-16,Male,21,20-24,1
4,4,0,0,4,2020-06-17,Female,3,1-4,1
4,2,41,100,143,2020-06-17,Female,45,45-54,1
4,1,1,0,2,2020-06-16,Female,10,10-14,1
4,2,0,1,3,2020-06-16,Male,51,45-54,1
4,2,2,0,4,2020-06-13,Male,60,55-64,4
4,1,0,0,1,2020-06-13,Male,64,55-64,4
4,3,8,0,11,2020-06-14,Female,61,55-64,4
4,1,0,0,1,2020-06-13,Male,55,55-64,4
4,0,2,0,2,2020-06-12,Male,51,45-54,4
4,2,1,0,3,2020-06-13,Male,65,65-69,4
4,0,5,0,5,2020-06-15,Female,69,65-69,2
4,2,1,0,3,2020-06-17,Female,39,35-44,1
4,0,0,0,0,2020-06-12,Male,57,55-64,2
4,0,0,0,0,2020-06-15,Male,60,55-64,4
4,2,1,0,3,2020-06-14,Male,52,45-54,4
4,0,0,0,0,2020-06-15,Female,64,55-64,2
4,0,0,0,0,2020-06-18,Male,51,45-54,1
4,1,1,0,2,2020-06-16,Male,53,45-54,1
4,1,1,0,2,2020-06-17,Female,60,55-64,1
4,1,3,0,4,2020-06-17,Female,17,15-19,1
4,2,4,0,6,2020-06-18,Female,24,20-24,1
4,1,1,0,2,2020-06-13,Female,55,55-64,4
4,2,2,0,4,2020-06-16,Male,32,25-34,1
4,4,4,0,8,2020-06-17,Female,8,5-9,1
4,1,0,0,1,2020-06-16,Female,48,45-54,1
4,0,0,0,0,2020-06-12,Male,66,65-69,4
4,0,0,0,0,2020-06-12,Male,66,65-69,4
4,1,3,0,4,2020-06-16,Male,54,45-54,1
4,4,7,0,11,2020-06-18,Male,4,1-4,1
4,0,0,0,0,2020-06-15,Female,54,45-54,2
4,3,1,91,95,2020-06-17,Male,58,55-64,1
4,0,7,0,7,2020-06-15,Male,41,35-44,4
4,0,1,0,1,2020-06-13,Male,66,65-69,4
4,1,0,0,1,2020-06-16,Female,60,55-64,1
4,0,0,0,0,2020-06-22,Female,30,25-34,1
4,0,0,0,0,2020-06-13,Female,60,55-64,2
4,2,3,0,5,2020-06-16,Male,63,55-64,1
4,1,4,0,5,2020-06-17,Female,59,55-64,1
4,0,0,0,0,2020-06-12,Female,68,65-69,4
4,3,4,0,7,2020-06-16,Male,17,15-19,1
4,0,0,0,0,2020-06-15,Male,54,45-54,4
4,0,0,0,0,2020-06-13,Male,57,55-64,4
4,1,0,0,1,2020-06-16,Male,47,45-54,1
4,0,0,0,0,2020-06-16,Female,44,35-44,2
4,0,2,0,2,2020-06-17,Female,34,25-34,1
4,0,0,0,0,2020-06-12,Male,51,45-54,4
4,1,0,0,1,2020-06-16,Male,61,55-64,1
4,0,8,0,8,2020-06-13,Female,50,45-54,2
4,1,0,0,1,2020-06-14,Male,61,55-64,4
4,0,2,0,2,2020-06-12,Female,66,65-69,4
4,3,4,0,7,2020-06-16,Male,12,10-14,4
4,0,1,0,1,2020-06-12,Female,57,55-64,2
4,2,0,2,4,2020-06-13,Male,77,75-79,4
4,3,5,0,8,2020-06-18,Female,22,20-24,1
4,2,0,0,2,2020-06-15,Female,19,15-19,4
4,1,0,0,1,2020-06-15,Male,46,45-54,4
4,1,13,0,14,2020-06-17,Female,57,55-64,1
4,1,1,0,2,2020-06-16,Male,66,65-69,1
4,4,1,0,5,2020-06-16,Female,16,15-19,1
4,2,0,0,2,2020-06-22,Female,15,15-19,1
4,2,4,2,8,2020-06-16,Female,65,65-69,1
4,0,5,9,14,2020-06-12,Female,51,45-54,2
4,4,3,0,7,2020-06-16,Female,12,10-14,1
4,2,1,0,3,2020-06-16,Male,26,25-34,1
4,0,1,0,1,2020-06-15,Male,47,45-54,4
4,0,0,100,100,2020-06-17,Male,32,25-34,1
4,2,2,0,4,2020-06-16,Male,48,45-54,1
4,0,0,0,0,2020-06-14,Female,52,45-54,2
4,0,0,0,0,2020-06-15,Female,67,65-69,4
4,0,0,0,0,2020-06-16,Male,51,45-54,1
4,0,4,0,4,2020-06-17,Male,72,70-74,2
4,0,0,0,0,2020-06-17,Male,15,15-19,1
4,5,0,0,5,2020-06-17,Female,1,1-4,1
4,2,17,0,19,2020-06-18,Female,14,10-14,1
4,1,0,0,1,2020-06-17,Male,61,55-64,1
4,2,0,0,2,2020-06-16,Male,10,10-14,4
4,2,2,0,4,2020-06-17,Male,70,70-74,1
4,2,2,0,4,2020-06-16,Female,62,55-64,1
4,2,2,5,9,2020-06-16,Female,78,75-79,1
4,0,0,0,0,2020-06-16,Male,41,35-44,1
4,3,0,0,3,2020-06-16,Female,17,15-19,1
4,0,0,100,100,2020-06-16,Male,42,35-44,4
4,2,0,0,2,2020-06-12,Female,63,55-64,4
4,0,0,0,0,2020-06-17,Female,48,45-54,4
4,0,2,0,2,2020-06-16,Male,53,45-54,1
4,0,0,0,0,2020-06-13,Male,22,20-24,4
4,0,0,0,0,2020-06-11,Female,53,45-54,4
4,2,1,0,3,2020-06-16,Female,33,25-34,1
4,2,0,0,2,2020-06-15,Male,6,5-9,4
4,2,2,0,4,2020-06-15,Female,9,5-9,4
4,1,8,0,9,2020-06-16,Female,50,45-54,1
4,0,0,0,0,2020-06-18,Female,21,20-24,1
4,0,0,0,0,2020-06-15,Male,50,45-54,2
4,0,0,0,0,2020-06-16,Female,60,55-64,1
4,1,5,0,6,2020-06-16,Female,61,55-64,1
4,1,2,0,3,2020-06-17,Female,41,35-44,1
4,0,3,0,3,2020-06-17,Female,58,55-64,1
4,1,0,0,1,2020-06-12,Male,65,65-69,4
4,2,0,0,2,2020-06-19,Female,33,25-34,1
4,4,0,0,4,2020-06-14,Male,2,1-4,4
4,2,0,0,2,2020-06-17,Male,70,70-74,1
4,2,0,0,2,2020-06-15,Male,60,55-64,4
4,1,0,0,1,2020-06-12,Male,65,65-69,4
4,0,1,0,1,2020-06-17,Female,25,25-34,1
4,0,0,0,0,2020-06-18,Male,40,35-44,2
4,2,0,0,2,2020-06-16,Female,26,25-34,1
4,1,0,0,1,2020-06-16,Female,52,45-54,4
4,1,0,0,1,2020-06-13,Female,58,55-64,4
4,0,1,0,1,2020-06-18,Male,39,35-44,4
4,2,0,0,2,2020-06-16,Male,72,70-74,1
4,0,1,0,1,2020-06-18,Male,33,25-34,1
4,0,0,0,0,2020-06-18,Female,36,35-44,1
4,1,2,0,3,2020-06-17,Male,46,45-54,1
4,1,0,0,1,2020-06-14,Male,62,55-64,4
4,0,1,0,1,2020-06-17,Female,21,20-24,4
4,0,0,0,0,2020-06-17,Male,62,55-64,1
4,0,0,0,0,2020-06-16,Male,24,20-24,1
4,0,0,0,0,2020-06-16,Male,1,1-4,1
4,0,0,0,0,2020-06-12,Female,68,65-69,4
4,2,0,0,2,2020-06-16,Female,65,65-69,1
4,1,11,0,12,2020-06-16,Female,34,25-34,1
4,2,0,0,2,2020-06-14,Male,53,45-54,4
4,1,3,0,4,2020-06-16,Female,34,25-34,1
4,1,1,0,2,2020-06-16,Male,56,55-64,1
4,1,1,0,2,2020-06-12,Female,55,55-64,4
4,0,6,0,6,2020-06-12,Female,67,65-69,4
4,0,0,0,0,2020-06-16,Male,42,35-44,1
4,0,0,0,0,2020-06-19,Male,41,35-44,1
4,0,0,0,0,2020-06-12,Female,67,65-69,4
4,2,1,16,19,2020-06-15,Male,72,70-74,4
4,2,5,0,7,2020-06-12,Female,52,45-54,4
4,1,3,0,4,2020-06-16,Female,72,70-74,1
4,0,0,3,3,2020-06-16,Male,30,25-34,1
4,3,0,0,3,2020-06-13,Female,58,55-64,4
4,0,0,0,0,2020-06-16,Female,48,45-54,1
4,2,1,0,3,2020-06-22,Female,55,55-64,1
4,2,0,0,2,2020-06-16,Female,69,65-69,1
4,0,0,0,0,2020-06-14,Female,70,70-74,4
4,2,5,0,7,2020-06-16,Male,72,70-74,1
4,0,2,0,2,2020-06-15,Male,66,65-69,4
4,1,0,0,1,2020-06-15,Male,50,45-54,4
4,0,0,0,0,2020-06-12,Male,58,55-64,2
4,0,0,0,0,2020-06-22,Male,28,25-34,1
4,2,0,0,2,2020-06-19,Female,58,55-64,1
4,0,0,0,0,2020-06-16,Female,25,25-34,1
4,0,2,0,2,2020-06-16,Female,73,70-74,1
4,1,0,0,1,2020-06-16,Male,65,65-69,1
4,1,0,0,1,2020-06-15,Female,53,45-54,4
4,0,0,0,0,2020-06-22,Female,66,65-69,1
4,0,1,0,1,2020-06-16,Male,28,25-34,1
4,1,2,0,3,2020-06-13,Male,62,55-64,4
4,0,0,0,0,2020-06-11,Male,37,35-44,4
4,0,0,0,0,2020-06-16,Female,67,65-69,1
4,0,7,5,12,2020-06-12,Female,27,25-34,4
4,0,0,0,0,2020-06-15,Female,13,10-14,4
4,0,0,0,0,2020-06-15,Male,53,45-54,4
4,3,0,0,3,2020-06-13,Male,32,25-34,4
4,3,0,0,3,2020-06-18,Male,17,15-19,1
4,1,2,0,3,2020-06-18,Female,34,25-34,1
4,0,0,0,0,2020-06-12,Female,71,70-74,4
4,0,0,0,0,2020-06-15,Female,36,35-44,2
4,1,0,0,1,2020-06-17,Female,75,75-79,1
4,2,1,0,3,2020-06-17,Female,26,25-34,1
4,0,0,0,0,2020-06-20,Male,12,10-14,1
4,3,0,0,3,2020-06-17,Male,41,35-44,1
4,1,0,0,1,2020-06-15,Female,24,20-24,4
4,0,1,2,3,2020-06-20,Male,11,10-14,1
4,1,0,0,1,2020-06-15,Male,32,25-34,4
4,1,0,0,1,2020-06-16,Female,42,35-44,1
4,2,2,0,4,2020-06-12,Female,71,70-74,4
4,1,4,0,5,2020-06-16,Male,58,55-64,1
4,3,15,0,18,2020-06-16,Male,4,1-4,1
4,3,1,0,4,2020-06-15,Female,35,35-44,4
4,1,0,0,1,2020-06-16,Female,58,55-64,4
4,1,2,0,3,2020-06-12,Male,69,65-69,4
4,1,2,0,3,2020-06-17,Female,65,65-69,1
4,1,2,0,3,2020-06-16,Female,25,25-34,1
4,4,2,0,6,2020-06-17,Male,14,10-14,1
4,0,8,0,8,2020-06-12,Female,44,35-44,2
4,0,0,0,0,2020-06-13,Female,57,55-64,4
4,5,5,0,10,2020-06-17,Male,11,10-14,1
4,1,0,0,1,2020-06-17,Male,75,75-79,1
4,2,0,0,2,2020-06-16,Female,67,65-69,1
4,1,2,0,3,2020-06-16,Male,79,75-79,1
4,2,2,0,4,2020-06-16,Female,75,75-79,1
4,0,0,0,0,2020-06-16,Male,66,65-69,1
4,4,0,0,4,2020-06-16,Male,15,15-19,1
4,2,0,0,2,2020-06-16,Male,65,65-69,1
4,1,10,27,38,2020-06-13,Male,18,15-19,4
4,0,2,0,2,2020-06-15,Male,50,45-54,4
4,1,1,100,102,2020-06-16,Male,47,45-54,1
4,3,0,0,3,2020-06-12,Female,19,15-19,4
4,0,0,0,0,2020-06-12,Female,58,55-64,2
4,0,1,0,1,2020-06-13,Male,74,70-74,4
4,0,1,0,1,2020-06-12,Male,73,70-74,4
4,4,31,0,35,2020-06-21,Female,17,15-19,1
4,0,2,0,2,2020-06-14,Female,53,45-54,4
4,2,1,0,3,2020-06-16,Male,2,1-4,1
4,1,2,0,3,2020-06-21,Female,28,25-34,1
4,2,0,0,2,2020-06-16,Female,45,45-54,1
4,1,1,0,2,2020-06-16,Male,30,25-34,1
4,2,1,0,3,2020-06-16,Male,70,70-74,1
4,0,5,0,5,2020-06-16,Male,53,45-54,1
4,5,1,0,6,2020-06-16,Male,10,10-14,1
4,0,0,0,0,2020-06-13,Female,62,55-64,4
4,4,0,0,4,2020-06-18,Male,25,25-34,1
4,1,0,0,1,2020-06-20,Female,23,20-24,1
4,2,4,0,6,2020-06-13,Male,73,70-74,4
4,1,0,0,1,2020-06-12,Female,70,70-74,4
4,1,0,0,1,2020-06-18,Male,34,25-34,1
4,2,0,3,5,2020-06-16,Male,73,70-74,1
4,2,0,0,2,2020-06-16,Female,77,75-79,1
4,1,0,0,1,2020-06-15,Male,27,25-34,4
4,0,6,0,6,2020-06-16,Female,30,25-34,1
4,5,11,5,21,2020-06-16,Female,3,1-4,1
4,0,4,0,4,2020-06-12,Female,64,55-64,4
4,0,2,0,2,2020-06-12,Male,70,70-74,4
4,1,1,0,2,2020-06-18,Male,39,35-44,1
4,0,11,0,11,2020-06-11,Female,68,65-69,4
4,0,1,0,1,2020-06-12,Female,62,55-64,4
4,3,7,0,10,2020-06-16,Male,30,25-34,1
4,1,15,0,16,2020-06-16,Male,72,70-74,1
4,1,1,0,2,2020-06-16,Male,60,55-64,1
4,0,1,0,1,2020-06-12,Male,65,65-69,4
4,2,1,5,8,2020-06-18,Male,27,25-34,1
4,3,0,0,3,2020-06-16,Male,6,5-9,1
4,1,0,0,1,2020-06-16,Male,52,45-54,1
4,1,0,0,1,2020-06-16,Female,47,45-54,1
4,1,0,0,1,2020-06-12,Male,68,65-69,4
4,2,3,0,5,2020-06-16,Female,69,65-69,1
4,2,1,0,3,2020-06-12,Female,66,65-69,4
4,2,5,0,7,2020-06-13,Male,68,65-69,4
4,3,0,25,28,2020-06-17,Male,16,15-19,1
4,0,0,0,0,2020-06-16,Male,33,25-34,1
4,4,1,0,5,2020-06-17,Male,19,15-19,1
4,1,0,0,1,2020-06-16,Female,77,75-79,1
4,0,4,0,4,2020-06-12,Female,55,55-64,4
4,0,4,0,4,2020-06-13,Female,61,55-64,4
4,0,3,0,3,2020-06-15,Male,42,35-44,2
4,3,0,0,3,2020-06-12,Female,4,1-4,4
4,1,2,0,3,2020-06-16,Male,66,65-69,1
4,1,0,0,1,2020-06-12,Male,55,55-64,4
4,1,1,2,4,2020-06-16,Male,8,5-9,1
4,0,0,0,0,2020-06-16,Male,41,35-44,1
4,0,1,0,1,2020-06-12,Female,62,55-64,4
4,0,2,0,2,2020-06-17,Female,53,45-54,1
4,0,1,0,1,2020-06-22,Male,21,20-24,1
4,1,1,0,2,2020-06-16,Female,54,45-54,1
4,0,1,0,1,2020-06-12,Female,59,55-64,4
4,2,2,0,4,2020-06-16,Female,66,65-69,1
4,4,3,0,7,2020-06-16,Female,2,1-4,1
4,2,2,0,4,2020-06-17,Male,57,55-64,1
4,3,4,0,7,2020-06-19,Male,7,5-9,1
4,4,2,0,6,2020-06-16,Female,54,45-54,1
4,2,0,0,2,2020-06-17,Male,66,65-69,1
4,1,4,0,5,2020-06-14,Male,41,35-44,4
4,2,3,0,5,2020-06-16,Female,55,55-64,1
4,2,2,0,4,2020-06-12,Female,59,55-64,4
4,0,0,0,0,2020-06-15,Male,69,65-69,4
4,0,2,0,2,2020-06-13,Male,60,55-64,2
4,0,0,2,2,2020-06-12,Male,67,65-69,2
4,1,3,0,4,2020-06-17,Male,60,55-64,1
4,1,1,0,2,2020-06-18,Female,51,45-54,4
4,3,1,0,4,2020-06-16,Male,68,65-69,1
4,3,1,0,4,2020-06-16,Male,58,55-64,1
4,2,1,0,3,2020-06-16,Male,77,75-79,1
4,3,2,66,71,2020-06-16,Male,14,10-14,1
4,4,0,0,4,2020-06-17,Male,51,45-54,1
4,1,1,0,2,2020-06-14,Male,69,65-69,4
4,7,0,0,7,2020-06-16,Female,18,15-19,1
4,0,0,0,0,2020-06-16,Male,51,45-54,4
4,3,1,0,4,2020-06-13,Female,19,15-19,4
4,2,2,0,4,2020-06-12,Female,64,55-64,4
4,0,0,0,0,2020-06-15,Male,35,35-44,2
4,3,0,2,5,2020-06-17,Female,13,10-14,1
4,4,23,0,27,2020-06-18,Male,11,10-14,1
4,0,0,0,0,2020-06-15,Male,57,55-64,4
4,2,2,0,4,2020-06-16,Male,15,15-19,1
4,2,0,0,2,2020-06-17,Male,3,1-4,1
4,0,0,0,0,2020-06-11,Female,50,45-54,2
4,3,4,48,55,2020-06-17,Female,47,45-54,1
4,3,1,0,4,2020-06-17,Female,16,15-19,1
4,0,0,0,0,2020-06-16,Male,13,10-14,1
4,0,2,0,2,2020-06-17,Female,58,55-64,1
4,0,0,0,0,2020-06-16,Male,59,55-64,1
4,3,0,0,3,2020-06-16,Female,4,1-4,1
4,3,2,0,5,2020-06-16,Male,63,55-64,1
4,0,0,0,0,2020-06-15,Female,49,45-54,4
4,3,0,0,3,2020-06-16,Female,5,5-9,1
4,0,0,0,0,2020-06-22,Male,36,35-44,1
4,0,2,40,42,2020-06-13,Female,60,55-64,4
4,4,0,0,4,2020-06-18,Female,2,1-4,1
4,2,1,0,3,2020-06-17,Male,63,55-64,1
4,2,9,0,11,2020-06-16,Male,50,45-54,1
4,0,2,2,4,2020-06-16,Male,73,70-74,1
4,2,1,0,3,2020-06-12,Female,51,45-54,4
4,1,3,0,4,2020-06-11,Female,32,25-34,4
4,2,3,0,5,2020-06-17,Female,73,70-74,1
4,3,0,0,3,2020-06-12,Male,10,10-14,4
4,0,1,0,1,2020-06-12,Female,40,35-44,2
4,2,0,0,2,2020-06-16,Female,15,15-19,1
4,0,6,0,6,2020-06-17,Male,61,55-64,1
4,3,0,0,3,2020-06-22,Female,19,15-19,1
4,1,0,0,1,2020-06-18,Male,53,45-54,1
4,1,0,0,1,2020-06-16,Male,53,45-54,1
4,3,1,0,4,2020-06-18,Male,28,25-34,1
4,1,0,0,1,2020-06-16,Female,43,35-44,1
4,1,0,0,1,2020-06-16,Male,61,55-64,1
4,1,1,7,9,2020-06-12,Male,17,15-19,4
4,1,1,0,2,2020-06-17,Male,52,45-54,1
4,3,2,0,5,2020-06-22,Male,19,15-19,1
4,2,2,0,4,2020-06-16,Female,50,45-54,1
4,0,0,0,0,2020-06-13,Female,60,55-64,4
4,1,0,0,1,2020-06-13,Male,16,15-19,4
4,1,0,0,1,2020-06-15,Male,63,55-64,2
4,2,0,0,2,2020-06-18,Female,59,55-64,1
4,3,1,0,4,2020-06-16,Female,67,65-69,1
4,2,1,0,3,2020-06-22,Male,51,45-54,1
4,0,0,0,0,2020-06-15,Female,65,65-69,4
4,0,1,0,1,2020-06-16,Male,73,70-74,1
4,2,2,0,4,2020-06-13,Male,67,65-69,4
4,0,0,0,0,2020-06-14,Male,37,35-44,4
4,0,1,0,1,2020-06-17,Female,66,65-69,1
4,0,6,90,96,2020-06-22,Female,23,20-24,1
4,0,3,0,3,2020-06-16,Male,60,55-64,4
4,0,0,0,0,2020-06-16,Female,65,65-69,1
4,1,1,0,2,2020-06-13,Female,67,65-69,4
4,0,0,0,0,2020-06-17,Female,43,35-44,1
4,0,4,0,4,2020-06-12,Female,63,55-64,2
4,2,0,0,2,2020-06-11,Female,39,35-44,4
4,1,2,0,3,2020-06-16,Male,37,35-44,1
4,4,1,0,5,2020-06-16,Male,8,5-9,1
4,0,19,5,24,2020-06-18,Female,46,45-54,1
4,1,1,0,2,2020-06-13,Female,33,25-34,4
4,0,0,2,2,2020-06-13,Male,66,65-69,4
4,0,0,0,0,2020-06-15,Female,47,45-54,2
4,4,3,0,7,2020-06-16,Female,54,45-54,1
4,4,2,5,11,2020-06-16,Female,16,15-19,1
4,0,1,0,1,2020-06-16,Female,43,35-44,1
4,0,0,0,0,2020-06-16,Female,24,20-24,1
4,1,0,0,1,2020-06-16,Male,66,65-69,1
4,2,37,0,39,2020-06-17,Female,62,55-64,1
4,4,4,0,8,2020-06-16,Female,4,1-4,1
4,1,0,0,1,2020-06-14,Female,72,70-74,4
4,2,0,0,2,2020-06-16,Female,41,35-44,1
4,1,4,0,5,2020-06-16,Male,36,35-44,1
4,0,0,0,0,2020-06-15,Male,58,55-64,4
4,1,3,0,4,2020-06-17,Male,25,25-34,1
4,2,2,4,8,2020-06-12,Female,17,15-19,4
4,1,0,0,1,2020-06-12,Female,78,75-79,4
4,3,3,0,6,2020-06-16,Female,7,5-9,1
4,2,0,0,2,2020-06-16,Male,43,35-44,1
4,0,4,30,34,2020-06-17,Female,62,55-64,1
4,1,2,0,3,2020-06-14,Female,52,45-54,4
4,2,2,0,4,2020-06-12,Male,68,65-69,4
4,2,10,75,87,2020-06-12,Female,55,55-64,4
4,3,3,0,6,2020-06-17,Female,60,55-64,1
4,0,0,0,0,2020-06-16,Male,22,20-24,1
4,1,2,0,3,2020-06-18,Female,61,55-64,1
4,1,6,0,7,2020-06-16,Male,67,65-69,1
4,1,3,55,59,2020-06-12,Male,63,55-64,4
4,2,2,0,4,2020-06-12,Male,72,70-74,4
4,1,1,0,2,2020-06-12,Female,64,55-64,4
4,2,1,6,9,2020-06-16,Male,53,45-54,1
4,0,3,0,3,2020-06-13,Female,66,65-69,4
4,4,0,0,4,2020-06-17,Male,18,15-19,1
4,0,0,0,0,2020-06-16,Female,27,25-34,4
4,0,4,0,4,2020-06-17,Female,71,70-74,4
4,2,2,0,4,2020-06-13,Female,71,70-74,4
4,0,2,0,2,2020-06-16,Female,65,65-69,1
4,1,1,0,2,2020-06-13,Female,49,45-54,4
4,4,0,0,4,2020-06-13,Female,58,55-64,4
4,1,0,0,1,2020-06-16,Female,33,25-34,1
4,1,0,0,1,2020-06-16,Male,73,70-74,1
4,3,1,0,4,2020-06-18,Female,4,1-4,1
4,2,0,0,2,2020-06-16,Female,66,65-69,1
4,0,1,69,70,2020-06-12,Female,50,45-54,2
4,0,1,0,1,2020-06-15,Female,74,70-74,2
4,0,0,0,0,2020-06-15,Female,40,35-44,4
4,0,0,26,26,2020-06-13,Male,21,20-24,4
4,0,0,0,0,2020-06-12,Male,54,45-54,4
4,0,1,0,1,2020-06-16,Male,23,20-24,1
4,0,2,27,29,2020-06-15,Female,36,35-44,4
4,3,2,0,5,2020-06-12,Female,8,5-9,4
4,0,0,0,0,2020-06-16,Male,54,45-54,1
4,2,3,0,5,2020-06-13,Male,61,55-64,4
4,4,5,0,9,2020-06-16,Female,14,10-14,1
4,0,0,0,0,2020-06-15,Male,39,35-44,4
4,2,2,0,4,2020-06-22,Male,69,65-69,1
4,1,0,0,1,2020-06-16,Female,56,55-64,1
4,0,0,1,1,2020-06-12,Female,67,65-69,4
4,0,0,0,0,2020-06-16,Female,85,85+,1
4,0,0,0,0,2020-06-12,Female,70,70-74,4
4,2,2,0,4,2020-06-13,Male,73,70-74,4
4,1,1,0,2,2020-06-13,Female,65,65-69,4
4,0,4,0,4,2020-06-11,Female,33,25-34,4
4,1,2,0,3,2020-06-20,Male,30,25-34,1
4,0,0,6,6,2020-06-16,Female,36,35-44,1
4,0,7,0,7,2020-06-18,Female,37,35-44,1
4,0,0,0,0,2020-06-13,Male,67,65-69,4
4,2,3,0,5,2020-06-16,Female,60,55-64,1
4,3,1,40,44,2020-06-16,Female,11,10-14,1
4,0,0,0,0,2020-06-15,Male,66,65-69,4
4,0,6,43,49,2020-06-16,Male,19,15-19,1
4,1,0,0,1,2020-06-16,Female,60,55-64,4
4,3,0,0,3,2020-06-16,Male,27,25-34,1
4,2,2,0,4,2020-06-13,Male,66,65-69,4
4,3,0,0,3,2020-06-16,Female,10,10-14,1
4,3,2,0,5,2020-06-17,Female,10,10-14,1
4,2,5,0,7,2020-06-17,Male,70,70-74,1
4,5,4,1,10,2020-06-16,Female,50,45-54,1
4,3,5,0,8,2020-06-18,Male,5,5-9,1
4,3,2,0,5,2020-06-18,Female,11,10-14,4
4,1,0,0,1,2020-06-18,Male,43,35-44,1
4,4,2,0,6,2020-06-22,Female,4,1-4,1
4,2,0,2,4,2020-06-16,Male,25,25-34,1
4,2,2,0,4,2020-06-12,Male,69,65-69,4
4,1,11,50,62,2020-06-11,Male,65,65-69,4
4,1,0,0,1,2020-06-16,Male,66,65-69,1
4,0,0,0,0,2020-06-17,Male,31,25-34,1
4,1,0,0,1,2020-06-17,Male,74,70-74,1
4,4,0,0,4,2020-06-18,Female,10,10-14,1
4,0,0,0,0,2020-06-16,Female,36,35-44,1
4,0,0,0,0,2020-06-16,Male,77,75-79,2
4,3,1,0,4,2020-06-12,Female,64,55-64,4
4,2,0,0,2,2020-06-12,Female,66,65-69,4
4,1,2,0,3,2020-06-12,Female,75,75-79,4
4,0,0,0,0,2020-06-18,Female,36,35-44,4
4,2,1,0,3,2020-06-16,Female,44,35-44,1
4,2,0,0,2,2020-06-14,Male,32,25-34,4
4,3,0,0,3,2020-06-14,Male,18,15-19,4
4,0,7,0,7,2020-06-13,Female,59,55-64,2
4,0,0,0,0,2020-06-12,Female,58,55-64,2
4,2,0,0,2,2020-06-14,Female,22,20-24,4
4,0,1,0,1,2020-06-20,Male,34,25-34,1
4,0,3,0,3,2020-06-16,Male,62,55-64,1
4,3,5,0,8,2020-06-16,Male,16,15-19,1
4,0,0,0,0,2020-06-15,Male,70,70-74,2
4,1,0,0,1,2020-06-13,Female,63,55-64,4
4,1,1,0,2,2020-06-17,Male,22,20-24,1
4,0,0,0,0,2020-06-18,Male,55,55-64,1
4,0,0,0,0,2020-06-16,Female,10,10-14,4
4,0,0,0,0,2020-06-20,Male,26,25-34,1
4,1,2,0,3,2020-06-16,Female,65,65-69,1
4,4,0,0,4,2020-06-18,Male,11,10-14,1
4,2,0,0,2,2020-06-12,Male,53,45-54,4
4,6,5,0,11,2020-06-21,Female,10,10-14,1
4,0,0,0,0,2020-06-12,Male,77,75-79,2
4,0,1,1,2,2020-06-16,Male,38,35-44,1
4,0,0,0,0,2020-06-15,Female,51,45-54,4
4,3,2,0,5,2020-06-17,Male,11,10-14,1
4,2,0,0,2,2020-06-18,Male,58,55-64,1
4,2,0,0,2,2020-06-12,Male,62,55-64,4
4,0,1,0,1,2020-06-17,Female,37,35-44,1
4,3,4,0,7,2020-06-16,Female,21,20-24,1
4,2,5,0,7,2020-06-14,Female,66,65-69,4
4,0,1,0,1,2020-06-12,Male,52,45-54,4
4,0,0,0,0,2020-06-22,Male,29,25-34,1
4,0,1,0,1,2020-06-16,Male,51,45-54,1
4,0,0,0,0,2020-06-16,Male,27,25-34,1
4,0,0,0,0,2020-06-14,Female,43,35-44,4
4,1,3,47,51,2020-06-16,Male,67,65-69,1
4,1,4,0,5,2020-06-16,Female,61,55-64,1
4,2,1,0,3,2020-06-22,Female,30,25-34,1
4,1,6,0,7,2020-06-17,Male,32,25-34,1
4,0,6,0,6,2020-06-12,Male,63,55-64,4
4,1,5,2,8,2020-06-12,Female,52,45-54,4
4,0,5,0,5,2020-06-16,Female,24,20-24,1
4,2,4,6,12,2020-06-17,Male,24,20-24,1
4,0,0,0,0,2020-06-16,Male,53,45-54,1
4,0,0,0,0,2020-06-16,Male,74,70-74,1
4,1,0,0,1,2020-06-12,Female,48,45-54,4
4,1,3,0,4,2020-06-16,Male,23,20-24,1
4,3,1,24,28,2020-06-19,Male,19,15-19,1
4,0,4,0,4,2020-06-16,Female,72,70-74,1
4,0,0,0,0,2020-06-15,Female,63,55-64,4
4,4,1,1,6,2020-06-16,Female,11,10-14,1
4,1,1,6,8,2020-06-16,Male,65,65-69,4
4,2,4,0,6,2020-06-19,Female,31,25-34,1
4,4,3,0,7,2020-06-16,Male,6,5-9,1
4,0,0,0,0,2020-06-15,Female,30,25-34,2
4,2,2,0,4,2020-06-16,Male,39,35-44,1
4,0,0,0,0,2020-06-13,Male,33,25-34,4
4,0,0,0,0,2020-06-15,Male,46,45-54,4
4,1,2,0,3,2020-06-13,Male,61,55-64,4
4,0,0,0,0,2020-06-16,Female,68,65-69,1
4,1,0,0,1,2020-06-12,Male,67,65-69,4
4,0,0,0,0,2020-06-16,Female,0,<1,1
4,2,0,0,2,2020-06-15,Male,9,5-9,4
4,2,3,0,5,2020-06-22,Female,24,20-24,1
4,6,1,9,16,2020-06-17,Female,12,10-14,1
4,0,0,0,0,2020-06-13,Male,55,55-64,4
4,2,1,0,3,2020-06-16,Male,70,70-74,1
4,0,2,0,2,2020-06-14,Female,47,45-54,4
4,0,0,0,0,2020-06-18,Female,28,25-34,1
4,2,0,0,2,2020-06-15,Female,60,55-64,4
4,3,8,0,11,2020-06-16,Female,15,15-19,1
4,0,0,0,0,2020-06-16,Male,45,45-54,1
4,4,3,0,7,2020-06-16,Female,18,15-19,1
4,4,10,0,14,2020-06-17,Female,9,5-9,1
4,0,0,0,0,2020-06-12,Male,63,55-64,4
4,2,7,0,9,2020-06-16,Female,65,65-69,1
4,0,10,2,12,2020-06-21,Female,19,15-19,1
4,0,0,0,0,2020-06-16,Female,19,15-19,1
4,2,2,0,4,2020-06-16,Female,66,65-69,1
4,0,1,0,1,2020-06-16,Male,34,25-34,1
4,5,0,0,5,2020-06-18,Male,9,5-9,1
4,2,4,0,6,2020-06-16,Female,57,55-64,1
4,1,1,0,2,2020-06-17,Male,45,45-54,1
4,0,0,35,35,2020-06-16,Female,34,25-34,1
4,2,1,0,3,2020-06-16,Female,32,25-34,4
4,1,0,5,6,2020-06-13,Male,57,55-64,4
4,2,0,0,2,2020-06-12,Male,63,55-64,4
4,0,0,0,0,2020-06-12,Male,71,70-74,2
4,0,2,0,2,2020-06-11,Female,60,55-64,2
4,0,0,0,0,2020-06-22,Female,20,20-24,1
4,2,3,0,5,2020-06-13,Female,68,65-69,4
4,1,0,0,1,2020-06-12,Male,52,45-54,4
4,2,0,0,2,2020-06-16,Female,17,15-19,4
4,2,0,0,2,2020-06-16,Female,63,55-64,1
4,0,1,0,1,2020-06-17,Female,69,65-69,1
4,5,0,0,5,2020-06-17,Male,6,5-9,1
4,0,0,0,0,2020-06-12,Male,19,15-19,4
4,0,0,0,0,2020-06-16,Female,65,65-69,1
4,2,3,0,5,2020-06-16,Male,24,20-24,1
4,1,0,0,1,2020-06-16,Male,59,55-64,4
4,4,2,0,6,2020-06-21,Male,10,10-14,1
4,0,0,0,0,2020-06-16,Male,32,25-34,1
4,3,2,0,5,2020-06-18,Male,8,5-9,1
4,2,0,0,2,2020-06-16,Female,65,65-69,1
4,3,0,0,3,2020-06-17,Male,65,65-69,1
4,1,5,0,6,2020-06-15,Male,67,65-69,4
4,3,1,0,4,2020-06-18,Male,10,10-14,1
4,2,0,0,2,2020-06-12,Male,76,75-79,4
4,1,3,0,4,2020-06-11,Female,58,55-64,4
4,3,0,0,3,2020-06-18,Female,24,20-24,1
4,2,33,50,85,2020-06-21,Female,31,25-34,1
4,2,0,0,2,2020-06-22,Female,66,65-69,1
4,0,0,0,0,2020-06-12,Male,60,55-64,4
4,0,1,3,4,2020-06-11,Female,47,45-54,2
4,0,2,0,2,2020-06-20,Male,34,25-34,1
4,0,0,0,0,2020-06-12,Female,14,10-14,4
4,2,16,60,78,2020-06-22,Female,25,25-34,1
4,2,0,0,2,2020-06-16,Male,62,55-64,1
4,0,0,0,0,2020-06-12,Male,69,65-69,2
4,0,6,0,6,2020-06-13,Female,54,45-54,4
4,2,2,0,4,2020-06-17,Male,66,65-69,1
4,2,4,0,6,2020-06-17,Female,65,65-69,1
4,2,0,0,2,2020-06-16,Female,33,25-34,1
4,3,0,0,3,2020-06-14,Male,11,10-14,4
4,0,1,6,7,2020-06-16,Female,18,15-19,1
4,2,0,0,2,2020-06-17,Male,23,20-24,1
4,4,5,0,9,2020-06-22,Male,12,10-14,1
4,3,0,0,3,2020-06-20,Male,3,1-4,1
4,0,4,0,4,2020-06-14,Female,39,35-44,4
4,2,0,0,2,2020-06-16,Male,17,15-19,1
4,2,0,0,2,2020-06-17,Female,54,45-54,1
4,2,0,0,2,2020-06-16,Male,50,45-54,1
4,2,0,0,2,2020-06-17,Male,46,45-54,1
4,0,2,0,2,2020-06-16,Male,49,45-54,1
4,5,4,100,109,2020-06-18,Female,21,20-24,1
4,0,0,0,0,2020-06-21,Male,30,25-34,1
4,0,1,0,1,2020-06-16,Male,7,5-9,1
4,0,0,11,11,2020-06-12,Female,18,15-19,2
4,0,2,0,2,2020-06-16,Male,45,45-54,1
4,0,0,0,0,2020-06-12,Male,62,55-64,2
4,2,3,0,5,2020-06-17,Female,70,70-74,1
4,1,0,0,1,2020-06-16,Male,71,70-74,1
4,5,0,0,5,2020-06-20,Female,19,15-19,1
4,1,0,0,1,2020-06-16,Female,52,45-54,1
4,0,0,0,0,2020-06-11,Male,70,70-74,4
4,3,2,0,5,2020-06-17,Male,25,25-34,1
4,4,3,0,7,2020-06-16,Female,11,10-14,1
4,0,1,0,1,2020-06-13,Female,57,55-64,2
4,0,0,0,0,2020-06-16,Female,65,65-69,1
4,2,2,1,5,2020-06-16,Female,7,5-9,1
4,2,1,0,3,2020-06-12,Female,73,70-74,4
4,0,5,0,5,2020-06-15,Female,66,65-69,4
4,0,0,0,0,2020-06-17,Female,67,65-69,1
4,0,0,0,0,2020-06-13,Female,68,65-69,4
4,3,0,0,3,2020-06-17,Female,51,45-54,1
4,0,0,0,0,2020-06-20,Female,16,15-19,1
4,4,1,0,5,2020-06-14,Male,13,10-14,4
4,0,0,0,0,2020-06-18,Male,45,45-54,1
4,2,4,0,6,2020-06-16,Female,54,45-54,1
4,0,2,0,2,2020-06-12,Female,27,25-34,4
4,2,0,0,2,2020-06-15,Male,47,45-54,4
4,0,0,0,0,2020-06-12,Female,52,45-54,4
4,1,0,0,1,2020-06-12,Female,68,65-69,4
4,4,1,0,5,2020-06-20,Female,20,20-24,1
4,0,2,0,2,2020-06-12,Female,37,35-44,4
4,4,1,0,5,2020-06-21,Female,20,20-24,1
4,2,0,0,2,2020-06-13,Male,67,65-69,4
4,0,1,0,1,2020-06-16,Male,48,45-54,1
4,1,2,0,3,2020-06-16,Female,24,20-24,4
4,2,0,0,2,2020-06-16,Male,63,55-64,1
4,2,1,0,3,2020-06-18,Male,27,25-34,1
4,1,0,0,1,2020-06-16,Male,35,35-44,1
4,0,0,0,0,2020-06-12,Female,49,45-54,4
4,1,1,0,2,2020-06-13,Male,68,65-69,4
4,2,7,25,34,2020-06-17,Female,51,45-54,1
4,0,1,0,1,2020-06-15,Female,42,35-44,2
4,0,0,0,0,2020-06-17,Female,52,45-54,1
4,2,0,0,2,2020-06-13,Male,68,65-69,4
4,2,3,0,5,2020-06-17,Female,65,65-69,1
4,3,1,0,4,2020-06-12,Male,84,80-84,4
4,1,0,0,1,2020-06-15,Female,31,25-34,4
4,0,4,0,4,2020-06-12,Female,62,55-64,2
4,1,1,0,2,2020-06-12,Female,53,45-54,4
4,1,5,0,6,2020-06-16,Female,70,70-74,1
4,2,0,6,8,2020-06-17,Male,56,55-64,1
4,0,1,0,1,2020-06-12,Male,49,45-54,4
4,0,3,0,3,2020-06-16,Male,20,20-24,1
4,6,7,0,13,2020-06-17,Male,22,20-24,1
4,1,2,0,3,2020-06-16,Female,70,70-74,1
4,0,1,0,1,2020-06-17,Female,50,45-54,4
4,2,7,0,9,2020-06-22,Female,21,20-24,1
4,0,1,0,1,2020-06-13,Male,60,55-64,4
4,5,7,0,12,2020-06-16,Female,5,5-9,1
4,1,3,0,4,2020-06-18,Female,37,35-44,1
4,2,0,2,4,2020-06-11,Male,54,45-54,4
4,2,0,0,2,2020-06-13,Male,65,65-69,4
4,1,0,0,1,2020-06-16,Female,56,55-64,1
4,0,0,0,0,2020-06-15,Female,30,25-34,4
4,2,0,0,2,2020-06-13,Female,79,75-79,4
4,0,3,0,3,2020-06-22,Female,20,20-24,1
4,0,0,0,0,2020-06-12,Female,69,65-69,4
4,1,1,0,2,2020-06-12,Male,70,70-74,4
4,3,1,0,4,2020-06-20,Female,21,20-24,1
4,0,5,0,5,2020-06-11,Male,60,55-64,4
4,0,0,0,0,2020-06-16,Male,73,70-74,1
4,4,0,0,4,2020-06-15,Female,6,5-9,4
4,4,0,1,5,2020-06-20,Male,14,10-14,1
4,0,0,0,0,2020-06-18,Male,33,25-34,4
4,1,1,0,2,2020-06-18,Male,15,15-19,1
4,3,0,0,3,2020-06-17,Male,1,1-4,1
4,4,0,0,4,2020-06-16,Male,19,15-19,1
5,2,0,0,2,2020-06-30,Female,69,65-69,2
5,0,4,0,4,2020-06-28,Male,66,65-69,5
5,1,0,0,1,2020-07-01,Female,65,65-69,5
5,0,0,0,0,2020-06-29,Female,19,15-19,2
5,0,0,0,0,2020-06-29,Female,71,70-74,3
5,0,0,0,0,2020-06-28,Female,33,25-34,5
5,0,1,1,2,2020-06-26,Female,50,45-54,2
5,1,1,0,2,2020-06-27,Female,71,70-74,5
5,0,1,0,1,2020-06-29,Male,29,25-34,2
5,0,0,0,0,2020-06-27,Female,53,45-54,2
5,0,0,0,0,2020-06-29,Female,67,65-69,2
5,0,3,32,35,2020-06-26,Female,56,55-64,5
5,3,0,0,3,2020-06-29,Male,34,25-34,5
5,3,0,0,3,2020-06-30,Male,6,5-9,5
5,1,0,0,1,2020-06-30,Female,59,55-64,5
5,1,4,0,5,2020-06-29,Female,60,55-64,3
5,0,0,0,0,2020-06-30,Male,50,45-54,4
5,0,0,0,0,2020-06-29,Male,67,65-69,5
5,1,0,0,1,2020-06-26,Male,50,45-54,2
5,2,2,0,4,2020-06-28,Male,34,25-34,2
5,2,0,0,2,2020-06-26,Female,7,5-9,5
5,0,0,0,0,2020-06-26,Male,32,25-34,4
5,1,4,0,5,2020-06-27,Male,66,65-69,2
5,1,0,0,1,2020-06-26,Male,62,55-64,5
5,1,0,0,1,2020-06-26,Male,12,10-14,2
5,1,1,1,3,2020-06-27,Male,18,15-19,5
5,0,2,0,2,2020-06-26,Male,48,45-54,2
5,2,1,0,3,2020-06-28,Male,58,55-64,3
5,1,2,0,3,2020-06-29,Male,34,25-34,2
5,2,2,0,4,2020-06-29,Female,70,70-74,5
5,1,0,0,1,2020-06-30,Male,67,65-69,5
5,4,0,0,4,2020-06-26,Male,20,20-24,2
5,0,2,0,2,2020-06-30,Male,56,55-64,5
5,2,0,0,2,2020-06-28,Female,52,45-54,2
5,2,1,0,3,2020-06-29,Female,68,65-69,5
5,0,0,0,0,2020-06-26,Male,41,35-44,5
5,0,1,0,1,2020-06-30,Male,58,55-64,5
5,1,0,0,1,2020-06-29,Female,56,55-64,5
5,2,0,0,2,2020-06-30,Male,51,45-54,5
5,0,0,0,0,2020-06-29,Male,85,85+,5
5,0,1,0,1,2020-07-01,Female,68,65-69,4
5,0,7,0,7,2020-07-01,Female,66,65-69,2
5,2,0,0,2,2020-06-28,Male,0,<1,2
5,0,1,0,1,2020-06-29,Male,53,45-54,5
5,1,0,0,1,2020-06-29,Male,57,55-64,5
5,0,0,0,0,2020-06-26,Male,67,65-69,5
5,1,0,0,1,2020-06-29,Female,22,20-24,2
5,0,0,0,0,2020-06-26,Male,57,55-64,2
5,1,0,0,1,2020-06-27,Male,71,70-74,2
5,0,5,0,5,2020-06-28,Male,76,75-79,5
5,2,0,0,2,2020-06-26,Male,71,70-74,5
5,2,5,0,7,2020-06-28,Male,43,35-44,2
5,0,0,0,0,2020-06-26,Male,51,45-54,5
5,0,0,0,0,2020-06-29,Male,36,35-44,2
5,0,0,0,0,2020-06-30,Male,52,45-54,2
5,1,0,0,1,2020-06-27,Male,43,35-44,2
5,0,1,0,1,2020-06-29,Female,74,70-74,5
5,1,0,0,1,2020-06-27,Female,59,55-64,5
5,3,0,0,3,2020-06-28,Male,0,<1,2
5,2,0,0,2,2020-06-28,Male,34,25-34,5
5,1,0,0,1,2020-06-29,Male,38,35-44,2
5,2,10,0,12,2020-06-30,Male,69,65-69,3
5,1,1,0,2,2020-06-29,Female,76,75-79,5
5,2,0,0,2,2020-06-30,Female,55,55-64,2
5,2,0,0,2,2020-06-29,Male,66,65-69,4
5,1,0,0,1,2020-06-29,Female,67,65-69,3
5,0,5,0,5,2020-06-30,Female,51,45-54,2
5,1,1,0,2,2020-06-29,Male,38,35-44,4
5,1,6,0,7,2020-06-26,Male,62,55-64,2
5,3,1,2,6,2020-06-26,Female,12,10-14,2
5,0,0,0,0,2020-07-01,Male,72,70-74,2
5,0,0,0,0,2020-06-29,Male,85,85+,2
5,1,8,0,9,2020-06-27,Male,44,35-44,5
5,2,3,0,5,2020-06-28,Male,54,45-54,5
5,0,3,0,3,2020-06-27,Male,31,25-34,2
5,1,0,0,1,2020-06-26,Male,70,70-74,2
5,2,0,0,2,2020-06-29,Female,70,70-74,4
5,2,4,0,6,2020-06-28,Male,66,65-69,2
5,1,3,0,4,2020-06-26,Female,65,65-69,5
5,2,0,0,2,2020-06-26,Male,69,65-69,5
5,2,1,0,3,2020-06-27,Male,68,65-69,2
5,2,0,0,2,2020-06-27,Male,33,25-34,2
5,1,0,0,1,2020-06-29,Male,67,65-69,4
5,3,0,2,5,2020-06-30,Female,17,15-19,3
5,1,0,0,1,2020-06-28,Male,42,35-44,2
5,0,0,0,0,2020-06-29,Female,5,5-9,4
5,0,1,0,1,2020-07-01,Female,54,45-54,3
5,2,0,0,2,2020-07-01,Male,32,25-34,2
5,1,8,0,9,2020-06-28,Male,69,65-69,5
5,4,0,0,4,2020-06-29,Female,4,1-4,3
5,2,2,0,4,2020-06-27,Male,37,35-44,3
5,4,0,0,4,2020-06-30,Female,17,15-19,3
5,2,0,0,2,2020-06-26,Female,60,55-64,5
5,5,0,0,5,2020-06-29,Male,14,10-14,4
5,1,0,0,1,2020-06-27,Male,48,45-54,5
5,1,2,0,3,2020-06-29,Male,21,20-24,2
5,1,3,0,4,2020-06-30,Male,69,65-69,2
5,1,9,0,10,2020-06-26,Female,66,65-69,2
5,2,1,0,3,2020-06-29,Female,26,25-34,2
5,1,5,0,6,2020-06-28,Female,62,55-64,4
5,0,1,9,10,2020-06-26,Female,2,1-4,2
5,0,0,0,0,2020-06-28,Female,28,25-34,3
5,1,2,0,3,2020-06-28,Male,74,70-74,2
5,2,0,0,2,2020-06-29,Female,67,65-69,2
5,2,3,0,5,2020-06-30,Male,17,15-19,2
5,0,0,0,0,2020-06-27,Female,62,55-64,4
5,4,0,0,4,2020-06-29,Male,16,15-19,2
5,0,2,0,2,2020-06-27,Male,67,65-69,2
5,0,5,0,5,2020-06-30,Male,54,45-54,2
5,2,0,0,2,2020-06-26,Female,65,65-69,5
5,0,0,0,0,2020-06-26,Male,33,25-34,2
5,1,4,0,5,2020-06-26,Male,57,55-64,3
5,0,0,0,0,2020-06-27,Female,72,70-74,5
5,0,0,0,0,2020-06-26,Male,32,25-34,5
5,0,0,3,3,2020-07-01,Male,65,65-69,2
5,0,2,0,2,2020-06-26,Male,27,25-34,2
5,0,0,0,0,2020-07-01,Female,30,25-34,2
5,0,0,0,0,2020-06-26,Female,5,5-9,2
5,2,6,0,8,2020-06-26,Female,32,25-34,2
5,0,1,0,1,2020-06-26,Male,36,35-44,4
5,0,4,0,4,2020-06-30,Female,61,55-64,3
5,0,1,0,1,2020-06-27,Female,57,55-64,5
5,1,0,0,1,2020-06-29,Male,65,65-69,2
5,0,2,0,2,2020-06-28,Female,25,25-34,2
5,0,1,0,1,2020-06-29,Male,68,65-69,2
5,2,0,0,2,2020-06-26,Male,58,55-64,5
5,0,1,0,1,2020-06-27,Male,25,25-34,2
5,2,0,1,3,2020-06-30,Female,41,35-44,2
5,0,0,0,0,2020-06-30,Female,62,55-64,2
5,3,1,55,59,2020-06-29,Female,68,65-69,3
5,0,1,0,1,2020-06-30,Male,50,45-54,5
5,0,1,0,1,2020-06-26,Male,69,65-69,2
5,3,0,0,3,2020-06-26,Male,31,25-34,2
5,2,0,0,2,2020-06-29,Male,35,35-44,4
5,0,1,0,1,2020-06-29,Female,53,45-54,5
5,2,0,0,2,2020-06-29,Male,69,65-69,2
5,0,0,0,0,2020-06-27,Male,19,15-19,2
5,3,0,0,3,2020-06-26,Female,10,10-14,2
5,1,0,0,1,2020-07-01,Male,65,65-69,4
5,1,2,0,3,2020-06-29,Female,78,75-79,5
5,2,2,0,4,2020-06-28,Male,56,55-64,5
5,0,1,0,1,2020-06-27,Male,17,15-19,2
5,1,0,0,1,2020-06-29,Female,28,25-34,4
5,2,3,16,21,2020-06-26,Female,66,65-69,3
5,3,0,0,3,2020-06-26,Male,22,20-24,2
5,1,0,0,1,2020-06-29,Female,56,55-64,2
5,0,1,0,1,2020-06-26,Female,50,45-54,3
5,1,0,0,1,2020-07-01,Male,52,45-54,5
5,0,0,0,0,2020-06-26,Male,56,55-64,5
5,2,1,10,13,2020-06-29,Male,70,70-74,2
5,2,2,0,4,2020-06-27,Male,18,15-19,5
5,1,0,0,1,2020-06-26,Female,51,45-54,5
5,4,0,0,4,2020-06-27,Male,28,25-34,2
5,3,0,11,14,2020-06-29,Male,0,<1,2
5,4,0,0,4,2020-06-28,Male,5,5-9,2
5,3,2,0,5,2020-06-26,Male,65,65-69,3
5,0,0,0,0,2020-06-27,Male,67,65-69,5
5,1,0,0,1,2020-06-26,Male,65,65-69,3
5,0,0,0,0,2020-06-26,Female,23,20-24,2
5,0,4,0,4,2020-06-26,Female,65,65-69,5
5,0,0,0,0,2020-06-28,Female,41,35-44,2
5,1,1,0,2,2020-06-30,Female,59,55-64,5
5,0,0,0,0,2020-06-30,Female,65,65-69,2
5,0,0,0,0,2020-06-26,Male,70,70-74,5
5,2,2,0,4,2020-06-30,Male,31,25-34,2
5,0,1,0,1,2020-06-30,Female,71,70-74,5
5,1,1,0,2,2020-06-29,Male,73,70-74,5
5,1,0,9,10,2020-06-28,Female,1,1-4,1
5,2,1,0,3,2020-06-29,Female,65,65-69,5
5,2,0,0,2,2020-06-27,Female,30,25-34,2
5,0,0,0,0,2020-06-28,Male,38,35-44,5
5,1,2,0,3,2020-06-30,Female,54,45-54,5
5,2,0,0,2,2020-07-01,Male,33,25-34,2
5,0,0,1,1,2020-06-27,Male,53,45-54,2
5,1,0,0,1,2020-06-30,Male,50,45-54,5
5,1,3,100,104,2020-06-26,Female,49,45-54,2
5,0,0,0,0,2020-06-26,Female,21,20-24,2
5,1,9,0,10,2020-06-27,Female,28,25-34,2
5,2,2,0,4,2020-06-26,Male,17,15-19,2
5,2,0,0,2,2020-06-29,Female,68,65-69,2
5,2,0,0,2,2020-06-26,Male,65,65-69,5
5,1,0,0,1,2020-06-29,Male,64,55-64,2
5,0,1,0,1,2020-06-29,Male,68,65-69,5
5,1,1,0,2,2020-06-26,Male,52,45-54,5
5,1,0,0,1,2020-06-30,Female,57,55-64,4
5,3,0,0,3,2020-06-29,Male,14,10-14,5
5,2,2,0,4,2020-06-29,Female,58,55-64,2
5,0,1,0,1,2020-06-27,Female,25,25-34,2
5,0,1,0,1,2020-06-26,Male,70,70-74,5
5,2,0,1,3,2020-06-27,Female,69,65-69,5
5,0,5,0,5,2020-06-29,Male,37,35-44,2
5,0,0,0,0,2020-06-26,Male,19,15-19,2
5,2,0,2,4,2020-06-28,Female,72,70-74,2
5,0,0,0,0,2020-06-27,Female,56,55-64,5
5,1,0,0,1,2020-06-29,Female,59,55-64,5
5,0,0,0,0,2020-06-30,Male,43,35-44,5
5,2,1,0,3,2020-07-01,Male,62,55-64,2
5,2,1,0,3,2020-06-30,Female,62,55-64,5
5,2,0,0,2,2020-06-28,Male,31,25-34,4
5,0,3,0,3,2020-06-29,Female,22,20-24,2
5,2,0,0,2,2020-06-29,Male,73,70-74,5
5,0,4,0,4,2020-06-27,Female,68,65-69,5
5,1,10,0,11,2020-06-26,Male,44,35-44,5
5,2,6,0,8,2020-06-26,Female,52,45-54,4
5,2,4,0,6,2020-06-26,Male,68,65-69,5
5,2,1,0,3,2020-06-30,Male,10,10-14,2
5,0,0,0,0,2020-06-29,Male,33,25-34,4
5,1,0,0,1,2020-06-30,Male,47,45-54,2
5,3,3,0,6,2020-06-29,Male,69,65-69,2
5,2,3,0,5,2020-06-26,Male,65,65-69,5
5,2,3,0,5,2020-06-27,Male,65,65-69,3
5,3,1,0,4,2020-06-30,Male,7,5-9,2
5,2,0,0,2,2020-06-29,Male,67,65-69,5
5,4,2,0,6,2020-06-29,Female,3,1-4,2
5,0,4,0,4,2020-06-30,Male,61,55-64,5
5,2,2,0,4,2020-07-01,Male,70,70-74,4
5,1,0,0,1,2020-06-29,Female,56,55-64,4
5,0,0,0,0,2020-06-27,Female,58,55-64,2
5,0,1,0,1,2020-06-26,Female,66,65-69,5
5,1,0,0,1,2020-06-27,Female,40,35-44,5
5,0,0,0,0,2020-06-30,Male,44,35-44,5
5,0,0,0,0,2020-06-27,Female,66,65-69,5
5,0,0,0,0,2020-07-01,Female,66,65-69,3
5,0,2,0,2,2020-06-26,Female,63,55-64,3
5,3,0,0,3,2020-06-26,Male,18,15-19,2
5,0,0,91,91,2020-06-30,Female,10,10-14,5
5,1,3,0,4,2020-06-28,Female,60,55-64,5
5,0,1,0,1,2020-06-26,Male,34,25-34,2
5,1,4,0,5,2020-07-01,Male,61,55-64,4
5,0,0,0,0,2020-06-29,Male,47,45-54,5
5,1,0,0,1,2020-06-30,Male,60,55-64,2
5,3,1,0,4,2020-06-27,Male,19,15-19,2
5,1,0,0,1,2020-06-30,Female,53,45-54,5
5,0,1,0,1,2020-06-30,Male,55,55-64,2
5,0,0,0,0,2020-06-26,Female,65,65-69,5
5,1,1,0,2,2020-06-26,Male,19,15-19,3
5,1,0,0,1,2020-06-29,Male,72,70-74,5
5,0,1,0,1,2020-06-29,Female,21,20-24,2
5,3,0,0,3,2020-06-29,Female,5,5-9,2
5,3,0,0,3,2020-06-30,Male,5,5-9,2
5,2,0,0,2,2020-06-29,Male,78,75-79,2
5,0,1,0,1,2020-06-26,Female,66,65-69,2
5,3,1,6,10,2020-06-30,Male,38,35-44,3
5,3,4,0,7,2020-06-30,Female,16,15-19,2
5,0,0,0,0,2020-06-26,Female,55,55-64,5
5,1,1,0,2,2020-06-28,Male,48,45-54,3
5,1,0,0,1,2020-06-27,Male,68,65-69,5
5,1,0,0,1,2020-06-29,Female,31,25-34,3
5,0,1,0,1,2020-06-26,Male,36,35-44,5
5,3,4,4,11,2020-06-30,Female,49,45-54,2
5,2,0,0,2,2020-06-26,Male,65,65-69,2
5,2,2,0,4,2020-06-29,Male,39,35-44,5
5,2,0,0,2,2020-06-26,Female,60,55-64,2
5,0,31,0,31,2020-06-28,Male,32,25-34,3
5,2,0,0,2,2020-06-30,Male,61,55-64,5
5,1,3,0,4,2020-06-29,Female,69,65-69,5
5,1,1,0,2,2020-06-29,Male,67,65-69,2
5,0,1,0,1,2020-06-29,Male,2,1-4,2
5,1,0,2,3,2020-06-28,Female,33,25-34,4
5,1,0,1,2,2020-06-29,Male,72,70-74,3
5,0,3,0,3,2020-06-29,Male,68,65-69,5
5,0,0,0,0,2020-06-29,Male,36,35-44,2
5,0,0,0,0,2020-06-26,Male,28,25-34,5
5,1,0,35,36,2020-06-27,Male,15,15-19,2
5,0,0,0,0,2020-06-26,Male,7,5-9,2
5,3,11,0,14,2020-07-01,Male,7,5-9,4
5,0,0,0,0,2020-06-29,Male,76,75-79,2
5,0,0,0,0,2020-06-29,Female,60,55-64,4
5,0,2,1,3,2020-06-30,Male,46,45-54,2
5,1,2,0,3,2020-06-29,Male,52,45-54,2
5,0,2,0,2,2020-06-28,Female,70,70-74,2
5,3,0,0,3,2020-06-26,Male,69,65-69,2
5,4,0,0,4,2020-06-29,Female,68,65-69,5
5,3,0,3,6,2020-07-01,Male,19,15-19,2
5,2,0,0,2,2020-06-26,Male,64,55-64,3
5,0,1,0,1,2020-06-30,Male,49,45-54,5
5,0,0,0,0,2020-06-27,Female,83,80-84,4
5,2,3,0,5,2020-06-26,Female,66,65-69,2
5,2,2,0,4,2020-06-30,Male,75,75-79,5
5,1,0,0,1,2020-06-26,Male,52,45-54,2
5,0,0,0,0,2020-06-26,Female,60,55-64,2
5,0,0,0,0,2020-06-26,Male,17,15-19,2
5,2,0,0,2,2020-06-28,Female,64,55-64,2
5,4,4,0,8,2020-07-01,Male,21,20-24,2
5,1,0,0,1,2020-06-26,Male,66,65-69,5
5,0,0,0,0,2020-06-26,Male,64,55-64,5
5,0,1,0,1,2020-06-29,Female,73,70-74,5
5,0,0,0,0,2020-06-26,Male,67,65-69,5
5,0,0,2,2,2020-07-01,Male,39,35-44,2
5,2,0,0,2,2020-06-26,Male,74,70-74,5
5,4,0,0,4,2020-06-26,Female,5,5-9,2
5,0,1,0,1,2020-06-26,Male,65,65-69,2
5,1,1,0,2,2020-06-28,Female,43,35-44,2
5,3,3,0,6,2020-06-29,Male,3,1-4,2
5,0,0,0,0,2020-06-30,Male,52,45-54,5
5,3,0,0,3,2020-06-26,Female,17,15-19,2
5,0,0,0,0,2020-06-26,Female,46,45-54,2
5,0,0,0,0,2020-06-30,Female,60,55-64,2
5,3,1,0,4,2020-06-26,Male,13,10-14,5
5,0,0,0,0,2020-06-30,Female,51,45-54,5
5,0,0,0,0,2020-06-30,Female,46,45-54,2
5,4,0,0,4,2020-06-30,Male,14,10-14,5
5,0,1,0,1,2020-06-27,Female,59,55-64,5
5,0,0,0,0,2020-06-27,Male,13,10-14,5
5,2,2,2,6,2020-06-29,Male,81,80-84,5
5,1,0,0,1,2020-06-28,Female,58,55-64,2
5,0,1,0,1,2020-06-30,Female,7,5-9,2
5,2,2,5,9,2020-06-29,Male,59,55-64,3
5,2,0,0,2,2020-06-28,Female,48,45-54,5
5,2,0,0,2,2020-06-30,Female,52,45-54,5
5,0,1,0,1,2020-06-27,Male,26,25-34,2
5,0,0,0,0,2020-06-30,Male,19,15-19,4
5,2,1,0,3,2020-06-27,Male,70,70-74,5
5,0,0,0,0,2020-06-29,Male,34,25-34,5
5,0,5,0,5,2020-06-28,Male,27,25-34,2
5,3,4,0,7,2020-06-30,Female,21,20-24,2
5,2,1,0,3,2020-06-28,Female,23,20-24,5
5,1,3,0,4,2020-06-27,Female,66,65-69,2
5,0,0,0,0,2020-06-29,Male,23,20-24,5
5,0,0,0,0,2020-07-01,Female,1,1-4,4
5,0,0,0,0,2020-06-29,Male,67,65-69,5
5,1,3,0,4,2020-06-26,Male,62,55-64,3
5,2,0,0,2,2020-06-29,Male,21,20-24,2
5,2,1,0,3,2020-06-26,Male,41,35-44,5
5,1,0,9,10,2020-06-27,Male,65,65-69,5
5,0,1,0,1,2020-06-29,Male,70,70-74,2
5,0,4,0,4,2020-06-29,Female,85,85+,4
5,2,0,0,2,2020-06-26,Male,58,55-64,3
5,0,1,0,1,2020-06-30,Male,50,45-54,3
5,0,0,0,0,2020-06-27,Male,75,75-79,5
5,1,2,0,3,2020-06-29,Male,79,75-79,5
5,0,0,0,0,2020-07-01,Male,32,25-34,3
5,2,0,0,2,2020-06-29,Male,53,45-54,5
5,0,3,0,3,2020-06-29,Male,51,45-54,5
5,2,4,4,10,2020-06-26,Female,68,65-69,2
5,3,4,0,7,2020-06-26,Male,64,55-64,2
5,1,0,1,2,2020-06-26,Male,63,55-64,2
5,0,1,0,1,2020-06-26,Female,66,65-69,5
5,3,0,0,3,2020-06-30,Male,14,10-14,2
5,0,0,0,0,2020-06-28,Female,25,25-34,5
5,0,1,0,1,2020-06-28,Female,68,65-69,4
5,2,2,2,6,2020-06-27,Female,77,75-79,5
5,0,0,0,0,2020-06-28,Female,66,65-69,2
5,0,0,1,1,2020-06-28,Male,23,20-24,3
5,0,1,0,1,2020-06-26,Female,63,55-64,2
5,1,0,0,1,2020-06-28,Male,68,65-69,5
5,3,8,37,48,2020-06-26,Male,53,45-54,3
5,0,1,0,1,2020-06-30,Male,58,55-64,4
5,2,0,0,2,2020-06-26,Female,10,10-14,4
5,0,1,0,1,2020-06-27,Male,29,25-34,5
5,0,3,0,3,2020-06-30,Male,53,45-54,3
5,0,4,0,4,2020-06-28,Female,71,70-74,3
5,0,0,0,0,2020-06-27,Female,8,5-9,4
5,3,1,0,4,2020-06-30,Female,52,45-54,2
5,2,0,0,2,2020-06-27,Female,65,65-69,5
5,2,2,0,4,2020-06-27,Female,78,75-79,5
5,2,12,0,14,2020-06-27,Female,27,25-34,2
5,0,1,0,1,2020-06-30,Male,53,45-54,5
5,0,0,0,0,2020-06-26,Male,65,65-69,5
5,1,1,0,2,2020-06-29,Female,69,65-69,5
5,0,0,0,0,2020-06-26,Female,75,75-79,5
5,4,1,0,5,2020-06-30,Male,36,35-44,2
5,4,1,0,5,2020-06-29,Female,14,10-14,4
5,0,1,0,1,2020-06-29,Male,60,55-64,3
5,2,0,0,2,2020-06-29,Female,50,45-54,3
5,0,0,0,0,2020-06-28,Female,54,45-54,5
5,1,4,0,5,2020-06-26,Male,51,45-54,2
5,1,0,0,1,2020-06-26,Male,68,65-69,5
5,2,1,0,3,2020-06-30,Male,56,55-64,2
5,2,2,0,4,2020-06-28,Female,54,45-54,2
5,0,0,0,0,2020-06-29,Female,39,35-44,4
5,2,3,0,5,2020-06-27,Male,61,55-64,2
5,0,0,0,0,2020-07-01,Female,26,25-34,2
5,0,1,0,1,2020-06-27,Female,65,65-69,2
5,0,4,0,4,2020-06-26,Female,65,65-69,5
5,0,1,0,1,2020-06-30,Male,20,20-24,2
5,1,3,0,4,2020-06-27,Female,60,55-64,2
5,0,3,0,3,2020-06-29,Male,51,45-54,3
5,2,0,0,2,2020-06-28,Male,71,70-74,3
5,0,0,0,0,2020-06-29,Male,73,70-74,4
5,4,3,0,7,2020-06-27,Female,14,10-14,5
5,4,2,0,6,2020-06-26,Female,13,10-14,4
5,1,6,0,7,2020-06-26,Male,29,25-34,3
5,1,1,0,2,2020-06-26,Female,69,65-69,5
5,0,1,0,1,2020-06-29,Male,18,15-19,2
5,3,1,2,6,2020-06-29,Female,13,10-14,2
5,0,2,0,2,2020-07-01,Female,65,65-69,2
5,1,0,0,1,2020-06-26,Female,26,25-34,5
5,2,1,0,3,2020-07-01,Male,75,75-79,5
5,1,3,0,4,2020-06-30,Female,52,45-54,5
5,1,5,0,6,2020-06-29,Male,73,70-74,5
5,2,0,0,2,2020-06-26,Male,52,45-54,3
5,0,6,0,6,2020-06-30,Male,37,35-44,2
5,0,0,0,0,2020-06-26,Male,30,25-34,2
5,2,9,0,11,2020-06-30,Female,29,25-34,2
5,0,1,1,2,2020-06-26,Female,20,20-24,4
5,1,0,0,1,2020-06-30,Female,22,20-24,3
5,4,10,0,14,2020-06-27,Male,62,55-64,5
5,2,4,0,6,2020-07-01,Male,29,25-34,5
5,0,4,0,4,2020-06-30,Male,56,55-64,2
5,1,10,0,11,2020-06-26,Male,63,55-64,2
5,4,0,0,4,2020-06-29,Female,12,10-14,2
5,2,0,0,2,2020-06-28,Male,54,45-54,5
5,0,0,0,0,2020-06-30,Male,60,55-64,2
5,0,0,0,0,2020-06-26,Female,8,5-9,3
5,0,5,0,5,2020-06-27,Female,65,65-69,5
5,2,0,6,8,2020-06-29,Male,72,70-74,2
5,2,0,9,11,2020-06-29,Male,72,70-74,2
5,1,20,0,21,2020-06-27,Male,65,65-69,5
5,2,10,0,12,2020-06-27,Female,52,45-54,5
5,4,0,0,4,2020-06-26,Female,44,35-44,2
5,0,1,0,1,2020-06-29,Female,71,70-74,5
5,0,0,0,0,2020-06-30,Male,29,25-34,4
5,0,1,0,1,2020-06-29,Male,67,65-69,5
5,0,6,0,6,2020-06-26,Female,56,55-64,5
5,0,0,0,0,2020-06-29,Male,67,65-69,2
5,0,0,0,0,2020-07-01,Female,85,85+,5
5,0,0,0,0,2020-06-30,Male,51,45-54,4
5,4,0,0,4,2020-06-26,Female,9,5-9,4
5,3,0,10,13,2020-06-26,Male,3,1-4,2
5,2,4,0,6,2020-06-29,Male,66,65-69,5
5,0,3,0,3,2020-06-26,Female,68,65-69,2
5,2,0,0,2,2020-06-30,Male,50,45-54,4
5,1,3,0,4,2020-06-29,Female,69,65-69,2
5,0,0,0,0,2020-06-28,Female,29,25-34,2
5,0,2,0,2,2020-06-26,Male,45,45-54,4
5,0,0,0,0,2020-06-30,Male,43,35-44,4
5,2,0,0,2,2020-06-29,Female,68,65-69,2
5,1,31,42,74,2020-07-01,Female,24,20-24,2
5,2,0,1,3,2020-06-28,Female,1,1-4,5
5,0,0,0,0,2020-06-26,Male,63,55-64,5
5,0,0,0,0,2020-06-30,Female,52,45-54,4
5,1,13,0,14,2020-06-26,Male,65,65-69,2
5,2,0,0,2,2020-06-27,Male,5,5-9,4
5,0,0,0,0,2020-06-26,Female,17,15-19,2
5,0,0,0,0,2020-06-30,Male,24,20-24,2
5,2,1,0,3,2020-06-27,Male,59,55-64,5
5,0,0,0,0,2020-06-29,Female,49,45-54,5
5,1,12,20,33,2020-06-26,Male,65,65-69,3
5,0,1,0,1,2020-06-26,Male,57,55-64,5
5,2,0,0,2,2020-06-26,Female,65,65-69,5
5,2,3,0,5,2020-06-28,Male,4,1-4,3
5,3,0,0,3,2020-06-29,Female,2,1-4,5
5,3,0,0,3,2020-06-30,Female,14,10-14,2
5,2,18,0,20,2020-06-30,Female,24,20-24,5
5,4,2,0,6,2020-06-27,Male,14,10-14,5
5,2,7,0,9,2020-06-30,Male,50,45-54,5
5,0,0,0,0,2020-06-26,Female,65,65-69,5
5,0,0,0,0,2020-06-29,Male,73,70-74,5
5,3,0,0,3,2020-06-29,Male,23,20-24,2
5,1,0,0,1,2020-06-26,Female,66,65-69,2
5,0,0,0,0,2020-06-29,Male,70,70-74,2
5,1,3,0,4,2020-06-30,Male,54,45-54,4
5,0,1,0,1,2020-06-27,Female,68,65-69,5
5,0,2,0,2,2020-06-28,Female,78,75-79,5
5,2,2,0,4,2020-06-29,Male,67,65-69,3
5,0,0,0,0,2020-06-29,Male,77,75-79,4
5,0,0,0,0,2020-06-26,Male,21,20-24,2
5,0,0,0,0,2020-06-30,Male,55,55-64,5
5,1,4,0,5,2020-06-28,Female,63,55-64,3
5,2,0,0,2,2020-06-27,Male,65,65-69,3
5,0,0,0,0,2020-06-29,Male,59,55-64,5
5,1,0,0,1,2020-06-27,Male,54,45-54,2
5,0,5,62,67,2020-06-26,Female,32,25-34,5
5,0,0,1,1,2020-06-29,Male,34,25-34,3
5,1,4,0,5,2020-06-30,Male,62,55-64,3
5,1,0,0,1,2020-06-29,Female,68,65-69,5
5,0,3,0,3,2020-06-30,Female,53,45-54,2
5,0,0,0,0,2020-06-26,Female,24,20-24,5
5,0,0,0,0,2020-06-29,Male,43,35-44,2
5,1,0,0,1,2020-07-01,Male,51,45-54,5
5,0,0,0,0,2020-06-26,Male,29,25-34,5
5,1,2,0,3,2020-06-30,Female,32,25-34,2
5,0,2,0,2,2020-06-26,Female,23,20-24,2
5,0,0,0,0,2020-06-26,Female,48,45-54,5
5,2,0,0,2,2020-06-26,Female,63,55-64,5
5,1,7,0,8,2020-06-27,Male,63,55-64,2
5,4,4,0,8,2020-06-30,Female,1,1-4,2
5,3,2,0,5,2020-06-26,Female,37,35-44,4
5,2,2,0,4,2020-06-30,Female,60,55-64,5
5,0,0,0,0,2020-06-29,Male,70,70-74,5
5,0,1,0,1,2020-06-30,Female,21,20-24,2
5,1,0,0,1,2020-06-27,Male,52,45-54,5
5,2,0,0,2,2020-06-30,Male,50,45-54,3
5,0,5,0,5,2020-06-26,Female,65,65-69,5
5,0,4,0,4,2020-06-30,Female,69,65-69,2
5,3,1,0,4,2020-06-27,Female,8,5-9,3
5,0,2,0,2,2020-06-27,Male,42,35-44,2
5,0,0,0,0,2020-06-29,Male,53,45-54,2
5,4,0,0,4,2020-06-26,Female,45,45-54,5
5,2,3,0,5,2020-06-26,Male,65,65-69,2
5,0,3,0,3,2020-06-27,Male,57,55-64,2
5,0,1,0,1,2020-06-26,Female,67,65-69,5
5,2,0,0,2,2020-06-29,Male,39,35-44,5
5,0,3,0,3,2020-06-29,Male,38,35-44,3
5,4,0,0,4,2020-06-29,Female,15,15-19,3
5,0,3,0,3,2020-06-26,Male,39,35-44,2
5,3,0,0,3,2020-06-28,Male,42,35-44,2
5,4,0,0,4,2020-06-26,Female,20,20-24,2
5,1,1,6,8,2020-06-29,Male,24,20-24,2
5,0,0,0,0,2020-06-30,Female,56,55-64,2
5,2,3,0,5,2020-06-29,Female,8,5-9,5
5,1,2,0,3,2020-06-26,Male,65,65-69,5
5,0,0,0,0,2020-06-26,Male,60,55-64,5
5,0,2,0,2,2020-06-26,Male,63,55-64,2
5,2,3,0,5,2020-07-01,Female,1,1-4,4
5,0,3,0,3,2020-06-26,Male,72,70-74,2
5,0,0,0,0,2020-06-30,Female,56,55-64,5
5,4,0,1,5,2020-06-30,Male,19,15-19,2
5,2,0,0,2,2020-06-29,Male,70,70-74,5
5,0,0,0,0,2020-06-29,Female,17,15-19,5
5,1,0,0,1,2020-06-30,Male,62,55-64,5
5,1,1,0,2,2020-06-29,Male,67,65-69,5
5,2,0,0,2,2020-07-01,Female,57,55-64,5
5,2,1,0,3,2020-06-30,Male,76,75-79,2
5,0,1,0,1,2020-06-29,Male,57,55-64,5
5,1,0,0,1,2020-06-29,Female,70,70-74,2
5,0,0,0,0,2020-06-30,Male,51,45-54,2
5,0,4,40,44,2020-06-30,Female,59,55-64,2
5,1,0,0,1,2020-06-27,Male,7,5-9,5
5,2,4,0,6,2020-06-29,Female,55,55-64,5
5,0,12,2,14,2020-06-27,Male,56,55-64,4
5,0,0,0,0,2020-06-29,Female,26,25-34,2
5,3,1,0,4,2020-06-29,Female,8,5-9,2
5,2,0,0,2,2020-06-26,Male,52,45-54,2
5,0,0,0,0,2020-06-26,Female,21,20-24,3
5,1,8,0,9,2020-06-28,Female,66,65-69,2
5,0,3,0,3,2020-06-26,Female,35,35-44,2
5,2,13,0,15,2020-06-30,Male,55,55-64,2
5,0,1,0,1,2020-06-27,Male,30,25-34,5
5,2,1,0,3,2020-06-26,Male,62,55-64,4
5,0,3,0,3,2020-06-26,Male,26,25-34,2
5,0,0,0,0,2020-06-26,Male,65,65-69,3
5,0,0,0,0,2020-06-29,Male,38,35-44,5
5,1,7,0,8,2020-06-29,Female,6,5-9,2
5,3,0,15,18,2020-06-30,Female,14,10-14,5
5,1,1,0,2,2020-06-29,Male,53,45-54,2
5,2,1,0,3,2020-06-30,Female,58,55-64,5
5,2,1,0,3,2020-06-27,Female,72,70-74,2
5,0,0,0,0,2020-06-30,Male,13,10-14,3
5,2,0,0,2,2020-07-01,Male,78,75-79,3
5,1,0,0,1,2020-06-30,Female,65,65-69,4
5,3,0,0,3,2020-06-30,Male,12,10-14,2
5,6,0,0,6,2020-06-29,Female,10,10-14,5
5,2,0,0,2,2020-06-26,Male,64,55-64,5
5,1,2,0,3,2020-06-30,Female,51,45-54,5
5,0,0,0,0,2020-07-01,Male,55,55-64,2
5,4,0,0,4,2020-06-30,Female,17,15-19,5
5,1,0,0,1,2020-06-29,Female,72,70-74,2
5,4,0,0,4,2020-06-29,Female,5,5-9,4
5,0,0,0,0,2020-06-30,Female,61,55-64,5
5,1,0,0,1,2020-06-29,Female,25,25-34,2
5,1,1,0,2,2020-06-28,Male,53,45-54,5
5,2,3,0,5,2020-06-30,Male,55,55-64,5
5,2,1,0,3,2020-07-01,Female,54,45-54,2
5,0,0,0,0,2020-06-27,Male,59,55-64,5
5,0,4,0,4,2020-06-28,Female,58,55-64,5
5,0,0,0,0,2020-06-26,Female,19,15-19,2
5,1,1,0,2,2020-06-28,Female,31,25-34,2
5,0,0,0,0,2020-06-30,Female,23,20-24,3
5,2,10,0,12,2020-06-27,Male,31,25-34,2
5,0,0,0,0,2020-06-26,Male,27,25-34,4
5,3,8,0,11,2020-06-27,Male,58,55-64,2
5,0,0,0,0,2020-06-27,Male,47,45-54,5
5,2,1,0,3,2020-06-29,Female,67,65-69,2
5,3,0,0,3,2020-06-26,Female,7,5-9,5
5,0,0,0,0,2020-06-26,Female,40,35-44,5
5,1,0,0,1,2020-06-26,Male,68,65-69,2
5,1,0,0,1,2020-06-30,Female,26,25-34,2
5,0,5,0,5,2020-06-29,Male,72,70-74,3
5,2,2,28,32,2020-06-28,Female,73,70-74,2
5,0,1,0,1,2020-06-29,Male,30,25-34,2
5,4,0,0,4,2020-06-29,Male,10,10-14,2
5,2,4,11,17,2020-06-26,Male,65,65-69,2
5,2,0,0,2,2020-06-28,Female,61,55-64,2
5,3,4,0,7,2020-06-27,Female,65,65-69,2
5,0,0,0,0,2020-06-26,Male,68,65-69,2
5,0,0,0,0,2020-06-29,Female,30,25-34,5
5,3,2,0,5,2020-06-27,Male,37,35-44,2
5,0,2,0,2,2020-06-26,Male,48,45-54,5
5,2,1,0,3,2020-06-30,Male,22,20-24,2
5,0,2,0,2,2020-06-26,Female,56,55-64,2
5,0,0,0,0,2020-06-26,Male,58,55-64,4
5,1,0,0,1,2020-07-01,Female,51,45-54,2
5,1,14,0,15,2020-06-30,Male,42,35-44,2
5,2,0,5,7,2020-06-26,Male,68,65-69,5
5,0,0,0,0,2020-06-26,Female,23,20-24,2
5,1,2,0,3,2020-06-29,Male,78,75-79,2
5,2,2,0,4,2020-06-27,Male,70,70-74,5
5,1,0,0,1,2020-06-30,Male,59,55-64,2
5,1,0,8,9,2020-06-30,Male,58,55-64,3
5,2,1,0,3,2020-06-26,Male,66,65-69,2
5,0,0,0,0,2020-06-27,Male,34,25-34,2
5,0,0,0,0,2020-06-26,Male,46,45-54,5
5,0,1,0,1,2020-06-26,Female,53,45-54,2
5,0,1,0,1,2020-06-30,Male,50,45-54,2
5,4,0,0,4,2020-06-29,Male,4,1-4,2
5,0,4,0,4,2020-06-27,Male,60,55-64,5
5,1,2,0,3,2020-06-29,Female,69,65-69,5
5,1,2,0,3,2020-06-26,Male,67,65-69,5
5,0,1,9,10,2020-06-27,Male,21,20-24,3
5,2,6,11,19,2020-06-29,Male,76,75-79,2
5,3,4,0,7,2020-06-29,Female,65,65-69,2
5,0,0,0,0,2020-06-29,Male,34,25-34,3
5,2,0,0,2,2020-06-28,Male,75,75-79,2
5,0,0,0,0,2020-06-30,Female,15,15-19,2
5,0,3,0,3,2020-06-30,Male,58,55-64,5
5,1,21,0,22,2020-06-30,Female,54,45-54,3
5,1,0,1,2,2020-06-30,Male,51,45-54,2
5,0,0,0,0,2020-06-29,Female,31,25-34,3
5,2,0,0,2,2020-06-30,Female,45,45-54,5
5,2,0,0,2,2020-06-26,Male,67,65-69,2
5,0,0,0,0,2020-06-30,Male,49,45-54,3
5,2,0,1,3,2020-06-29,Female,13,10-14,3
5,0,0,0,0,2020-06-27,Male,41,35-44,2
5,1,0,0,1,2020-06-30,Male,51,45-54,2
5,1,0,0,1,2020-06-30,Male,54,45-54,5
5,1,0,0,1,2020-06-26,Female,68,65-69,3
5,1,1,0,2,2020-06-28,Female,41,35-44,2
5,2,1,0,3,2020-06-28,Female,70,70-74,5
5,0,2,0,2,2020-06-26,Female,65,65-69,2
5,3,0,0,3,2020-06-30,Male,19,15-19,5
5,1,0,0,1,2020-06-26,Male,54,45-54,2
5,3,0,0,3,2020-06-28,Male,19,15-19,2
5,4,1,0,5,2020-06-27,Female,59,55-64,5
5,0,4,0,4,2020-06-27,Male,59,55-64,2
5,1,0,0,1,2020-06-26,Male,22,20-24,3
5,1,0,0,1,2020-06-28,Male,30,25-34,2
5,1,1,0,2,2020-06-26,Female,20,20-24,2
5,3,0,0,3,2020-06-27,Female,55,55-64,5
5,3,0,0,3,2020-06-28,Female,66,65-69,5
5,2,3,0,5,2020-06-29,Female,69,65-69,2
5,2,2,1,5,2020-06-26,Male,51,45-54,5
5,1,2,0,3,2020-06-26,Male,64,55-64,5
5,2,2,0,4,2020-06-26,Male,63,55-64,2
5,0,0,0,0,2020-06-27,Male,48,45-54,2
5,0,0,0,0,2020-06-26,Male,59,55-64,3
5,0,1,0,1,2020-06-27,Male,59,55-64,5
5,1,1,0,2,2020-06-29,Male,69,65-69,2
5,0,5,4,9,2020-06-26,Male,30,25-34,2
5,1,0,0,1,2020-06-29,Female,29,25-34,2
5,1,0,0,1,2020-06-29,Female,68,65-69,5
5,1,10,0,11,2020-06-30,Female,56,55-64,2
5,0,1,0,1,2020-06-27,Female,25,25-34,3
5,3,8,1,12,2020-06-29,Female,27,25-34,2
5,2,7,0,9,2020-06-30,Female,54,45-54,3
5,1,0,100,101,2020-07-01,Male,36,35-44,2
5,0,2,0,2,2020-06-26,Male,65,65-69,5
5,1,5,0,6,2020-06-30,Male,52,45-54,2
5,0,0,0,0,2020-06-26,Male,69,65-69,2
5,2,0,0,2,2020-06-27,Male,56,55-64,2
5,0,3,0,3,2020-06-29,Female,23,20-24,2
5,0,3,0,3,2020-06-29,Female,47,45-54,2
5,2,0,0,2,2020-06-26,Female,65,65-69,5
5,2,33,0,35,2020-07-01,Male,69,65-69,5
5,1,2,0,3,2020-06-28,Male,33,25-34,3
5,1,2,0,3,2020-07-01,Female,70,70-74,2
5,0,5,0,5,2020-06-29,Male,70,70-74,2
5,0,0,0,0,2020-06-29,Male,45,45-54,2
5,1,3,0,4,2020-06-26,Female,65,65-69,2
5,1,0,0,1,2020-06-29,Male,78,75-79,4
5,1,6,11,18,2020-06-29,Male,71,70-74,2
5,0,0,1,1,2020-06-29,Male,45,45-54,4
5,2,2,10,14,2020-06-29,Female,67,65-69,2
5,0,2,0,2,2020-06-27,Female,64,55-64,5
5,0,10,0,10,2020-06-30,Female,59,55-64,5
5,1,0,0,1,2020-06-27,Male,58,55-64,5
5,2,1,0,3,2020-06-29,Male,69,65-69,5
5,0,0,0,0,2020-06-26,Male,50,45-54,5
5,0,0,0,0,2020-06-26,Male,66,65-69,5
5,1,1,40,42,2020-06-27,Male,71,70-74,5
5,2,4,0,6,2020-06-26,Female,77,75-79,5
5,2,3,0,5,2020-06-27,Male,71,70-74,4
5,1,1,0,2,2020-06-26,Female,63,55-64,2
5,2,0,0,2,2020-06-27,Female,18,15-19,5
5,0,0,0,0,2020-06-28,Male,0,<1,2
5,1,3,0,4,2020-06-30,Female,38,35-44,5
5,2,0,0,2,2020-06-30,Female,57,55-64,5
5,1,12,0,13,2020-06-26,Female,65,65-69,2
5,3,0,0,3,2020-06-30,Male,16,15-19,5
5,0,0,0,0,2020-06-27,Male,39,35-44,5
5,0,2,0,2,2020-06-26,Male,66,65-69,2
5,1,1,0,2,2020-06-26,Female,66,65-69,2
5,1,0,0,1,2020-06-27,Female,68,65-69,4
5,0,5,0,5,2020-06-30,Male,23,20-24,5
5,3,1,0,4,2020-06-29,Female,15,15-19,2
5,4,1,0,5,2020-06-29,Female,32,25-34,3
5,1,0,0,1,2020-06-26,Female,63,55-64,2
5,0,0,0,0,2020-06-29,Female,32,25-34,2
5,0,1,0,1,2020-06-26,Female,46,45-54,2
5,1,0,0,1,2020-06-29,Male,32,25-34,2
5,1,4,0,5,2020-06-26,Male,65,65-69,2
5,1,9,0,10,2020-06-29,Female,67,65-69,5
5,4,24,25,53,2020-06-27,Female,18,15-19,2
5,2,4,0,6,2020-06-30,Female,49,45-54,3
5,1,2,0,3,2020-06-29,Male,61,55-64,3
5,1,2,0,3,2020-06-27,Female,17,15-19,5
5,0,3,0,3,2020-06-27,Male,22,20-24,3
5,0,0,0,0,2020-06-30,Male,59,55-64,2
5,0,0,0,0,2020-06-27,Male,42,35-44,2
5,0,0,0,0,2020-06-28,Male,31,25-34,2
5,2,1,0,3,2020-06-28,Female,67,65-69,3
5,2,2,0,4,2020-06-26,Male,56,55-64,2
5,2,0,0,2,2020-06-29,Male,69,65-69,2
5,2,0,2,4,2020-06-27,Male,69,65-69,4
5,0,5,5,10,2020-07-01,Female,52,45-54,2
5,1,4,0,5,2020-06-29,Male,59,55-64,4
5,4,0,29,33,2020-06-30,Male,29,25-34,2
5,2,4,0,6,2020-06-29,Male,43,35-44,5
5,0,0,0,0,2020-06-30,Male,51,45-54,2
5,3,12,60,75,2020-06-29,Male,30,25-34,5
5,4,2,0,6,2020-06-28,Female,3,1-4,2
5,0,0,0,0,2020-06-30,Male,52,45-54,5
5,1,2,0,3,2020-06-26,Female,63,55-64,2
5,0,1,0,1,2020-06-26,Male,42,35-44,5
5,0,3,100,103,2020-06-29,Male,34,25-34,3
5,2,8,0,10,2020-06-30,Male,3,1-4,2
5,1,2,0,3,2020-06-29,Male,29,25-34,2
5,2,0,0,2,2020-06-27,Male,36,35-44,3
5,2,0,0,2,2020-06-27,Female,24,20-24,3
5,0,0,0,0,2020-06-29,Male,56,55-64,5
5,3,0,0,3,2020-06-30,Male,14,10-14,5
5,0,2,0,2,2020-06-30,Female,51,45-54,4
5,0,0,0,0,2020-06-27,Male,24,20-24,2
5,3,1,0,4,2020-06-30,Female,50,45-54,3
5,2,1,0,3,2020-06-29,Female,67,65-69,3
5,1,0,0,1,2020-06-30,Male,49,45-54,5
5,2,10,0,12,2020-06-27,Male,51,45-54,5
5,1,0,0,1,2020-07-01,Female,25,25-34,2
5,0,0,0,0,2020-06-26,Male,70,70-74,5
5,2,1,0,3,2020-06-26,Male,67,65-69,5
5,0,0,0,0,2020-06-26,Female,59,55-64,5
5,1,0,0,1,2020-06-29,Male,40,35-44,2
5,0,0,0,0,2020-06-30,Male,38,35-44,4
5,0,1,0,1,2020-07-01,Male,53,45-54,2
5,1,0,0,1,2020-06-28,Female,30,25-34,5
5,0,0,0,0,2020-06-28,Male,32,25-34,5
5,2,13,2,17,2020-06-30,Male,14,10-14,2
5,1,2,0,3,2020-06-28,Female,54,45-54,5
5,1,0,0,1,2020-06-29,Female,68,65-69,4
5,2,0,0,2,2020-06-27,Female,11,10-14,2
5,0,0,0,0,2020-06-30,Female,67,65-69,2
5,0,0,0,0,2020-06-29,Female,69,65-69,2
5,2,0,0,2,2020-06-26,Male,45,45-54,5
5,0,0,0,0,2020-06-28,Female,55,55-64,5
5,1,8,0,9,2020-06-26,Male,29,25-34,2
5,1,0,0,1,2020-07-01,Male,65,65-69,3
5,1,0,0,1,2020-06-30,Male,59,55-64,2
5,1,15,0,16,2020-06-29,Male,67,65-69,2
5,2,0,0,2,2020-06-29,Male,28,25-34,2
5,0,0,0,0,2020-06-29,Male,23,20-24,2
5,2,0,0,2,2020-06-30,Male,78,75-79,2
5,2,0,0,2,2020-06-27,Male,17,15-19,5
5,2,1,0,3,2020-06-28,Male,14,10-14,5
5,2,1,0,3,2020-06-26,Female,45,45-54,3
5,2,0,0,2,2020-06-29,Male,67,65-69,2
5,0,0,0,0,2020-06-30,Male,59,55-64,4
5,5,3,0,8,2020-06-27,Male,7,5-9,2
5,2,0,0,2,2020-06-29,Female,65,65-69,2
5,2,0,0,2,2020-06-26,Female,57,55-64,5
5,3,1,0,4,2020-06-29,Male,34,25-34,4
5,2,0,0,2,2020-06-30,Male,75,75-79,5
5,0,0,0,0,2020-06-26,Male,69,65-69,4
5,2,1,0,3,2020-07-01,Female,67,65-69,2
5,1,0,0,1,2020-06-29,Male,57,55-64,3
5,0,2,0,2,2020-06-29,Male,41,35-44,4
5,2,0,10,12,2020-06-29,Female,23,20-24,2
5,0,0,0,0,2020-07-01,Male,18,15-19,4
5,1,3,0,4,2020-06-27,Male,63,55-64,2
5,3,0,0,3,2020-06-26,Male,12,10-14,2
5,4,1,0,5,2020-06-30,Male,13,10-14,2
5,0,0,0,0,2020-06-29,Female,33,25-34,2
5,1,3,0,4,2020-06-26,Female,66,65-69,5
5,2,10,0,12,2020-06-29,Female,67,65-69,5
5,0,0,0,0,2020-06-28,Female,69,65-69,5
5,2,1,0,3,2020-06-29,Male,80,80-84,2
5,2,0,0,2,2020-07-01,Male,50,45-54,3
5,1,3,0,4,2020-06-30,Female,53,45-54,2
5,2,3,44,49,2020-06-29,Female,62,55-64,5
5,0,2,0,2,2020-06-26,Male,48,45-54,2
5,1,0,0,1,2020-06-29,Male,71,70-74,4
5,0,0,0,0,2020-06-26,Female,20,20-24,2
5,3,4,0,7,2020-06-26,Male,27,25-34,2
5,1,0,0,1,2020-07-01,Male,65,65-69,3
5,0,6,0,6,2020-06-27,Female,64,55-64,2
5,2,0,0,2,2020-06-30,Female,11,10-14,2
5,0,0,0,0,2020-06-26,Female,62,55-64,4
5,1,1,0,2,2020-06-30,Female,52,45-54,2
5,0,0,0,0,2020-06-28,Male,65,65-69,5
5,1,0,0,1,2020-06-28,Male,56,55-64,2
5,1,6,13,20,2020-06-28,Male,70,70-74,3
5,0,0,0,0,2020-06-26,Male,65,65-69,5
5,1,0,0,1,2020-06-26,Male,63,55-64,5
5,0,11,0,11,2020-06-29,Female,35,35-44,3
5,0,0,0,0,2020-06-28,Female,29,25-34,2
5,1,0,0,1,2020-06-28,Male,71,70-74,5
5,2,3,0,5,2020-06-30,Female,45,45-54,2
5,0,1,0,1,2020-06-26,Female,62,55-64,4
5,0,0,0,0,2020-06-28,Female,35,35-44,5
5,5,2,24,31,2020-06-30,Female,2,1-4,2
5,0,1,0,1,2020-06-28,Male,44,35-44,2
5,2,0,0,2,2020-06-27,Male,70,70-74,2
5,5,1,0,6,2020-06-27,Male,14,10-14,2
5,3,4,0,7,2020-06-26,Female,64,55-64,5
5,0,1,0,1,2020-06-30,Female,61,55-64,5
5,0,0,0,0,2020-06-26,Female,31,25-34,2
5,0,3,0,3,2020-06-26,Male,26,25-34,2
5,2,2,0,4,2020-06-28,Male,54,45-54,2
5,0,1,0,1,2020-06-30,Female,42,35-44,2
5,0,0,0,0,2020-06-30,Male,16,15-19,3
5,2,0,0,2,2020-06-30,Female,59,55-64,5
5,0,2,0,2,2020-06-26,Female,65,65-69,5
5,1,0,0,1,2020-06-29,Female,22,20-24,2
5,2,3,0,5,2020-06-27,Male,55,55-64,2
5,0,3,0,3,2020-06-29,Female,30,25-34,4
5,0,0,0,0,2020-06-26,Female,63,55-64,5
5,0,2,3,5,2020-06-26,Female,46,45-54,5
5,0,1,0,1,2020-06-27,Male,53,45-54,2
5,8,1,0,9,2020-06-28,Female,28,25-34,2
5,2,11,0,13,2020-06-30,Male,56,55-64,5
5,0,0,0,0,2020-06-28,Male,30,25-34,3
5,1,3,0,4,2020-06-30,Male,39,35-44,2
5,4,2,0,6,2020-06-26,Female,13,10-14,5
5,0,3,0,3,2020-06-27,Female,21,20-24,2
5,1,18,0,19,2020-06-28,Male,42,35-44,4
5,2,0,0,2,2020-06-30,Female,50,45-54,2
5,2,2,0,4,2020-06-30,Male,40,35-44,2
5,4,0,0,4,2020-06-26,Male,19,15-19,2
5,0,1,0,1,2020-06-26,Female,63,55-64,5
5,0,0,0,0,2020-06-27,Male,10,10-14,5
5,1,2,0,3,2020-06-26,Female,66,65-69,4
5,2,1,0,3,2020-07-01,Female,60,55-64,5
5,0,3,0,3,2020-06-28,Female,61,55-64,5
5,0,0,0,0,2020-06-30,Male,50,45-54,2
5,2,1,0,3,2020-06-29,Male,44,35-44,5
5,2,2,0,4,2020-06-29,Male,15,15-19,2
5,1,1,0,2,2020-06-29,Male,70,70-74,2
5,0,0,0,0,2020-06-30,Female,67,65-69,5
5,0,15,0,15,2020-06-27,Female,55,55-64,4
5,0,6,0,6,2020-06-27,Female,67,65-69,2
5,0,0,0,0,2020-06-27,Male,50,45-54,3
5,1,0,0,1,2020-06-27,Male,69,65-69,2
5,2,16,0,18,2020-06-28,Male,37,35-44,3
5,2,0,0,2,2020-06-29,Male,21,20-24,2
5,0,3,0,3,2020-06-28,Male,22,20-24,3
5,2,6,0,8,2020-06-30,Male,7,5-9,2
5,2,0,0,2,2020-06-26,Male,11,10-14,2
5,2,0,0,2,2020-06-28,Male,67,65-69,3
5,2,5,0,7,2020-06-26,Male,66,65-69,2
5,0,1,0,1,2020-06-30,Female,57,55-64,4
5,2,8,0,10,2020-07-01,Male,56,55-64,5
5,0,0,1,1,2020-06-29,Male,69,65-69,2
5,0,0,0,0,2020-06-29,Male,73,70-74,5
5,0,1,40,41,2020-06-27,Female,33,25-34,5
5,0,0,0,0,2020-06-26,Male,20,20-24,2
5,0,0,2,2,2020-06-30,Male,52,45-54,5
5,0,0,0,0,2020-06-28,Male,67,65-69,5
5,0,0,0,0,2020-06-26,Male,33,25-34,5
5,0,2,0,2,2020-06-27,Female,37,35-44,5
5,0,1,1,2,2020-06-28,Female,52,45-54,2
5,1,0,0,1,2020-06-28,Male,29,25-34,2
5,2,2,3,7,2020-06-27,Male,78,75-79,2
5,4,1,0,5,2020-07-01,Female,11,10-14,2
5,1,0,0,1,2020-06-26,Male,68,65-69,2
5,0,0,0,0,2020-06-29,Male,58,55-64,4
5,0,0,0,0,2020-06-26,Male,18,15-19,2
5,1,0,0,1,2020-06-29,Female,7,5-9,2
5,3,1,0,4,2020-06-30,Female,9,5-9,2
5,4,4,0,8,2020-06-30,Female,9,5-9,2
5,1,24,14,39,2020-06-30,Female,56,55-64,3
5,4,0,0,4,2020-06-29,Male,11,10-14,2
5,2,5,0,7,2020-06-28,Female,61,55-64,2
5,4,7,0,11,2020-06-27,Male,41,35-44,2
5,2,5,0,7,2020-06-30,Female,35,35-44,2
5,3,6,0,9,2020-07-01,Male,78,75-79,2
5,3,0,0,3,2020-06-26,Male,52,45-54,2
5,1,7,4,12,2020-07-01,Female,33,25-34,2
5,2,4,0,6,2020-06-26,Male,66,65-69,2
5,2,2,0,4,2020-06-30,Male,51,45-54,2
5,0,1,0,1,2020-06-27,Female,32,25-34,4
5,0,2,0,2,2020-06-30,Female,52,45-54,2
5,3,0,0,3,2020-06-28,Female,42,35-44,4
5,0,0,0,0,2020-06-29,Female,70,70-74,5
5,1,1,0,2,2020-06-30,Female,65,65-69,2
5,1,1,0,2,2020-07-01,Female,23,20-24,5
5,0,1,0,1,2020-06-29,Female,71,70-74,2
5,0,0,0,0,2020-06-29,Male,31,25-34,2
5,0,0,0,0,2020-06-26,Female,65,65-69,5
5,0,0,0,0,2020-06-27,Male,59,55-64,2
5,0,0,4,4,2020-06-29,Female,36,35-44,3
5,2,0,0,2,2020-06-28,Male,13,10-14,2
5,1,1,0,2,2020-06-27,Male,70,70-74,4
5,1,1,0,2,2020-07-01,Female,33,25-34,2
5,2,1,0,3,2020-06-29,Female,50,45-54,5
5,0,8,0,8,2020-06-27,Female,69,65-69,2
5,1,1,0,2,2020-06-29,Female,5,5-9,3
5,3,0,0,3,2020-06-26,Male,32,25-34,2
5,5,5,0,10,2020-06-26,Female,12,10-14,4
5,0,0,0,0,2020-06-29,Male,31,25-34,3
5,1,0,0,1,2020-07-01,Male,44,35-44,4
5,0,1,8,9,2020-06-29,Female,67,65-69,5
5,1,1,0,2,2020-06-30,Female,58,55-64,5
5,0,0,0,0,2020-06-26,Female,66,65-69,2
5,0,2,0,2,2020-06-27,Female,54,45-54,5
5,3,0,0,3,2020-06-29,Male,69,65-69,5
5,1,1,0,2,2020-06-29,Female,22,20-24,2
5,0,0,0,0,2020-06-30,Female,40,35-44,5
5,0,0,0,0,2020-06-28,Female,23,20-24,2
5,3,1,0,4,2020-06-28,Female,20,20-24,3
5,0,0,0,0,2020-06-27,Male,33,25-34,2
5,0,0,0,0,2020-06-26,Female,63,55-64,5
5,4,2,0,6,2020-06-26,Female,19,15-19,3
5,2,0,0,2,2020-06-30,Male,58,55-64,5
5,0,0,0,0,2020-06-29,Male,81,80-84,5
5,2,1,0,3,2020-06-27,Male,63,55-64,4
5,0,0,0,0,2020-06-26,Female,52,45-54,5
5,0,1,0,1,2020-06-27,Male,39,35-44,2
5,1,5,0,6,2020-07-01,Male,78,75-79,4
5,0,10,0,10,2020-06-26,Female,42,35-44,4
5,0,2,0,2,2020-06-26,Male,49,45-54,5
5,0,1,0,1,2020-06-29,Male,35,35-44,2
5,4,0,65,69,2020-06-26,Male,17,15-19,2
5,0,1,0,1,2020-06-29,Male,77,75-79,5
5,1,0,0,1,2020-07-01,Male,43,35-44,2
5,1,0,0,1,2020-06-26,Male,66,65-69,5
5,2,3,0,5,2020-06-28,Female,66,65-69,5
5,0,0,0,0,2020-06-26,Female,65,65-69,2
5,0,0,0,0,2020-06-26,Male,36,35-44,5
5,3,0,0,3,2020-06-30,Female,13,10-14,3
5,0,0,0,0,2020-06-28,Male,2,1-4,2
5,0,0,0,0,2020-06-29,Male,47,45-54,5
5,2,2,0,4,2020-06-30,Male,19,15-19,5
5,1,0,0,1,2020-06-26,Male,65,65-69,2
5,1,1,0,2,2020-06-30,Male,39,35-44,4
5,1,7,0,8,2020-06-27,Female,65,65-69,5
5,0,0,0,0,2020-06-27,Male,37,35-44,5
5,2,1,0,3,2020-06-27,Male,74,70-74,5
5,0,0,0,0,2020-07-01,Male,30,25-34,2
5,2,0,0,2,2020-06-27,Female,62,55-64,5
5,0,0,0,0,2020-06-26,Male,15,15-19,5
5,2,8,0,10,2020-06-29,Male,72,70-74,2
5,0,0,0,0,2020-06-28,Female,53,45-54,2
5,1,3,0,4,2020-06-26,Female,67,65-69,3
5,4,0,0,4,2020-06-28,Female,37,35-44,2
5,3,2,0,5,2020-06-30,Female,8,5-9,5
5,3,0,0,3,2020-06-27,Male,39,35-44,5
5,2,1,0,3,2020-07-01,Male,64,55-64,2
5,0,0,0,0,2020-06-29,Male,57,55-64,5
5,2,0,0,2,2020-06-29,Male,59,55-64,2
5,0,0,0,0,2020-06-26,Male,40,35-44,3
5,0,2,0,2,2020-06-30,Male,44,35-44,5
5,1,0,0,1,2020-06-26,Female,19,15-19,4
5,0,0,0,0,2020-06-29,Male,34,25-34,2
5,3,1,0,4,2020-06-29,Male,68,65-69,2
5,2,0,0,2,2020-06-26,Female,13,10-14,5
5,2,4,0,6,2020-06-30,Female,52,45-54,5
5,1,2,0,3,2020-06-29,Female,34,25-34,2
5,2,0,0,2,2020-06-29,Female,57,55-64,5
5,0,0,0,0,2020-06-26,Female,59,55-64,5
5,0,0,0,0,2020-06-29,Male,59,55-64,2
5,2,0,0,2,2020-06-26,Male,10,10-14,5
5,2,1,0,3,2020-06-29,Male,19,15-19,2
5,2,0,0,2,2020-06-26,Male,65,65-69,2
5,2,0,0,2,2020-06-30,Female,19,15-19,4
5,2,0,0,2,2020-06-26,Male,54,45-54,4
5,1,0,0,1,2020-06-30,Female,49,45-54,5
5,0,1,0,1,2020-06-29,Male,23,20-24,2
5,2,0,0,2,2020-06-30,Female,22,20-24,4
5,4,0,0,4,2020-07-01,Female,21,20-24,2
5,0,0,0,0,2020-06-29,Female,21,20-24,2
5,2,0,0,2,2020-06-29,Female,13,10-14,3
5,0,0,0,0,2020-06-28,Female,13,10-14,2
5,4,13,0,17,2020-07-01,Female,15,15-19,2
5,2,0,0,2,2020-06-29,Female,69,65-69,4
5,0,1,0,1,2020-06-28,Female,24,20-24,3
5,3,0,0,3,2020-06-26,Female,8,5-9,3
5,0,13,0,13,2020-06-30,Female,67,65-69,2
5,0,7,0,7,2020-06-28,Female,53,45-54,5
5,1,2,0,3,2020-06-30,Male,74,70-74,2
5,0,0,0,0,2020-06-26,Male,38,35-44,2
5,0,0,0,0,2020-06-26,Male,35,35-44,2
5,4,2,0,6,2020-06-30,Male,15,15-19,3
5,0,0,0,0,2020-06-27,Male,35,35-44,2
5,2,2,0,4,2020-06-29,Male,67,65-69,2
5,3,0,0,3,2020-07-01,Female,18,15-19,2
5,1,4,0,5,2020-06-27,Male,65,65-69,5
5,3,0,95,98,2020-06-30,Male,13,10-14,2
5,1,0,0,1,2020-06-28,Female,65,65-69,5
5,3,2,0,5,2020-06-30,Female,12,10-14,2
5,2,1,6,9,2020-06-28,Female,65,65-69,2
5,0,1,0,1,2020-06-29,Male,77,75-79,2
5,2,0,0,2,2020-06-28,Male,6,5-9,2
5,1,0,0,1,2020-06-29,Female,54,45-54,3
5,0,0,0,0,2020-06-26,Male,32,25-34,2
5,2,0,0,2,2020-06-27,Female,67,65-69,2
5,0,5,0,5,2020-06-27,Male,52,45-54,5
5,1,0,0,1,2020-06-29,Female,40,35-44,3
5,0,2,0,2,2020-06-28,Female,30,25-34,2
5,2,10,0,12,2020-06-29,Male,66,65-69,5
5,2,0,0,2,2020-06-26,Female,75,75-79,2
5,3,3,0,6,2020-06-30,Female,9,5-9,2
5,1,0,0,1,2020-06-27,Male,62,55-64,5
5,2,0,0,2,2020-06-26,Female,61,55-64,5
5,4,3,0,7,2020-06-30,Female,16,15-19,2
5,2,1,0,3,2020-07-01,Female,70,70-74,3
5,0,1,0,1,2020-06-30,Female,27,25-34,2
5,1,0,1,2,2020-06-26,Female,68,65-69,2
5,0,3,0,3,2020-06-29,Male,27,25-34,5
5,2,0,0,2,2020-06-29,Male,72,70-74,4
5,0,2,0,2,2020-06-27,Male,57,55-64,4
5,0,3,0,3,2020-06-30,Male,62,55-64,2
5,4,3,43,50,2020-06-26,Male,22,20-24,2
5,0,0,0,0,2020-06-29,Male,22,20-24,4
5,0,0,0,0,2020-06-29,Male,68,65-69,5
5,0,3,0,3,2020-06-27,Male,44,35-44,2
5,1,0,0,1,2020-06-30,Female,29,25-34,2
5,1,5,0,6,2020-07-01,Male,54,45-54,3
5,2,0,0,2,2020-06-30,Male,15,15-19,4
5,0,0,0,0,2020-06-30,Male,30,25-34,3
5,0,0,0,0,2020-06-29,Female,73,70-74,2
5,1,0,0,1,2020-06-26,Female,67,65-69,5
5,1,0,0,1,2020-06-27,Male,54,45-54,5
5,1,0,0,1,2020-06-30,Female,61,55-64,5
5,0,1,0,1,2020-06-28,Male,65,65-69,5
5,2,0,1,3,2020-06-26,Female,61,55-64,5
5,1,2,0,3,2020-06-27,Male,52,45-54,4
5,0,5,0,5,2020-06-28,Female,65,65-69,5
5,0,0,0,0,2020-06-26,Male,65,65-69,2
5,1,1,0,2,2020-06-30,Female,59,55-64,4
5,1,0,0,1,2020-06-26,Male,65,65-69,5
5,2,0,0,2,2020-06-30,Female,12,10-14,5
5,3,13,0,16,2020-07-01,Male,14,10-14,2
5,1,2,0,3,2020-07-01,Female,62,55-64,5
5,0,2,0,2,2020-06-26,Female,51,45-54,5
5,1,1,14,16,2020-06-27,Female,1,1-4,2
5,1,3,0,4,2020-06-26,Female,55,55-64,2
5,2,1,0,3,2020-06-27,Female,52,45-54,2
5,3,0,0,3,2020-06-27,Female,47,45-54,2
5,1,0,1,2,2020-06-27,Male,66,65-69,5
5,0,1,0,1,2020-06-28,Male,28,25-34,5
5,1,4,0,5,2020-06-27,Male,59,55-64,5
5,4,0,0,4,2020-06-27,Female,44,35-44,5
5,1,2,0,3,2020-06-29,Male,71,70-74,2
5,2,0,0,2,2020-06-29,Female,67,65-69,5
5,0,1,0,1,2020-06-28,Female,63,55-64,3
5,2,0,0,2,2020-06-29,Female,35,35-44,3
5,3,0,0,3,2020-06-29,Male,15,15-19,2
5,2,2,0,4,2020-06-27,Female,66,65-69,2
5,1,2,0,3,2020-06-26,Male,57,55-64,5
5,2,4,0,6,2020-06-26,Male,66,65-69,2
5,2,0,29,31,2020-06-28,Male,12,10-14,2
5,3,4,0,7,2020-06-29,Male,3,1-4,3
5,0,1,0,1,2020-06-28,Male,34,25-34,2
5,0,0,0,0,2020-06-30,Male,18,15-19,4
5,0,1,0,1,2020-06-30,Male,49,45-54,5
5,0,0,0,0,2020-06-29,Male,69,65-69,3
5,2,8,0,10,2020-06-26,Female,25,25-34,5
5,3,0,0,3,2020-06-26,Male,29,25-34,5
5,0,0,0,0,2020-06-29,Male,33,25-34,2
5,2,1,1,4,2020-06-30,Male,71,70-74,2
5,3,1,0,4,2020-06-29,Female,9,5-9,2
5,2,2,4,8,2020-06-30,Female,69,65-69,3
5,0,0,0,0,2020-06-26,Male,64,55-64,2
5,1,1,0,2,2020-06-28,Male,66,65-69,3
5,1,5,0,6,2020-06-27,Male,66,65-69,2
5,0,0,0,0,2020-06-26,Male,35,35-44,2
5,2,0,0,2,2020-06-28,Female,7,5-9,3
5,0,3,0,3,2020-06-27,Female,65,65-69,5
5,0,0,0,0,2020-06-28,Female,49,45-54,2
5,3,5,0,8,2020-06-26,Male,41,35-44,2
5,1,0,0,1,2020-06-28,Female,3,1-4,2
5,0,0,0,0,2020-06-27,Male,40,35-44,5
5,0,1,0,1,2020-06-27,Male,41,35-44,2
5,1,5,1,7,2020-07-01,Female,61,55-64,2
5,2,0,0,2,2020-06-30,Male,54,45-54,5
5,1,1,0,2,2020-06-29,Male,67,65-69,4
5,4,2,0,6,2020-06-26,Male,3,1-4,5
5,0,0,0,0,2020-06-26,Male,64,55-64,5
5,4,3,0,7,2020-06-27,Male,22,20-24,2
5,2,7,0,9,2020-06-30,Male,43,35-44,3
5,2,4,0,6,2020-06-29,Female,2,1-4,3
5,2,0,0,2,2020-06-26,Female,12,10-14,2
5,1,0,0,1,2020-06-29,Male,51,45-54,2
5,1,2,0,3,2020-07-01,Male,76,75-79,3
5,2,2,0,4,2020-06-28,Male,60,55-64,5
5,1,0,0,1,2020-06-26,Male,64,55-64,5
5,0,0,0,0,2020-06-27,Male,55,55-64,5
5,0,0,0,0,2020-06-26,Male,51,45-54,5
5,1,2,0,3,2020-06-27,Male,65,65-69,5
5,2,10,0,12,2020-06-30,Female,39,35-44,2
5,0,1,0,1,2020-06-30,Male,60,55-64,5
5,2,2,0,4,2020-06-30,Male,52,45-54,5
5,0,0,0,0,2020-06-26,Male,51,45-54,2
5,5,0,0,5,2020-06-29,Female,6,5-9,4
5,1,1,0,2,2020-06-26,Male,53,45-54,2
5,0,0,0,0,2020-07-01,Female,60,55-64,2
5,1,0,0,1,2020-06-28,Female,55,55-64,5
5,2,5,0,7,2020-06-26,Male,32,25-34,2
5,3,2,0,5,2020-06-27,Female,48,45-54,2
5,0,0,0,0,2020-07-01,Male,66,65-69,5
5,2,0,0,2,2020-06-26,Male,66,65-69,5
5,1,3,0,4,2020-06-28,Male,54,45-54,2
5,0,0,0,0,2020-06-26,Male,40,35-44,4
5,0,0,100,100,2020-06-30,Male,58,55-64,2
5,0,6,0,6,2020-06-26,Male,41,35-44,5
5,0,1,0,1,2020-06-26,Male,66,65-69,5
5,0,0,0,0,2020-06-26,Female,34,25-34,4
5,2,2,0,4,2020-06-27,Male,63,55-64,2
5,1,4,0,5,2020-06-30,Female,59,55-64,2
5,0,0,0,0,2020-06-29,Female,68,65-69,5
5,3,3,0,6,2020-06-30,Male,16,15-19,2
5,4,1,0,5,2020-06-27,Male,4,1-4,4
5,0,0,6,6,2020-06-30,Male,54,45-54,5
5,0,0,0,0,2020-06-30,Male,57,55-64,5
5,2,0,0,2,2020-06-29,Male,47,45-54,2
5,0,1,0,1,2020-06-26,Female,34,25-34,2
5,1,0,0,1,2020-06-30,Male,51,45-54,5
5,1,0,0,1,2020-06-27,Male,61,55-64,5
5,0,3,0,3,2020-06-26,Female,66,65-69,5
5,0,4,0,4,2020-06-30,Male,58,55-64,3
5,4,4,0,8,2020-06-30,Male,10,10-14,5
5,3,0,0,3,2020-06-30,Female,38,35-44,4
5,2,0,1,3,2020-06-29,Male,77,75-79,5
5,4,1,0,5,2020-06-30,Female,38,35-44,4
5,1,12,0,13,2020-06-26,Female,63,55-64,3
5,2,0,0,2,2020-06-30,Female,15,15-19,5
5,1,0,0,1,2020-06-28,Female,57,55-64,2
5,1,3,0,4,2020-06-26,Male,66,65-69,2
5,4,0,0,4,2020-06-30,Female,15,15-19,2
5,0,3,0,3,2020-06-27,Female,20,20-24,2
5,2,6,3,11,2020-06-26,Female,65,65-69,2
5,4,1,0,5,2020-06-27,Female,14,10-14,2
5,0,0,0,0,2020-06-26,Male,26,25-34,2
5,0,1,0,1,2020-06-27,Male,47,45-54,5
5,1,6,0,7,2020-06-27,Male,30,25-34,3
5,0,0,0,0,2020-06-28,Male,32,25-34,2
5,2,2,0,4,2020-06-30,Male,48,45-54,2
5,0,0,0,0,2020-06-26,Male,51,45-54,2
5,0,0,0,0,2020-07-01,Male,66,65-69,3
5,4,0,0,4,2020-06-30,Male,16,15-19,2
5,2,2,0,4,2020-06-26,Female,13,10-14,2
5,0,0,0,0,2020-06-30,Male,61,55-64,2
5,2,0,0,2,2020-06-29,Male,11,10-14,5
5,1,0,0,1,2020-06-29,Female,62,55-64,2
5,0,2,0,2,2020-06-29,Female,78,75-79,2
5,0,0,0,0,2020-06-30,Male,41,35-44,2
5,0,0,0,0,2020-06-30,Male,42,35-44,5
5,2,0,0,2,2020-07-01,Female,63,55-64,5
5,1,4,0,5,2020-06-26,Female,48,45-54,5
5,0,0,0,0,2020-06-29,Male,71,70-74,2
5,0,0,0,0,2020-06-29,Male,22,20-24,5
5,0,0,0,0,2020-06-26,Female,53,45-54,5
5,2,2,0,4,2020-06-30,Female,33,25-34,2
5,2,1,0,3,2020-06-30,Female,5,5-9,5
5,2,0,0,2,2020-06-27,Female,50,45-54,2
5,1,0,9,10,2020-06-26,Female,21,20-24,2
5,1,0,0,1,2020-06-28,Male,56,55-64,3
5,0,0,0,0,2020-06-28,Female,60,55-64,2
5,0,5,0,5,2020-06-30,Female,61,55-64,2
5,1,0,0,1,2020-06-30,Male,56,55-64,3
5,1,0,0,1,2020-06-28,Male,65,65-69,5
5,1,40,0,41,2020-06-26,Male,60,55-64,5
5,0,0,0,0,2020-06-26,Male,65,65-69,5
5,2,0,0,2,2020-06-29,Male,33,25-34,4
5,0,6,0,6,2020-06-29,Female,25,25-34,2
5,1,0,0,1,2020-06-28,Female,58,55-64,5
5,2,1,0,3,2020-06-26,Male,72,70-74,2
5,2,0,0,2,2020-06-30,Female,68,65-69,3
5,2,0,0,2,2020-06-29,Male,33,25-34,2
5,0,0,0,0,2020-06-30,Female,36,35-44,2
5,1,1,0,2,2020-07-01,Male,62,55-64,5
5,0,0,0,0,2020-06-30,Male,62,55-64,2
5,4,0,0,4,2020-06-27,Male,3,1-4,2
5,1,3,0,4,2020-06-26,Female,68,65-69,5
5,2,4,0,6,2020-06-26,Female,65,65-69,2
5,1,1,1,3,2020-06-26,Female,34,25-34,2
5,0,0,0,0,2020-06-27,Male,53,45-54,5
5,1,1,0,2,2020-06-29,Female,34,25-34,2
5,1,0,0,1,2020-06-30,Male,56,55-64,2
5,1,1,0,2,2020-06-30,Female,55,55-64,5
5,0,1,0,1,2020-06-27,Female,67,65-69,5
5,0,0,0,0,2020-06-29,Female,67,65-69,5
5,2,2,0,4,2020-06-26,Male,72,70-74,5
5,2,0,0,2,2020-06-26,Female,52,45-54,5
5,1,2,0,3,2020-07-01,Female,72,70-74,2
5,2,1,0,3,2020-06-29,Male,30,25-34,2
5,0,0,0,0,2020-06-29,Male,71,70-74,3
5,2,1,0,3,2020-06-30,Female,55,55-64,2
5,2,0,0,2,2020-06-29,Female,69,65-69,2
5,0,0,0,0,2020-06-26,Male,66,65-69,5
5,1,0,0,1,2020-06-30,Male,50,45-54,5
5,0,1,0,1,2020-06-26,Male,28,25-34,2
5,1,0,0,1,2020-06-29,Male,67,65-69,3
5,0,13,0,13,2020-06-27,Female,25,25-34,2
5,1,1,0,2,2020-06-29,Female,73,70-74,2
5,1,0,0,1,2020-06-27,Male,60,55-64,2
5,1,0,0,1,2020-06-26,Female,53,45-54,5
5,0,0,0,0,2020-06-30,Female,66,65-69,2
5,0,0,0,0,2020-06-28,Male,28,25-34,2
5,2,2,0,4,2020-06-27,Male,62,55-64,5
5,0,0,0,0,2020-06-29,Male,37,35-44,5
5,1,3,0,4,2020-06-29,Female,27,25-34,5
5,4,1,0,5,2020-06-30,Female,47,45-54,3
5,0,1,0,1,2020-06-30,Male,53,45-54,5
5,2,0,0,2,2020-06-28,Male,8,5-9,5
5,0,0,0,0,2020-06-26,Male,34,25-34,4
5,0,1,0,1,2020-06-29,Female,34,25-34,2
5,0,0,0,0,2020-06-29,Female,71,70-74,5
5,0,1,0,1,2020-06-29,Female,75,75-79,2
5,2,1,0,3,2020-06-29,Female,26,25-34,2
5,3,0,1,4,2020-06-26,Male,41,35-44,2
5,1,1,0,2,2020-06-27,Female,24,20-24,5
5,3,2,0,5,2020-06-30,Male,12,10-14,2
5,2,0,0,2,2020-06-29,Male,32,25-34,5
5,1,0,0,1,2020-06-26,Female,42,35-44,2
5,2,0,0,2,2020-06-29,Female,71,70-74,5
5,1,3,0,4,2020-06-26,Male,58,55-64,2
5,1,1,0,2,2020-06-26,Male,31,25-34,3
5,2,1,0,3,2020-06-27,Male,57,55-64,3
5,3,4,0,7,2020-06-26,Male,4,1-4,2
5,2,1,0,3,2020-06-26,Female,35,35-44,5
5,1,0,0,1,2020-06-27,Female,58,55-64,5
5,1,0,52,53,2020-06-27,Male,69,65-69,5
5,0,1,0,1,2020-06-26,Male,66,65-69,4
5,4,2,0,6,2020-06-30,Male,10,10-14,2
5,0,0,0,0,2020-06-27,Female,57,55-64,5
5,1,1,0,2,2020-06-29,Male,75,75-79,2
5,0,0,0,0,2020-06-28,Male,51,45-54,4
5,0,0,0,0,2020-06-28,Male,56,55-64,4
5,2,1,0,3,2020-06-29,Female,75,75-79,2
5,0,0,0,0,2020-06-26,Male,66,65-69,2
5,4,2,0,6,2020-06-30,Male,19,15-19,2
5,2,1,0,3,2020-06-26,Female,63,55-64,3
5,0,0,0,0,2020-06-26,Male,65,65-69,2
5,0,4,0,4,2020-06-30,Male,50,45-54,5
5,0,1,0,1,2020-06-29,Male,74,70-74,5
5,0,3,0,3,2020-06-26,Male,73,70-74,5
5,0,3,0,3,2020-06-26,Female,65,65-69,4
5,0,10,0,10,2020-06-28,Female,19,15-19,2
5,2,1,0,3,2020-06-27,Female,45,45-54,2
5,1,1,3,5,2020-06-27,Male,30,25-34,2
5,2,0,0,2,2020-06-29,Male,70,70-74,2
5,3,2,0,5,2020-06-27,Male,53,45-54,2
5,0,1,0,1,2020-06-28,Male,11,10-14,2
5,0,0,0,0,2020-07-01,Female,62,55-64,5
5,4,0,0,4,2020-06-29,Male,25,25-34,2
5,2,3,0,5,2020-06-29,Male,73,70-74,5
5,2,2,0,4,2020-06-29,Female,70,70-74,5
5,1,0,0,1,2020-06-26,Male,34,25-34,2
5,2,3,0,5,2020-07-01,Female,62,55-64,4
5,2,4,0,6,2020-06-28,Male,73,70-74,2
5,2,1,0,3,2020-06-29,Male,31,25-34,3
5,0,0,0,0,2020-06-30,Male,26,25-34,4
5,1,1,0,2,2020-06-29,Male,27,25-34,5
5,0,3,0,3,2020-06-26,Male,30,25-34,3
5,0,4,0,4,2020-06-29,Female,30,25-34,2
5,0,0,2,2,2020-06-26,Female,64,55-64,5
5,1,0,0,1,2020-06-30,Male,41,35-44,4
5,0,2,0,2,2020-06-28,Male,70,70-74,5
5,0,3,0,3,2020-06-26,Male,65,65-69,4
5,1,2,0,3,2020-06-27,Female,68,65-69,5
5,0,1,0,1,2020-06-30,Female,62,55-64,5
5,1,0,0,1,2020-06-30,Male,60,55-64,2
5,0,1,0,1,2020-06-27,Male,65,65-69,5
5,2,2,8,12,2020-06-26,Male,36,35-44,2
5,0,0,19,19,2020-06-26,Male,6,5-9,2
5,1,3,0,4,2020-06-30,Male,52,45-54,2
5,1,1,0,2,2020-06-30,Female,33,25-34,2
5,1,0,0,1,2020-06-29,Male,68,65-69,5
5,1,1,0,2,2020-07-01,Female,69,65-69,2
5,2,1,0,3,2020-06-28,Male,67,65-69,3
5,2,0,0,2,2020-06-28,Female,66,65-69,5
5,1,3,0,4,2020-06-28,Male,68,65-69,5
5,1,0,0,1,2020-06-27,Male,61,55-64,3
5,3,2,0,5,2020-06-30,Male,16,15-19,2
5,0,0,0,0,2020-06-28,Male,33,25-34,2
5,3,0,0,3,2020-06-30,Male,18,15-19,2
5,1,0,0,1,2020-06-26,Female,61,55-64,2
5,0,2,0,2,2020-06-26,Female,55,55-64,5
5,3,2,0,5,2020-06-29,Female,52,45-54,4
5,3,1,0,4,2020-06-27,Female,1,1-4,5
5,1,0,0,1,2020-06-26,Male,66,65-69,2
5,1,1,0,2,2020-06-30,Male,55,55-64,5
5,0,0,0,0,2020-06-30,Male,41,35-44,2
5,0,0,0,0,2020-07-01,Female,53,45-54,2
5,2,0,1,3,2020-06-27,Female,33,25-34,4
5,1,0,0,1,2020-06-30,Female,54,45-54,2
5,0,0,0,0,2020-06-26,Female,59,55-64,5
5,2,3,0,5,2020-06-29,Female,2,1-4,2
5,2,2,0,4,2020-06-30,Male,57,55-64,2
5,1,1,0,2,2020-06-28,Female,30,25-34,3
5,3,4,0,7,2020-06-30,Male,6,5-9,2
5,4,1,0,5,2020-06-30,Female,54,45-54,2
5,1,0,0,1,2020-06-28,Male,41,35-44,5
5,2,2,0,4,2020-06-26,Female,55,55-64,2
5,2,0,0,2,2020-06-29,Female,59,55-64,5
5,3,1,0,4,2020-06-30,Male,60,55-64,4
5,0,1,1,2,2020-06-29,Male,69,65-69,5
5,0,0,0,0,2020-06-28,Male,32,25-34,4
5,1,0,0,1,2020-06-30,Male,60,55-64,2
5,2,0,0,2,2020-06-29,Female,51,45-54,5
5,0,0,0,0,2020-06-27,Male,68,65-69,2
5,2,2,0,4,2020-06-30,Male,77,75-79,2
5,2,4,0,6,2020-06-29,Female,66,65-69,3
5,3,1,0,4,2020-06-30,Male,51,45-54,2
5,1,2,0,3,2020-06-30,Male,69,65-69,5
5,3,2,0,5,2020-06-27,Female,18,15-19,2
5,0,0,0,0,2020-06-26,Male,85,85+,5
5,4,0,0,4,2020-06-30,Female,16,15-19,5
5,1,0,0,1,2020-06-26,Female,64,55-64,5
5,2,0,0,2,2020-06-27,Female,37,35-44,3
5,0,5,3,8,2020-06-26,Male,67,65-69,4
5,4,1,0,5,2020-06-28,Female,47,45-54,2
5,2,0,0,2,2020-06-27,Male,13,10-14,2
5,1,11,1,13,2020-06-27,Female,55,55-64,2
5,3,3,0,6,2020-06-26,Male,63,55-64,2
5,0,0,0,0,2020-06-28,Female,49,45-54,5
5,0,3,7,10,2020-07-01,Female,60,55-64,5
5,0,1,0,1,2020-06-30,Male,36,35-44,4
5,3,0,0,3,2020-06-29,Female,3,1-4,2
5,2,5,0,7,2020-06-30,Female,52,45-54,3
5,2,0,0,2,2020-06-30,Male,63,55-64,2
5,2,3,0,5,2020-06-28,Male,50,45-54,2
5,0,0,0,0,2020-06-29,Male,73,70-74,2
5,2,1,0,3,2020-06-29,Female,73,70-74,2
5,4,0,0,4,2020-06-30,Male,12,10-14,5
5,1,0,0,1,2020-06-26,Female,17,15-19,2
5,0,7,0,7,2020-06-26,Male,61,55-64,2
5,2,0,0,2,2020-06-28,Female,54,45-54,3
5,2,1,1,4,2020-06-29,Female,19,15-19,2
5,2,0,0,2,2020-06-27,Female,52,45-54,3
5,1,0,0,1,2020-06-26,Male,53,45-54,2
5,3,2,0,5,2020-06-30,Male,28,25-34,2
5,2,1,0,3,2020-07-01,Female,65,65-69,4
5,0,2,0,2,2020-06-29,Female,43,35-44,2
5,2,0,0,2,2020-06-29,Male,61,55-64,2
5,3,0,0,3,2020-06-27,Male,15,15-19,5
5,1,2,0,3,2020-06-30,Male,52,45-54,2
5,2,5,0,7,2020-06-30,Female,50,45-54,2
5,0,1,2,3,2020-06-26,Female,60,55-64,5
5,3,0,0,3,2020-06-27,Male,12,10-14,4
5,1,0,0,1,2020-06-30,Male,18,15-19,5
5,2,2,0,4,2020-06-27,Female,59,55-64,2
5,2,3,0,5,2020-06-27,Female,67,65-69,2
5,0,1,0,1,2020-06-26,Male,63,55-64,2
5,2,0,0,2,2020-06-28,Male,67,65-69,5
5,0,0,0,0,2020-06-30,Male,37,35-44,5
5,0,0,0,0,2020-07-01,Female,66,65-69,2
5,0,0,0,0,2020-06-30,Male,60,55-64,5
5,1,1,0,2,2020-06-26,Female,63,55-64,3
5,1,0,0,1,2020-06-29,Female,67,65-69,5
5,2,1,0,3,2020-06-28,Female,39,35-44,5
5,0,11,2,13,2020-06-26,Female,5,5-9,2
5,1,0,0,1,2020-06-30,Female,33,25-34,5
5,0,2,2,4,2020-06-27,Male,66,65-69,5
5,0,0,0,0,2020-06-30,Female,51,45-54,4
5,0,0,0,0,2020-06-26,Female,32,25-34,4
5,4,0,0,4,2020-06-28,Female,54,45-54,2
5,4,0,0,4,2020-06-30,Female,17,15-19,2
5,0,3,0,3,2020-06-29,Female,43,35-44,2
5,1,0,0,1,2020-06-27,Male,66,65-69,2
5,2,0,0,2,2020-06-27,Female,62,55-64,2
5,4,15,0,19,2020-06-27,Female,2,1-4,2
5,1,5,0,6,2020-06-27,Female,50,45-54,3
5,0,0,0,0,2020-06-30,Female,66,65-69,4
5,1,0,0,1,2020-06-29,Female,72,70-74,5
5,2,0,0,2,2020-07-01,Female,41,35-44,2
5,0,0,0,0,2020-06-29,Male,58,55-64,5
5,0,0,0,0,2020-06-30,Female,23,20-24,3
5,1,0,0,1,2020-06-30,Male,78,75-79,5
5,3,27,0,30,2020-06-30,Female,6,5-9,2
5,2,4,0,6,2020-06-26,Male,43,35-44,2
5,0,4,30,34,2020-06-26,Female,62,55-64,2
5,2,2,0,4,2020-07-01,Male,68,65-69,5
5,2,0,0,2,2020-06-29,Female,55,55-64,5
5,0,0,9,9,2020-06-26,Male,43,35-44,2
5,1,1,0,2,2020-06-26,Female,61,55-64,2
5,1,7,0,8,2020-06-27,Male,67,65-69,2
5,1,2,60,63,2020-06-27,Male,63,55-64,5
5,2,4,0,6,2020-06-29,Male,72,70-74,5
5,1,0,0,1,2020-06-26,Female,64,55-64,5
5,2,2,0,4,2020-06-26,Male,53,45-54,2
5,0,1,0,1,2020-06-26,Female,66,65-69,5
5,0,3,0,3,2020-06-26,Female,71,70-74,5
5,2,0,0,2,2020-06-30,Female,71,70-74,5
5,0,0,0,0,2020-06-26,Female,65,65-69,2
5,1,1,0,2,2020-06-30,Female,49,45-54,5
5,4,0,0,4,2020-06-26,Female,58,55-64,5
5,1,0,0,1,2020-06-28,Female,33,25-34,2
5,1,0,0,1,2020-06-29,Male,73,70-74,2
5,3,1,0,4,2020-06-30,Female,2,1-4,2
5,0,2,0,2,2020-06-27,Female,40,35-44,5
5,0,0,0,0,2020-06-26,Male,21,20-24,5
5,0,0,40,40,2020-06-26,Male,35,35-44,4
5,0,0,0,0,2020-06-27,Male,54,45-54,5
5,0,1,2,3,2020-06-26,Male,23,20-24,2
5,1,3,0,4,2020-07-01,Female,36,35-44,5
5,3,0,0,3,2020-06-30,Female,9,5-9,5
5,1,1,0,2,2020-06-30,Male,54,45-54,2
5,2,1,0,3,2020-06-30,Male,61,55-64,5
5,4,3,0,7,2020-06-26,Female,10,10-14,2
5,0,0,0,0,2020-06-26,Male,39,35-44,5
5,0,0,0,0,2020-06-30,Female,56,55-64,2
5,2,0,0,2,2020-06-29,Female,67,65-69,5
5,0,1,2,3,2020-06-26,Male,14,10-14,3
5,0,0,0,0,2020-06-26,Female,70,70-74,5
5,2,3,0,5,2020-06-29,Male,73,70-74,5
5,2,0,0,2,2020-06-26,Female,65,65-69,5
5,0,0,0,0,2020-06-27,Female,33,25-34,5
5,3,1,0,4,2020-06-26,Male,41,35-44,4
5,1,4,0,5,2020-06-29,Male,73,70-74,4
5,1,5,0,6,2020-06-27,Male,30,25-34,2
5,0,0,0,0,2020-06-28,Female,36,35-44,2
5,0,1,0,1,2020-06-26,Female,37,35-44,2
5,0,1,0,1,2020-06-30,Male,67,65-69,5
5,3,1,0,4,2020-06-26,Female,9,5-9,2
5,1,35,32,68,2020-06-27,Male,66,65-69,5
5,1,0,0,1,2020-06-26,Female,60,55-64,5
5,1,2,0,3,2020-07-01,Female,66,65-69,4
5,1,1,0,2,2020-06-26,Male,66,65-69,5
5,2,0,0,2,2020-06-29,Female,11,10-14,2
5,1,2,0,3,2020-06-29,Male,70,70-74,2
5,3,2,0,5,2020-06-30,Female,12,10-14,5
5,3,2,0,5,2020-06-27,Male,43,35-44,2
5,0,3,0,3,2020-06-26,Male,21,20-24,3
5,0,0,0,0,2020-06-28,Female,4,1-4,4
5,2,0,0,2,2020-06-27,Male,25,25-34,2
5,2,3,0,5,2020-06-29,Male,69,65-69,5
5,1,30,0,31,2020-06-26,Male,65,65-69,5
5,0,1,0,1,2020-06-26,Male,31,25-34,2
5,1,0,0,1,2020-06-29,Male,74,70-74,2
5,0,5,0,5,2020-07-01,Female,36,35-44,2
5,0,2,0,2,2020-06-30,Female,24,20-24,3
5,3,0,0,3,2020-06-28,Female,64,55-64,5
5,0,3,0,3,2020-06-29,Female,66,65-69,5
5,0,2,15,17,2020-07-01,Female,75,75-79,5
5,0,0,0,0,2020-06-26,Female,36,35-44,5
5,0,1,0,1,2020-06-30,Female,44,35-44,2
5,2,0,0,2,2020-06-29,Male,32,25-34,5
5,3,0,0,3,2020-06-30,Male,17,15-19,5
5,3,0,0,3,2020-06-27,Male,33,25-34,3
5,2,0,0,2,2020-06-28,Female,22,20-24,5
5,0,0,0,0,2020-06-30,Male,34,25-34,2
5,2,0,0,2,2020-06-29,Male,62,55-64,2
5,3,1,0,4,2020-06-28,Male,19,15-19,2
5,1,3,0,4,2020-06-26,Male,65,65-69,3
5,3,0,0,3,2020-06-27,Female,10,10-14,5
5,0,1,0,1,2020-07-01,Male,26,25-34,2
5,1,1,26,28,2020-06-26,Female,65,65-69,2
5,1,0,0,1,2020-06-29,Male,53,45-54,5
5,0,0,0,0,2020-06-29,Female,51,45-54,5
5,1,0,0,1,2020-06-30,Male,58,55-64,2
5,2,0,0,2,2020-06-26,Male,62,55-64,5
5,2,0,0,2,2020-06-26,Male,65,65-69,4
5,2,0,0,2,2020-06-29,Female,21,20-24,2
5,2,0,0,2,2020-06-26,Male,37,35-44,4
5,2,0,0,2,2020-06-28,Female,66,65-69,5
5,0,0,0,0,2020-07-01,Male,30,25-34,2
5,0,0,0,0,2020-06-26,Male,27,25-34,2
5,0,0,0,0,2020-06-26,Female,43,35-44,5
5,1,17,25,43,2020-06-30,Male,67,65-69,2
5,0,2,0,2,2020-06-27,Female,61,55-64,2
5,1,0,0,1,2020-06-29,Male,32,25-34,2
5,0,0,0,0,2020-06-26,Male,63,55-64,5
5,2,0,0,2,2020-06-30,Female,52,45-54,5
5,0,0,2,2,2020-06-30,Male,53,45-54,2
5,2,0,0,2,2020-06-26,Female,48,45-54,5
5,0,5,0,5,2020-06-27,Male,23,20-24,2
5,3,0,0,3,2020-06-29,Male,19,15-19,2
5,0,1,0,1,2020-06-29,Female,72,70-74,2
5,0,0,0,0,2020-06-26,Female,63,55-64,5
5,4,1,0,5,2020-06-30,Female,13,10-14,2
5,1,2,0,3,2020-06-30,Female,31,25-34,2
5,4,0,0,4,2020-06-28,Male,9,5-9,2
5,0,0,0,0,2020-06-28,Female,25,25-34,4
5,0,2,0,2,2020-06-27,Female,21,20-24,4
5,2,0,0,2,2020-06-30,Male,39,35-44,2
5,2,0,0,2,2020-06-29,Male,46,45-54,5
5,1,0,0,1,2020-06-30,Male,61,55-64,5
5,0,5,0,5,2020-06-29,Female,68,65-69,2
5,1,0,0,1,2020-06-27,Male,67,65-69,5
5,3,0,0,3,2020-06-29,Female,0,<1,2
5,3,0,0,3,2020-06-26,Male,6,5-9,5
5,2,1,0,3,2020-06-29,Male,70,70-74,2
5,2,1,0,3,2020-06-27,Female,47,45-54,5
5,1,0,0,1,2020-06-29,Female,60,55-64,5
5,4,0,0,4,2020-06-29,Female,32,25-34,3
5,3,4,18,25,2020-06-30,Female,16,15-19,2
5,4,1,0,5,2020-06-27,Female,17,15-19,2
5,4,12,0,16,2020-06-30,Female,7,5-9,2
5,1,0,0,1,2020-06-26,Male,63,55-64,5
5,0,4,0,4,2020-06-29,Female,19,15-19,2
5,1,0,0,1,2020-06-26,Female,19,15-19,2
5,2,3,0,5,2020-06-30,Female,47,45-54,4
5,1,4,0,5,2020-06-26,Female,66,65-69,2
5,0,0,0,0,2020-06-28,Male,34,25-34,2
5,5,1,0,6,2020-06-26,Male,43,35-44,2
5,0,3,0,3,2020-06-27,Female,69,65-69,3
5,0,1,6,7,2020-06-27,Female,34,25-34,2
5,1,0,0,1,2020-06-30,Male,57,55-64,5
5,2,0,0,2,2020-06-26,Male,63,55-64,5
5,1,1,4,6,2020-06-26,Female,62,55-64,4
5,1,1,1,3,2020-06-29,Female,63,55-64,4
5,0,2,0,2,2020-06-28,Female,20,20-24,2
5,2,0,0,2,2020-06-29,Female,68,65-69,5
5,1,0,0,1,2020-06-30,Male,52,45-54,5
5,3,0,0,3,2020-06-29,Male,49,45-54,4
5,2,0,0,2,2020-07-01,Female,63,55-64,2
5,0,0,0,0,2020-06-29,Female,69,65-69,2
5,1,3,0,4,2020-06-26,Female,67,65-69,3
5,0,0,0,0,2020-06-30,Male,17,15-19,5
5,0,0,0,0,2020-06-26,Female,65,65-69,2
5,2,0,0,2,2020-06-29,Male,24,20-24,2
5,1,0,0,1,2020-06-27,Male,59,55-64,5
5,2,0,0,2,2020-06-29,Female,38,35-44,3
5,4,2,3,9,2020-06-28,Male,13,10-14,2
5,0,0,0,0,2020-06-29,Male,32,25-34,2
5,0,0,0,0,2020-06-26,Male,41,35-44,4
5,2,1,0,3,2020-06-26,Female,64,55-64,2
5,1,1,0,2,2020-06-26,Male,67,65-69,5
5,3,1,0,4,2020-06-27,Male,12,10-14,2
5,1,8,0,9,2020-06-29,Female,58,55-64,5
5,2,0,0,2,2020-06-27,Female,24,20-24,2
5,2,3,40,45,2020-06-26,Female,31,25-34,2
5,0,1,0,1,2020-06-30,Male,60,55-64,5
5,1,2,8,11,2020-06-27,Female,25,25-34,2
5,2,8,0,10,2020-07-01,Male,62,55-64,2
5,0,1,0,1,2020-06-28,Female,54,45-54,5
5,2,0,0,2,2020-06-28,Female,65,65-69,2
5,0,0,0,0,2020-06-27,Female,67,65-69,3
5,1,0,0,1,2020-06-29,Female,37,35-44,2
5,1,1,0,2,2020-06-29,Male,29,25-34,4
5,0,1,0,1,2020-06-26,Female,18,15-19,2
5,0,0,0,0,2020-06-27,Male,29,25-34,4
5,0,0,0,0,2020-06-28,Male,1,1-4,2
5,0,5,0,5,2020-07-01,Female,39,35-44,5
5,2,1,3,6,2020-06-30,Male,15,15-19,2
5,2,0,0,2,2020-06-26,Male,50,45-54,2
5,2,0,0,2,2020-06-30,Male,46,45-54,2
5,0,4,0,4,2020-06-29,Male,39,35-44,2
5,0,4,90,94,2020-06-26,Male,9,5-9,2
5,0,3,0,3,2020-06-27,Female,67,65-69,3
5,1,0,0,1,2020-06-26,Male,45,45-54,2
5,0,0,3,3,2020-06-26,Female,19,15-19,2
5,1,0,0,1,2020-06-28,Female,52,45-54,2
5,3,0,0,3,2020-06-26,Male,25,25-34,2
5,4,2,0,6,2020-06-29,Female,12,10-14,2
5,1,3,0,4,2020-06-28,Female,27,25-34,3
5,2,3,10,15,2020-07-01,Female,7,5-9,2
5,0,1,0,1,2020-06-26,Male,12,10-14,3
5,0,3,0,3,2020-06-27,Female,66,65-69,5
5,2,2,0,4,2020-06-28,Female,67,65-69,2
5,0,0,0,0,2020-06-28,Female,68,65-69,5
5,3,0,0,3,2020-06-27,Female,51,45-54,2
5,4,2,0,6,2020-06-29,Female,15,15-19,3
5,4,0,0,4,2020-06-29,Male,11,10-14,5
5,0,5,0,5,2020-06-26,Male,45,45-54,2
5,2,4,0,6,2020-06-30,Female,54,45-54,2
5,0,3,0,3,2020-06-27,Female,27,25-34,5
5,2,0,0,2,2020-06-28,Male,47,45-54,5
5,2,3,0,5,2020-06-26,Female,52,45-54,5
5,2,3,0,5,2020-06-29,Female,68,65-69,5
5,4,11,0,15,2020-06-26,Female,20,20-24,2
5,0,2,0,2,2020-06-30,Female,37,35-44,5
5,4,0,0,4,2020-06-28,Female,20,20-24,2
5,2,0,0,2,2020-06-29,Male,67,65-69,5
5,0,1,0,1,2020-06-26,Male,48,45-54,2
5,2,0,0,2,2020-06-29,Female,72,70-74,4
5,2,0,0,2,2020-06-26,Male,63,55-64,2
5,3,2,0,5,2020-06-30,Female,22,20-24,4
5,0,1,0,1,2020-06-29,Male,27,25-34,2
5,2,0,0,2,2020-06-26,Male,35,35-44,2
5,1,0,0,1,2020-06-30,Male,49,45-54,4
5,0,0,0,0,2020-07-01,Female,49,45-54,5
5,2,2,0,4,2020-06-30,Female,68,65-69,5
5,0,0,0,0,2020-06-26,Female,52,45-54,2
5,2,0,0,2,2020-06-29,Male,68,65-69,5
5,2,0,0,2,2020-06-28,Female,47,45-54,4
5,4,10,10,24,2020-06-27,Female,16,15-19,4
5,3,2,0,5,2020-06-29,Male,84,80-84,5
5,1,0,0,1,2020-06-28,Female,51,45-54,3
5,1,0,0,1,2020-06-26,Female,31,25-34,5
5,1,2,0,3,2020-06-27,Female,53,45-54,5
5,2,1,0,3,2020-06-28,Female,70,70-74,2
5,2,4,0,6,2020-06-27,Female,66,65-69,3
5,0,0,0,0,2020-06-26,Male,49,45-54,5
5,0,1,0,1,2020-07-01,Female,50,45-54,5
5,2,2,0,4,2020-06-29,Female,21,20-24,2
5,1,1,0,2,2020-06-27,Female,67,65-69,3
5,1,0,0,1,2020-06-29,Male,31,25-34,4
5,1,0,0,1,2020-06-29,Male,13,10-14,3
5,2,0,0,2,2020-06-28,Male,25,25-34,4
5,0,4,0,4,2020-06-28,Male,30,25-34,3
5,2,0,0,2,2020-06-27,Male,65,65-69,5
5,1,2,0,3,2020-06-27,Male,42,35-44,4
5,0,2,0,2,2020-06-28,Female,56,55-64,2
5,0,0,0,0,2020-06-28,Female,30,25-34,5
5,2,3,0,5,2020-06-27,Female,79,75-79,5
5,1,0,0,1,2020-06-29,Female,69,65-69,4
5,0,0,0,0,2020-06-29,Female,69,65-69,5
5,1,1,0,2,2020-06-26,Male,70,70-74,5
5,0,0,0,0,2020-06-29,Female,36,35-44,3
5,0,0,0,0,2020-06-30,Male,60,55-64,5
5,4,1,8,13,2020-06-30,Male,6,5-9,4
5,1,6,0,7,2020-06-29,Female,29,25-34,4
5,3,0,2,5,2020-06-26,Male,11,10-14,2
5,0,1,0,1,2020-06-26,Male,33,25-34,5
5,2,0,0,2,2020-06-30,Male,17,15-19,2
5,4,0,0,4,2020-06-26,Male,17,15-19,2
6,0,11,0,11,2020-07-14,Male,59,55-64,4
6,1,2,0,3,2020-07-13,Male,67,65-69,2
6,2,1,0,3,2020-07-10,Female,58,55-64,4
6,2,4,0,6,2020-07-14,Female,69,65-69,3
6,1,0,0,1,2020-07-10,Female,65,65-69,6
6,0,1,0,1,2020-07-14,Female,71,70-74,4
6,0,1,0,1,2020-07-10,Female,50,45-54,3
6,1,1,0,2,2020-07-09,Female,71,70-74,6
6,0,0,0,0,2020-07-09,Male,29,25-34,3
6,0,2,0,2,2020-07-12,Female,52,45-54,4
6,0,0,0,0,2020-07-10,Female,53,45-54,3
6,0,0,0,0,2020-07-11,Female,67,65-69,3
6,2,0,0,2,2020-07-10,Male,34,25-34,6
6,3,0,0,3,2020-07-13,Male,7,5-9,6
6,1,0,0,1,2020-07-14,Female,60,55-64,4
6,0,0,0,0,2020-07-15,Male,50,45-54,5
6,1,0,1,2,2020-07-10,Male,50,45-54,3
6,0,1,0,1,2020-07-11,Female,35,35-44,3
6,4,1,0,5,2020-07-14,Female,57,55-64,5
6,3,0,0,3,2020-07-09,Female,9,5-9,6
6,0,0,0,0,2020-07-09,Male,32,25-34,5
6,1,5,0,6,2020-07-12,Male,66,65-69,3
6,2,2,0,4,2020-07-13,Male,66,65-69,4
6,1,1,0,2,2020-07-11,Male,62,55-64,6
6,0,0,0,0,2020-07-09,Male,12,10-14,3
6,0,0,0,0,2020-07-12,Male,19,15-19,6
6,0,2,0,2,2020-07-09,Male,48,45-54,3
6,1,0,0,1,2020-07-10,Male,34,25-34,3
6,0,3,0,3,2020-07-11,Male,53,45-54,2
6,2,2,0,4,2020-07-14,Female,70,70-74,6
6,1,3,0,4,2020-07-14,Male,67,65-69,6
6,5,0,0,5,2020-07-09,Male,20,20-24,3
6,1,2,0,3,2020-07-09,Female,52,45-54,3
6,2,0,0,2,2020-07-13,Female,68,65-69,6
6,0,0,0,0,2020-07-09,Male,41,35-44,6
6,1,1,0,2,2020-07-13,Female,56,55-64,6
6,2,0,0,2,2020-07-09,Female,21,20-24,5
6,2,0,0,2,2020-07-09,Male,51,45-54,6
6,0,0,0,0,2020-07-14,Male,85,85+,6
6,0,0,0,0,2020-07-13,Female,61,55-64,5
6,0,4,0,4,2020-07-10,Female,66,65-69,3
6,2,0,0,2,2020-07-13,Male,1,1-4,3
6,2,0,0,2,2020-07-12,Female,9,5-9,2
6,5,0,0,5,2020-07-13,Male,19,15-19,2
6,1,0,0,1,2020-07-10,Male,57,55-64,6
6,0,0,0,0,2020-07-13,Male,67,65-69,6
6,1,4,0,5,2020-07-11,Male,50,45-54,4
6,1,0,0,1,2020-07-14,Male,71,70-74,3
6,0,0,0,0,2020-07-14,Male,76,75-79,6
6,2,0,0,2,2020-07-14,Male,71,70-74,6
6,1,6,0,7,2020-07-13,Male,43,35-44,3
6,0,0,0,0,2020-07-10,Male,51,45-54,6
6,1,0,1,2,2020-07-11,Male,43,35-44,3
6,4,0,0,4,2020-07-15,Male,43,35-44,5
6,1,2,0,3,2020-07-09,Female,59,55-64,6
6,0,1,0,1,2020-07-10,Male,0,<1,3
6,0,4,0,4,2020-07-09,Male,48,45-54,3
6,2,4,0,6,2020-07-10,Male,69,65-69,4
6,0,1,0,1,2020-07-15,Female,76,75-79,6
6,2,0,0,2,2020-07-13,Female,55,55-64,3
6,1,2,0,3,2020-07-13,Female,67,65-69,4
6,0,2,0,2,2020-07-14,Female,51,45-54,3
6,1,2,0,3,2020-07-09,Male,38,35-44,5
6,1,4,0,5,2020-07-09,Male,62,55-64,3
6,2,0,0,2,2020-07-13,Female,13,10-14,3
6,0,0,0,0,2020-07-14,Male,72,70-74,3
6,0,0,0,0,2020-07-14,Male,85,85+,3
6,2,1,0,3,2020-07-14,Female,71,70-74,5
6,1,5,0,6,2020-07-12,Male,44,35-44,6
6,2,3,0,5,2020-07-09,Male,54,45-54,6
6,2,4,1,7,2020-07-09,Male,70,70-74,3
6,2,1,0,3,2020-07-16,Male,66,65-69,3
6,1,1,0,2,2020-07-10,Female,65,65-69,6
6,1,2,0,3,2020-07-10,Male,11,10-14,3
6,2,0,22,24,2020-07-13,Male,67,65-69,6
6,0,1,0,1,2020-07-10,Male,68,65-69,3
6,2,0,0,2,2020-07-09,Male,34,25-34,3
6,4,6,0,10,2020-07-14,Female,14,10-14,3
6,1,1,0,2,2020-07-13,Male,67,65-69,5
6,0,0,0,0,2020-07-09,Male,42,35-44,3
6,0,0,0,0,2020-07-10,Female,9,5-9,5
6,1,4,1,6,2020-07-15,Female,43,35-44,3
6,0,0,0,0,2020-07-13,Male,32,25-34,3
6,1,8,0,9,2020-07-14,Male,69,65-69,6
6,4,0,0,4,2020-07-09,Female,2,1-4,4
6,0,0,0,0,2020-07-10,Male,37,35-44,4
6,3,0,0,3,2020-07-12,Female,15,15-19,4
6,2,0,0,2,2020-07-09,Female,60,55-64,6
6,6,0,0,6,2020-07-10,Male,18,15-19,5
6,1,11,6,18,2020-07-09,Male,31,25-34,3
6,0,2,0,2,2020-07-14,Female,52,45-54,5
6,1,0,0,1,2020-07-10,Male,48,45-54,6
6,1,2,0,3,2020-07-14,Male,69,65-69,3
6,1,3,0,4,2020-07-13,Female,66,65-69,3
6,1,1,0,2,2020-07-13,Female,26,25-34,3
6,1,7,0,8,2020-07-10,Female,62,55-64,5
6,0,1,0,1,2020-07-11,Female,33,25-34,3
6,1,1,0,2,2020-07-14,Male,74,70-74,3
6,0,1,0,1,2020-07-12,Female,30,25-34,5
6,2,2,0,4,2020-07-15,Female,67,65-69,3
6,2,1,0,3,2020-07-14,Male,18,15-19,3
6,1,0,0,1,2020-07-15,Female,62,55-64,5
6,0,0,0,0,2020-07-09,Male,17,15-19,3
6,0,1,0,1,2020-07-15,Female,46,45-54,5
6,1,2,1,4,2020-07-13,Male,68,65-69,3
6,1,1,0,2,2020-07-15,Female,57,55-64,2
6,0,4,0,4,2020-07-10,Male,54,45-54,3
6,0,0,0,0,2020-07-10,Male,33,25-34,3
6,2,4,0,6,2020-07-09,Male,29,25-34,2
6,1,2,0,3,2020-07-14,Male,57,55-64,4
6,0,0,0,0,2020-07-10,Male,3,1-4,2
6,3,0,0,3,2020-07-14,Female,72,70-74,6
6,0,1,0,1,2020-07-09,Male,33,25-34,6
6,0,0,0,0,2020-07-10,Male,65,65-69,3
6,2,1,0,3,2020-07-13,Male,27,25-34,3
6,0,0,0,0,2020-07-15,Female,30,25-34,3
6,0,0,0,0,2020-07-10,Male,7,5-9,3
6,0,1,0,1,2020-07-12,Female,33,25-34,3
6,0,0,0,0,2020-07-09,Male,37,35-44,5
6,1,3,0,4,2020-07-09,Female,61,55-64,4
6,1,1,0,2,2020-07-09,Male,65,65-69,3
6,0,4,0,4,2020-07-10,Male,63,55-64,5
6,0,0,0,0,2020-07-14,Male,6,5-9,3
6,1,3,0,4,2020-07-16,Female,55,55-64,3
6,0,5,0,5,2020-07-13,Male,68,65-69,3
6,1,1,10,12,2020-07-09,Female,67,65-69,5
6,3,0,0,3,2020-07-09,Male,41,35-44,3
6,2,0,0,2,2020-07-14,Male,58,55-64,6
6,2,0,32,34,2020-07-10,Male,25,25-34,3
6,0,1,0,1,2020-07-10,Female,62,55-64,3
6,4,0,0,4,2020-07-13,Male,11,10-14,3
6,3,1,0,4,2020-07-12,Female,68,65-69,4
6,0,1,1,2,2020-07-13,Male,69,65-69,3
6,3,0,0,3,2020-07-09,Male,31,25-34,3
6,2,1,0,3,2020-07-09,Male,35,35-44,5
6,2,0,0,2,2020-07-09,Male,69,65-69,3
6,3,0,0,3,2020-07-13,Male,24,20-24,3
6,5,0,0,5,2020-07-09,Male,16,15-19,3
6,3,0,0,3,2020-07-09,Female,12,10-14,3
6,1,0,0,1,2020-07-10,Male,65,65-69,5
6,0,14,0,14,2020-07-10,Female,66,65-69,2
6,1,0,0,1,2020-07-09,Female,28,25-34,5
6,2,3,10,15,2020-07-09,Female,66,65-69,4
6,1,0,0,1,2020-07-09,Female,56,55-64,3
6,3,1,0,4,2020-07-09,Female,23,20-24,2
6,1,0,0,1,2020-07-14,Male,52,45-54,6
6,1,1,0,2,2020-07-14,Male,27,25-34,2
6,0,0,0,0,2020-07-09,Male,56,55-64,6
6,2,2,0,4,2020-07-14,Male,70,70-74,3
6,2,3,0,5,2020-07-14,Male,17,15-19,6
6,1,0,0,1,2020-07-09,Female,51,45-54,6
6,5,0,0,5,2020-07-09,Male,28,25-34,3
6,4,0,0,4,2020-07-11,Male,6,5-9,3
6,0,1,0,1,2020-07-09,Male,16,15-19,3
6,3,3,0,6,2020-07-09,Male,65,65-69,4
6,1,1,0,2,2020-07-13,Female,58,55-64,4
6,2,0,0,2,2020-07-11,Female,23,20-24,3
6,0,4,0,4,2020-07-10,Female,65,65-69,6
6,0,0,0,0,2020-07-13,Female,41,35-44,3
6,1,0,0,1,2020-07-14,Female,59,55-64,6
6,0,0,0,0,2020-07-14,Female,66,65-69,3
6,0,0,0,0,2020-07-13,Male,70,70-74,6
6,2,2,0,4,2020-07-09,Male,21,20-24,3
6,1,1,0,2,2020-07-14,Male,74,70-74,6
6,0,0,0,0,2020-07-10,Male,50,45-54,2
6,2,0,0,2,2020-07-11,Female,30,25-34,3
6,1,0,0,1,2020-07-13,Female,54,45-54,6
6,0,0,0,0,2020-07-09,Female,21,20-24,2
6,0,0,0,0,2020-07-10,Male,53,45-54,3
6,1,0,0,1,2020-07-14,Male,50,45-54,6
6,1,0,0,1,2020-07-09,Female,49,45-54,3
6,1,2,0,3,2020-07-14,Female,60,55-64,2
6,1,1,0,2,2020-07-09,Female,29,25-34,3
6,3,1,0,4,2020-07-10,Male,41,35-44,2
6,2,12,0,14,2020-07-09,Male,17,15-19,3
6,2,0,0,2,2020-07-14,Female,68,65-69,3
6,2,0,0,2,2020-07-10,Male,65,65-69,6
6,0,2,0,2,2020-07-12,Male,64,55-64,3
6,2,0,0,2,2020-07-13,Male,68,65-69,6
6,1,0,0,1,2020-07-13,Male,52,45-54,6
6,1,1,0,2,2020-07-11,Female,57,55-64,5
6,0,0,0,0,2020-07-10,Male,50,45-54,5
6,1,1,0,2,2020-07-13,Female,59,55-64,3
6,0,1,0,1,2020-07-09,Male,70,70-74,6
6,1,0,0,1,2020-07-15,Male,40,35-44,2
6,2,0,0,2,2020-07-09,Female,69,65-69,6
6,0,2,0,2,2020-07-12,Male,37,35-44,3
6,0,0,0,0,2020-07-09,Male,19,15-19,3
6,0,0,0,0,2020-07-10,Male,51,45-54,2
6,1,0,0,1,2020-07-12,Female,56,55-64,6
6,1,0,0,1,2020-07-09,Female,59,55-64,6
6,0,0,0,0,2020-07-12,Male,43,35-44,6
6,2,0,0,2,2020-07-13,Female,62,55-64,6
6,2,0,0,2,2020-07-09,Male,31,25-34,5
6,2,5,0,7,2020-07-11,Female,52,45-54,5
6,2,5,0,7,2020-07-11,Male,68,65-69,6
6,0,0,0,0,2020-07-09,Male,33,25-34,5
6,0,0,0,0,2020-07-12,Male,47,45-54,3
6,2,0,0,2,2020-07-14,Male,69,65-69,3
6,0,2,0,2,2020-07-10,Male,65,65-69,6
6,2,1,0,3,2020-07-11,Male,65,65-69,4
6,3,0,0,3,2020-07-09,Male,11,10-14,3
6,2,2,0,4,2020-07-14,Male,67,65-69,6
6,4,3,0,7,2020-07-10,Female,1,1-4,3
6,0,9,0,9,2020-07-10,Male,39,35-44,3
6,2,6,0,8,2020-07-13,Female,18,15-19,2
6,0,0,0,0,2020-07-14,Male,43,35-44,2
6,0,0,0,0,2020-07-09,Female,56,55-64,5
6,0,0,0,0,2020-07-09,Female,58,55-64,3
6,0,0,0,0,2020-07-14,Female,66,65-69,6
6,1,0,70,71,2020-07-09,Male,22,20-24,2
6,0,0,0,0,2020-07-10,Female,40,35-44,6
6,0,0,0,0,2020-07-13,Male,44,35-44,6
6,0,4,0,4,2020-07-09,Female,24,20-24,2
6,0,5,0,5,2020-07-11,Female,63,55-64,4
6,3,0,0,3,2020-07-09,Male,18,15-19,3
6,1,2,0,3,2020-07-09,Female,60,55-64,6
6,1,1,0,2,2020-07-10,Male,61,55-64,5
6,1,0,0,1,2020-07-10,Male,60,55-64,3
6,0,0,0,0,2020-07-09,Male,17,15-19,3
6,1,0,0,1,2020-07-10,Female,53,45-54,6
6,0,0,0,0,2020-07-11,Male,33,25-34,3
6,0,1,0,1,2020-07-14,Male,55,55-64,3
6,0,0,0,0,2020-07-10,Female,65,65-69,6
6,2,0,0,2,2020-07-09,Male,27,25-34,4
6,1,0,0,1,2020-07-14,Male,73,70-74,6
6,3,0,0,3,2020-07-14,Female,8,5-9,3
6,1,2,0,3,2020-07-14,Male,78,75-79,3
6,0,2,0,2,2020-07-10,Female,66,65-69,3
6,0,1,2,3,2020-07-12,Male,38,35-44,4
6,2,3,0,5,2020-07-10,Female,19,15-19,3
6,2,0,0,2,2020-07-14,Female,54,45-54,6
6,1,4,0,5,2020-07-14,Female,70,70-74,3
6,0,0,0,0,2020-07-11,Male,53,45-54,5
6,1,0,40,41,2020-07-14,Male,48,45-54,4
6,1,0,0,1,2020-07-13,Male,68,65-69,6
6,0,3,0,3,2020-07-09,Male,15,15-19,4
6,1,1,0,2,2020-07-13,Female,32,25-34,4
6,0,3,0,3,2020-07-09,Male,36,35-44,6
6,3,0,0,3,2020-07-12,Female,49,45-54,3
6,2,1,0,3,2020-07-10,Male,39,35-44,6
6,2,1,0,3,2020-07-09,Female,60,55-64,3
6,0,0,0,0,2020-07-09,Male,32,25-34,4
6,2,1,0,3,2020-07-10,Male,61,55-64,6
6,1,2,0,3,2020-07-13,Female,68,65-69,5
6,4,1,0,5,2020-07-09,Female,23,20-24,2
6,0,0,0,0,2020-07-09,Male,8,5-9,3
6,1,0,0,1,2020-07-09,Female,33,25-34,5
6,0,2,0,2,2020-07-14,Male,68,65-69,6
6,1,16,0,17,2020-07-09,Male,36,35-44,3
6,0,0,0,0,2020-07-12,Male,28,25-34,6
6,0,1,0,1,2020-07-10,Female,53,45-54,5
6,2,2,0,4,2020-07-10,Male,19,15-19,3
6,3,1,0,4,2020-07-10,Male,8,5-9,5
6,1,2,0,3,2020-07-14,Male,52,45-54,3
6,0,2,0,2,2020-07-14,Female,70,70-74,3
6,0,0,0,0,2020-07-09,Male,32,25-34,2
6,3,1,0,4,2020-07-14,Male,69,65-69,3
6,1,10,0,11,2020-07-14,Female,68,65-69,6
6,3,0,0,3,2020-07-09,Male,18,15-19,3
6,2,0,0,2,2020-07-10,Male,64,55-64,4
6,0,2,0,2,2020-07-14,Male,49,45-54,6
6,3,3,3,9,2020-07-14,Female,66,65-69,3
6,1,0,0,1,2020-07-15,Female,53,45-54,2
6,1,0,0,1,2020-07-10,Male,52,45-54,3
6,0,3,0,3,2020-07-10,Female,60,55-64,3
6,2,0,0,2,2020-07-16,Female,65,65-69,3
6,4,1,0,5,2020-07-09,Male,21,20-24,3
6,0,0,0,0,2020-07-09,Male,66,65-69,6
6,0,0,0,0,2020-07-10,Male,64,55-64,6
6,2,0,0,2,2020-07-09,Female,67,65-69,5
6,0,2,0,2,2020-07-14,Female,73,70-74,6
6,0,0,0,0,2020-07-09,Male,67,65-69,6
6,0,0,0,0,2020-07-09,Male,40,35-44,3
6,1,0,0,1,2020-07-09,Male,74,70-74,6
6,0,0,0,0,2020-07-11,Female,7,5-9,3
6,1,2,0,3,2020-07-14,Female,44,35-44,3
6,3,0,0,3,2020-07-10,Female,15,15-19,3
6,1,1,0,2,2020-07-12,Female,61,55-64,3
6,3,1,0,4,2020-07-10,Male,18,15-19,6
6,0,1,0,1,2020-07-10,Male,52,45-54,2
6,0,0,0,0,2020-07-09,Male,13,10-14,3
6,0,0,0,0,2020-07-14,Female,51,45-54,6
6,5,0,0,5,2020-07-14,Male,14,10-14,6
6,5,0,0,5,2020-07-10,Male,27,25-34,2
6,0,0,0,0,2020-07-10,Male,14,10-14,6
6,1,1,0,2,2020-07-14,Male,81,80-84,6
6,3,2,0,5,2020-07-13,Female,53,45-54,4
6,0,0,0,0,2020-07-09,Female,58,55-64,3
6,0,0,0,0,2020-07-13,Female,7,5-9,3
6,2,1,0,3,2020-07-11,Male,59,55-64,4
6,2,0,0,2,2020-07-09,Female,46,45-54,6
6,1,0,0,1,2020-07-14,Female,52,45-54,6
6,0,1,2,3,2020-07-14,Female,28,25-34,2
6,0,2,0,2,2020-07-10,Male,24,20-24,3
6,0,0,0,0,2020-07-09,Male,34,25-34,6
6,3,0,0,3,2020-07-11,Female,21,20-24,3
6,1,0,0,1,2020-07-16,Female,34,25-34,4
6,0,0,0,0,2020-07-13,Female,45,45-54,3
6,0,0,0,0,2020-07-09,Female,23,20-24,6
6,1,0,0,1,2020-07-10,Female,66,65-69,3
6,5,0,0,5,2020-07-13,Male,23,20-24,6
6,1,0,0,1,2020-07-13,Female,67,65-69,2
6,0,0,0,0,2020-07-13,Male,67,65-69,6
6,1,3,0,4,2020-07-10,Male,62,55-64,4
6,2,0,0,2,2020-07-09,Male,41,35-44,6
6,0,1,12,13,2020-07-11,Male,65,65-69,6
6,2,1,0,3,2020-07-10,Female,29,25-34,2
6,4,1,0,5,2020-07-11,Male,49,45-54,5
6,0,0,0,0,2020-07-14,Male,70,70-74,3
6,2,0,0,2,2020-07-14,Male,58,55-64,4
6,1,0,0,1,2020-07-10,Male,79,75-79,6
6,0,11,0,11,2020-07-09,Male,32,25-34,4
6,2,0,0,2,2020-07-14,Male,54,45-54,6
6,0,3,10,13,2020-07-13,Female,68,65-69,3
6,2,80,0,82,2020-07-10,Male,64,55-64,3
6,0,1,1,2,2020-07-09,Male,63,55-64,3
6,0,1,0,1,2020-07-13,Female,66,65-69,6
6,2,0,0,2,2020-07-09,Male,13,10-14,3
6,0,0,0,0,2020-07-09,Female,25,25-34,6
6,0,1,0,1,2020-07-13,Female,68,65-69,5
6,2,2,0,4,2020-07-14,Female,77,75-79,6
6,0,0,0,0,2020-07-13,Female,66,65-69,3
6,0,5,0,5,2020-07-16,Male,67,65-69,2
6,0,0,0,0,2020-07-10,Female,63,55-64,3
6,1,1,0,2,2020-07-11,Male,68,65-69,6
6,1,0,0,1,2020-07-13,Female,33,25-34,4
6,3,1,0,4,2020-07-10,Male,53,45-54,4
6,2,0,0,2,2020-07-15,Female,13,10-14,5
6,0,1,0,1,2020-07-11,Male,29,25-34,6
6,0,0,0,0,2020-07-09,Female,5,5-9,5
6,3,0,0,3,2020-07-10,Female,52,45-54,3
6,1,1,0,2,2020-07-09,Male,61,55-64,5
6,2,0,0,2,2020-07-11,Female,65,65-69,6
6,2,0,0,2,2020-07-14,Female,78,75-79,6
6,2,1,0,3,2020-07-10,Female,27,25-34,3
6,0,2,3,5,2020-07-10,Male,65,65-69,6
6,2,0,0,2,2020-07-14,Female,2,1-4,5
6,1,0,0,1,2020-07-13,Female,69,65-69,6
6,0,0,0,0,2020-07-14,Female,75,75-79,6
6,3,1,0,4,2020-07-11,Male,36,35-44,3
6,5,1,0,6,2020-07-14,Male,14,10-14,5
6,2,10,0,12,2020-07-16,Male,40,35-44,2
6,1,2,0,3,2020-07-11,Female,50,45-54,4
6,1,0,0,1,2020-07-14,Male,51,45-54,3
6,1,0,0,1,2020-07-12,Male,68,65-69,6
6,2,0,3,5,2020-07-14,Male,56,55-64,3
6,1,1,0,2,2020-07-09,Female,54,45-54,3
6,0,0,0,0,2020-07-11,Female,26,25-34,3
6,0,4,0,4,2020-07-10,Female,65,65-69,3
6,1,0,2,3,2020-07-12,Female,32,25-34,2
6,0,7,0,7,2020-07-11,Female,60,55-64,3
6,0,1,0,1,2020-07-09,Male,25,25-34,3
6,1,3,0,4,2020-07-13,Female,60,55-64,3
6,0,8,0,8,2020-07-10,Male,51,45-54,4
6,0,0,0,0,2020-07-15,Female,49,45-54,5
6,2,0,0,2,2020-07-13,Male,71,70-74,4
6,0,0,0,0,2020-07-14,Male,73,70-74,5
6,3,1,0,4,2020-07-09,Female,17,15-19,6
6,3,0,0,3,2020-07-12,Female,10,10-14,5
6,1,4,0,5,2020-07-09,Male,27,25-34,4
6,0,0,0,0,2020-07-13,Male,42,35-44,2
6,3,5,0,8,2020-07-10,Female,11,10-14,3
6,0,0,0,0,2020-07-10,Female,65,65-69,3
6,1,0,0,1,2020-07-10,Female,26,25-34,6
6,2,1,0,3,2020-07-10,Male,75,75-79,6
6,1,4,0,5,2020-07-14,Male,73,70-74,6
6,2,1,0,3,2020-07-10,Male,52,45-54,4
6,0,7,0,7,2020-07-10,Male,37,35-44,3
6,0,0,0,0,2020-07-10,Male,30,25-34,3
6,0,0,0,0,2020-07-09,Female,20,20-24,5
6,1,0,0,1,2020-07-15,Female,22,20-24,4
6,5,1,0,6,2020-07-10,Male,62,55-64,6
6,3,1,0,4,2020-07-14,Female,55,55-64,2
6,1,10,0,11,2020-07-11,Male,63,55-64,3
6,4,0,0,4,2020-07-14,Female,12,10-14,3
6,2,0,0,2,2020-07-09,Male,54,45-54,6
6,0,0,0,0,2020-07-09,Female,5,5-9,4
6,2,0,0,2,2020-07-14,Male,72,70-74,3
6,2,0,0,2,2020-07-14,Male,72,70-74,3
6,1,0,0,1,2020-07-14,Male,65,65-69,6
6,0,0,0,0,2020-07-12,Female,52,45-54,6
6,0,0,0,0,2020-07-10,Female,17,15-19,3
6,0,0,0,0,2020-07-09,Female,71,70-74,6
6,0,1,0,1,2020-07-09,Male,29,25-34,5
6,0,1,0,1,2020-07-09,Female,56,55-64,6
6,0,0,0,0,2020-07-13,Male,67,65-69,3
6,0,0,0,0,2020-07-14,Male,51,45-54,5
6,0,1,0,1,2020-07-09,Male,54,45-54,5
6,0,0,0,0,2020-07-09,Female,5,5-9,5
6,3,3,1,7,2020-07-11,Male,3,1-4,3
6,2,3,0,5,2020-07-09,Male,66,65-69,6
6,0,6,0,6,2020-07-12,Female,68,65-69,3
6,1,3,0,4,2020-07-14,Female,69,65-69,3
6,0,0,0,0,2020-07-09,Female,29,25-34,3
6,0,1,0,1,2020-07-09,Male,45,45-54,5
6,2,0,0,2,2020-07-14,Female,68,65-69,3
6,2,3,0,5,2020-07-14,Male,54,45-54,2
6,1,0,0,1,2020-07-09,Female,24,20-24,3
6,2,7,0,9,2020-07-13,Female,47,45-54,2
6,0,0,0,0,2020-07-10,Male,58,55-64,6
6,1,9,0,10,2020-07-09,Male,65,65-69,3
6,2,2,0,4,2020-07-11,Male,9,5-9,5
6,0,1,0,1,2020-07-09,Female,16,15-19,3
6,3,10,0,13,2020-07-14,Male,59,55-64,6
6,0,2,0,2,2020-07-13,Male,57,55-64,6
6,2,13,0,15,2020-07-09,Female,46,45-54,6
6,2,1,0,3,2020-07-09,Male,4,1-4,4
6,2,1,0,3,2020-07-16,Female,53,45-54,2
6,0,3,0,3,2020-07-11,Female,14,10-14,3
6,0,4,10,14,2020-07-10,Female,24,20-24,6
6,4,5,0,9,2020-07-09,Male,13,10-14,6
6,2,3,0,5,2020-07-10,Male,50,45-54,6
6,0,0,0,0,2020-07-14,Male,73,70-74,6
6,3,0,0,3,2020-07-09,Male,23,20-24,3
6,0,0,0,0,2020-07-10,Female,66,65-69,3
6,0,0,0,0,2020-07-14,Male,70,70-74,3
6,1,0,0,1,2020-07-14,Male,54,45-54,5
6,0,0,0,0,2020-07-13,Female,68,65-69,6
6,0,0,0,0,2020-07-14,Male,77,75-79,5
6,0,0,0,0,2020-07-14,Male,85,85+,5
6,2,19,0,21,2020-07-11,Female,55,55-64,4
6,0,0,0,0,2020-07-11,Male,21,20-24,3
6,0,0,0,0,2020-07-09,Female,5,5-9,2
6,2,3,0,5,2020-07-10,Male,65,65-69,4
6,1,0,0,1,2020-07-09,Male,59,55-64,6
6,1,0,0,1,2020-07-15,Male,54,45-54,3
6,1,3,0,4,2020-07-14,Female,68,65-69,6
6,0,0,0,0,2020-07-10,Female,24,20-24,6
6,1,1,0,2,2020-07-09,Male,34,25-34,3
6,1,0,0,1,2020-07-13,Male,51,45-54,6
6,0,0,0,0,2020-07-11,Female,65,65-69,3
6,2,0,0,2,2020-07-10,Male,29,25-34,6
6,1,1,0,2,2020-07-09,Female,32,25-34,3
6,3,1,0,4,2020-07-09,Female,1,1-4,2
6,0,3,0,3,2020-07-09,Female,23,20-24,3
6,1,0,5,6,2020-07-14,Male,33,25-34,2
6,0,1,0,1,2020-07-09,Female,48,45-54,6
6,0,11,0,11,2020-07-09,Male,39,35-44,2
6,0,2,0,2,2020-07-09,Male,69,65-69,5
6,2,0,0,2,2020-07-09,Female,63,55-64,6
6,2,7,0,9,2020-07-10,Male,63,55-64,3
6,5,2,0,7,2020-07-10,Female,1,1-4,3
6,3,0,0,3,2020-07-09,Female,37,35-44,5
6,2,1,0,3,2020-07-14,Female,60,55-64,6
6,1,0,0,1,2020-07-14,Male,70,70-74,6
6,2,7,0,9,2020-07-14,Female,56,55-64,2
6,2,2,0,4,2020-07-14,Male,50,45-54,4
6,0,2,0,2,2020-07-09,Female,65,65-69,6
6,0,0,0,0,2020-07-10,Female,66,65-69,5
6,0,1,0,1,2020-07-13,Female,69,65-69,3
6,3,0,0,3,2020-07-09,Female,9,5-9,4
6,5,2,0,7,2020-07-09,Female,45,45-54,6
6,2,5,0,7,2020-07-14,Male,65,65-69,3
6,2,1,0,3,2020-07-10,Male,57,55-64,3
6,1,1,50,52,2020-07-11,Female,55,55-64,5
6,2,1,0,3,2020-07-11,Male,39,35-44,6
6,0,1,0,1,2020-07-09,Male,38,35-44,4
6,5,3,0,8,2020-07-09,Female,20,20-24,3
6,1,0,0,1,2020-07-09,Male,24,20-24,3
6,1,5,0,6,2020-07-11,Female,62,55-64,5
6,2,1,0,3,2020-07-14,Female,56,55-64,3
6,2,2,0,4,2020-07-10,Female,6,5-9,6
6,1,1,0,2,2020-07-10,Male,65,65-69,6
6,0,0,0,0,2020-07-10,Male,60,55-64,6
6,2,2,0,4,2020-07-10,Male,63,55-64,3
6,1,0,1,2,2020-07-10,Female,63,55-64,2
6,0,14,0,14,2020-07-09,Male,72,70-74,3
6,0,0,3,3,2020-07-14,Female,57,55-64,6
6,3,3,0,6,2020-07-10,Male,15,15-19,3
6,0,1,0,1,2020-07-14,Male,69,65-69,6
6,0,0,0,0,2020-07-10,Female,16,15-19,6
6,1,0,0,1,2020-07-09,Male,62,55-64,6
6,1,1,0,2,2020-07-14,Male,67,65-69,6
6,2,0,0,2,2020-07-14,Female,57,55-64,6
6,2,0,0,2,2020-07-14,Male,76,75-79,3
6,0,1,0,1,2020-07-14,Male,57,55-64,6
6,1,1,0,2,2020-07-14,Female,70,70-74,3
6,0,5,0,5,2020-07-16,Male,51,45-54,3
6,3,0,0,3,2020-07-10,Male,5,5-9,6
6,2,10,0,12,2020-07-09,Female,55,55-64,6
6,0,4,0,4,2020-07-09,Female,26,25-34,3
6,0,0,0,0,2020-07-09,Female,21,20-24,4
6,0,0,0,0,2020-07-10,Female,35,35-44,3
6,2,11,0,13,2020-07-14,Male,55,55-64,3
6,1,1,0,2,2020-07-10,Male,62,55-64,5
6,0,0,0,0,2020-07-10,Male,65,65-69,4
6,1,1,0,2,2020-07-09,Female,8,5-9,3
6,0,0,0,0,2020-07-11,Female,12,10-14,6
6,0,1,0,1,2020-07-12,Male,53,45-54,3
6,2,1,0,3,2020-07-13,Female,58,55-64,6
6,2,0,0,2,2020-07-09,Male,13,10-14,4
6,2,0,0,2,2020-07-09,Male,78,75-79,4
6,1,0,0,1,2020-07-09,Female,65,65-69,5
6,3,0,0,3,2020-07-14,Male,12,10-14,3
6,7,0,0,7,2020-07-09,Female,11,10-14,6
6,2,0,0,2,2020-07-10,Male,64,55-64,6
6,1,5,0,6,2020-07-14,Female,51,45-54,6
6,4,0,0,4,2020-07-12,Female,17,15-19,6
6,0,2,0,2,2020-07-14,Female,72,70-74,3
6,1,10,42,53,2020-07-12,Male,53,45-54,6
6,5,0,0,5,2020-07-10,Female,41,35-44,2
6,2,2,0,4,2020-07-09,Male,55,55-64,6
6,1,0,0,1,2020-07-12,Female,54,45-54,3
6,1,2,0,3,2020-07-14,Male,56,55-64,2
6,0,0,0,0,2020-07-09,Male,59,55-64,6
6,0,2,0,2,2020-07-09,Female,58,55-64,6
6,0,1,0,1,2020-07-14,Female,66,65-69,2
6,1,0,0,1,2020-07-10,Female,32,25-34,3
6,0,0,0,0,2020-07-09,Female,23,20-24,4
6,0,10,0,10,2020-07-09,Male,31,25-34,3
6,0,0,0,0,2020-07-09,Male,27,25-34,5
6,3,9,0,12,2020-07-09,Male,58,55-64,3
6,0,1,0,1,2020-07-13,Male,47,45-54,6
6,2,3,0,5,2020-07-13,Female,67,65-69,3
6,0,0,0,0,2020-07-10,Female,9,5-9,6
6,1,0,0,1,2020-07-09,Female,40,35-44,6
6,1,2,0,3,2020-07-09,Male,68,65-69,3
6,1,0,0,1,2020-07-15,Female,26,25-34,3
6,0,0,0,0,2020-07-09,Male,30,25-34,3
6,0,1,15,16,2020-07-15,Male,11,10-14,3
6,2,2,0,4,2020-07-10,Male,65,65-69,3
6,2,5,0,7,2020-07-10,Male,33,25-34,3
6,2,10,0,12,2020-07-09,Female,61,55-64,3
6,3,0,0,3,2020-07-10,Female,65,65-69,3
6,0,0,0,0,2020-07-13,Male,68,65-69,3
6,5,2,0,7,2020-07-13,Male,17,15-19,3
6,0,0,0,0,2020-07-12,Male,59,55-64,5
6,1,7,8,16,2020-07-13,Male,42,35-44,3
6,2,0,0,2,2020-07-09,Male,68,65-69,6
6,2,1,0,3,2020-07-11,Male,70,70-74,6
6,0,6,0,6,2020-07-10,Male,59,55-64,3
6,1,3,0,4,2020-07-10,Male,58,55-64,4
6,2,0,0,2,2020-07-10,Male,66,65-69,3
6,0,0,0,0,2020-07-09,Female,53,45-54,3
6,0,1,0,1,2020-07-10,Male,50,45-54,3
6,3,0,0,3,2020-07-11,Male,15,15-19,2
6,4,0,0,4,2020-07-09,Male,3,1-4,3
6,0,0,0,0,2020-07-09,Female,30,25-34,4
6,0,5,0,5,2020-07-14,Male,61,55-64,6
6,1,2,0,3,2020-07-16,Female,69,65-69,6
6,1,6,0,7,2020-07-13,Male,67,65-69,6
6,0,0,0,0,2020-07-11,Male,34,25-34,4
6,2,1,0,3,2020-07-13,Male,75,75-79,3
6,2,3,0,5,2020-07-13,Male,64,55-64,3
6,0,0,7,7,2020-07-11,Male,26,25-34,4
6,0,0,0,0,2020-07-14,Female,18,15-19,3
6,0,3,0,3,2020-07-14,Male,58,55-64,6
6,0,0,0,0,2020-07-09,Male,36,35-44,5
6,0,2,0,2,2020-07-13,Female,42,35-44,3
6,1,1,0,2,2020-07-09,Female,49,45-54,2
6,2,0,0,2,2020-07-09,Male,6,5-9,2
6,0,0,0,0,2020-07-13,Male,51,45-54,3
6,0,0,0,0,2020-07-14,Female,31,25-34,4
6,2,0,0,2,2020-07-11,Male,7,5-9,2
6,2,0,0,2,2020-07-11,Female,45,45-54,6
6,2,6,0,8,2020-07-11,Male,68,65-69,3
6,2,3,0,5,2020-07-13,Male,68,65-69,2
6,2,1,0,3,2020-07-09,Female,10,10-14,4
6,1,5,0,6,2020-07-12,Male,62,55-64,2
6,1,0,0,1,2020-07-09,Male,54,45-54,6
6,1,2,0,3,2020-07-14,Female,68,65-69,4
6,1,1,0,2,2020-07-11,Female,41,35-44,3
6,1,0,0,1,2020-07-10,Female,51,45-54,3
6,2,1,0,3,2020-07-09,Female,70,70-74,6
6,1,0,0,1,2020-07-10,Male,51,45-54,3
6,4,0,0,4,2020-07-10,Male,19,15-19,6
6,1,0,0,1,2020-07-09,Male,54,45-54,3
6,3,5,2,10,2020-07-09,Male,17,15-19,3
6,4,0,0,4,2020-07-10,Female,59,55-64,6
6,0,0,0,0,2020-07-10,Female,35,35-44,2
6,0,0,0,0,2020-07-14,Male,59,55-64,3
6,0,0,0,0,2020-07-09,Male,22,20-24,4
6,1,0,0,1,2020-07-09,Male,30,25-34,3
6,1,1,0,2,2020-07-10,Female,20,20-24,3
6,3,0,0,3,2020-07-10,Female,55,55-64,6
6,3,0,0,3,2020-07-11,Female,66,65-69,6
6,0,2,0,2,2020-07-15,Female,70,70-74,3
6,2,1,0,3,2020-07-09,Male,51,45-54,6
6,0,2,0,2,2020-07-09,Female,61,55-64,4
6,0,3,0,3,2020-07-11,Male,64,55-64,6
6,2,1,0,3,2020-07-10,Male,64,55-64,3
6,0,0,0,0,2020-07-13,Male,48,45-54,3
6,0,0,0,0,2020-07-10,Male,59,55-64,4
6,1,1,0,2,2020-07-13,Male,69,65-69,3
6,0,0,0,0,2020-07-09,Male,30,25-34,3
6,0,0,0,0,2020-07-09,Male,36,35-44,5
6,1,0,0,1,2020-07-13,Female,68,65-69,6
6,0,5,0,5,2020-07-09,Female,25,25-34,4
6,3,0,0,3,2020-07-09,Female,27,25-34,3
6,2,0,0,2,2020-07-14,Female,54,45-54,4
6,1,0,1,2,2020-07-14,Female,60,55-64,5
6,1,0,100,101,2020-07-09,Male,43,35-44,3
6,0,4,0,4,2020-07-10,Male,65,65-69,6
6,1,6,0,7,2020-07-09,Male,52,45-54,3
6,0,2,42,44,2020-07-14,Male,70,70-74,3
6,2,0,0,2,2020-07-10,Male,56,55-64,3
6,0,2,0,2,2020-07-10,Female,39,35-44,3
6,0,0,0,0,2020-07-10,Female,65,65-69,6
6,1,3,0,4,2020-07-12,Male,33,25-34,4
6,1,3,0,4,2020-07-14,Female,70,70-74,3
6,2,2,0,4,2020-07-14,Male,61,55-64,5
6,0,0,0,0,2020-07-11,Male,45,45-54,3
6,0,3,0,3,2020-07-10,Female,65,65-69,3
6,1,0,0,1,2020-07-14,Male,78,75-79,5
6,0,1,0,1,2020-07-13,Male,45,45-54,5
6,1,0,0,1,2020-07-13,Female,67,65-69,3
6,0,0,4,4,2020-07-10,Female,64,55-64,6
6,1,0,0,1,2020-07-10,Male,58,55-64,6
6,2,1,0,3,2020-07-13,Male,69,65-69,6
6,1,0,0,1,2020-07-10,Male,51,45-54,6
6,1,0,0,1,2020-07-09,Male,71,70-74,6
6,2,1,1,4,2020-07-14,Male,71,70-74,5
6,1,1,0,2,2020-07-10,Female,63,55-64,3
6,2,0,0,2,2020-07-14,Female,16,15-19,6
6,1,9,0,10,2020-07-10,Female,38,35-44,6
6,2,0,0,2,2020-07-13,Female,57,55-64,6
6,1,12,0,13,2020-07-09,Female,65,65-69,3
6,2,1,0,3,2020-07-14,Male,77,75-79,2
6,2,0,0,2,2020-07-09,Male,16,15-19,6
6,0,3,0,3,2020-07-12,Male,39,35-44,6
6,0,1,0,1,2020-07-13,Male,67,65-69,3
6,1,6,0,7,2020-07-14,Female,66,65-69,3
6,0,0,1,1,2020-07-13,Female,68,65-69,5
6,3,1,0,4,2020-07-09,Female,17,15-19,3
6,2,2,2,6,2020-07-14,Male,66,65-69,3
6,4,0,0,4,2020-07-10,Female,32,25-34,4
6,1,0,0,1,2020-07-10,Female,63,55-64,3
6,0,2,0,2,2020-07-10,Female,32,25-34,3
6,3,0,0,3,2020-07-13,Male,15,15-19,2
6,0,0,0,0,2020-07-13,Female,46,45-54,3
6,1,5,0,6,2020-07-09,Male,32,25-34,3
6,1,1,2,4,2020-07-10,Male,65,65-69,3
6,1,4,0,5,2020-07-14,Female,67,65-69,6
6,0,3,0,3,2020-07-09,Female,16,15-19,3
6,2,4,0,6,2020-07-09,Female,49,45-54,4
6,1,0,0,1,2020-07-09,Male,61,55-64,4
6,1,0,0,1,2020-07-10,Female,15,15-19,6
6,0,1,0,1,2020-07-10,Male,22,20-24,4
6,0,0,0,0,2020-07-13,Male,59,55-64,3
6,0,0,0,0,2020-07-11,Male,42,35-44,3
6,2,1,0,3,2020-07-14,Male,59,55-64,5
6,0,0,0,0,2020-07-10,Male,31,25-34,3
6,2,0,0,2,2020-07-11,Male,25,25-34,5
6,1,2,0,3,2020-07-13,Female,67,65-69,4
6,2,0,0,2,2020-07-12,Male,56,55-64,3
6,2,3,0,5,2020-07-09,Male,69,65-69,3
6,2,0,0,2,2020-07-13,Male,69,65-69,5
6,1,3,0,4,2020-07-10,Male,59,55-64,5
6,3,1,0,4,2020-07-11,Male,63,55-64,2
6,1,1,0,2,2020-07-13,Male,44,35-44,6
6,3,62,45,110,2020-07-14,Male,30,25-34,6
6,3,0,0,3,2020-07-09,Female,0,<1,5
6,1,0,0,1,2020-07-10,Female,63,55-64,3
6,0,2,0,2,2020-07-11,Male,42,35-44,6
6,1,2,4,7,2020-07-12,Male,2,1-4,3
6,2,0,0,2,2020-07-12,Male,36,35-44,4
6,4,0,0,4,2020-07-14,Male,11,10-14,6
6,0,0,0,0,2020-07-10,Female,51,45-54,5
6,0,0,0,0,2020-07-15,Male,24,20-24,3
6,3,1,0,4,2020-07-14,Female,50,45-54,4
6,2,0,0,2,2020-07-14,Female,67,65-69,4
6,1,0,0,1,2020-07-10,Male,49,45-54,6
6,0,0,0,0,2020-07-15,Female,24,20-24,4
6,2,0,0,2,2020-07-10,Male,51,45-54,6
6,0,0,0,0,2020-07-13,Female,55,55-64,2
6,0,0,0,0,2020-07-09,Female,25,25-34,3
6,0,0,0,0,2020-07-09,Male,70,70-74,6
6,1,0,0,1,2020-07-14,Female,10,10-14,2
6,2,0,0,2,2020-07-09,Female,59,55-64,6
6,1,0,0,1,2020-07-10,Male,40,35-44,3
6,0,0,0,0,2020-07-14,Male,53,45-54,3
6,1,6,0,7,2020-07-09,Female,30,25-34,6
6,0,0,0,0,2020-07-09,Male,33,25-34,6
6,0,0,0,0,2020-07-09,Male,46,45-54,3
6,1,0,0,1,2020-07-13,Female,54,45-54,6
6,0,1,0,1,2020-07-09,Female,66,65-69,4
6,2,0,0,2,2020-07-11,Female,14,10-14,3
6,0,1,0,1,2020-07-15,Female,67,65-69,3
6,0,0,0,0,2020-07-13,Female,69,65-69,3
6,2,0,0,2,2020-07-10,Male,45,45-54,6
6,0,0,0,0,2020-07-10,Female,55,55-64,6
6,2,0,0,2,2020-07-09,Female,29,25-34,2
6,0,1,0,1,2020-07-09,Male,29,25-34,3
6,1,0,0,1,2020-07-13,Male,65,65-69,4
6,0,3,0,3,2020-07-09,Male,38,35-44,2
6,1,8,0,9,2020-07-14,Male,67,65-69,3
6,1,0,0,1,2020-07-10,Male,28,25-34,3
6,3,20,0,23,2020-07-16,Female,54,45-54,2
6,0,0,0,0,2020-07-09,Male,23,20-24,3
6,2,0,0,2,2020-07-14,Male,78,75-79,3
6,2,1,0,3,2020-07-11,Male,12,10-14,6
6,1,0,0,1,2020-07-11,Female,45,45-54,4
6,0,0,0,0,2020-07-14,Male,47,45-54,3
6,2,1,0,3,2020-07-10,Female,57,55-64,6
6,1,0,0,1,2020-07-09,Male,34,25-34,5
6,5,0,24,29,2020-07-14,Male,15,15-19,3
6,1,5,0,6,2020-07-11,Male,31,25-34,4
6,1,0,0,1,2020-07-11,Female,67,65-69,3
6,1,3,0,4,2020-07-11,Male,57,55-64,4
6,2,0,0,2,2020-07-10,Female,29,25-34,2
6,0,2,0,2,2020-07-14,Male,42,35-44,5
6,1,0,0,1,2020-07-13,Male,63,55-64,3
6,3,2,0,5,2020-07-13,Male,12,10-14,3
6,4,2,0,6,2020-07-10,Male,10,10-14,3
6,2,0,0,2,2020-07-10,Male,64,55-64,2
6,1,1,0,2,2020-07-13,Female,66,65-69,6
6,2,0,0,2,2020-07-09,Female,29,25-34,6
6,2,6,0,8,2020-07-14,Male,80,80-84,3
6,2,0,21,23,2020-07-14,Male,50,45-54,4
6,2,10,0,12,2020-07-09,Female,20,20-24,2
6,1,5,0,6,2020-07-10,Female,53,45-54,3
6,2,2,15,19,2020-07-16,Female,62,55-64,6
6,0,4,0,4,2020-07-13,Female,47,45-54,2
6,0,0,0,0,2020-07-09,Female,20,20-24,3
6,2,2,0,4,2020-07-09,Male,27,25-34,3
6,1,2,0,3,2020-07-10,Male,65,65-69,4
6,0,1,0,1,2020-07-11,Female,64,55-64,3
6,2,0,0,2,2020-07-15,Female,11,10-14,3
6,1,0,0,1,2020-07-09,Female,62,55-64,5
6,1,2,0,3,2020-07-14,Female,52,45-54,3
6,0,2,0,2,2020-07-10,Male,65,65-69,6
6,0,1,0,1,2020-07-11,Male,70,70-74,4
6,0,0,0,0,2020-07-10,Male,66,65-69,6
6,1,1,0,2,2020-07-09,Male,63,55-64,6
6,0,0,0,0,2020-07-14,Female,69,65-69,4
6,0,0,0,0,2020-07-10,Male,30,25-34,2
6,1,0,0,1,2020-07-14,Male,72,70-74,6
6,2,3,0,5,2020-07-13,Female,45,45-54,3
6,0,0,0,0,2020-07-09,Female,62,55-64,5
6,0,0,0,0,2020-07-10,Female,35,35-44,6
6,6,4,0,10,2020-07-12,Male,9,5-9,3
6,2,0,0,2,2020-07-09,Male,70,70-74,3
6,1,4,0,5,2020-07-13,Male,43,35-44,2
6,6,4,0,10,2020-07-09,Female,11,10-14,3
6,2,0,0,2,2020-07-10,Female,64,55-64,6
6,0,0,0,0,2020-07-10,Female,61,55-64,6
6,0,0,0,0,2020-07-09,Female,31,25-34,3
6,3,5,0,8,2020-07-09,Male,26,25-34,3
6,2,0,0,2,2020-07-09,Male,54,45-54,5
6,0,0,0,0,2020-07-13,Female,42,35-44,3
6,0,0,0,0,2020-07-09,Male,16,15-19,4
6,2,0,0,2,2020-07-14,Female,59,55-64,6
6,1,3,0,4,2020-07-09,Female,22,20-24,3
6,1,0,0,1,2020-07-10,Male,55,55-64,3
6,0,0,0,0,2020-07-09,Female,30,25-34,5
6,1,1,0,2,2020-07-10,Male,53,45-54,3
6,0,0,0,0,2020-07-10,Male,60,55-64,5
6,9,1,0,10,2020-07-11,Female,28,25-34,3
6,2,4,0,6,2020-07-14,Male,56,55-64,6
6,0,7,0,7,2020-07-09,Male,39,35-44,3
6,5,3,0,8,2020-07-13,Female,13,10-14,6
6,1,7,0,8,2020-07-09,Male,42,35-44,5
6,2,2,0,4,2020-07-10,Male,40,35-44,3
6,4,0,0,4,2020-07-15,Male,16,15-19,3
6,0,1,0,1,2020-07-10,Female,63,55-64,6
6,0,0,0,0,2020-07-09,Female,17,15-19,6
6,1,6,0,7,2020-07-14,Female,66,65-69,5
6,2,9,0,11,2020-07-14,Female,60,55-64,6
6,0,0,0,0,2020-07-15,Male,60,55-64,2
6,0,4,0,4,2020-07-09,Female,61,55-64,6
6,0,2,0,2,2020-07-09,Male,50,45-54,3
6,2,0,0,2,2020-07-09,Male,44,35-44,6
6,4,1,11,16,2020-07-10,Male,7,5-9,2
6,2,2,0,4,2020-07-10,Male,18,15-19,3
6,1,0,0,1,2020-07-14,Male,70,70-74,3
6,0,1,0,1,2020-07-10,Female,68,65-69,5
6,0,1,1,2,2020-07-13,Male,50,45-54,4
6,0,0,0,0,2020-07-13,Male,69,65-69,3
6,2,0,0,2,2020-07-09,Male,21,20-24,3
6,1,3,0,4,2020-07-14,Male,22,20-24,4
6,0,0,0,0,2020-07-16,Male,16,15-19,2
6,1,4,0,5,2020-07-13,Male,8,5-9,3
6,3,0,0,3,2020-07-12,Male,60,55-64,2
6,2,0,0,2,2020-07-09,Female,70,70-74,5
6,0,0,3,3,2020-07-09,Female,6,5-9,3
6,2,0,0,2,2020-07-09,Male,67,65-69,4
6,1,0,0,1,2020-07-10,Male,66,65-69,3
6,0,1,0,1,2020-07-14,Female,57,55-64,5
6,2,1,0,3,2020-07-13,Male,56,55-64,6
6,0,0,0,0,2020-07-13,Male,69,65-69,3
6,0,0,0,0,2020-07-13,Male,73,70-74,6
6,0,0,0,0,2020-07-09,Female,33,25-34,6
6,0,1,0,1,2020-07-10,Male,20,20-24,3
6,0,0,0,0,2020-07-13,Male,52,45-54,6
6,0,0,0,0,2020-07-13,Male,67,65-69,6
6,0,1,0,1,2020-07-12,Female,37,35-44,6
6,0,1,2,3,2020-07-10,Female,52,45-54,3
6,0,0,0,0,2020-07-09,Male,29,25-34,3
6,2,6,0,8,2020-07-11,Male,78,75-79,3
6,5,3,0,8,2020-07-13,Female,13,10-14,3
6,2,0,0,2,2020-07-14,Male,17,15-19,3
6,3,1,0,4,2020-07-13,Female,6,5-9,3
6,0,3,3,6,2020-07-14,Female,10,10-14,2
6,4,0,0,4,2020-07-15,Male,11,10-14,3
6,2,4,0,6,2020-07-14,Female,61,55-64,3
6,4,6,1,11,2020-07-12,Male,41,35-44,3
6,0,0,0,0,2020-07-12,Female,35,35-44,3
6,2,3,0,5,2020-07-14,Male,78,75-79,3
6,3,2,0,5,2020-07-09,Male,52,45-54,3
6,1,1,0,2,2020-07-09,Female,33,25-34,3
6,1,1,2,4,2020-07-10,Male,7,5-9,2
6,2,2,0,4,2020-07-10,Male,66,65-69,3
6,2,1,0,3,2020-07-10,Male,51,45-54,3
6,0,4,0,4,2020-07-14,Male,51,45-54,3
6,3,4,0,7,2020-07-10,Female,42,35-44,5
6,2,0,0,2,2020-07-14,Female,70,70-74,6
6,1,1,0,2,2020-07-14,Female,65,65-69,3
6,1,0,0,1,2020-07-09,Female,23,20-24,6
6,0,2,0,2,2020-07-14,Female,71,70-74,3
6,2,0,0,2,2020-07-09,Male,31,25-34,3
6,0,0,0,0,2020-07-09,Female,68,65-69,6
6,0,0,0,0,2020-07-14,Male,59,55-64,3
6,2,0,0,2,2020-07-10,Male,10,10-14,3
6,2,0,0,2,2020-07-15,Male,69,65-69,3
6,2,1,0,3,2020-07-10,Female,50,45-54,6
6,3,0,0,3,2020-07-10,Male,53,45-54,4
6,0,13,0,13,2020-07-14,Female,69,65-69,3
6,2,1,0,3,2020-07-09,Male,27,25-34,4
6,3,0,0,3,2020-07-09,Male,32,25-34,3
6,5,0,0,5,2020-07-14,Female,10,10-14,5
6,3,0,0,3,2020-07-10,Female,1,1-4,4
6,1,0,0,1,2020-07-09,Male,38,35-44,2
6,0,1,0,1,2020-07-14,Female,67,65-69,6
6,0,0,0,0,2020-07-09,Female,58,55-64,6
6,0,1,0,1,2020-07-15,Female,66,65-69,3
6,0,0,0,0,2020-07-13,Female,54,45-54,6
6,3,1,0,4,2020-07-14,Male,69,65-69,6
6,4,0,8,12,2020-07-11,Male,9,5-9,2
6,4,6,56,66,2020-07-13,Male,5,5-9,2
6,0,0,0,0,2020-07-10,Female,40,35-44,6
6,3,1,0,4,2020-07-11,Female,7,5-9,4
6,0,0,0,0,2020-07-09,Female,64,55-64,6
6,3,0,0,3,2020-07-09,Male,39,35-44,4
6,3,0,0,3,2020-07-09,Female,52,45-54,6
6,2,2,0,4,2020-07-10,Male,26,25-34,4
6,0,1,0,1,2020-07-11,Male,39,35-44,3
6,2,0,0,2,2020-07-13,Female,43,35-44,5
6,3,0,3,6,2020-07-13,Male,17,15-19,3
6,0,0,0,0,2020-07-14,Male,77,75-79,6
6,1,0,0,1,2020-07-09,Male,43,35-44,3
6,1,0,0,1,2020-07-10,Male,66,65-69,6
6,0,1,0,1,2020-07-09,Female,42,35-44,2
6,0,1,0,1,2020-07-09,Male,33,25-34,3
6,2,5,0,7,2020-07-09,Female,66,65-69,6
6,1,0,0,1,2020-07-10,Female,65,65-69,3
6,3,0,0,3,2020-07-12,Female,14,10-14,4
6,2,1,0,3,2020-07-14,Male,6,5-9,4
6,0,0,0,0,2020-07-13,Male,47,45-54,6
6,2,0,0,2,2020-07-10,Male,15,15-19,6
6,1,0,0,1,2020-07-15,Male,65,65-69,3
6,2,11,0,13,2020-07-10,Female,67,65-69,3
6,0,2,0,2,2020-07-11,Male,39,35-44,5
6,1,8,0,9,2020-07-10,Female,65,65-69,6
6,0,1,0,1,2020-07-10,Male,38,35-44,6
6,0,0,0,0,2020-07-09,Male,30,25-34,3
6,2,0,0,2,2020-07-10,Female,62,55-64,6
6,0,1,0,1,2020-07-10,Female,53,45-54,3
6,2,0,0,2,2020-07-14,Male,57,55-64,2
6,1,1,0,2,2020-07-13,Female,67,65-69,4
6,3,0,0,3,2020-07-14,Female,9,5-9,6
6,0,0,0,0,2020-07-11,Male,40,35-44,6
6,2,0,1,3,2020-07-10,Male,64,55-64,3
6,2,0,0,2,2020-07-12,Male,59,55-64,3
6,0,2,0,2,2020-07-10,Male,40,35-44,4
6,1,0,0,1,2020-07-09,Female,19,15-19,5
6,0,0,0,0,2020-07-11,Male,34,25-34,3
6,3,0,0,3,2020-07-13,Male,68,65-69,3
6,2,0,0,2,2020-07-09,Female,12,10-14,6
6,0,0,0,0,2020-07-10,Female,58,55-64,5
6,2,3,0,5,2020-07-09,Female,52,45-54,6
6,0,0,0,0,2020-07-09,Female,34,25-34,3
6,1,0,0,1,2020-07-11,Female,57,55-64,6
6,0,1,0,1,2020-07-15,Female,59,55-64,6
6,2,0,0,2,2020-07-09,Male,12,10-14,6
6,1,0,0,1,2020-07-12,Male,10,10-14,3
6,1,0,0,1,2020-07-09,Male,65,65-69,3
6,2,0,0,2,2020-07-10,Female,19,15-19,5
6,1,0,0,1,2020-07-14,Female,49,45-54,6
6,2,0,0,2,2020-07-11,Female,54,45-54,5
6,1,0,0,1,2020-07-11,Female,23,20-24,3
6,0,0,0,0,2020-07-09,Female,21,20-24,3
6,2,0,0,2,2020-07-10,Female,10,10-14,4
6,3,0,0,3,2020-07-09,Female,11,10-14,3
6,3,12,0,15,2020-07-11,Female,17,15-19,3
6,2,0,0,2,2020-07-14,Female,69,65-69,5
6,0,1,0,1,2020-07-09,Female,24,20-24,4
6,2,3,0,5,2020-07-10,Female,7,5-9,4
6,2,1,0,3,2020-07-12,Female,13,10-14,2
6,0,6,0,6,2020-07-14,Female,67,65-69,3
6,0,4,0,4,2020-07-14,Female,53,45-54,6
6,1,0,0,1,2020-07-14,Male,74,70-74,3
6,0,0,0,0,2020-07-09,Male,38,35-44,3
6,0,0,0,0,2020-07-09,Male,35,35-44,3
6,4,0,0,4,2020-07-13,Male,17,15-19,4
6,0,0,0,0,2020-07-09,Male,35,35-44,3
6,2,0,0,2,2020-07-13,Male,67,65-69,3
6,0,0,0,0,2020-07-13,Female,18,15-19,3
6,1,0,0,1,2020-07-10,Male,66,65-69,6
6,0,4,2,6,2020-07-15,Female,65,65-69,6
6,2,0,1,3,2020-07-09,Female,65,65-69,3
6,2,1,60,63,2020-07-13,Male,42,35-44,3
6,2,0,0,2,2020-07-10,Male,6,5-9,3
6,1,1,0,2,2020-07-15,Female,54,45-54,4
6,1,1,0,2,2020-07-14,Male,52,45-54,3
6,1,0,0,1,2020-07-10,Female,67,65-69,3
6,0,0,0,0,2020-07-14,Male,52,45-54,6
6,0,2,0,2,2020-07-09,Female,30,25-34,3
6,1,1,3,5,2020-07-12,Male,56,55-64,4
6,1,6,0,7,2020-07-10,Male,65,65-69,3
6,2,6,0,8,2020-07-13,Male,66,65-69,6
6,2,1,0,3,2020-07-14,Female,75,75-79,3
6,3,1,0,4,2020-07-09,Female,8,5-9,3
6,2,0,0,2,2020-07-10,Female,62,55-64,6
6,1,0,0,1,2020-07-10,Female,28,25-34,5
6,2,0,0,2,2020-07-10,Male,11,10-14,3
6,0,0,0,0,2020-07-09,Female,14,10-14,4
6,0,0,0,0,2020-07-11,Female,27,25-34,3
6,0,0,0,0,2020-07-13,Female,69,65-69,3
6,2,6,0,8,2020-07-10,Male,53,45-54,3
6,0,8,0,8,2020-07-09,Male,27,25-34,6
6,1,3,0,4,2020-07-15,Male,61,55-64,5
6,4,2,0,6,2020-07-14,Female,5,5-9,5
6,0,1,0,1,2020-07-10,Male,62,55-64,3
6,4,2,46,52,2020-07-09,Male,24,20-24,3
6,0,0,0,0,2020-07-09,Male,23,20-24,5
6,2,0,0,2,2020-07-15,Male,68,65-69,6
6,0,0,0,0,2020-07-09,Female,28,25-34,2
6,0,3,0,3,2020-07-10,Male,44,35-44,3
6,1,5,0,6,2020-07-12,Female,29,25-34,3
6,1,0,0,1,2020-07-11,Male,54,45-54,4
6,2,0,0,2,2020-07-13,Male,15,15-19,5
6,0,0,0,0,2020-07-12,Male,30,25-34,4
6,2,2,1,5,2020-07-15,Female,69,65-69,5
6,2,1,0,3,2020-07-10,Female,62,55-64,5
6,1,0,0,1,2020-07-09,Female,68,65-69,6
6,1,0,0,1,2020-07-09,Male,54,45-54,6
6,1,0,0,1,2020-07-09,Female,61,55-64,6
6,0,0,0,0,2020-07-14,Male,66,65-69,6
6,0,0,0,0,2020-07-09,Female,2,1-4,2
6,0,0,0,0,2020-07-09,Male,54,45-54,2
6,2,0,0,2,2020-07-10,Female,61,55-64,6
6,1,2,0,3,2020-07-09,Male,52,45-54,5
6,0,0,0,0,2020-07-14,Female,51,45-54,2
6,0,2,0,2,2020-07-10,Female,65,65-69,6
6,4,0,0,4,2020-07-12,Female,45,45-54,5
6,0,0,0,0,2020-07-10,Male,65,65-69,3
6,1,4,0,5,2020-07-14,Female,59,55-64,5
6,1,1,0,2,2020-07-09,Male,65,65-69,6
6,0,10,0,10,2020-07-14,Female,68,65-69,5
6,1,0,0,1,2020-07-10,Female,11,10-14,6
6,2,3,0,5,2020-07-12,Male,11,10-14,3
6,1,1,0,2,2020-07-10,Female,62,55-64,6
6,0,1,0,1,2020-07-12,Female,51,45-54,6
6,2,2,4,8,2020-07-09,Male,32,25-34,3
6,2,0,0,2,2020-07-10,Female,52,45-54,3
6,3,0,0,3,2020-07-10,Female,47,45-54,3
6,1,3,0,4,2020-07-10,Female,62,55-64,6
6,0,3,0,3,2020-07-14,Female,67,65-69,2
6,0,0,10,10,2020-07-11,Male,28,25-34,6
6,1,1,0,2,2020-07-14,Male,59,55-64,6
6,4,0,0,4,2020-07-10,Female,44,35-44,6
6,1,0,0,1,2020-07-14,Male,71,70-74,3
6,2,0,0,2,2020-07-15,Female,67,65-69,6
6,0,0,0,0,2020-07-09,Female,64,55-64,4
6,2,4,0,6,2020-07-15,Male,69,65-69,5
6,3,0,0,3,2020-07-10,Male,15,15-19,3
6,2,0,0,2,2020-07-13,Female,66,65-69,3
6,1,2,0,3,2020-07-10,Male,58,55-64,6
6,1,2,0,3,2020-07-09,Male,66,65-69,3
6,2,0,1,3,2020-07-09,Male,10,10-14,3
6,1,0,0,1,2020-07-16,Female,58,55-64,3
6,0,0,0,0,2020-07-10,Male,17,15-19,5
6,0,1,0,1,2020-07-14,Male,49,45-54,6
6,0,2,0,2,2020-07-16,Male,56,55-64,3
6,2,4,0,6,2020-07-09,Female,25,25-34,6
6,2,0,0,2,2020-07-09,Male,29,25-34,6
6,0,0,0,0,2020-07-09,Male,33,25-34,3
6,2,2,0,4,2020-07-13,Female,5,5-9,3
6,1,3,0,4,2020-07-09,Female,69,65-69,4
6,1,0,0,1,2020-07-10,Male,66,65-69,3
6,1,0,0,1,2020-07-12,Female,48,45-54,2
6,2,0,0,2,2020-07-14,Female,67,65-69,2
6,0,0,0,0,2020-07-09,Male,35,35-44,3
6,2,0,0,2,2020-07-09,Female,6,5-9,4
6,1,0,0,1,2020-07-11,Female,66,65-69,6
6,0,0,0,0,2020-07-10,Male,42,35-44,3
6,5,0,14,19,2020-07-15,Female,3,1-4,3
6,0,1,2,3,2020-07-09,Male,40,35-44,6
6,0,1,0,1,2020-07-10,Male,41,35-44,3
6,1,1,1,3,2020-07-15,Female,61,55-64,3
6,1,2,0,3,2020-07-14,Male,67,65-69,5
6,4,0,0,4,2020-07-09,Male,6,5-9,6
6,5,3,0,8,2020-07-11,Male,22,20-24,3
6,3,0,0,3,2020-07-10,Male,21,20-24,2
6,4,0,0,4,2020-07-10,Female,1,1-4,2
6,2,49,100,151,2020-07-12,Female,45,45-54,2
6,0,0,0,0,2020-07-09,Female,26,25-34,3
6,2,0,0,2,2020-07-10,Male,51,45-54,3
6,1,3,0,4,2020-07-10,Female,68,65-69,4
6,2,10,0,12,2020-07-13,Male,60,55-64,6
6,1,0,0,1,2020-07-09,Male,64,55-64,6
6,0,3,0,3,2020-07-13,Male,51,45-54,6
6,1,1,0,2,2020-07-10,Male,65,65-69,6
6,1,0,0,1,2020-07-13,Female,39,35-44,3
6,2,3,0,5,2020-07-14,Male,52,45-54,6
6,0,0,0,0,2020-07-13,Male,51,45-54,3
6,1,1,0,2,2020-07-16,Female,19,15-19,2
6,1,3,0,4,2020-07-11,Female,55,55-64,6
6,2,2,0,4,2020-07-09,Male,32,25-34,3
6,0,0,0,0,2020-07-09,Female,48,45-54,3
6,1,0,0,1,2020-07-10,Male,66,65-69,6
6,0,0,0,0,2020-07-09,Male,40,35-44,5
6,2,0,28,30,2020-07-13,Male,59,55-64,3
6,0,4,0,4,2020-07-09,Male,41,35-44,6
6,0,0,11,11,2020-07-12,Male,66,65-69,6
6,1,1,0,2,2020-07-10,Male,63,55-64,3
6,0,0,0,0,2020-07-09,Female,68,65-69,6
6,5,0,0,5,2020-07-09,Male,2,1-4,5
6,0,0,0,0,2020-07-12,Male,57,55-64,6
6,0,13,0,13,2020-07-09,Male,47,45-54,3
6,0,0,0,0,2020-07-15,Female,34,25-34,3
6,0,0,100,100,2020-07-14,Male,52,45-54,6
6,1,0,0,1,2020-07-10,Male,61,55-64,6
6,0,5,0,5,2020-07-09,Female,67,65-69,6
6,3,3,0,6,2020-07-12,Male,58,55-64,4
6,3,4,0,7,2020-07-09,Male,14,10-14,6
6,3,1,0,4,2020-07-10,Female,38,35-44,5
6,2,1,0,3,2020-07-14,Male,77,75-79,6
6,3,0,0,3,2020-07-13,Female,38,35-44,5
6,1,0,0,1,2020-07-12,Female,22,20-24,2
6,2,0,0,2,2020-07-13,Female,15,15-19,6
6,0,0,0,0,2020-07-13,Male,46,45-54,5
6,0,0,0,0,2020-07-12,Female,57,55-64,3
6,2,2,0,4,2020-07-13,Male,66,65-69,3
6,4,0,0,4,2020-07-14,Male,49,45-54,3
6,2,1,0,3,2020-07-10,Female,21,20-24,3
6,5,0,0,5,2020-07-15,Female,11,10-14,3
6,1,0,0,1,2020-07-09,Male,26,25-34,3
6,0,1,0,1,2020-07-10,Male,47,45-54,6
6,2,5,0,7,2020-07-14,Male,48,45-54,3
6,0,0,0,0,2020-07-10,Female,67,65-69,5
6,0,0,0,0,2020-07-13,Male,51,45-54,3
6,0,0,0,0,2020-07-11,Male,66,65-69,4
6,4,0,0,4,2020-07-10,Male,19,15-19,3
6,5,0,0,5,2020-07-16,Female,1,1-4,2
6,2,2,0,4,2020-07-09,Female,10,10-14,3
6,2,0,0,2,2020-07-10,Male,61,55-64,3
6,2,0,0,2,2020-07-10,Male,13,10-14,6
6,2,2,0,4,2020-07-14,Male,70,70-74,2
6,2,2,0,4,2020-07-11,Female,62,55-64,3
6,2,1,3,6,2020-07-14,Female,78,75-79,3
6,3,0,0,3,2020-07-12,Female,18,15-19,2
6,0,0,100,100,2020-07-09,Male,43,35-44,6
6,2,2,0,4,2020-07-10,Female,63,55-64,6
6,1,4,0,5,2020-07-10,Female,48,45-54,6
6,0,0,0,0,2020-07-13,Male,53,45-54,2
6,0,3,0,3,2020-07-14,Male,71,70-74,3
6,0,0,0,0,2020-07-14,Female,53,45-54,6
6,0,0,0,0,2020-07-09,Female,33,25-34,3
6,2,0,0,2,2020-07-09,Male,6,5-9,5
6,2,3,0,5,2020-07-13,Female,5,5-9,6
6,1,0,0,1,2020-07-10,Female,50,45-54,3
6,2,0,0,2,2020-07-10,Male,56,55-64,4
6,0,7,0,7,2020-07-11,Female,61,55-64,3
6,0,1,0,1,2020-07-11,Female,59,55-64,2
6,1,5,3,9,2020-07-11,Male,56,55-64,4
6,2,12,0,14,2020-07-10,Male,65,65-69,6
6,6,2,69,77,2020-07-10,Female,5,5-9,3
6,4,0,0,4,2020-07-09,Female,33,25-34,5
6,2,1,0,3,2020-07-14,Male,70,70-74,2
6,1,0,0,1,2020-07-09,Male,61,55-64,6
6,0,0,0,0,2020-07-11,Male,65,65-69,6
6,0,0,0,0,2020-07-09,Male,33,25-34,5
6,1,0,0,1,2020-07-14,Female,53,45-54,5
6,1,0,0,1,2020-07-10,Female,58,55-64,6
6,2,2,0,4,2020-07-09,Male,72,70-74,3
6,2,1,0,3,2020-07-14,Female,68,65-69,4
6,0,2,0,2,2020-07-09,Male,33,25-34,3
6,0,0,0,0,2020-07-10,Female,36,35-44,3
6,1,0,0,1,2020-07-16,Male,46,45-54,2
6,2,0,0,2,2020-07-15,Female,46,45-54,3
6,1,0,0,1,2020-07-09,Female,21,20-24,5
6,0,1,0,1,2020-07-10,Male,62,55-64,3
6,0,0,0,0,2020-07-09,Male,24,20-24,2
6,4,9,0,13,2020-07-10,Male,1,1-4,3
6,2,1,0,3,2020-07-10,Female,65,65-69,3
6,1,1,3,5,2020-07-10,Female,34,25-34,3
6,2,0,0,2,2020-07-13,Male,53,45-54,6
6,1,1,0,2,2020-07-10,Female,35,35-44,3
6,0,1,0,1,2020-07-14,Male,56,55-64,3
6,1,1,0,2,2020-07-10,Female,55,55-64,6
6,0,3,0,3,2020-07-10,Female,67,65-69,6
6,2,2,0,4,2020-07-16,Male,72,70-74,6
6,2,1,0,3,2020-07-10,Female,52,45-54,6
6,2,0,0,2,2020-07-14,Male,66,65-69,4
6,0,0,0,0,2020-07-09,Male,31,25-34,3
6,0,1,0,1,2020-07-09,Female,48,45-54,2
6,2,0,0,2,2020-07-11,Female,70,70-74,3
6,0,0,0,0,2020-07-14,Female,70,70-74,5
6,0,0,0,0,2020-07-10,Male,66,65-69,6
6,1,1,0,2,2020-07-15,Male,50,45-54,6
6,0,0,0,0,2020-07-13,Male,67,65-69,4
6,0,1,0,1,2020-07-09,Female,26,25-34,3
6,0,1,0,1,2020-07-11,Female,73,70-74,3
6,0,1,0,1,2020-07-10,Male,61,55-64,3
6,1,0,0,1,2020-07-14,Female,53,45-54,6
6,0,0,0,0,2020-07-14,Female,66,65-69,3
6,0,1,0,1,2020-07-09,Male,28,25-34,3
6,1,2,0,3,2020-07-09,Male,62,55-64,6
6,0,0,0,0,2020-07-09,Male,37,35-44,6
6,0,4,0,4,2020-07-14,Female,67,65-69,2
6,1,0,0,1,2020-07-09,Female,27,25-34,6
6,0,0,0,0,2020-07-11,Female,12,10-14,5
6,0,0,0,0,2020-07-10,Male,53,45-54,6
6,1,4,0,5,2020-07-11,Male,27,25-34,6
6,3,0,0,3,2020-07-12,Male,18,15-19,2
6,1,0,0,1,2020-07-09,Male,34,25-34,5
6,0,3,0,3,2020-07-09,Female,71,70-74,6
6,1,1,0,2,2020-07-10,Female,26,25-34,3
6,3,0,0,3,2020-07-11,Male,41,35-44,3
6,7,0,0,7,2020-07-11,Female,9,5-9,4
6,1,1,0,2,2020-07-09,Female,24,20-24,6
6,0,1,0,1,2020-07-09,Male,14,10-14,3
6,0,0,0,0,2020-07-09,Male,32,25-34,6
6,0,0,0,0,2020-07-09,Female,42,35-44,3
6,2,0,0,2,2020-07-14,Female,71,70-74,6
6,1,1,0,2,2020-07-09,Male,58,55-64,3
6,1,1,0,2,2020-07-09,Male,31,25-34,4
6,2,2,0,4,2020-07-10,Male,57,55-64,4
6,3,2,0,5,2020-07-09,Male,2,1-4,3
6,1,0,0,1,2020-07-10,Female,58,55-64,6
6,1,0,0,1,2020-07-13,Male,69,65-69,6
6,1,0,0,1,2020-07-10,Male,66,65-69,5
6,1,0,0,1,2020-07-14,Male,75,75-79,3
6,0,0,0,0,2020-07-10,Male,52,45-54,5
6,0,0,0,0,2020-07-14,Male,56,55-64,5
6,1,2,0,3,2020-07-11,Male,25,25-34,3
6,0,3,0,3,2020-07-09,Male,66,65-69,3
6,2,1,0,3,2020-07-10,Female,63,55-64,4
6,2,0,0,2,2020-07-10,Male,65,65-69,3
6,3,1,0,4,2020-07-10,Female,15,15-19,5
6,0,0,0,0,2020-07-14,Male,74,70-74,6
6,0,1,0,1,2020-07-09,Female,65,65-69,5
6,1,10,0,11,2020-07-09,Female,16,15-19,3
6,0,2,0,2,2020-07-16,Female,53,45-54,5
6,1,0,0,1,2020-07-10,Female,45,45-54,3
6,1,0,0,1,2020-07-09,Male,30,25-34,3
6,1,1,0,2,2020-07-14,Male,70,70-74,3
6,3,0,0,3,2020-07-09,Male,53,45-54,3
6,6,11,0,17,2020-07-15,Male,16,15-19,3
6,2,5,0,7,2020-07-14,Male,73,70-74,6
6,2,2,0,4,2020-07-14,Female,70,70-74,6
6,2,3,20,25,2020-07-14,Male,73,70-74,3
6,0,0,0,0,2020-07-09,Male,27,25-34,5
6,1,1,0,2,2020-07-09,Male,27,25-34,6
6,0,1,0,1,2020-07-09,Male,30,25-34,4
6,0,13,0,13,2020-07-09,Female,30,25-34,3
6,1,0,1,2,2020-07-11,Female,64,55-64,6
6,1,0,0,1,2020-07-13,Male,41,35-44,5
6,1,0,0,1,2020-07-12,Male,39,35-44,2
6,0,2,0,2,2020-07-10,Male,65,65-69,5
6,0,3,0,3,2020-07-13,Female,68,65-69,6
6,1,5,0,6,2020-07-14,Male,72,70-74,2
6,1,0,0,1,2020-07-10,Male,60,55-64,3
6,0,2,0,2,2020-07-09,Male,27,25-34,3
6,0,0,3,3,2020-07-09,Male,7,5-9,3
6,0,0,0,0,2020-07-09,Male,52,45-54,3
6,1,1,0,2,2020-07-11,Female,33,25-34,3
6,1,3,0,4,2020-07-13,Male,68,65-69,6
6,2,0,0,2,2020-07-12,Male,67,65-69,4
6,2,1,0,3,2020-07-09,Female,66,65-69,6
6,1,6,0,7,2020-07-09,Male,68,65-69,6
6,1,0,0,1,2020-07-10,Male,61,55-64,4
6,0,0,0,0,2020-07-09,Male,33,25-34,3
6,3,0,0,3,2020-07-14,Male,18,15-19,3
6,1,0,0,1,2020-07-09,Female,61,55-64,3
6,0,1,0,1,2020-07-13,Female,56,55-64,6
6,3,0,0,3,2020-07-13,Female,53,45-54,5
6,3,0,0,3,2020-07-14,Female,1,1-4,6
6,1,4,0,5,2020-07-10,Male,66,65-69,3
6,4,0,0,4,2020-07-09,Male,5,5-9,2
6,0,0,0,0,2020-07-09,Male,42,35-44,3
6,0,2,0,2,2020-07-10,Female,62,55-64,5
6,0,5,0,5,2020-07-14,Female,53,45-54,3
6,2,4,0,6,2020-07-10,Female,33,25-34,5
6,1,0,0,1,2020-07-14,Female,54,45-54,3
6,0,1,0,1,2020-07-09,Female,59,55-64,6
6,0,2,0,2,2020-07-14,Female,4,1-4,3
6,1,10,0,11,2020-07-13,Female,59,55-64,4
6,1,1,0,2,2020-07-12,Female,30,25-34,4
6,5,0,0,5,2020-07-14,Female,54,45-54,3
6,2,0,0,2,2020-07-10,Female,55,55-64,3
6,1,2,0,3,2020-07-10,Female,60,55-64,6
6,2,1,0,3,2020-07-14,Male,60,55-64,5
6,0,0,0,0,2020-07-09,Male,69,65-69,6
6,0,3,0,3,2020-07-10,Female,54,45-54,3
6,1,3,0,4,2020-07-10,Male,61,55-64,3
6,1,0,0,1,2020-07-14,Female,51,45-54,6
6,2,0,0,2,2020-07-10,Male,68,65-69,3
6,2,3,0,5,2020-07-14,Male,71,70-74,4
6,2,6,0,8,2020-07-14,Male,77,75-79,3
6,0,0,0,0,2020-07-14,Female,67,65-69,3
6,3,0,0,3,2020-07-09,Male,13,10-14,2
6,2,4,0,6,2020-07-15,Female,66,65-69,4
6,3,0,0,3,2020-07-14,Male,51,45-54,3
6,1,0,0,1,2020-07-14,Male,69,65-69,6
6,0,2,0,2,2020-07-10,Female,18,15-19,3
6,0,0,0,0,2020-07-10,Male,51,45-54,6
6,3,0,0,3,2020-07-09,Female,17,15-19,6
6,1,0,0,1,2020-07-10,Female,64,55-64,6
6,9,0,0,9,2020-07-09,Female,16,15-19,3
6,0,0,0,0,2020-07-09,Female,37,35-44,4
6,4,0,0,4,2020-07-10,Male,11,10-14,2
6,2,0,0,2,2020-07-12,Male,4,1-4,2
6,0,2,0,2,2020-07-11,Male,59,55-64,2
6,2,1,0,3,2020-07-09,Female,55,55-64,3
6,3,2,0,5,2020-07-09,Female,59,55-64,3
6,3,0,3,6,2020-07-10,Female,7,5-9,2
6,0,0,0,0,2020-07-10,Male,36,35-44,2
6,0,1,0,1,2020-07-10,Male,36,35-44,5
6,3,1,0,4,2020-07-09,Female,3,1-4,3
6,3,4,0,7,2020-07-10,Female,52,45-54,4
6,2,0,0,2,2020-07-10,Male,63,55-64,3
6,2,3,0,5,2020-07-14,Male,51,45-54,3
6,0,0,0,0,2020-07-16,Male,73,70-74,3
6,3,0,0,3,2020-07-15,Male,11,10-14,6
6,1,0,0,1,2020-07-09,Female,15,15-19,3
6,0,2,0,2,2020-07-11,Male,61,55-64,3
6,1,0,0,1,2020-07-12,Female,54,45-54,4
6,2,4,0,6,2020-07-09,Female,19,15-19,3
6,0,0,0,0,2020-07-14,Female,52,45-54,4
6,1,0,0,1,2020-07-09,Male,53,45-54,2
6,1,0,0,1,2020-07-10,Male,53,45-54,3
6,3,1,0,4,2020-07-12,Male,28,25-34,3
6,2,2,0,4,2020-07-10,Female,65,65-69,5
6,1,10,0,11,2020-07-10,Male,61,55-64,3
6,3,2,0,5,2020-07-09,Male,18,15-19,6
6,1,3,0,4,2020-07-14,Female,50,45-54,3
6,1,1,0,2,2020-07-09,Female,60,55-64,6
6,1,0,0,1,2020-07-09,Male,13,10-14,5
6,1,0,50,51,2020-07-10,Male,15,15-19,6
6,0,1,0,1,2020-07-12,Female,43,35-44,3
6,3,0,0,3,2020-07-15,Male,32,25-34,3
6,0,0,0,0,2020-07-10,Female,65,65-69,5
6,1,11,0,12,2020-07-14,Male,67,65-69,6
6,0,0,0,0,2020-07-11,Male,37,35-44,6
6,0,3,45,48,2020-07-11,Female,24,20-24,2
6,0,1,0,1,2020-07-14,Male,60,55-64,6
6,1,2,0,3,2020-07-10,Female,63,55-64,4
6,0,0,0,0,2020-07-16,Female,65,65-69,2
6,1,2,0,3,2020-07-14,Female,67,65-69,6
6,1,0,0,1,2020-07-13,Female,43,35-44,2
6,1,0,0,1,2020-07-10,Female,39,35-44,6
6,0,0,0,0,2020-07-09,Male,34,25-34,4
6,1,1,0,2,2020-07-09,Male,32,25-34,3
6,1,0,0,1,2020-07-11,Male,37,35-44,2
6,1,0,0,1,2020-07-10,Female,37,35-44,4
6,0,0,0,0,2020-07-09,Female,5,5-9,3
6,0,4,5,9,2020-07-11,Female,46,45-54,2
6,1,0,0,1,2020-07-09,Female,33,25-34,6
6,0,1,10,11,2020-07-14,Male,66,65-69,6
6,0,0,0,0,2020-07-13,Female,51,45-54,5
6,3,0,0,3,2020-07-14,Female,18,15-19,3
6,0,1,0,1,2020-07-11,Female,43,35-44,3
6,1,0,0,1,2020-07-09,Male,66,65-69,3
6,2,1,1,4,2020-07-10,Female,62,55-64,3
6,0,5,0,5,2020-07-14,Female,51,45-54,4
6,0,0,0,0,2020-07-09,Female,66,65-69,5
6,1,0,0,1,2020-07-11,Female,72,70-74,6
6,0,0,0,0,2020-07-12,Male,58,55-64,6
6,2,1,0,3,2020-07-14,Female,14,10-14,4
6,0,0,0,0,2020-07-13,Female,23,20-24,4
6,2,1,1,4,2020-07-10,Female,19,15-19,5
6,3,3,0,6,2020-07-09,Female,8,5-9,3
6,2,2,0,4,2020-07-11,Male,43,35-44,3
6,1,2,0,3,2020-07-12,Female,62,55-64,3
6,0,0,0,0,2020-07-15,Female,52,45-54,5
6,2,2,0,4,2020-07-13,Male,68,65-69,6
6,1,13,100,114,2020-07-11,Female,55,55-64,6
6,3,2,0,5,2020-07-14,Female,60,55-64,2
6,1,2,0,3,2020-07-10,Female,61,55-64,3
6,1,2,0,3,2020-07-13,Male,67,65-69,3
6,1,2,90,93,2020-07-10,Male,64,55-64,6
6,2,1,0,3,2020-07-14,Male,72,70-74,6
6,3,0,0,3,2020-07-09,Female,22,20-24,3
6,1,0,0,1,2020-07-10,Female,64,55-64,6
6,2,2,0,4,2020-07-10,Male,53,45-54,3
6,0,2,0,2,2020-07-14,Female,66,65-69,6
6,0,3,0,3,2020-07-12,Female,71,70-74,6
6,2,1,0,3,2020-07-14,Female,71,70-74,6
6,0,1,0,1,2020-07-10,Female,45,45-54,3
6,1,0,0,1,2020-07-10,Female,49,45-54,6
6,5,0,0,5,2020-07-10,Female,58,55-64,6
6,0,0,0,0,2020-07-09,Female,33,25-34,3
6,1,0,0,1,2020-07-14,Male,73,70-74,3
6,2,4,0,6,2020-07-10,Female,50,45-54,3
6,0,1,0,1,2020-07-10,Female,40,35-44,6
6,0,0,0,0,2020-07-09,Male,21,20-24,6
6,0,0,0,0,2020-07-10,Male,54,45-54,6
6,0,1,0,1,2020-07-10,Male,23,20-24,3
6,0,1,0,1,2020-07-13,Female,36,35-44,6
6,3,0,0,3,2020-07-15,Female,8,5-9,6
6,0,1,0,1,2020-07-09,Male,54,45-54,3
6,2,2,0,4,2020-07-11,Male,61,55-64,6
6,5,2,0,7,2020-07-09,Female,13,10-14,3
6,2,11,0,13,2020-07-09,Female,56,55-64,3
6,0,1,0,1,2020-07-09,Male,11,10-14,4
6,0,0,0,0,2020-07-14,Female,70,70-74,6
6,2,3,0,5,2020-07-14,Male,73,70-74,6
6,3,1,0,4,2020-07-10,Male,13,10-14,5
6,1,2,0,3,2020-07-14,Male,73,70-74,5
6,0,0,0,0,2020-07-10,Female,36,35-44,3
6,0,1,0,1,2020-07-09,Female,37,35-44,3
6,2,4,0,6,2020-07-14,Female,60,55-64,2
6,3,0,0,3,2020-07-10,Female,7,5-9,3
6,1,1,0,2,2020-07-10,Male,66,65-69,6
6,1,0,0,1,2020-07-10,Female,60,55-64,6
6,1,0,0,1,2020-07-09,Female,66,65-69,5
6,2,0,0,2,2020-07-09,Male,27,25-34,2
6,1,1,0,2,2020-07-13,Male,66,65-69,6
6,3,0,0,3,2020-07-09,Female,13,10-14,3
6,0,0,0,0,2020-07-12,Female,50,45-54,2
6,0,1,0,1,2020-07-10,Male,21,20-24,4
6,3,0,0,3,2020-07-11,Female,1,1-4,5
6,1,2,0,3,2020-07-10,Male,65,65-69,6
6,1,2,1,4,2020-07-12,Female,28,25-34,3
6,0,1,0,1,2020-07-09,Male,31,25-34,3
6,1,0,0,1,2020-07-10,Female,11,10-14,2
6,3,0,0,3,2020-07-11,Female,64,55-64,6
6,0,1,0,1,2020-07-14,Female,66,65-69,6
6,0,0,0,0,2020-07-14,Female,75,75-79,6
6,0,0,0,0,2020-07-13,Female,37,35-44,6
6,2,1,1,4,2020-07-15,Female,44,35-44,3
6,2,0,0,2,2020-07-09,Male,32,25-34,6
6,3,0,0,3,2020-07-13,Male,17,15-19,6
6,3,0,0,3,2020-07-09,Male,33,25-34,4
6,2,0,0,2,2020-07-11,Female,22,20-24,6
6,0,0,0,0,2020-07-14,Male,34,25-34,3
6,3,0,0,3,2020-07-13,Male,17,15-19,3
6,0,0,0,0,2020-07-10,Female,63,55-64,5
6,1,0,0,1,2020-07-09,Male,65,65-69,4
6,0,0,0,0,2020-07-14,Male,55,55-64,2
6,0,0,0,0,2020-07-10,Female,14,10-14,6
6,1,0,0,1,2020-07-09,Male,26,25-34,3
6,0,13,0,13,2020-07-11,Female,65,65-69,3
6,4,2,0,6,2020-07-09,Male,12,10-14,2
6,1,0,0,1,2020-07-14,Male,54,45-54,6
6,1,3,0,4,2020-07-13,Male,58,55-64,3
6,2,0,0,2,2020-07-10,Male,62,55-64,6
6,2,0,0,2,2020-07-09,Male,65,65-69,5
6,3,10,0,13,2020-07-09,Female,21,20-24,3
6,2,2,0,4,2020-07-16,Female,66,65-69,6
6,0,0,0,0,2020-07-09,Male,30,25-34,3
6,0,0,0,0,2020-07-09,Male,27,25-34,3
6,0,0,0,0,2020-07-13,Female,43,35-44,6
6,1,8,10,19,2020-07-14,Male,67,65-69,3
6,0,2,0,2,2020-07-11,Female,61,55-64,3
6,1,5,0,6,2020-07-14,Female,30,25-34,2
6,0,3,0,3,2020-07-10,Male,63,55-64,6
6,1,2,0,3,2020-07-14,Female,52,45-54,6
6,0,0,0,0,2020-07-14,Male,53,45-54,3
6,2,0,0,2,2020-07-11,Female,48,45-54,6
6,3,0,0,3,2020-07-11,Male,19,15-19,3
6,1,0,0,1,2020-07-10,Male,65,65-69,5
6,0,0,0,0,2020-07-12,Female,25,25-34,5
6,0,0,0,0,2020-07-13,Female,21,20-24,5
6,1,0,0,1,2020-07-10,Male,40,35-44,3
6,0,0,0,0,2020-07-09,Male,33,25-34,5
6,1,0,0,1,2020-07-09,Male,46,45-54,6
6,1,3,0,4,2020-07-11,Male,61,55-64,6
6,1,0,0,1,2020-07-09,Male,67,65-69,6
6,3,0,0,3,2020-07-09,Female,0,<1,3
6,2,0,0,2,2020-07-09,Male,6,5-9,6
6,1,5,0,6,2020-07-15,Female,24,20-24,2
6,5,3,7,15,2020-07-16,Female,11,10-14,2
6,0,0,0,0,2020-07-11,Male,55,55-64,5
6,2,2,0,4,2020-07-14,Male,70,70-74,3
6,2,2,0,4,2020-07-09,Female,47,45-54,6
6,2,0,0,2,2020-07-10,Female,60,55-64,6
6,3,6,0,9,2020-07-10,Female,18,15-19,3
6,1,1,1,3,2020-07-15,Male,45,45-54,2
6,1,0,0,1,2020-07-10,Male,63,55-64,6
6,1,0,8,9,2020-07-09,Female,19,15-19,3
6,2,0,0,2,2020-07-10,Female,63,55-64,5
6,4,0,0,4,2020-07-09,Male,14,10-14,3
6,1,0,0,1,2020-07-10,Male,45,45-54,2
6,0,12,0,12,2020-07-11,Female,34,25-34,3
6,2,1,0,3,2020-07-13,Female,32,25-34,5
6,1,0,2,3,2020-07-09,Male,57,55-64,6
6,2,0,0,2,2020-07-09,Male,63,55-64,6
6,1,2,0,3,2020-07-10,Female,62,55-64,5
6,1,10,0,11,2020-07-10,Female,63,55-64,5
6,0,4,0,4,2020-07-11,Female,43,35-44,4
6,0,1,0,1,2020-07-13,Female,20,20-24,3
6,2,0,0,2,2020-07-13,Female,68,65-69,6
6,1,6,0,7,2020-07-13,Male,52,45-54,6
6,3,10,0,13,2020-07-10,Male,49,45-54,5
6,2,0,0,2,2020-07-10,Female,63,55-64,3
6,1,3,0,4,2020-07-09,Female,67,65-69,4
6,0,0,0,0,2020-07-10,Male,18,15-19,6
6,0,2,0,2,2020-07-10,Female,65,65-69,3
6,0,0,0,0,2020-07-14,Male,59,55-64,6
6,2,0,0,2,2020-07-10,Female,38,35-44,4
6,4,5,0,9,2020-07-13,Male,13,10-14,3
6,0,1,0,1,2020-07-09,Male,32,25-34,3
6,0,0,0,0,2020-07-09,Male,41,35-44,5
6,1,0,0,1,2020-07-09,Female,64,55-64,3
6,2,3,0,5,2020-07-11,Male,67,65-69,6
6,3,1,0,4,2020-07-10,Male,13,10-14,3
6,2,0,0,2,2020-07-15,Male,76,75-79,5
6,1,0,0,1,2020-07-10,Female,58,55-64,6
6,0,0,0,0,2020-07-09,Female,25,25-34,3
6,2,0,80,82,2020-07-09,Female,32,25-34,3
6,0,2,0,2,2020-07-12,Female,12,10-14,5
6,1,3,1,5,2020-07-14,Female,25,25-34,3
6,2,2,1,5,2020-07-14,Male,62,55-64,3
6,2,0,0,2,2020-07-10,Male,66,65-69,2
6,0,0,0,0,2020-07-12,Female,67,65-69,4
6,1,0,0,1,2020-07-10,Female,37,35-44,3
6,4,0,0,4,2020-07-14,Male,10,10-14,5
6,0,0,0,0,2020-07-13,Female,18,15-19,3
6,2,0,0,2,2020-07-11,Male,23,20-24,2
6,5,12,0,17,2020-07-09,Male,37,35-44,3
6,0,0,0,0,2020-07-13,Female,39,35-44,6
6,2,0,0,2,2020-07-14,Male,19,15-19,3
6,1,0,0,1,2020-07-09,Female,54,45-54,2
6,2,0,0,2,2020-07-09,Male,50,45-54,3
6,1,0,0,1,2020-07-12,Male,46,45-54,3
6,0,4,0,4,2020-07-10,Male,39,35-44,3
6,0,0,0,0,2020-07-09,Female,34,25-34,4
6,1,2,0,3,2020-07-10,Male,45,45-54,3
6,1,3,0,4,2020-07-09,Female,65,65-69,4
6,1,1,0,2,2020-07-13,Female,52,45-54,3
6,3,2,0,5,2020-07-09,Male,25,25-34,3
6,2,3,0,5,2020-07-13,Female,5,5-9,3
6,2,1,0,3,2020-07-14,Female,73,70-74,5
6,2,9,0,11,2020-07-14,Male,11,10-14,4
6,0,0,0,0,2020-07-16,Female,68,65-69,6
6,4,2,0,6,2020-07-15,Female,27,25-34,4
6,1,1,0,2,2020-07-09,Female,19,15-19,2
6,1,0,0,1,2020-07-09,Female,30,25-34,3
6,5,2,0,7,2020-07-14,Male,10,10-14,6
6,2,3,0,5,2020-07-09,Female,54,45-54,3
6,0,5,0,5,2020-07-09,Female,27,25-34,6
6,2,0,0,2,2020-07-13,Male,47,45-54,6
6,0,0,0,0,2020-07-09,Female,52,45-54,6
6,1,1,0,2,2020-07-13,Female,68,65-69,6
6,5,0,0,5,2020-07-15,Female,20,20-24,3
6,0,3,0,3,2020-07-10,Female,37,35-44,6
6,0,1,0,1,2020-07-09,Male,48,45-54,3
6,1,0,0,1,2020-07-11,Male,63,55-64,3
6,2,4,4,10,2020-07-10,Female,22,20-24,5
6,0,0,0,0,2020-07-10,Male,27,25-34,3
6,1,0,0,1,2020-07-09,Male,35,35-44,3
6,0,0,0,0,2020-07-14,Male,49,45-54,5
6,2,3,0,5,2020-07-14,Female,68,65-69,6
6,3,7,0,10,2020-07-16,Female,9,5-9,3
6,1,3,11,15,2020-07-10,Female,51,45-54,2
6,0,0,0,0,2020-07-10,Female,52,45-54,3
6,2,0,0,2,2020-07-13,Male,68,65-69,6
6,1,0,0,1,2020-07-09,Female,47,45-54,5
6,5,5,0,10,2020-07-11,Female,15,15-19,5
6,1,0,0,1,2020-07-09,Female,31,25-34,6
6,1,3,0,4,2020-07-12,Female,53,45-54,6
6,0,2,0,2,2020-07-15,Male,47,45-54,4
6,1,10,0,11,2020-07-09,Female,33,25-34,3
6,2,2,0,4,2020-07-13,Female,66,65-69,4
6,0,0,0,0,2020-07-11,Male,50,45-54,6
6,3,2,0,5,2020-07-09,Male,23,20-24,2
6,0,0,0,0,2020-07-09,Male,28,25-34,5
6,2,1,0,3,2020-07-09,Male,26,25-34,5
6,2,1,0,3,2020-07-10,Male,44,35-44,5
6,2,1,12,15,2020-07-11,Female,5,5-9,3
6,0,2,0,2,2020-07-14,Male,30,25-34,4
6,2,0,0,2,2020-07-10,Male,65,65-69,6
6,0,0,0,0,2020-07-13,Male,42,35-44,5
6,1,1,0,2,2020-07-14,Female,79,75-79,6
6,0,1,0,1,2020-07-10,Female,20,20-24,2
6,1,0,0,1,2020-07-13,Female,69,65-69,5
6,0,1,0,1,2020-07-09,Female,69,65-69,6
6,1,1,0,2,2020-07-09,Male,70,70-74,6
6,0,0,0,0,2020-07-11,Female,36,35-44,4
6,0,1,0,1,2020-07-10,Male,61,55-64,6
6,5,1,13,19,2020-07-10,Male,8,5-9,5
6,1,7,0,8,2020-07-09,Female,29,25-34,5
6,4,0,0,4,2020-07-10,Female,8,5-9,5
6,3,1,0,4,2020-07-09,Male,13,10-14,3
6,0,0,0,0,2020-07-09,Male,33,25-34,6
6,2,0,0,2,2020-07-10,Male,19,15-19,3
6,4,0,0,4,2020-07-12,Male,15,15-19,3
7,0,0,0,0,2020-07-24,Male,59,55-64,5
7,1,1,0,2,2020-07-29,Male,67,65-69,3
7,2,0,0,2,2020-07-29,Female,69,65-69,4
7,2,0,0,2,2020-07-29,Male,65,65-69,7
7,2,0,0,2,2020-07-25,Female,17,15-19,3
7,0,0,0,0,2020-07-24,Female,50,45-54,4
7,1,0,0,1,2020-07-24,Female,71,70-74,7
7,0,1,1,2,2020-07-28,Male,29,25-34,4
7,0,0,0,0,2020-07-24,Female,53,45-54,4
7,0,0,0,0,2020-07-24,Female,67,65-69,4
7,2,0,0,2,2020-07-24,Male,34,25-34,7
7,0,0,0,0,2020-07-24,Male,50,45-54,6
7,1,0,1,2,2020-07-24,Male,50,45-54,4
7,0,1,0,1,2020-07-28,Female,35,35-44,4
7,3,3,0,6,2020-07-26,Female,57,55-64,6
7,2,0,0,2,2020-07-25,Female,6,5-9,7
7,3,2,0,5,2020-07-29,Female,4,1-4,2
7,0,0,0,0,2020-07-24,Male,32,25-34,6
7,0,1,0,1,2020-07-27,Male,66,65-69,5
7,0,0,0,0,2020-07-24,Male,62,55-64,7
7,1,0,0,1,2020-07-24,Male,10,10-14,4
7,0,0,0,0,2020-07-28,Male,17,15-19,7
7,0,0,0,0,2020-07-25,Male,48,45-54,4
7,1,0,0,1,2020-07-28,Male,34,25-34,4
7,0,1,0,1,2020-07-28,Male,53,45-54,3
7,2,0,0,2,2020-07-29,Female,70,70-74,7
7,1,0,0,1,2020-07-29,Male,67,65-69,7
7,1,0,0,1,2020-07-27,Female,52,45-54,4
7,0,0,0,0,2020-07-25,Male,41,35-44,7
7,1,0,0,1,2020-07-27,Female,56,55-64,7
7,2,0,0,2,2020-07-24,Female,21,20-24,6
7,2,0,0,2,2020-07-24,Male,51,45-54,7
7,3,1,0,4,2020-07-27,Female,10,10-14,3
7,2,0,0,2,2020-07-24,Male,1,1-4,4
7,2,0,0,2,2020-07-27,Female,8,5-9,3
7,1,0,0,1,2020-07-24,Male,57,55-64,7
7,0,2,0,2,2020-07-29,Male,67,65-69,7
7,1,1,0,2,2020-07-28,Male,50,45-54,5
7,2,0,0,2,2020-07-27,Male,71,70-74,7
7,0,2,0,2,2020-07-27,Male,43,35-44,4
7,0,1,0,1,2020-07-29,Male,36,35-44,3
7,0,0,0,0,2020-07-24,Male,52,45-54,3
7,0,0,0,0,2020-07-26,Male,43,35-44,4
7,3,3,0,6,2020-07-24,Male,43,35-44,6
7,2,0,0,2,2020-07-28,Male,0,<1,4
7,1,3,1,5,2020-07-24,Male,40,35-44,4
7,2,1,0,3,2020-07-25,Male,69,65-69,5
7,1,0,0,1,2020-07-28,Female,55,55-64,4
7,0,1,0,1,2020-07-29,Male,3,1-4,4
7,1,0,0,1,2020-07-29,Female,67,65-69,5
7,0,4,0,4,2020-07-24,Female,51,45-54,4
7,1,2,0,3,2020-07-24,Male,38,35-44,6
7,1,3,0,4,2020-07-24,Male,62,55-64,4
7,2,1,0,3,2020-07-28,Female,11,10-14,4
7,2,2,0,4,2020-07-25,Male,54,45-54,7
7,1,0,0,1,2020-07-24,Male,70,70-74,4
7,1,3,0,4,2020-07-29,Female,65,65-69,7
7,2,0,0,2,2020-07-27,Male,67,65-69,7
7,2,1,0,3,2020-07-29,Male,68,65-69,4
7,0,0,0,0,2020-07-26,Male,34,25-34,4
7,4,0,0,4,2020-07-26,Female,11,10-14,4
7,0,0,0,0,2020-07-29,Male,40,35-44,2
7,1,1,0,2,2020-07-29,Male,67,65-69,6
7,0,0,0,0,2020-07-24,Female,24,20-24,4
7,0,2,0,2,2020-07-24,Male,42,35-44,4
7,0,0,0,0,2020-07-29,Male,32,25-34,4
7,1,8,0,9,2020-07-29,Male,69,65-69,7
7,4,1,32,37,2020-07-28,Female,3,1-4,5
7,0,0,0,0,2020-07-26,Male,37,35-44,5
7,4,2,0,6,2020-07-27,Male,15,15-19,6
7,1,0,0,1,2020-07-27,Male,31,25-34,4
7,0,3,0,3,2020-07-29,Female,52,45-54,6
7,0,0,0,0,2020-07-24,Male,48,45-54,7
7,0,1,0,1,2020-07-28,Male,69,65-69,4
7,2,0,0,2,2020-07-24,Female,26,25-34,4
7,1,2,0,3,2020-07-25,Female,62,55-64,6
7,0,1,0,1,2020-07-28,Female,27,25-34,4
7,1,2,0,3,2020-07-24,Female,30,25-34,6
7,2,1,0,3,2020-07-27,Female,67,65-69,4
7,0,0,0,0,2020-07-28,Female,62,55-64,6
7,2,0,0,2,2020-07-24,Male,19,15-19,4
7,0,0,0,0,2020-07-24,Female,46,45-54,6
7,0,2,0,2,2020-07-26,Male,54,45-54,4
7,2,0,0,2,2020-07-29,Female,65,65-69,6
7,0,0,0,0,2020-07-29,Male,33,25-34,4
7,1,3,0,4,2020-07-24,Male,57,55-64,5
7,0,1,0,1,2020-07-24,Male,32,25-34,7
7,0,0,0,0,2020-07-24,Female,33,25-34,4
7,4,0,0,4,2020-07-24,Male,36,35-44,6
7,1,2,0,3,2020-07-29,Male,65,65-69,4
7,0,0,0,0,2020-07-24,Male,63,55-64,6
7,0,0,0,0,2020-07-24,Male,29,25-34,2
7,0,2,0,2,2020-07-29,Female,55,55-64,4
7,2,0,0,2,2020-07-24,Female,25,25-34,3
7,0,6,0,6,2020-07-26,Male,68,65-69,4
7,1,0,0,1,2020-07-25,Female,67,65-69,6
7,3,4,0,7,2020-07-25,Male,41,35-44,4
7,2,0,0,2,2020-07-24,Male,58,55-64,7
7,0,1,5,6,2020-07-24,Male,25,25-34,4
7,0,0,0,0,2020-07-29,Female,62,55-64,4
7,3,3,0,6,2020-07-24,Female,58,55-64,5
7,0,0,0,0,2020-07-28,Male,69,65-69,4
7,0,1,0,1,2020-07-29,Female,39,35-44,3
7,3,0,0,3,2020-07-24,Male,31,25-34,4
7,2,0,0,2,2020-07-24,Male,35,35-44,6
7,0,1,0,1,2020-07-25,Male,23,20-24,4
7,0,0,0,0,2020-07-27,Female,33,25-34,3
7,3,0,0,3,2020-07-24,Female,12,10-14,4
7,1,0,0,1,2020-07-29,Male,65,65-69,6
7,2,0,0,2,2020-07-26,Male,56,55-64,6
7,1,0,0,1,2020-07-27,Female,28,25-34,6
7,2,3,17,22,2020-07-24,Female,66,65-69,5
7,2,7,0,9,2020-07-27,Female,56,55-64,4
7,0,0,0,0,2020-07-28,Male,52,45-54,2
7,1,0,0,1,2020-07-26,Male,27,25-34,3
7,0,0,0,0,2020-07-24,Male,56,55-64,7
7,2,2,4,8,2020-07-29,Male,70,70-74,4
7,2,2,0,4,2020-07-27,Male,19,15-19,7
7,0,0,0,0,2020-07-24,Female,51,45-54,7
7,0,0,0,0,2020-07-26,Male,28,25-34,4
7,3,0,2,5,2020-07-25,Male,7,5-9,4
7,3,0,0,3,2020-07-28,Male,65,65-69,5
7,0,0,0,0,2020-07-24,Female,23,20-24,4
7,0,0,0,0,2020-07-29,Female,65,65-69,7
7,1,1,0,2,2020-07-24,Female,41,35-44,4
7,0,3,0,3,2020-07-25,Male,70,70-74,7
7,2,2,0,4,2020-07-24,Female,27,25-34,4
7,1,8,0,9,2020-07-29,Male,74,70-74,7
7,0,0,0,0,2020-07-24,Male,50,45-54,3
7,1,0,0,1,2020-07-25,Female,30,25-34,4
7,1,0,0,1,2020-07-24,Female,54,45-54,7
7,0,0,0,0,2020-07-29,Female,21,20-24,3
7,0,0,0,0,2020-07-27,Male,53,45-54,4
7,1,0,0,1,2020-07-25,Male,50,45-54,7
7,0,0,0,0,2020-07-24,Female,24,20-24,3
7,1,0,0,1,2020-07-28,Female,49,45-54,4
7,1,4,0,5,2020-07-25,Female,29,25-34,4
7,1,1,4,6,2020-07-29,Male,13,10-14,3
7,2,8,100,110,2020-07-29,Male,17,15-19,4
7,1,1,0,2,2020-07-24,Male,52,45-54,7
7,1,0,0,1,2020-07-29,Female,57,55-64,6
7,0,1,0,1,2020-07-24,Male,50,45-54,6
7,3,0,0,3,2020-07-27,Male,13,10-14,6
7,0,0,0,0,2020-07-24,Male,70,70-74,7
7,0,0,0,0,2020-07-28,Female,69,65-69,7
7,0,3,0,3,2020-07-26,Male,37,35-44,4
7,0,0,0,0,2020-07-25,Male,19,15-19,4
7,0,1,1,2,2020-07-26,Female,7,5-9,3
7,0,2,0,2,2020-07-26,Male,51,45-54,3
7,1,1,0,2,2020-07-28,Female,56,55-64,7
7,1,0,0,1,2020-07-29,Female,59,55-64,7
7,0,0,0,0,2020-07-24,Male,43,35-44,7
7,0,0,0,0,2020-07-24,Male,27,25-34,4
7,2,0,0,2,2020-07-24,Male,31,25-34,6
7,0,5,0,5,2020-07-24,Female,22,20-24,3
7,2,9,0,11,2020-07-24,Female,52,45-54,6
7,2,0,0,2,2020-07-29,Male,68,65-69,7
7,0,0,0,0,2020-07-24,Male,33,25-34,6
7,0,0,0,0,2020-07-25,Male,47,45-54,4
7,3,1,0,4,2020-07-27,Male,69,65-69,4
7,0,1,0,1,2020-07-28,Male,65,65-69,7
7,0,0,0,0,2020-07-24,Male,36,35-44,4
7,0,3,0,3,2020-07-28,Male,61,55-64,6
7,0,0,0,0,2020-07-27,Female,56,55-64,6
7,0,0,0,0,2020-07-24,Female,58,55-64,4
7,0,0,0,0,2020-07-27,Male,22,20-24,3
7,0,0,0,0,2020-07-29,Female,40,35-44,7
7,1,2,0,3,2020-07-28,Female,24,20-24,3
7,5,0,0,5,2020-07-24,Female,11,10-14,6
7,1,1,0,2,2020-07-27,Female,60,55-64,7
7,1,2,0,3,2020-07-29,Male,61,55-64,6
7,0,0,0,0,2020-07-24,Male,18,15-19,4
7,1,0,0,1,2020-07-27,Female,53,45-54,7
7,0,0,0,0,2020-07-25,Male,33,25-34,4
7,0,2,0,2,2020-07-28,Male,55,55-64,4
7,1,1,0,2,2020-07-29,Female,37,35-44,2
7,0,0,0,0,2020-07-24,Female,65,65-69,7
7,2,0,0,2,2020-07-24,Male,14,10-14,5
7,3,1,0,4,2020-07-24,Female,5,5-9,4
7,4,3,0,7,2020-07-25,Male,8,5-9,3
7,2,0,0,2,2020-07-24,Female,48,45-54,4
7,0,0,0,0,2020-07-24,Female,55,55-64,7
7,0,0,0,0,2020-07-28,Male,53,45-54,6
7,1,0,0,1,2020-07-26,Male,68,65-69,7
7,0,7,0,7,2020-07-24,Male,36,35-44,7
7,1,1,0,2,2020-07-24,Male,39,35-44,7
7,2,0,0,2,2020-07-29,Female,60,55-64,4
7,0,0,0,0,2020-07-24,Male,32,25-34,5
7,2,0,0,2,2020-07-25,Male,61,55-64,7
7,1,3,0,4,2020-07-29,Female,68,65-69,6
7,4,3,0,7,2020-07-24,Female,23,20-24,3
7,1,3,0,4,2020-07-29,Male,67,65-69,3
7,0,1,8,9,2020-07-27,Male,5,5-9,4
7,1,1,0,2,2020-07-27,Female,33,25-34,6
7,0,0,0,0,2020-07-29,Male,68,65-69,7
7,0,0,0,0,2020-07-27,Male,28,25-34,7
7,0,0,0,0,2020-07-24,Female,53,45-54,6
7,2,2,0,4,2020-07-25,Male,19,15-19,4
7,3,2,0,5,2020-07-27,Male,8,5-9,6
7,1,2,0,3,2020-07-24,Male,52,45-54,4
7,0,2,0,2,2020-07-25,Female,70,70-74,4
7,2,1,0,3,2020-07-29,Female,68,65-69,3
7,2,1,0,3,2020-07-24,Male,32,25-34,3
7,3,1,0,4,2020-07-29,Male,69,65-69,4
7,2,10,0,12,2020-07-29,Female,68,65-69,7
7,3,0,9,12,2020-07-27,Male,18,15-19,4
7,0,0,0,0,2020-07-24,Male,64,55-64,2
7,0,1,0,1,2020-07-24,Male,49,45-54,7
7,1,2,0,3,2020-07-26,Male,65,65-69,4
7,1,0,0,1,2020-07-24,Female,53,45-54,3
7,1,0,0,1,2020-07-25,Male,52,45-54,4
7,0,0,0,0,2020-07-24,Female,60,55-64,4
7,2,0,0,2,2020-07-27,Female,65,65-69,4
7,3,1,0,4,2020-07-26,Male,21,20-24,4
7,1,0,0,1,2020-07-25,Male,66,65-69,7
7,0,0,0,0,2020-07-29,Male,64,55-64,7
7,2,4,0,6,2020-07-24,Female,67,65-69,6
7,1,2,0,3,2020-07-29,Male,67,65-69,7
7,1,1,0,2,2020-07-29,Male,74,70-74,7
7,4,0,0,4,2020-07-25,Female,8,5-9,4
7,2,0,0,2,2020-07-29,Male,70,70-74,2
7,3,1,0,4,2020-07-29,Male,13,10-14,7
7,0,0,0,0,2020-07-24,Male,52,45-54,3
7,0,0,0,0,2020-07-24,Male,19,15-19,4
7,0,0,0,0,2020-07-24,Female,51,45-54,7
7,5,0,0,5,2020-07-27,Male,27,25-34,3
7,0,1,0,1,2020-07-25,Female,59,55-64,6
7,0,0,1,1,2020-07-24,Male,13,10-14,7
7,4,3,0,7,2020-07-25,Female,4,1-4,2
7,0,0,0,0,2020-07-25,Male,46,45-54,3
7,3,1,0,4,2020-07-26,Female,53,45-54,5
7,0,0,0,0,2020-07-27,Female,58,55-64,4
7,0,0,0,0,2020-07-24,Female,9,5-9,4
7,2,0,0,2,2020-07-24,Male,59,55-64,5
7,0,0,0,0,2020-07-24,Female,49,45-54,7
7,0,1,0,1,2020-07-24,Male,24,20-24,4
7,0,0,0,0,2020-07-25,Male,22,20-24,5
7,2,1,0,3,2020-07-29,Male,71,70-74,6
7,0,0,0,0,2020-07-27,Male,34,25-34,7
7,0,2,0,2,2020-07-25,Male,27,25-34,3
7,3,0,0,3,2020-07-24,Female,21,20-24,4
7,0,3,0,3,2020-07-29,Female,34,25-34,5
7,1,0,0,1,2020-07-27,Female,23,20-24,7
7,1,0,0,1,2020-07-28,Female,66,65-69,4
7,1,0,0,1,2020-07-29,Female,67,65-69,3
7,2,0,0,2,2020-07-24,Male,41,35-44,7
7,0,0,0,0,2020-07-29,Male,65,65-69,7
7,3,1,0,4,2020-07-24,Male,49,45-54,6
7,0,1,0,1,2020-07-29,Male,70,70-74,4
7,2,0,1,3,2020-07-25,Male,58,55-64,5
7,0,10,0,10,2020-07-24,Male,32,25-34,5
7,0,4,18,22,2020-07-24,Female,68,65-69,4
7,0,0,0,0,2020-07-27,Male,63,55-64,4
7,2,0,0,2,2020-07-26,Male,13,10-14,4
7,0,0,0,0,2020-07-26,Female,25,25-34,7
7,0,1,0,1,2020-07-29,Female,68,65-69,6
7,0,0,3,3,2020-07-24,Female,66,65-69,4
7,0,4,0,4,2020-07-28,Male,67,65-69,3
7,0,0,0,0,2020-07-24,Female,63,55-64,4
7,1,1,0,2,2020-07-29,Male,68,65-69,7
7,3,1,0,4,2020-07-25,Male,53,45-54,5
7,0,1,0,1,2020-07-25,Male,29,25-34,7
7,0,0,0,0,2020-07-25,Female,5,5-9,6
7,3,0,0,3,2020-07-28,Female,52,45-54,4
7,1,1,0,2,2020-07-24,Female,52,45-54,6
7,2,0,0,2,2020-07-25,Female,65,65-69,7
7,1,10,0,11,2020-07-27,Female,27,25-34,4
7,0,0,0,0,2020-07-28,Male,54,45-54,6
7,0,1,10,11,2020-07-27,Male,65,65-69,7
7,0,0,0,0,2020-07-29,Female,4,1-4,6
7,1,2,0,3,2020-07-29,Female,69,65-69,7
7,2,0,0,2,2020-07-25,Male,36,35-44,4
7,3,1,0,4,2020-07-25,Male,12,10-14,6
7,1,3,5,9,2020-07-28,Female,50,45-54,5
7,1,2,0,3,2020-07-28,Male,51,45-54,4
7,0,1,0,1,2020-07-29,Male,68,65-69,7
7,2,1,0,3,2020-07-29,Male,56,55-64,4
7,2,11,0,13,2020-07-24,Male,61,55-64,3
7,0,1,0,1,2020-07-29,Female,65,65-69,4
7,0,0,0,0,2020-07-25,Female,28,25-34,4
7,0,2,0,2,2020-07-27,Male,51,45-54,5
7,0,0,0,0,2020-07-24,Female,49,45-54,6
7,0,0,0,0,2020-07-27,Male,73,70-74,6
7,3,0,0,3,2020-07-24,Female,12,10-14,7
7,3,0,0,3,2020-07-24,Female,13,10-14,6
7,1,5,0,6,2020-07-24,Male,7,5-9,5
7,2,0,0,2,2020-07-27,Male,19,15-19,3
7,3,0,0,3,2020-07-24,Female,10,10-14,4
7,0,0,0,0,2020-07-29,Female,65,65-69,4
7,1,0,0,1,2020-07-24,Female,26,25-34,7
7,0,0,0,0,2020-07-26,Male,30,25-34,4
7,1,0,0,1,2020-07-28,Female,22,20-24,5
7,5,0,0,5,2020-07-27,Male,62,55-64,7
7,3,1,0,4,2020-07-28,Female,55,55-64,3
7,1,0,0,1,2020-07-24,Male,63,55-64,4
7,1,3,0,4,2020-07-29,Female,11,10-14,4
7,2,1,0,3,2020-07-25,Male,54,45-54,7
7,1,0,0,1,2020-07-24,Female,7,5-9,5
7,4,0,0,4,2020-07-29,Male,12,10-14,4
7,0,1,0,1,2020-07-29,Male,29,25-34,6
7,2,0,0,2,2020-07-26,Female,19,15-19,2
7,0,1,0,1,2020-07-26,Female,56,55-64,7
7,0,0,0,0,2020-07-29,Male,67,65-69,4
7,0,0,0,0,2020-07-26,Male,51,45-54,6
7,0,4,0,4,2020-07-25,Male,54,45-54,6
7,0,0,0,0,2020-07-25,Female,7,5-9,6
7,2,0,0,2,2020-07-24,Male,3,1-4,4
7,0,2,0,2,2020-07-25,Female,68,65-69,4
7,1,0,0,1,2020-07-27,Male,50,45-54,5
7,0,0,0,0,2020-07-28,Female,29,25-34,4
7,2,0,0,2,2020-07-29,Female,68,65-69,4
7,0,1,0,1,2020-07-28,Female,38,35-44,2
7,1,1,0,2,2020-07-24,Female,47,45-54,3
7,2,0,7,9,2020-07-25,Male,63,55-64,7
7,1,12,0,13,2020-07-24,Male,65,65-69,4
7,2,1,0,3,2020-07-25,Male,7,5-9,6
7,3,10,0,13,2020-07-24,Male,59,55-64,7
7,0,10,0,10,2020-07-29,Male,65,65-69,4
7,0,0,0,0,2020-07-26,Male,57,55-64,7
7,0,0,0,0,2020-07-24,Female,65,65-69,7
7,2,0,0,2,2020-07-28,Male,3,1-4,5
7,2,1,0,3,2020-07-29,Female,53,45-54,3
7,2,2,0,4,2020-07-27,Female,13,10-14,4
7,2,3,0,5,2020-07-24,Female,24,20-24,7
7,4,4,0,8,2020-07-25,Male,12,10-14,7
7,2,2,0,4,2020-07-24,Female,50,45-54,7
7,0,5,0,5,2020-07-25,Female,51,45-54,4
7,0,0,0,0,2020-07-28,Male,73,70-74,7
7,1,0,2,3,2020-07-28,Male,54,45-54,6
7,0,0,0,0,2020-07-29,Female,68,65-69,7
7,3,0,0,3,2020-07-27,Male,16,15-19,3
7,1,11,0,12,2020-07-24,Female,55,55-64,5
7,0,0,0,0,2020-07-26,Male,21,20-24,4
7,2,0,0,2,2020-07-28,Male,65,65-69,5
7,1,2,0,3,2020-07-24,Male,59,55-64,7
7,1,0,0,1,2020-07-24,Male,54,45-54,4
7,1,2,0,3,2020-07-29,Female,68,65-69,7
7,0,0,0,0,2020-07-24,Female,24,20-24,7
7,1,0,0,1,2020-07-24,Male,51,45-54,7
7,2,0,0,2,2020-07-26,Male,29,25-34,7
7,3,0,0,3,2020-07-25,Female,2,1-4,3
7,0,1,0,1,2020-07-25,Female,23,20-24,4
7,1,0,0,1,2020-07-24,Male,33,25-34,3
7,0,1,0,1,2020-07-24,Female,48,45-54,7
7,3,4,0,7,2020-07-28,Male,9,5-9,2
7,0,42,0,42,2020-07-24,Male,39,35-44,3
7,0,0,0,0,2020-07-29,Male,69,65-69,6
7,2,0,0,2,2020-07-24,Female,63,55-64,7
7,2,1,0,3,2020-07-29,Male,63,55-64,4
7,2,1,0,3,2020-07-26,Female,37,35-44,6
7,2,3,0,5,2020-07-29,Female,60,55-64,7
7,1,0,0,1,2020-07-29,Male,70,70-74,7
7,2,4,0,6,2020-07-29,Female,56,55-64,3
7,1,0,0,1,2020-07-25,Male,52,45-54,6
7,0,0,0,0,2020-07-25,Male,50,45-54,5
7,0,5,0,5,2020-07-24,Female,65,65-69,7
7,0,0,0,0,2020-07-28,Female,66,65-69,6
7,3,0,0,3,2020-07-24,Female,6,5-9,5
7,1,4,0,5,2020-07-27,Female,52,45-54,5
7,0,1,0,1,2020-07-26,Male,53,45-54,3
7,5,0,0,5,2020-07-24,Female,45,45-54,7
7,0,2,0,2,2020-07-28,Male,54,45-54,5
7,2,0,0,2,2020-07-26,Male,65,65-69,4
7,0,0,0,0,2020-07-24,Male,57,55-64,4
7,1,0,0,1,2020-07-28,Female,55,55-64,6
7,2,0,0,2,2020-07-25,Male,39,35-44,7
7,0,0,0,0,2020-07-28,Male,38,35-44,5
7,0,1,0,1,2020-07-24,Male,39,35-44,3
7,4,0,0,4,2020-07-27,Female,20,20-24,4
7,1,1,0,2,2020-07-29,Male,24,20-24,4
7,3,0,0,3,2020-07-29,Female,15,15-19,3
7,2,1,6,9,2020-07-29,Female,56,55-64,4
7,0,0,0,0,2020-07-29,Female,5,5-9,7
7,0,0,0,0,2020-07-27,Male,65,65-69,7
7,2,0,7,9,2020-07-29,Male,63,55-64,4
7,0,4,0,4,2020-07-24,Male,72,70-74,4
7,0,0,0,0,2020-07-28,Female,57,55-64,7
7,3,3,0,6,2020-07-24,Male,42,35-44,4
7,1,0,0,1,2020-07-29,Male,70,70-74,7
7,0,0,0,0,2020-07-24,Female,19,15-19,7
7,1,0,0,1,2020-07-26,Male,62,55-64,7
7,1,1,0,2,2020-07-25,Male,67,65-69,7
7,2,0,0,2,2020-07-29,Female,57,55-64,7
7,0,0,0,0,2020-07-28,Male,57,55-64,7
7,1,0,0,1,2020-07-29,Female,70,70-74,4
7,2,0,0,2,2020-07-24,Male,6,5-9,7
7,2,2,7,11,2020-07-24,Female,55,55-64,7
7,0,1,0,1,2020-07-24,Female,26,25-34,4
7,2,1,0,3,2020-07-27,Female,5,5-9,3
7,0,0,0,0,2020-07-28,Male,52,45-54,3
7,0,0,0,0,2020-07-28,Female,21,20-24,5
7,0,0,0,0,2020-07-27,Female,35,35-44,4
7,2,8,0,10,2020-07-28,Male,55,55-64,4
7,1,2,0,3,2020-07-29,Male,62,55-64,6
7,0,2,0,2,2020-07-27,Male,26,25-34,3
7,1,1,0,2,2020-07-28,Female,8,5-9,4
7,0,1,0,1,2020-07-26,Male,53,45-54,4
7,2,4,0,6,2020-07-28,Male,30,25-34,3
7,2,1,0,3,2020-07-25,Female,58,55-64,7
7,0,0,0,0,2020-07-24,Male,12,10-14,5
7,1,0,0,1,2020-07-27,Female,65,65-69,6
7,2,0,0,2,2020-07-24,Male,64,55-64,7
7,1,1,0,2,2020-07-24,Female,51,45-54,7
7,3,0,0,3,2020-07-28,Female,18,15-19,7
7,1,0,0,1,2020-07-26,Female,55,55-64,3
7,4,2,0,6,2020-07-24,Female,6,5-9,3
7,2,0,0,2,2020-07-24,Male,55,55-64,7
7,1,0,0,1,2020-07-25,Female,54,45-54,4
7,1,0,0,1,2020-07-28,Male,56,55-64,3
7,0,7,0,7,2020-07-28,Female,58,55-64,7
7,0,2,0,2,2020-07-28,Female,32,25-34,4
7,1,0,0,1,2020-07-24,Female,23,20-24,5
7,0,10,0,10,2020-07-25,Male,31,25-34,4
7,0,0,0,0,2020-07-26,Male,27,25-34,6
7,3,6,0,9,2020-07-28,Male,58,55-64,4
7,0,1,0,1,2020-07-27,Male,47,45-54,7
7,4,0,0,4,2020-07-24,Female,5,5-9,7
7,0,0,0,0,2020-07-24,Female,40,35-44,7
7,1,2,0,3,2020-07-24,Male,68,65-69,4
7,0,0,0,0,2020-07-29,Female,26,25-34,4
7,0,0,0,0,2020-07-24,Male,12,10-14,4
7,2,2,0,4,2020-07-25,Male,65,65-69,4
7,2,3,0,5,2020-07-28,Male,33,25-34,4
7,2,0,0,2,2020-07-25,Female,61,55-64,4
7,0,0,0,0,2020-07-29,Male,68,65-69,4
7,0,0,0,0,2020-07-29,Female,30,25-34,6
7,3,1,0,4,2020-07-25,Male,22,20-24,4
7,2,1,0,3,2020-07-24,Male,22,20-24,3
7,0,1,0,1,2020-07-27,Female,72,70-74,5
7,1,1,0,2,2020-07-24,Female,51,45-54,3
7,1,8,5,14,2020-07-29,Male,42,35-44,4
7,1,0,2,3,2020-07-24,Male,68,65-69,7
7,0,0,0,0,2020-07-29,Male,70,70-74,7
7,0,0,0,0,2020-07-29,Male,35,35-44,2
7,0,2,0,2,2020-07-24,Male,59,55-64,4
7,0,0,0,0,2020-07-28,Female,53,45-54,4
7,0,3,0,3,2020-07-28,Male,28,25-34,2
7,0,1,0,1,2020-07-24,Male,50,45-54,4
7,2,0,0,2,2020-07-25,Male,16,15-19,3
7,3,0,0,3,2020-07-24,Male,1,1-4,4
7,0,1,0,1,2020-07-24,Female,30,25-34,5
7,1,2,0,3,2020-07-29,Male,67,65-69,7
7,0,0,0,0,2020-07-27,Male,34,25-34,5
7,2,0,0,2,2020-07-27,Female,22,20-24,4
7,0,0,0,0,2020-07-25,Male,26,25-34,5
7,0,1,0,1,2020-07-29,Female,68,65-69,2
7,0,0,0,0,2020-07-25,Female,15,15-19,4
7,0,3,0,3,2020-07-29,Male,58,55-64,7
7,0,10,0,10,2020-07-24,Male,36,35-44,6
7,0,3,0,3,2020-07-24,Female,42,35-44,4
7,1,0,0,1,2020-07-29,Male,8,5-9,3
7,1,0,0,1,2020-07-24,Male,51,45-54,4
7,7,0,0,7,2020-07-26,Female,31,25-34,5
7,2,0,0,2,2020-07-26,Female,45,45-54,7
7,0,3,0,3,2020-07-27,Male,49,45-54,2
7,3,2,0,5,2020-07-29,Male,68,65-69,3
7,2,0,1,3,2020-07-29,Female,11,10-14,5
7,0,0,15,15,2020-07-29,Male,42,35-44,3
7,1,0,0,1,2020-07-25,Male,62,55-64,3
7,1,0,0,1,2020-07-28,Male,54,45-54,7
7,0,0,0,0,2020-07-25,Female,41,35-44,4
7,1,0,0,1,2020-07-24,Female,51,45-54,4
7,1,0,0,1,2020-07-27,Male,51,45-54,4
7,0,0,0,0,2020-07-29,Female,65,65-69,3
7,4,0,0,4,2020-07-25,Male,16,15-19,7
7,1,1,27,29,2020-07-28,Male,54,45-54,4
7,2,0,0,2,2020-07-26,Male,16,15-19,4
7,0,0,0,0,2020-07-26,Female,35,35-44,3
7,3,0,0,3,2020-07-25,Female,51,45-54,3
7,0,0,0,0,2020-07-24,Male,22,20-24,5
7,1,0,0,1,2020-07-24,Male,30,25-34,4
7,1,1,0,2,2020-07-26,Female,20,20-24,4
7,3,0,0,3,2020-07-28,Female,55,55-64,7
7,3,0,0,3,2020-07-27,Female,66,65-69,7
7,2,1,0,3,2020-07-24,Male,51,45-54,7
7,2,2,0,4,2020-07-25,Female,49,45-54,3
7,2,1,0,3,2020-07-29,Male,64,55-64,4
7,1,0,0,1,2020-07-24,Male,48,45-54,4
7,0,0,0,0,2020-07-25,Male,59,55-64,5
7,1,2,0,3,2020-07-29,Male,69,65-69,4
7,0,10,1,11,2020-07-24,Male,30,25-34,4
7,0,2,0,2,2020-07-27,Female,25,25-34,5
7,3,6,14,23,2020-07-24,Female,27,25-34,4
7,2,0,0,2,2020-07-28,Female,54,45-54,5
7,1,0,0,1,2020-07-29,Female,60,55-64,6
7,0,0,0,0,2020-07-27,Male,40,35-44,4
7,0,1,0,1,2020-07-29,Male,65,65-69,7
7,2,1,0,3,2020-07-24,Male,56,55-64,4
7,0,0,0,0,2020-07-25,Female,39,35-44,4
7,0,0,0,0,2020-07-25,Female,65,65-69,7
7,1,1,0,2,2020-07-26,Male,69,65-69,6
7,1,0,0,1,2020-07-24,Male,33,25-34,5
7,0,0,1,1,2020-07-26,Male,45,45-54,4
7,0,3,0,3,2020-07-25,Female,65,65-69,4
7,0,1,45,46,2020-07-25,Male,19,15-19,2
7,1,11,0,12,2020-07-29,Female,67,65-69,4
7,0,0,0,0,2020-07-24,Female,64,55-64,7
7,1,0,0,1,2020-07-24,Male,58,55-64,7
7,2,3,0,5,2020-07-29,Male,69,65-69,7
7,1,1,0,2,2020-07-24,Male,51,45-54,7
7,0,6,0,6,2020-07-28,Female,52,45-54,2
7,1,0,0,1,2020-07-24,Female,63,55-64,4
7,2,0,0,2,2020-07-29,Female,17,15-19,7
7,2,0,0,2,2020-07-26,Male,0,<1,3
7,1,7,0,8,2020-07-28,Female,38,35-44,7
7,2,0,0,2,2020-07-24,Female,57,55-64,7
7,2,0,1,3,2020-07-24,Male,16,15-19,7
7,0,1,0,1,2020-07-27,Male,39,35-44,7
7,0,0,0,0,2020-07-29,Male,67,65-69,4
7,1,0,0,1,2020-07-29,Female,68,65-69,6
7,0,0,0,0,2020-07-24,Female,28,25-34,5
7,4,0,0,4,2020-07-25,Female,32,25-34,5
7,1,0,0,1,2020-07-24,Female,63,55-64,4
7,3,0,0,3,2020-07-26,Male,15,15-19,3
7,2,2,0,4,2020-07-28,Female,48,45-54,4
7,0,0,0,0,2020-07-24,Female,46,45-54,4
7,1,2,0,3,2020-07-25,Male,32,25-34,4
7,1,3,3,7,2020-07-29,Female,67,65-69,7
7,2,8,0,10,2020-07-24,Female,18,15-19,4
7,2,5,0,7,2020-07-24,Female,49,45-54,5
7,0,1,0,1,2020-07-24,Male,22,20-24,5
7,0,1,0,1,2020-07-24,Male,59,55-64,4
7,2,0,0,2,2020-07-26,Male,59,55-64,6
7,0,0,0,0,2020-07-25,Male,31,25-34,4
7,2,0,0,2,2020-07-26,Male,25,25-34,6
7,2,0,0,2,2020-07-27,Male,56,55-64,4
7,2,0,0,2,2020-07-27,Male,69,65-69,4
7,0,0,0,0,2020-07-29,Male,69,65-69,6
7,0,7,0,7,2020-07-28,Male,59,55-64,6
7,1,0,0,1,2020-07-27,Male,43,35-44,7
7,2,10,100,112,2020-07-28,Male,30,25-34,7
7,3,2,0,5,2020-07-26,Female,3,1-4,3
7,3,3,0,6,2020-07-24,Male,21,20-24,2
7,3,0,0,3,2020-07-27,Female,0,<1,6
7,0,1,0,1,2020-07-25,Male,42,35-44,7
7,0,0,0,0,2020-07-26,Male,57,55-64,2
7,2,0,0,2,2020-07-25,Male,36,35-44,5
7,0,0,0,0,2020-07-28,Male,24,20-24,4
7,5,0,0,5,2020-07-29,Female,67,65-69,3
7,2,0,0,2,2020-07-29,Female,67,65-69,5
7,0,0,0,0,2020-07-24,Female,24,20-24,5
7,1,10,0,11,2020-07-25,Male,51,45-54,7
7,0,1,0,1,2020-07-24,Female,55,55-64,3
7,0,0,0,0,2020-07-27,Female,25,25-34,4
7,2,0,0,2,2020-07-24,Female,59,55-64,7
7,1,0,0,1,2020-07-29,Male,40,35-44,4
7,0,0,0,0,2020-07-25,Male,53,45-54,4
7,1,0,0,1,2020-07-26,Female,30,25-34,7
7,0,0,0,0,2020-07-24,Male,33,25-34,7
7,1,3,0,4,2020-07-26,Female,54,45-54,7
7,0,1,0,1,2020-07-24,Female,66,65-69,5
7,2,0,0,2,2020-07-25,Female,13,10-14,4
7,0,0,0,0,2020-07-29,Female,67,65-69,4
7,0,1,0,1,2020-07-25,Female,69,65-69,4
7,1,0,0,1,2020-07-24,Male,45,45-54,7
7,0,0,0,0,2020-07-28,Female,55,55-64,7
7,2,0,0,2,2020-07-26,Female,29,25-34,3
7,0,1,20,21,2020-07-24,Male,29,25-34,4
7,0,0,0,0,2020-07-24,Male,38,35-44,3
7,1,3,0,4,2020-07-29,Male,67,65-69,4
7,0,0,0,0,2020-07-28,Male,23,20-24,4
7,2,0,0,2,2020-07-24,Male,13,10-14,7
7,1,0,0,1,2020-07-25,Female,45,45-54,5
7,0,0,0,0,2020-07-29,Male,47,45-54,4
7,2,0,0,2,2020-07-24,Female,65,65-69,3
7,2,2,0,4,2020-07-25,Female,57,55-64,7
7,2,0,0,2,2020-07-28,Male,18,15-19,4
7,1,3,0,4,2020-07-28,Male,31,25-34,5
7,3,1,0,4,2020-07-25,Male,13,10-14,2
7,1,0,0,1,2020-07-25,Female,67,65-69,4
7,0,0,0,0,2020-07-27,Male,57,55-64,5
7,3,1,0,4,2020-07-29,Male,10,10-14,4
7,4,2,0,6,2020-07-24,Male,12,10-14,4
7,0,1,0,1,2020-07-25,Female,33,25-34,3
7,1,1,0,2,2020-07-28,Male,52,45-54,2
7,2,0,0,2,2020-07-29,Male,64,55-64,3
7,2,0,0,2,2020-07-25,Male,50,45-54,5
7,0,0,0,0,2020-07-25,Female,20,20-24,3
7,1,3,0,4,2020-07-28,Female,53,45-54,4
7,0,5,3,8,2020-07-24,Female,47,45-54,3
7,0,1,0,1,2020-07-28,Female,57,55-64,2
7,0,0,0,0,2020-07-24,Female,21,20-24,4
7,2,1,0,3,2020-07-27,Male,27,25-34,4
7,1,2,0,3,2020-07-29,Male,65,65-69,5
7,1,0,0,1,2020-07-29,Female,62,55-64,6
7,1,1,0,2,2020-07-28,Female,52,45-54,4
7,0,0,0,0,2020-07-29,Male,65,65-69,7
7,1,0,0,1,2020-07-24,Male,63,55-64,7
7,1,2,0,3,2020-07-28,Male,30,25-34,3
7,2,0,0,2,2020-07-26,Female,27,25-34,3
7,2,2,0,4,2020-07-25,Female,45,45-54,4
7,0,0,0,0,2020-07-29,Female,35,35-44,7
7,6,1,0,7,2020-07-26,Male,9,5-9,4
7,6,5,0,11,2020-07-28,Female,13,10-14,4
7,3,3,0,6,2020-07-29,Female,64,55-64,7
7,0,1,0,1,2020-07-29,Female,61,55-64,7
7,0,0,0,0,2020-07-24,Female,31,25-34,4
7,0,2,0,2,2020-07-26,Male,20,20-24,4
7,2,0,0,2,2020-07-24,Male,54,45-54,6
7,0,1,0,1,2020-07-26,Female,42,35-44,4
7,2,0,0,2,2020-07-26,Female,59,55-64,7
7,1,5,0,6,2020-07-25,Female,22,20-24,4
7,1,3,0,4,2020-07-27,Male,55,55-64,4
7,0,0,0,0,2020-07-27,Female,30,25-34,6
7,1,1,0,2,2020-07-24,Male,53,45-54,4
7,9,1,1,11,2020-07-24,Female,28,25-34,4
7,0,3,0,3,2020-07-29,Male,39,35-44,4
7,0,0,0,0,2020-07-28,Female,50,45-54,3
7,1,2,0,3,2020-07-29,Male,40,35-44,4
7,3,0,0,3,2020-07-24,Male,17,15-19,4
7,0,0,0,0,2020-07-26,Female,63,55-64,7
7,0,0,0,0,2020-07-25,Male,14,10-14,7
7,1,0,0,1,2020-07-27,Female,66,65-69,6
7,0,0,0,0,2020-07-25,Male,60,55-64,3
7,0,4,0,4,2020-07-26,Female,61,55-64,7
7,0,0,0,0,2020-07-24,Male,50,45-54,4
7,2,0,0,2,2020-07-29,Male,44,35-44,7
7,1,0,0,1,2020-07-24,Male,60,55-64,5
7,2,1,0,3,2020-07-27,Male,17,15-19,4
7,1,0,0,1,2020-07-29,Male,70,70-74,4
7,0,1,0,1,2020-07-27,Female,67,65-69,3
7,0,0,0,0,2020-07-29,Female,68,65-69,6
7,0,0,0,0,2020-07-26,Male,50,45-54,5
7,2,0,0,2,2020-07-29,Male,69,65-69,4
7,2,0,0,2,2020-07-24,Male,21,20-24,4
7,0,2,0,2,2020-07-27,Male,22,20-24,5
7,2,8,0,10,2020-07-24,Male,7,5-9,4
7,1,0,0,1,2020-07-27,Male,60,55-64,3
7,1,0,1,2,2020-07-27,Male,38,35-44,4
7,2,0,0,2,2020-07-29,Male,67,65-69,5
7,1,1,0,2,2020-07-27,Male,66,65-69,4
7,0,1,0,1,2020-07-24,Female,57,55-64,6
7,2,1,0,3,2020-07-24,Male,56,55-64,7
7,0,0,0,0,2020-07-29,Male,69,65-69,4
7,1,0,0,1,2020-07-26,Female,33,25-34,2
7,0,0,0,0,2020-07-24,Male,42,35-44,2
7,0,0,5,5,2020-07-27,Female,33,25-34,7
7,0,0,0,0,2020-07-28,Male,52,45-54,7
7,1,0,0,1,2020-07-25,Male,67,65-69,7
7,0,1,0,1,2020-07-24,Female,52,45-54,4
7,0,0,0,0,2020-07-24,Male,30,25-34,4
7,4,0,0,4,2020-07-29,Female,12,10-14,4
7,1,0,0,1,2020-07-28,Male,68,65-69,3
7,2,0,0,2,2020-07-26,Male,16,15-19,4
7,1,0,0,1,2020-07-28,Female,8,5-9,3
7,3,0,0,3,2020-07-24,Female,8,5-9,4
7,3,0,0,3,2020-07-25,Male,14,10-14,4
7,2,0,0,2,2020-07-25,Female,61,55-64,4
7,2,3,0,5,2020-07-27,Female,22,20-24,5
7,3,0,0,3,2020-07-24,Male,52,45-54,4
7,2,4,0,6,2020-07-26,Female,47,45-54,2
7,1,1,0,2,2020-07-28,Male,8,5-9,3
7,2,3,0,5,2020-07-29,Male,66,65-69,4
7,1,0,0,1,2020-07-24,Male,51,45-54,4
7,0,0,0,0,2020-07-25,Female,52,45-54,3
7,0,2,0,2,2020-07-24,Male,51,45-54,4
7,3,2,0,5,2020-07-27,Female,42,35-44,6
7,1,1,0,2,2020-07-28,Female,23,20-24,7
7,0,1,0,1,2020-07-27,Female,71,70-74,4
7,1,0,0,1,2020-07-29,Male,31,25-34,4
7,0,1,0,1,2020-07-25,Female,67,65-69,7
7,0,0,0,0,2020-07-25,Male,59,55-64,4
7,2,0,0,2,2020-07-27,Female,36,35-44,4
7,2,0,0,2,2020-07-27,Male,11,10-14,4
7,2,1,0,3,2020-07-26,Male,70,70-74,5
7,2,3,0,5,2020-07-24,Female,50,45-54,7
7,3,0,0,3,2020-07-25,Male,53,45-54,5
7,0,5,0,5,2020-07-29,Female,69,65-69,4
7,2,1,0,3,2020-07-24,Female,23,20-24,5
7,3,0,0,3,2020-07-24,Male,32,25-34,4
7,6,0,0,6,2020-07-24,Female,11,10-14,6
7,3,0,0,3,2020-07-26,Female,3,1-4,5
7,0,0,0,0,2020-07-29,Female,67,65-69,7
7,1,0,0,1,2020-07-28,Female,58,55-64,7
7,0,0,0,0,2020-07-25,Female,54,45-54,7
7,3,1,0,4,2020-07-29,Male,69,65-69,7
7,0,2,0,2,2020-07-28,Female,58,55-64,2
7,0,0,0,0,2020-07-25,Female,40,35-44,7
7,0,0,0,0,2020-07-25,Female,64,55-64,7
7,2,0,0,2,2020-07-27,Male,39,35-44,5
7,0,0,0,0,2020-07-28,Female,52,45-54,7
7,0,0,0,0,2020-07-24,Male,39,35-44,4
7,0,0,0,0,2020-07-27,Female,43,35-44,6
7,0,0,0,0,2020-07-29,Male,35,35-44,3
7,3,0,0,3,2020-07-27,Male,15,15-19,4
7,1,0,0,1,2020-07-29,Male,66,65-69,7
7,0,1,0,1,2020-07-25,Female,28,25-34,3
7,0,1,0,1,2020-07-25,Male,33,25-34,4
7,2,3,0,5,2020-07-24,Female,66,65-69,7
7,2,0,0,2,2020-07-26,Female,12,10-14,5
7,4,0,0,4,2020-07-26,Male,4,1-4,3
7,2,3,28,33,2020-07-29,Male,9,5-9,5
7,0,0,0,0,2020-07-24,Male,47,45-54,7
7,1,0,0,1,2020-07-26,Male,65,65-69,4
7,0,1,0,1,2020-07-24,Male,39,35-44,6
7,1,10,0,11,2020-07-24,Female,65,65-69,7
7,0,0,0,0,2020-07-26,Male,38,35-44,7
7,0,0,0,0,2020-07-29,Female,39,35-44,4
7,2,2,0,4,2020-07-24,Male,74,70-74,6
7,0,0,0,0,2020-07-28,Male,30,25-34,4
7,2,0,0,2,2020-07-25,Female,62,55-64,7
7,0,0,0,0,2020-07-25,Male,16,15-19,6
7,0,1,0,1,2020-07-24,Female,53,45-54,4
7,1,1,0,2,2020-07-29,Female,67,65-69,5
7,0,0,0,0,2020-07-27,Male,40,35-44,7
7,0,0,0,0,2020-07-26,Female,37,35-44,2
7,2,0,0,2,2020-07-29,Male,64,55-64,4
7,2,1,0,3,2020-07-28,Male,59,55-64,4
7,0,0,0,0,2020-07-25,Male,40,35-44,5
7,2,0,0,2,2020-07-29,Female,14,10-14,7
7,0,0,0,0,2020-07-24,Female,58,55-64,6
7,1,0,0,1,2020-07-27,Female,29,25-34,4
7,1,0,0,1,2020-07-24,Male,11,10-14,7
7,2,1,0,3,2020-07-24,Male,17,15-19,4
7,1,0,0,1,2020-07-25,Male,65,65-69,4
7,2,0,0,2,2020-07-24,Female,18,15-19,6
7,1,1,0,2,2020-07-26,Male,54,45-54,5
7,1,0,0,1,2020-07-24,Female,49,45-54,7
7,2,0,0,2,2020-07-24,Female,54,45-54,6
7,0,0,0,0,2020-07-24,Female,23,20-24,4
7,0,0,0,0,2020-07-24,Female,21,20-24,4
7,0,0,0,0,2020-07-27,Female,12,10-14,5
7,3,0,0,3,2020-07-26,Female,11,10-14,4
7,0,3,0,3,2020-07-29,Male,42,35-44,5
7,3,0,0,3,2020-07-26,Female,17,15-19,4
7,1,0,0,1,2020-07-27,Female,9,5-9,5
7,0,0,0,0,2020-07-28,Female,68,65-69,3
7,0,2,0,2,2020-07-29,Female,67,65-69,4
7,0,0,0,0,2020-07-28,Female,53,45-54,7
7,0,2,0,2,2020-07-24,Male,38,35-44,4
7,0,0,0,0,2020-07-24,Male,35,35-44,4
7,0,1,0,1,2020-07-26,Male,35,35-44,4
7,2,0,0,2,2020-07-29,Male,67,65-69,4
7,0,0,0,0,2020-07-28,Female,17,15-19,4
7,1,2,0,3,2020-07-25,Male,66,65-69,7
7,3,4,0,7,2020-07-28,Female,3,1-4,2
7,0,0,0,0,2020-07-25,Female,65,65-69,4
7,6,0,0,6,2020-07-24,Male,33,25-34,3
7,1,0,0,1,2020-07-25,Male,52,45-54,4
7,1,0,2,3,2020-07-29,Female,67,65-69,4
7,0,3,0,3,2020-07-25,Male,52,45-54,7
7,1,0,0,1,2020-07-27,Female,40,35-44,4
7,0,1,0,1,2020-07-28,Female,30,25-34,4
7,1,0,0,1,2020-07-27,Male,56,55-64,5
7,1,4,0,5,2020-07-29,Male,65,65-69,4
7,3,2,0,5,2020-07-24,Female,8,5-9,4
7,0,0,0,0,2020-07-24,Female,62,55-64,7
7,2,0,0,2,2020-07-24,Male,13,10-14,4
7,0,0,0,0,2020-07-24,Female,14,10-14,5
7,0,0,2,2,2020-07-29,Female,69,65-69,4
7,2,4,0,6,2020-07-28,Male,53,45-54,4
7,0,0,0,0,2020-07-29,Female,55,55-64,2
7,0,1,0,1,2020-07-29,Male,62,55-64,4
7,3,4,0,7,2020-07-24,Male,21,20-24,4
7,0,0,0,0,2020-07-24,Male,23,20-24,6
7,1,1,0,2,2020-07-25,Female,63,55-64,3
7,0,0,0,0,2020-07-29,Male,68,65-69,7
7,2,3,0,5,2020-07-29,Male,23,20-24,2
7,0,10,0,10,2020-07-25,Male,44,35-44,4
7,1,2,0,3,2020-07-24,Female,29,25-34,4
7,1,0,0,1,2020-07-28,Male,54,45-54,5
7,2,0,0,2,2020-07-28,Male,19,15-19,6
7,2,3,0,5,2020-07-24,Female,62,55-64,6
7,1,0,0,1,2020-07-29,Female,68,65-69,7
7,1,0,0,1,2020-07-27,Male,54,45-54,7
7,1,0,0,1,2020-07-25,Female,61,55-64,7
7,0,0,0,0,2020-07-27,Male,66,65-69,7
7,0,0,0,0,2020-07-26,Male,54,45-54,3
7,2,0,0,2,2020-07-25,Female,61,55-64,7
7,1,0,0,1,2020-07-27,Male,52,45-54,6
7,0,4,0,4,2020-07-24,Female,65,65-69,7
7,0,0,0,0,2020-07-24,Male,65,65-69,4
7,1,0,0,1,2020-07-25,Female,59,55-64,6
7,1,0,0,1,2020-07-24,Male,65,65-69,7
7,0,2,4,6,2020-07-29,Female,68,65-69,6
7,2,2,0,4,2020-07-25,Male,14,10-14,4
7,1,1,0,2,2020-07-24,Female,62,55-64,7
7,0,1,0,1,2020-07-25,Female,51,45-54,7
7,0,1,0,1,2020-07-25,Female,17,15-19,3
7,1,0,0,1,2020-07-27,Male,32,25-34,4
7,2,4,0,6,2020-07-24,Female,65,65-69,3
7,2,0,0,2,2020-07-26,Female,52,45-54,4
7,3,0,0,3,2020-07-24,Female,47,45-54,4
7,0,0,0,0,2020-07-28,Male,28,25-34,7
7,1,2,0,3,2020-07-29,Male,59,55-64,7
7,0,0,0,0,2020-07-24,Female,44,35-44,7
7,2,0,0,2,2020-07-24,Male,21,20-24,3
7,1,3,0,4,2020-07-26,Male,74,70-74,6
7,1,1,0,2,2020-07-26,Female,35,35-44,4
7,2,0,0,2,2020-07-29,Male,18,15-19,4
7,1,2,0,3,2020-07-24,Male,58,55-64,7
7,2,0,1,3,2020-07-25,Male,14,10-14,4
7,4,2,0,6,2020-07-28,Male,1,1-4,4
7,0,7,0,7,2020-07-25,Male,34,25-34,3
7,1,0,0,1,2020-07-29,Female,58,55-64,4
7,3,2,0,5,2020-07-29,Male,18,15-19,6
7,0,1,0,1,2020-07-24,Male,49,45-54,7
7,0,0,0,0,2020-07-28,Male,56,55-64,4
7,0,14,0,14,2020-07-24,Female,25,25-34,7
7,2,0,0,2,2020-07-24,Male,29,25-34,7
7,0,0,0,0,2020-07-25,Male,33,25-34,4
7,2,2,0,4,2020-07-27,Female,7,5-9,4
7,1,1,0,2,2020-07-29,Female,69,65-69,5
7,1,2,0,3,2020-07-26,Female,48,45-54,3
7,2,0,0,2,2020-07-29,Female,67,65-69,3
7,0,0,0,0,2020-07-27,Male,35,35-44,4
7,2,0,0,2,2020-07-25,Female,7,5-9,5
7,1,0,0,1,2020-07-27,Female,55,55-64,7
7,1,0,1,2,2020-07-24,Female,49,45-54,3
7,0,0,0,0,2020-07-25,Male,42,35-44,4
7,2,0,0,2,2020-07-24,Female,1,1-4,4
7,0,0,0,0,2020-07-24,Male,41,35-44,4
7,1,1,0,2,2020-07-29,Male,67,65-69,6
7,4,0,0,4,2020-07-24,Male,8,5-9,7
7,5,3,0,8,2020-07-27,Male,22,20-24,4
7,3,0,0,3,2020-07-29,Female,25,25-34,4
7,2,0,0,2,2020-07-24,Male,51,45-54,4
7,1,0,0,1,2020-07-29,Female,68,65-69,5
7,2,0,0,2,2020-07-29,Male,64,55-64,7
7,1,12,0,13,2020-07-29,Female,61,55-64,5
7,0,4,0,4,2020-07-24,Male,51,45-54,7
7,1,0,0,1,2020-07-29,Male,65,65-69,7
7,1,10,0,11,2020-07-27,Female,39,35-44,4
7,2,2,0,4,2020-07-28,Male,52,45-54,7
7,1,0,0,1,2020-07-25,Male,53,45-54,3
7,1,5,0,6,2020-07-28,Female,60,55-64,3
7,0,2,0,2,2020-07-27,Female,15,15-19,3
7,1,3,0,4,2020-07-27,Female,24,20-24,2
7,1,0,0,1,2020-07-26,Female,55,55-64,7
7,2,2,0,4,2020-07-25,Male,32,25-34,4
7,4,1,0,5,2020-07-27,Female,9,5-9,2
7,4,0,0,4,2020-07-27,Female,41,35-44,4
7,0,0,0,0,2020-07-27,Male,40,35-44,6
7,0,0,0,0,2020-07-26,Male,59,55-64,4
7,0,3,0,3,2020-07-24,Male,41,35-44,7
7,0,1,0,1,2020-07-27,Male,66,65-69,7
7,2,0,2,4,2020-07-24,Female,60,55-64,2
7,0,0,0,0,2020-07-26,Female,34,25-34,5
7,0,0,0,0,2020-07-29,Male,63,55-64,4
7,0,0,0,0,2020-07-29,Male,57,55-64,7
7,1,1,0,2,2020-07-24,Male,47,45-54,4
7,0,1,0,1,2020-07-25,Female,34,25-34,4
7,0,0,100,100,2020-07-28,Male,52,45-54,7
7,1,0,0,1,2020-07-27,Male,61,55-64,7
7,0,2,22,24,2020-07-29,Female,67,65-69,7
7,3,2,0,5,2020-07-27,Male,10,10-14,7
7,3,0,0,3,2020-07-29,Female,38,35-44,6
7,0,0,0,0,2020-07-24,Female,19,15-19,7
7,0,1,3,4,2020-07-24,Male,46,45-54,6
7,0,0,15,15,2020-07-28,Female,57,55-64,4
7,5,0,0,5,2020-07-24,Female,23,20-24,4
7,0,0,0,0,2020-07-24,Male,26,25-34,4
7,2,0,0,2,2020-07-24,Male,2,1-4,3
7,0,1,0,1,2020-07-27,Male,47,45-54,7
7,0,0,0,0,2020-07-25,Male,32,25-34,3
7,0,1,0,1,2020-07-24,Male,51,45-54,4
7,2,0,0,2,2020-07-27,Male,19,15-19,4
7,2,0,0,2,2020-07-24,Male,13,10-14,7
7,0,0,0,0,2020-07-26,Female,16,15-19,3
7,0,0,0,0,2020-07-24,Male,43,35-44,7
7,2,2,0,4,2020-07-25,Female,63,55-64,7
7,1,1,0,2,2020-07-25,Female,73,70-74,7
7,3,1,0,4,2020-07-27,Male,4,1-4,3
7,1,2,0,3,2020-07-27,Female,33,25-34,4
7,2,0,0,2,2020-07-24,Male,9,5-9,6
7,1,1,0,2,2020-07-24,Female,50,45-54,4
7,2,0,0,2,2020-07-24,Male,56,55-64,5
7,0,4,0,4,2020-07-24,Female,61,55-64,4
7,0,1,3,4,2020-07-24,Female,59,55-64,3
7,1,0,0,1,2020-07-26,Male,56,55-64,5
7,2,0,0,2,2020-07-27,Male,65,65-69,7
7,1,0,0,1,2020-07-27,Female,53,45-54,3
7,1,0,0,1,2020-07-28,Male,61,55-64,7
7,1,0,0,1,2020-07-28,Male,65,65-69,7
7,0,0,0,0,2020-07-29,Male,33,25-34,6
7,1,0,0,1,2020-07-24,Female,58,55-64,7
7,2,3,0,5,2020-07-24,Male,72,70-74,4
7,0,0,0,0,2020-07-29,Female,36,35-44,4
7,2,0,0,2,2020-07-24,Female,46,45-54,4
7,0,0,0,0,2020-07-29,Male,62,55-64,4
7,0,3,0,3,2020-07-28,Male,24,20-24,3
7,0,0,0,0,2020-07-29,Male,4,1-4,4
7,2,2,0,4,2020-07-26,Female,68,65-69,6
7,2,0,0,2,2020-07-26,Female,65,65-69,4
7,3,4,3,10,2020-07-25,Female,34,25-34,4
7,0,0,0,0,2020-07-29,Male,53,45-54,7
7,0,2,0,2,2020-07-29,Female,35,35-44,4
7,1,0,0,1,2020-07-24,Male,56,55-64,4
7,0,0,0,0,2020-07-29,Female,55,55-64,7
7,0,0,0,0,2020-07-26,Female,67,65-69,7
7,2,0,0,2,2020-07-24,Male,41,35-44,2
7,2,3,0,5,2020-07-28,Female,52,45-54,7
7,2,1,0,3,2020-07-28,Male,66,65-69,5
7,2,0,2,4,2020-07-27,Male,31,25-34,4
7,2,0,0,2,2020-07-28,Female,58,55-64,5
7,2,0,0,2,2020-07-25,Female,70,70-74,4
7,0,1,0,1,2020-07-29,Female,70,70-74,6
7,0,1,0,1,2020-07-27,Male,66,65-69,7
7,1,1,0,2,2020-07-24,Male,50,45-54,7
7,0,0,0,0,2020-07-24,Female,26,25-34,4
7,0,1,0,1,2020-07-27,Female,55,55-64,3
7,0,1,0,1,2020-07-28,Male,50,45-54,4
7,1,0,0,1,2020-07-25,Female,53,45-54,7
7,1,2,0,3,2020-07-24,Male,62,55-64,7
7,0,0,0,0,2020-07-29,Male,37,35-44,7
7,0,1,0,1,2020-07-29,Female,67,65-69,3
7,1,5,0,6,2020-07-24,Female,27,25-34,7
7,0,0,0,0,2020-07-28,Male,53,45-54,7
7,2,0,0,2,2020-07-27,Female,2,1-4,7
7,1,0,0,1,2020-07-24,Male,34,25-34,6
7,3,5,0,8,2020-07-27,Male,41,35-44,4
7,1,0,0,1,2020-07-24,Female,24,20-24,7
7,0,1,0,1,2020-07-24,Male,11,10-14,4
7,1,2,0,3,2020-07-24,Female,42,35-44,4
7,1,1,0,2,2020-07-25,Male,58,55-64,4
7,2,3,0,5,2020-07-26,Male,3,1-4,4
7,3,2,0,5,2020-07-24,Female,36,35-44,6
7,1,0,0,1,2020-07-24,Female,58,55-64,7
7,1,0,0,1,2020-07-29,Male,69,65-69,7
7,1,0,0,1,2020-07-24,Male,66,65-69,6
7,1,1,2,4,2020-07-25,Female,65,65-69,2
7,5,2,0,7,2020-07-24,Male,10,10-14,3
7,0,0,0,0,2020-07-27,Female,57,55-64,6
7,0,0,0,0,2020-07-25,Male,52,45-54,6
7,0,0,0,0,2020-07-27,Male,56,55-64,6
7,2,1,0,3,2020-07-29,Female,63,55-64,5
7,2,0,0,2,2020-07-24,Male,65,65-69,4
7,0,0,0,0,2020-07-27,Female,45,45-54,4
7,0,6,1,7,2020-07-25,Female,65,65-69,6
7,0,1,0,1,2020-07-29,Female,53,45-54,6
7,1,1,0,2,2020-07-24,Female,45,45-54,4
7,1,1,0,2,2020-07-25,Male,30,25-34,4
7,1,2,0,3,2020-07-29,Male,70,70-74,4
7,3,0,0,3,2020-07-28,Male,53,45-54,4
7,0,1,1,2,2020-07-26,Female,62,55-64,6
7,1,0,0,1,2020-07-24,Male,25,25-34,3
7,1,3,0,4,2020-07-25,Female,70,70-74,7
7,0,0,0,0,2020-07-25,Male,27,25-34,6
7,1,0,0,1,2020-07-24,Male,27,25-34,7
7,0,0,0,0,2020-07-24,Male,30,25-34,5
7,0,1,0,1,2020-07-27,Female,30,25-34,4
7,2,0,0,2,2020-07-29,Male,41,35-44,6
7,0,2,0,2,2020-07-29,Male,70,70-74,6
7,0,5,0,5,2020-07-24,Male,65,65-69,6
7,0,2,0,2,2020-07-29,Female,68,65-69,7
7,0,1,0,1,2020-07-29,Male,60,55-64,4
7,0,0,0,0,2020-07-24,Male,27,25-34,4
7,0,0,0,0,2020-07-25,Male,6,5-9,4
7,0,0,0,0,2020-07-24,Male,52,45-54,4
7,1,0,0,1,2020-07-24,Female,33,25-34,4
7,1,2,0,3,2020-07-29,Male,68,65-69,7
7,2,1,0,3,2020-07-25,Male,67,65-69,5
7,1,5,0,6,2020-07-28,Male,61,55-64,5
7,0,0,0,0,2020-07-27,Male,33,25-34,4
7,0,1,0,1,2020-07-24,Male,16,15-19,4
7,1,0,0,1,2020-07-24,Female,61,55-64,4
7,0,3,0,3,2020-07-24,Female,56,55-64,7
7,3,0,0,3,2020-07-25,Female,53,45-54,6
7,3,0,0,3,2020-07-24,Female,4,1-4,7
7,0,3,0,3,2020-07-29,Female,62,55-64,6
7,0,4,0,4,2020-07-29,Female,53,45-54,4
7,2,0,0,2,2020-07-26,Female,33,25-34,6
7,0,0,0,0,2020-07-28,Female,54,45-54,4
7,0,0,0,0,2020-07-24,Female,59,55-64,7
7,2,10,0,12,2020-07-24,Female,59,55-64,5
7,2,0,0,2,2020-07-29,Male,5,5-9,3
7,4,0,0,4,2020-07-28,Female,54,45-54,4
7,1,0,0,1,2020-07-26,Male,42,35-44,6
7,2,1,0,3,2020-07-24,Female,55,55-64,4
7,1,2,0,3,2020-07-26,Female,60,55-64,7
7,2,2,0,4,2020-07-29,Male,60,55-64,6
7,0,0,0,0,2020-07-29,Male,69,65-69,7
7,0,1,0,1,2020-07-27,Female,54,45-54,4
7,2,10,0,12,2020-07-26,Female,51,45-54,7
7,0,3,0,3,2020-07-24,Female,18,15-19,4
7,0,0,0,0,2020-07-25,Male,51,45-54,7
7,3,1,0,4,2020-07-28,Female,19,15-19,7
7,1,0,0,1,2020-07-24,Female,64,55-64,7
7,2,0,0,2,2020-07-24,Female,37,35-44,5
7,3,3,0,6,2020-07-24,Female,10,10-14,2
7,0,0,0,0,2020-07-26,Male,57,55-64,5
7,2,0,0,2,2020-07-27,Male,2,1-4,3
7,2,0,0,2,2020-07-27,Female,48,45-54,3
7,1,0,0,1,2020-07-28,Male,59,55-64,3
7,0,0,0,0,2020-07-24,Female,55,55-64,4
7,3,0,0,3,2020-07-24,Male,60,55-64,4
7,0,0,0,0,2020-07-25,Male,36,35-44,3
7,0,0,0,0,2020-07-29,Male,36,35-44,6
7,3,0,0,3,2020-07-25,Female,1,1-4,4
7,2,3,0,5,2020-07-24,Female,52,45-54,5
7,2,0,0,2,2020-07-25,Male,63,55-64,4
7,1,4,0,5,2020-07-24,Female,17,15-19,4
7,0,4,0,4,2020-07-25,Male,61,55-64,4
7,2,0,0,2,2020-07-26,Female,54,45-54,5
7,1,0,0,1,2020-07-24,Male,53,45-54,4
7,3,2,0,5,2020-07-25,Male,25,25-34,4
7,1,0,0,1,2020-07-25,Male,61,55-64,4
7,3,0,0,3,2020-07-24,Male,15,15-19,7
7,1,5,0,6,2020-07-24,Male,52,45-54,3
7,1,3,0,4,2020-07-24,Female,50,45-54,4
7,0,0,0,0,2020-07-29,Female,60,55-64,7
7,3,0,0,3,2020-07-27,Male,11,10-14,6
7,3,1,0,4,2020-07-29,Female,67,65-69,3
7,0,0,0,0,2020-07-25,Female,43,35-44,4
7,0,0,0,0,2020-07-29,Female,65,65-69,6
7,1,1,0,2,2020-07-25,Male,67,65-69,7
7,0,0,0,0,2020-07-24,Male,37,35-44,7
7,0,1,30,31,2020-07-24,Female,24,20-24,3
7,1,0,0,1,2020-07-25,Female,63,55-64,5
7,0,2,0,2,2020-07-29,Female,67,65-69,7
7,0,0,20,20,2020-07-24,Female,43,35-44,3
7,2,0,0,2,2020-07-24,Female,39,35-44,7
7,0,0,0,0,2020-07-29,Male,32,25-34,4
7,1,0,0,1,2020-07-29,Female,37,35-44,5
7,1,0,0,1,2020-07-28,Female,33,25-34,7
7,0,0,0,0,2020-07-24,Female,51,45-54,6
7,0,0,0,0,2020-07-25,Female,38,35-44,5
7,4,0,0,4,2020-07-26,Female,54,45-54,3
7,4,2,9,15,2020-07-29,Female,17,15-19,4
7,0,0,1,1,2020-07-25,Female,43,35-44,4
7,2,0,0,2,2020-07-28,Female,62,55-64,4
7,0,7,0,7,2020-07-24,Female,51,45-54,5
7,2,0,0,2,2020-07-26,Female,41,35-44,3
7,1,0,0,1,2020-07-28,Male,36,35-44,2
7,0,0,0,0,2020-07-28,Male,58,55-64,7
7,0,1,0,1,2020-07-27,Female,23,20-24,5
7,3,0,0,3,2020-07-29,Female,8,5-9,4
7,1,7,0,8,2020-07-25,Male,43,35-44,4
7,1,4,10,15,2020-07-27,Female,62,55-64,4
7,2,2,0,4,2020-07-29,Male,68,65-69,7
7,1,0,0,1,2020-07-27,Female,55,55-64,7
7,0,0,0,0,2020-07-24,Male,43,35-44,3
7,1,2,0,3,2020-07-28,Female,61,55-64,4
7,1,7,0,8,2020-07-24,Male,67,65-69,4
7,1,3,0,4,2020-07-29,Female,56,55-64,7
7,3,2,0,5,2020-07-24,Female,22,20-24,4
7,2,1,0,3,2020-07-24,Male,53,45-54,4
7,0,1,0,1,2020-07-29,Female,31,25-34,3
7,0,0,0,0,2020-07-29,Female,65,65-69,4
7,1,0,0,1,2020-07-24,Female,49,45-54,7
7,4,0,0,4,2020-07-29,Female,58,55-64,7
7,2,4,0,6,2020-07-29,Female,1,1-4,3
7,0,0,0,0,2020-07-24,Female,50,45-54,4
7,0,0,0,0,2020-07-27,Female,40,35-44,7
7,0,0,0,0,2020-07-25,Male,55,55-64,7
7,0,0,0,0,2020-07-24,Male,54,45-54,7
7,0,0,0,0,2020-07-25,Male,52,45-54,4
7,0,0,0,0,2020-07-28,Female,36,35-44,7
7,1,0,0,1,2020-07-28,Male,54,45-54,4
7,2,0,0,2,2020-07-29,Male,61,55-64,7
7,3,2,0,5,2020-07-24,Male,19,15-19,4
7,1,6,0,7,2020-07-25,Female,56,55-64,4
7,0,1,0,1,2020-07-29,Female,70,70-74,7
7,1,0,0,1,2020-07-28,Male,73,70-74,7
7,3,1,0,4,2020-07-24,Male,10,10-14,6
7,0,0,0,0,2020-07-25,Male,35,35-44,3
7,0,0,0,0,2020-07-29,Female,36,35-44,4
7,0,0,0,0,2020-07-24,Female,37,35-44,4
7,1,0,0,1,2020-07-24,Female,60,55-64,7
7,2,0,0,2,2020-07-29,Male,27,25-34,3
7,3,0,0,3,2020-07-27,Female,11,10-14,4
7,1,2,0,3,2020-07-27,Male,70,70-74,3
7,5,0,0,5,2020-07-26,Female,50,45-54,3
7,4,0,0,4,2020-07-26,Male,43,35-44,3
7,0,7,15,22,2020-07-26,Male,21,20-24,5
7,0,0,0,0,2020-07-26,Female,2,1-4,6
7,1,10,0,11,2020-07-29,Male,65,65-69,7
7,2,0,0,2,2020-07-24,Female,28,25-34,4
7,0,1,0,1,2020-07-24,Male,31,25-34,4
7,1,0,0,1,2020-07-27,Female,12,10-14,3
7,0,3,0,3,2020-07-24,Female,36,35-44,3
7,3,1,0,4,2020-07-24,Female,64,55-64,7
7,0,1,0,1,2020-07-27,Female,75,75-79,7
7,0,0,0,0,2020-07-28,Female,37,35-44,7
7,2,0,0,2,2020-07-29,Male,32,25-34,7
7,3,0,0,3,2020-07-24,Male,18,15-19,7
7,3,0,0,3,2020-07-27,Male,33,25-34,5
7,2,0,0,2,2020-07-24,Female,22,20-24,7
7,3,2,0,5,2020-07-29,Male,15,15-19,4
7,1,2,0,3,2020-07-25,Male,65,65-69,5
7,1,70,15,86,2020-07-25,Male,48,45-54,2
7,0,0,0,0,2020-07-25,Male,55,55-64,3
7,0,0,0,0,2020-07-25,Female,14,10-14,7
7,0,1,1,2,2020-07-29,Male,26,25-34,4
7,0,3,0,3,2020-07-25,Male,58,55-64,4
7,0,0,0,0,2020-07-25,Male,62,55-64,7
7,2,0,0,2,2020-07-24,Male,65,65-69,6
7,2,0,0,2,2020-07-27,Male,37,35-44,5
7,2,2,0,4,2020-07-24,Female,43,35-44,7
7,1,10,0,11,2020-07-29,Male,67,65-69,4
7,1,4,0,5,2020-07-26,Female,61,55-64,4
7,1,1,0,2,2020-07-25,Female,30,25-34,3
7,0,0,0,0,2020-07-27,Male,32,25-34,3
7,1,3,0,4,2020-07-29,Female,52,45-54,7
7,0,1,0,1,2020-07-27,Female,24,20-24,2
7,0,0,0,0,2020-07-24,Male,53,45-54,4
7,1,0,0,1,2020-07-24,Female,48,45-54,7
7,3,0,0,3,2020-07-27,Male,19,15-19,4
7,0,1,0,1,2020-07-24,Female,11,10-14,3
7,0,0,0,0,2020-07-26,Female,25,25-34,6
7,0,1,0,1,2020-07-26,Female,21,20-24,6
7,1,0,0,1,2020-07-28,Male,40,35-44,4
7,0,0,0,0,2020-07-25,Male,33,25-34,6
7,1,0,0,1,2020-07-24,Male,46,45-54,7
7,1,1,0,2,2020-07-29,Male,61,55-64,7
7,0,4,0,4,2020-07-29,Female,68,65-69,3
7,1,0,0,1,2020-07-29,Male,67,65-69,7
7,2,0,0,2,2020-07-24,Female,0,<1,4
7,0,0,0,0,2020-07-27,Female,5,5-9,7
7,1,4,15,20,2020-07-24,Female,24,20-24,3
7,5,0,0,5,2020-07-29,Female,13,10-14,3
7,0,0,0,0,2020-07-28,Male,55,55-64,6
7,2,2,0,4,2020-07-24,Female,47,45-54,7
7,5,0,0,5,2020-07-29,Female,33,25-34,4
7,0,0,0,0,2020-07-25,Male,45,45-54,3
7,4,6,0,10,2020-07-24,Female,8,5-9,3
7,1,4,0,5,2020-07-25,Female,65,65-69,2
7,0,3,0,3,2020-07-24,Female,19,15-19,4
7,2,1,0,3,2020-07-25,Female,47,45-54,6
7,6,1,9,16,2020-07-24,Female,63,55-64,4
7,1,0,0,1,2020-07-27,Male,45,45-54,3
7,0,1,0,1,2020-07-25,Female,34,25-34,4
7,2,1,0,3,2020-07-29,Female,32,25-34,6
7,0,0,0,0,2020-07-27,Male,57,55-64,7
7,2,0,0,2,2020-07-27,Male,63,55-64,7
7,1,2,0,3,2020-07-24,Female,62,55-64,6
7,1,1,0,2,2020-07-29,Female,63,55-64,6
7,2,2,0,4,2020-07-29,Female,68,65-69,7
7,3,10,0,13,2020-07-24,Male,49,45-54,6
7,2,1,0,3,2020-07-29,Female,63,55-64,4
7,1,1,0,2,2020-07-24,Female,67,65-69,5
7,5,0,0,5,2020-07-26,Male,6,5-9,2
7,0,0,0,0,2020-07-28,Male,17,15-19,7
7,2,2,0,4,2020-07-29,Male,59,55-64,7
7,2,0,0,2,2020-07-29,Female,38,35-44,5
7,0,0,0,0,2020-07-24,Male,32,25-34,4
7,3,3,0,6,2020-07-28,Male,6,5-9,2
7,0,0,0,0,2020-07-24,Male,41,35-44,6
7,1,1,0,2,2020-07-24,Female,64,55-64,4
7,1,6,0,7,2020-07-26,Male,67,65-69,7
7,3,0,0,3,2020-07-26,Male,13,10-14,4
7,1,0,0,1,2020-07-29,Female,58,55-64,7
7,0,0,0,0,2020-07-24,Female,25,25-34,4
7,2,0,0,2,2020-07-24,Female,32,25-34,4
7,0,0,0,0,2020-07-25,Female,12,10-14,6
7,1,2,17,20,2020-07-26,Female,25,25-34,4
7,1,0,0,1,2020-07-24,Female,33,25-34,4
7,2,0,0,2,2020-07-27,Male,10,10-14,6
7,0,0,0,0,2020-07-29,Female,30,25-34,4
7,0,0,0,0,2020-07-24,Male,17,15-19,4
7,1,0,0,1,2020-07-28,Female,54,45-54,3
7,2,0,0,2,2020-07-24,Male,50,45-54,4
7,1,0,0,1,2020-07-24,Male,46,45-54,4
7,0,4,0,4,2020-07-24,Male,39,35-44,4
7,0,0,0,0,2020-07-24,Female,34,25-34,5
7,1,0,0,1,2020-07-24,Male,45,45-54,4
7,1,3,0,4,2020-07-29,Female,65,65-69,5
7,5,0,0,5,2020-07-24,Female,19,15-19,3
7,1,1,0,2,2020-07-25,Female,52,45-54,4
7,3,1,0,4,2020-07-24,Male,25,25-34,4
7,3,0,0,3,2020-07-27,Female,10,10-14,3
7,0,3,0,3,2020-07-24,Female,27,25-34,4
7,0,0,0,0,2020-07-24,Male,13,10-14,5
7,0,0,0,0,2020-07-27,Female,67,65-69,6
7,0,3,0,3,2020-07-27,Female,19,15-19,3
7,4,1,0,5,2020-07-24,Male,6,5-9,3
7,1,0,50,51,2020-07-29,Female,30,25-34,4
7,2,3,0,5,2020-07-27,Female,54,45-54,4
7,0,7,0,7,2020-07-28,Female,27,25-34,7
7,2,0,0,2,2020-07-24,Male,47,45-54,7
7,0,0,0,0,2020-07-25,Female,52,45-54,7
7,5,0,0,5,2020-07-26,Male,20,20-24,4
7,0,0,0,0,2020-07-28,Male,53,45-54,4
7,0,1,0,1,2020-07-24,Male,48,45-54,4
7,2,0,0,2,2020-07-24,Male,63,55-64,4
7,0,1,0,1,2020-07-28,Male,27,25-34,4
7,1,0,0,1,2020-07-24,Male,35,35-44,4
7,1,0,0,1,2020-07-24,Male,49,45-54,6
7,0,0,0,0,2020-07-24,Female,52,45-54,4
7,2,0,0,2,2020-07-26,Male,68,65-69,7
7,1,3,10,14,2020-07-25,Female,47,45-54,6
7,5,10,100,115,2020-07-24,Female,16,15-19,6
7,1,0,0,1,2020-07-28,Female,51,45-54,4
7,1,2,0,3,2020-07-25,Female,53,45-54,7
7,2,0,0,2,2020-07-24,Female,20,20-24,4
7,2,1,15,18,2020-07-28,Male,56,55-64,2
7,0,1,0,1,2020-07-29,Female,33,25-34,4
7,0,3,0,3,2020-07-24,Male,50,45-54,7
7,1,2,0,3,2020-07-26,Male,23,20-24,3
7,0,0,0,0,2020-07-27,Male,31,25-34,6
7,1,0,0,1,2020-07-29,Male,12,10-14,4
7,2,0,0,2,2020-07-27,Male,54,45-54,6
7,0,2,0,2,2020-07-24,Male,30,25-34,5
7,0,2,0,2,2020-07-24,Male,42,35-44,6
7,1,1,0,2,2020-07-29,Female,69,65-69,6
7,0,0,0,0,2020-07-29,Female,69,65-69,7
7,1,0,0,1,2020-07-29,Male,70,70-74,7
7,0,0,0,0,2020-07-28,Female,36,35-44,5
7,3,2,3,8,2020-07-27,Female,12,10-14,6
7,1,1,0,2,2020-07-28,Female,29,25-34,6
7,0,0,0,0,2020-07-24,Male,33,25-34,7
7,4,0,0,4,2020-07-27,Male,19,15-19,4
8,0,2,0,2,2020-08-09,Male,59,55-64,6
8,1,10,0,11,2020-08-07,Male,68,65-69,4
8,2,0,0,2,2020-08-07,Female,69,65-69,5
8,2,0,0,2,2020-08-07,Female,65,65-69,8
8,0,0,0,0,2020-08-07,Female,17,15-19,4
8,0,0,0,0,2020-08-08,Female,50,45-54,5
8,1,1,0,2,2020-08-07,Female,71,70-74,8
8,0,1,0,1,2020-08-11,Male,29,25-34,5
8,1,0,1,2,2020-08-07,Female,53,45-54,5
8,0,0,0,0,2020-08-09,Female,67,65-69,5
8,2,0,0,2,2020-08-10,Male,34,25-34,8
8,0,0,0,0,2020-08-09,Male,50,45-54,7
8,1,0,0,1,2020-08-07,Male,50,45-54,5
8,2,1,0,3,2020-08-08,Female,35,35-44,5
8,3,0,0,3,2020-08-07,Female,57,55-64,7
8,0,0,0,0,2020-08-08,Male,42,35-44,2
8,0,0,0,0,2020-08-07,Male,32,25-34,7
8,1,4,0,5,2020-08-07,Male,66,65-69,4
8,1,1,0,2,2020-08-10,Male,62,55-64,8
8,4,0,0,4,2020-08-07,Male,11,10-14,4
8,0,0,0,0,2020-08-08,Male,11,10-14,5
8,0,0,0,0,2020-08-10,Male,18,15-19,8
8,0,2,0,2,2020-08-07,Male,48,45-54,5
8,2,2,0,4,2020-08-09,Male,58,55-64,4
8,1,0,0,1,2020-08-10,Male,34,25-34,5
8,0,11,0,11,2020-08-07,Male,53,45-54,4
8,1,0,0,1,2020-08-11,Male,67,65-69,8
8,5,0,0,5,2020-08-07,Male,20,20-24,4
8,1,1,0,2,2020-08-07,Female,52,45-54,5
8,0,0,0,0,2020-08-07,Male,41,35-44,8
8,1,0,0,1,2020-08-07,Female,56,55-64,8
8,2,0,0,2,2020-08-09,Female,21,20-24,7
8,2,0,0,2,2020-08-07,Male,51,45-54,8
8,2,0,0,2,2020-08-09,Female,7,5-9,4
8,0,1,0,1,2020-08-10,Male,67,65-69,8
8,1,0,0,1,2020-08-10,Male,43,35-44,5
8,0,0,0,0,2020-08-08,Male,51,45-54,7
8,1,0,0,1,2020-08-09,Male,43,35-44,5
8,4,3,0,7,2020-08-10,Male,43,35-44,7
8,1,0,0,1,2020-08-07,Female,60,55-64,7
8,0,0,0,0,2020-08-11,Female,7,5-9,2
8,2,0,0,2,2020-08-10,Male,35,35-44,6
8,1,0,0,1,2020-08-07,Male,38,35-44,5
8,2,4,0,6,2020-08-08,Male,69,65-69,6
8,1,0,0,1,2020-08-07,Female,55,55-64,5
8,1,0,0,1,2020-08-07,Female,67,65-69,6
8,1,2,0,3,2020-08-07,Male,38,35-44,7
8,1,2,0,3,2020-08-08,Male,62,55-64,5
8,0,0,0,0,2020-08-09,Female,10,10-14,5
8,0,32,0,32,2020-08-11,Female,34,25-34,2
8,2,3,0,5,2020-08-07,Male,54,45-54,8
8,1,0,0,1,2020-08-07,Male,70,70-74,5
8,1,4,0,5,2020-08-07,Female,65,65-69,8
8,2,0,0,2,2020-08-08,Male,68,65-69,5
8,0,0,0,0,2020-08-08,Male,34,25-34,5
8,0,0,0,0,2020-08-07,Male,42,35-44,5
8,1,9,0,10,2020-08-07,Male,69,65-69,8
8,4,0,0,4,2020-08-08,Female,4,1-4,6
8,2,0,0,2,2020-08-08,Male,37,35-44,6
8,2,0,0,2,2020-08-08,Female,16,15-19,5
8,2,0,0,2,2020-08-07,Female,60,55-64,7
8,1,0,0,1,2020-08-10,Male,31,25-34,5
8,0,5,0,5,2020-08-07,Female,52,45-54,7
8,2,7,0,9,2020-08-07,Female,27,25-34,5
8,0,0,0,0,2020-08-07,Female,62,55-64,7
8,0,0,0,0,2020-08-08,Female,34,25-34,5
8,1,2,0,3,2020-08-08,Female,30,25-34,7
8,0,1,0,1,2020-08-11,Female,67,65-69,5
8,0,0,0,0,2020-08-10,Female,62,55-64,7
8,0,2,0,2,2020-08-09,Male,54,45-54,5
8,0,0,0,0,2020-08-09,Male,33,25-34,5
8,1,0,0,1,2020-08-07,Male,57,55-64,6
8,0,0,9,9,2020-08-10,Male,4,1-4,3
8,0,0,0,0,2020-08-11,Male,32,25-34,8
8,0,0,0,0,2020-08-07,Male,65,65-69,4
8,0,0,0,0,2020-08-09,Female,30,25-34,4
8,0,0,0,0,2020-08-07,Female,33,25-34,5
8,0,0,0,0,2020-08-08,Male,36,35-44,7
8,1,3,0,4,2020-08-07,Female,62,55-64,5
8,1,6,0,7,2020-08-09,Male,65,65-69,5
8,0,0,0,0,2020-08-08,Male,63,55-64,7
8,0,0,0,0,2020-08-07,Male,29,25-34,3
8,0,0,0,0,2020-08-10,Female,55,55-64,5
8,1,0,0,1,2020-08-07,Female,25,25-34,4
8,1,0,0,1,2020-08-11,Female,67,65-69,7
8,3,0,0,3,2020-08-07,Male,41,35-44,5
8,1,0,0,1,2020-08-07,Male,58,55-64,8
8,2,0,5,7,2020-08-08,Female,41,35-44,3
8,0,0,0,0,2020-08-08,Female,62,55-64,5
8,3,4,0,7,2020-08-07,Female,58,55-64,6
8,3,0,0,3,2020-08-08,Male,32,25-34,5
8,2,0,0,2,2020-08-07,Male,35,35-44,7
8,0,0,0,0,2020-08-07,Male,17,15-19,5
8,3,0,0,3,2020-08-07,Female,13,10-14,5
8,1,0,0,1,2020-08-07,Male,65,65-69,7
8,1,0,0,1,2020-08-08,Male,56,55-64,7
8,1,0,0,1,2020-08-10,Female,66,65-69,6
8,2,16,0,18,2020-08-07,Female,56,55-64,5
8,1,1,0,2,2020-08-07,Female,23,20-24,3
8,1,0,0,1,2020-08-09,Male,52,45-54,7
8,0,0,0,0,2020-08-07,Male,52,45-54,3
8,1,0,0,1,2020-08-09,Male,27,25-34,4
8,0,0,0,0,2020-08-07,Male,57,55-64,8
8,2,2,2,6,2020-08-11,Male,70,70-74,5
8,2,1,0,3,2020-08-10,Male,31,25-34,8
8,0,0,0,0,2020-08-07,Female,52,45-54,8
8,0,0,0,0,2020-08-08,Male,28,25-34,5
8,0,0,0,0,2020-08-10,Male,37,35-44,4
8,1,1,0,2,2020-08-10,Female,58,55-64,5
8,0,4,0,4,2020-08-08,Female,66,65-69,8
8,1,0,0,1,2020-08-11,Female,66,65-69,4
8,0,1,0,1,2020-08-07,Male,70,70-74,8
8,2,0,0,2,2020-08-10,Female,28,25-34,5
8,1,0,0,1,2020-08-07,Female,31,25-34,5
8,1,0,0,1,2020-08-07,Female,54,45-54,8
8,4,0,1,5,2020-08-07,Female,21,20-24,4
8,2,0,0,2,2020-08-11,Male,33,25-34,3
8,0,0,0,0,2020-08-07,Male,53,45-54,5
8,1,1,0,2,2020-08-09,Female,49,45-54,5
8,1,1,0,2,2020-08-10,Female,60,55-64,3
8,1,0,0,1,2020-08-07,Female,29,25-34,5
8,3,0,0,3,2020-08-09,Male,42,35-44,4
8,2,3,0,5,2020-08-07,Male,17,15-19,5
8,2,0,0,2,2020-08-10,Male,66,65-69,7
8,1,9,0,10,2020-08-08,Male,52,45-54,8
8,1,0,0,1,2020-08-07,Female,57,55-64,7
8,0,0,0,0,2020-08-08,Male,50,45-54,7
8,0,0,18,18,2020-08-07,Male,12,10-14,7
8,2,1,4,7,2020-08-10,Female,59,55-64,4
8,0,3,0,3,2020-08-07,Male,47,45-54,3
8,2,0,0,2,2020-08-07,Female,69,65-69,8
8,0,0,0,0,2020-08-09,Male,19,15-19,5
8,2,0,0,2,2020-08-09,Female,5,5-9,4
8,2,3,1,6,2020-08-08,Female,72,70-74,3
8,0,0,0,0,2020-08-07,Male,51,45-54,4
8,1,0,0,1,2020-08-08,Female,59,55-64,8
8,0,0,0,0,2020-08-07,Male,43,35-44,8
8,0,0,0,0,2020-08-07,Male,27,25-34,5
8,0,1,0,1,2020-08-11,Female,23,20-24,4
8,2,5,0,7,2020-08-07,Female,52,45-54,7
8,0,0,0,0,2020-08-07,Male,33,25-34,7
8,3,3,0,6,2020-08-07,Male,69,65-69,5
8,0,1,0,1,2020-08-08,Male,65,65-69,8
8,3,0,0,3,2020-08-10,Male,6,5-9,5
8,2,5,0,7,2020-08-11,Male,67,65-69,7
8,4,0,0,4,2020-08-08,Female,1,1-4,4
8,0,3,0,3,2020-08-08,Male,39,35-44,4
8,0,0,0,0,2020-08-08,Female,19,15-19,3
8,0,0,0,0,2020-08-07,Female,56,55-64,7
8,0,0,0,0,2020-08-07,Female,58,55-64,5
8,0,0,0,0,2020-08-10,Female,66,65-69,7
8,0,0,0,0,2020-08-07,Female,40,35-44,8
8,1,3,0,4,2020-08-11,Female,60,55-64,8
8,2,0,0,2,2020-08-07,Male,16,15-19,5
8,1,0,0,1,2020-08-10,Female,53,45-54,8
8,0,0,0,0,2020-08-08,Male,33,25-34,5
8,0,1,0,1,2020-08-07,Male,55,55-64,5
8,0,0,0,0,2020-08-07,Female,65,65-69,8
8,0,0,0,0,2020-08-07,Male,14,10-14,6
8,4,1,0,5,2020-08-07,Male,7,5-9,4
8,0,1,0,1,2020-08-07,Female,66,65-69,4
8,0,0,0,0,2020-08-11,Male,38,35-44,5
8,0,0,0,0,2020-08-07,Female,55,55-64,8
8,0,4,0,4,2020-08-07,Male,36,35-44,8
8,3,0,0,3,2020-08-09,Female,49,45-54,4
8,1,4,0,5,2020-08-07,Male,39,35-44,8
8,2,0,0,2,2020-08-07,Female,60,55-64,5
8,0,1,0,1,2020-08-07,Male,32,25-34,6
8,2,0,0,2,2020-08-08,Male,61,55-64,8
8,4,6,2,12,2020-08-07,Female,23,20-24,4
8,0,8,0,8,2020-08-07,Female,69,65-69,6
8,0,1,0,1,2020-08-07,Male,9,5-9,5
8,1,1,0,2,2020-08-10,Female,33,25-34,7
8,0,1,0,1,2020-08-11,Male,68,65-69,8
8,0,2,0,2,2020-08-09,Male,28,25-34,8
8,0,0,0,0,2020-08-09,Female,53,45-54,7
8,3,3,0,6,2020-08-08,Male,5,5-9,7
8,1,3,0,4,2020-08-07,Male,52,45-54,5
8,2,0,0,2,2020-08-07,Male,32,25-34,4
8,3,0,0,3,2020-08-07,Male,18,15-19,5
8,2,0,0,2,2020-08-07,Male,64,55-64,5
8,1,1,0,2,2020-08-10,Male,65,65-69,5
8,3,2,0,5,2020-08-10,Female,68,65-69,4
8,1,1,0,2,2020-08-07,Female,65,65-69,5
8,2,3,0,5,2020-08-07,Male,22,20-24,5
8,1,0,0,1,2020-08-08,Male,66,65-69,8
8,0,0,0,0,2020-08-08,Male,64,55-64,8
8,2,3,0,5,2020-08-07,Female,67,65-69,7
8,0,1,0,1,2020-08-10,Female,73,70-74,7
8,1,2,0,3,2020-08-11,Male,67,65-69,8
8,1,1,0,2,2020-08-07,Male,74,70-74,8
8,0,3,0,3,2020-08-08,Male,65,65-69,3
8,3,1,0,4,2020-08-08,Female,19,15-19,4
8,0,1,0,1,2020-08-08,Female,47,45-54,3
8,2,0,0,2,2020-08-07,Male,52,45-54,4
8,0,0,0,0,2020-08-07,Male,15,15-19,5
8,5,0,0,5,2020-08-10,Male,27,25-34,4
8,3,3,0,6,2020-08-08,Female,2,1-4,3
8,1,3,0,4,2020-08-08,Male,81,80-84,7
8,3,0,0,3,2020-08-07,Female,53,45-54,6
8,0,0,0,0,2020-08-08,Female,58,55-64,5
8,0,0,0,0,2020-08-07,Female,16,15-19,5
8,0,0,0,0,2020-08-07,Male,24,20-24,5
8,0,0,0,0,2020-08-09,Male,24,20-24,6
8,3,0,0,3,2020-08-07,Female,21,20-24,5
8,0,0,0,0,2020-08-08,Female,23,20-24,8
8,0,0,0,0,2020-08-09,Female,66,65-69,5
8,1,0,0,1,2020-08-11,Female,67,65-69,4
8,0,0,0,0,2020-08-10,Male,67,65-69,7
8,2,0,0,2,2020-08-07,Male,41,35-44,8
8,2,2,0,4,2020-08-10,Male,58,55-64,6
8,2,2,0,4,2020-08-07,Male,75,75-79,6
8,0,11,0,11,2020-08-07,Male,32,25-34,6
8,2,3,2,7,2020-08-08,Female,68,65-69,5
8,2,80,0,82,2020-08-07,Male,64,55-64,4
8,0,1,0,1,2020-08-07,Female,66,65-69,7
8,1,0,0,1,2020-08-08,Male,10,10-14,5
8,0,3,0,3,2020-08-08,Female,25,25-34,8
8,0,1,0,1,2020-08-11,Female,68,65-69,7
8,0,0,0,0,2020-08-09,Female,66,65-69,5
8,0,31,2,33,2020-08-07,Female,63,55-64,5
8,1,4,0,5,2020-08-08,Male,68,65-69,8
8,5,0,0,5,2020-08-07,Male,10,10-14,2
8,2,0,0,2,2020-08-10,Female,11,10-14,6
8,0,1,0,1,2020-08-09,Male,29,25-34,8
8,0,0,0,0,2020-08-11,Female,6,5-9,7
8,2,1,0,3,2020-08-07,Female,52,45-54,7
8,2,0,0,2,2020-08-08,Female,66,65-69,8
8,2,1,0,3,2020-08-09,Female,27,25-34,5
8,0,1,0,1,2020-08-07,Male,54,45-54,7
8,0,3,0,3,2020-08-07,Male,65,65-69,8
8,3,0,0,3,2020-08-08,Male,36,35-44,5
8,1,11,0,12,2020-08-08,Male,61,55-64,4
8,1,0,0,1,2020-08-09,Male,51,45-54,5
8,1,0,0,1,2020-08-11,Male,68,65-69,8
8,2,2,0,4,2020-08-07,Female,54,45-54,4
8,2,2,0,4,2020-08-07,Male,62,55-64,4
8,0,0,0,0,2020-08-07,Female,26,25-34,4
8,0,0,0,0,2020-08-08,Female,65,65-69,5
8,1,2,0,3,2020-08-07,Female,60,55-64,4
8,0,0,0,0,2020-08-07,Male,73,70-74,7
8,3,3,0,6,2020-08-07,Female,11,10-14,8
8,3,1,0,4,2020-08-08,Female,12,10-14,7
8,1,1,0,2,2020-08-07,Male,33,25-34,6
8,0,2,0,2,2020-08-08,Female,12,10-14,5
8,0,0,0,0,2020-08-07,Female,65,65-69,5
8,2,1,0,3,2020-08-11,Male,75,75-79,7
8,0,0,0,0,2020-08-11,Male,30,25-34,5
8,0,0,0,0,2020-08-07,Female,20,20-24,6
8,1,0,0,1,2020-08-09,Male,63,55-64,5
8,2,0,0,2,2020-08-07,Male,54,45-54,8
8,0,0,3,3,2020-08-07,Female,6,5-9,6
8,1,10,0,11,2020-08-07,Female,52,45-54,7
8,0,1,0,1,2020-08-10,Female,71,70-74,7
8,3,0,0,3,2020-08-09,Female,19,15-19,3
8,0,0,0,0,2020-08-07,Female,56,55-64,8
8,0,0,0,0,2020-08-11,Male,67,65-69,5
8,0,0,0,0,2020-08-07,Male,51,45-54,7
8,0,1,0,1,2020-08-08,Male,54,45-54,7
8,1,0,0,1,2020-08-07,Female,7,5-9,7
8,2,2,0,4,2020-08-09,Male,65,65-69,7
8,0,0,0,0,2020-08-11,Male,50,45-54,6
8,0,0,0,0,2020-08-07,Female,29,25-34,5
8,0,2,0,2,2020-08-10,Male,45,45-54,6
8,2,0,0,2,2020-08-07,Female,68,65-69,5
8,2,8,0,10,2020-08-07,Male,54,45-54,3
8,1,11,0,12,2020-08-07,Male,66,65-69,5
8,2,0,0,2,2020-08-11,Male,9,5-9,7
8,0,0,0,0,2020-08-08,Male,65,65-69,5
8,2,0,0,2,2020-08-07,Female,65,65-69,8
8,3,0,0,3,2020-08-07,Female,12,10-14,5
8,2,0,3,5,2020-08-07,Female,72,70-74,2
8,4,5,0,9,2020-08-07,Male,10,10-14,8
8,2,3,0,5,2020-08-08,Male,50,45-54,8
8,0,0,0,0,2020-08-09,Male,73,70-74,8
8,0,0,0,0,2020-08-07,Female,66,65-69,4
8,1,1,0,2,2020-08-07,Male,54,45-54,7
8,0,2,0,2,2020-08-10,Female,68,65-69,8
8,2,4,0,6,2020-08-11,Male,67,65-69,4
8,2,7,0,9,2020-08-08,Female,55,55-64,6
8,0,0,30,30,2020-08-09,Male,21,20-24,5
8,0,0,0,0,2020-08-07,Female,7,5-9,3
8,1,0,0,1,2020-08-08,Female,63,55-64,4
8,2,0,0,2,2020-08-10,Male,66,65-69,6
8,1,0,0,1,2020-08-09,Male,59,55-64,8
8,1,0,0,1,2020-08-07,Male,54,45-54,5
8,1,1,0,2,2020-08-08,Female,68,65-69,8
8,0,0,0,0,2020-08-07,Female,24,20-24,8
8,1,0,2,3,2020-08-07,Male,43,35-44,4
8,1,0,0,1,2020-08-09,Male,51,45-54,8
8,0,0,0,0,2020-08-08,Female,65,65-69,4
8,1,2,0,3,2020-08-10,Male,45,45-54,2
8,0,0,0,0,2020-08-07,Male,30,25-34,8
8,3,0,0,3,2020-08-07,Female,2,1-4,4
8,0,1,0,1,2020-08-07,Female,23,20-24,5
8,1,0,0,1,2020-08-07,Male,33,25-34,4
8,0,0,0,0,2020-08-10,Female,48,45-54,8
8,0,8,0,8,2020-08-07,Male,39,35-44,4
8,2,0,0,2,2020-08-07,Female,63,55-64,8
8,2,4,0,6,2020-08-08,Male,63,55-64,5
8,2,0,0,2,2020-08-07,Female,37,35-44,7
8,1,0,0,1,2020-08-07,Male,52,45-54,7
8,0,4,0,4,2020-08-07,Female,65,65-69,8
8,0,1,0,1,2020-08-07,Female,66,65-69,7
8,0,1,0,1,2020-08-08,Female,69,65-69,4
8,1,1,0,2,2020-08-10,Female,52,45-54,6
8,0,1,0,1,2020-08-07,Male,53,45-54,4
8,5,1,0,6,2020-08-08,Female,46,45-54,8
8,0,4,0,4,2020-08-07,Male,54,45-54,6
8,2,1,0,3,2020-08-07,Male,65,65-69,5
8,0,0,5,5,2020-08-07,Male,57,55-64,5
8,1,1,0,2,2020-08-07,Female,55,55-64,7
8,2,0,0,2,2020-08-07,Male,39,35-44,8
8,0,0,0,0,2020-08-07,Male,38,35-44,6
8,0,3,0,3,2020-08-10,Male,39,35-44,4
8,3,4,0,7,2020-08-07,Female,20,20-24,5
8,0,0,1,1,2020-08-11,Female,7,5-9,8
8,1,0,0,1,2020-08-07,Male,65,65-69,8
8,0,0,0,0,2020-08-07,Male,63,55-64,5
8,1,0,0,1,2020-08-08,Female,63,55-64,3
8,0,1,0,1,2020-08-07,Male,72,70-74,5
8,3,0,0,3,2020-08-07,Male,43,35-44,5
8,1,1,0,2,2020-08-07,Female,18,15-19,8
8,1,0,0,1,2020-08-07,Male,61,55-64,8
8,1,0,0,1,2020-08-11,Male,67,65-69,8
8,0,0,0,0,2020-08-07,Male,57,55-64,8
8,2,0,0,2,2020-08-07,Male,8,5-9,8
8,2,1,0,3,2020-08-09,Female,55,55-64,8
8,3,0,0,3,2020-08-10,Female,8,5-9,4
8,2,0,0,2,2020-08-07,Male,30,25-34,4
8,0,0,0,0,2020-08-07,Female,35,35-44,5
8,2,6,0,8,2020-08-07,Male,55,55-64,5
8,1,0,0,1,2020-08-07,Female,6,5-9,5
8,0,1,0,1,2020-08-09,Male,53,45-54,5
8,2,1,0,3,2020-08-10,Female,58,55-64,8
8,0,0,0,0,2020-08-07,Male,42,35-44,6
8,2,0,0,2,2020-08-10,Male,78,75-79,5
8,2,0,0,2,2020-08-11,Male,10,10-14,4
8,2,0,0,2,2020-08-07,Male,64,55-64,8
8,3,0,0,3,2020-08-07,Female,18,15-19,8
8,0,33,0,33,2020-08-09,Female,55,55-64,4
8,2,0,0,2,2020-08-07,Male,55,55-64,8
8,1,0,0,1,2020-08-07,Female,54,45-54,5
8,1,0,0,1,2020-08-07,Male,56,55-64,4
8,0,0,0,0,2020-08-08,Male,59,55-64,7
8,0,3,0,3,2020-08-08,Female,59,55-64,8
8,1,1,0,2,2020-08-11,Female,32,25-34,5
8,1,0,0,1,2020-08-07,Female,23,20-24,6
8,1,10,0,11,2020-08-07,Male,32,25-34,5
8,0,0,0,0,2020-08-07,Male,27,25-34,7
8,3,8,0,11,2020-08-08,Male,58,55-64,5
8,1,1,0,2,2020-08-10,Female,67,65-69,4
8,0,0,0,0,2020-08-09,Female,6,5-9,8
8,0,0,0,0,2020-08-07,Female,40,35-44,8
8,1,2,0,3,2020-08-08,Male,68,65-69,5
8,0,0,0,0,2020-08-07,Male,12,10-14,5
8,2,4,17,23,2020-08-07,Male,65,65-69,5
8,2,1,0,3,2020-08-07,Male,33,25-34,5
8,2,0,0,2,2020-08-10,Female,61,55-64,5
8,3,0,0,3,2020-08-08,Female,65,65-69,4
8,0,0,0,0,2020-08-11,Male,69,65-69,5
8,0,0,0,0,2020-08-10,Female,30,25-34,7
8,3,0,0,3,2020-08-07,Male,23,20-24,5
8,1,4,0,5,2020-08-09,Male,62,55-64,5
8,1,0,0,1,2020-08-07,Male,22,20-24,4
8,0,0,0,0,2020-08-07,Male,59,55-64,6
8,1,0,0,1,2020-08-07,Female,52,45-54,4
8,3,0,0,3,2020-08-07,Male,68,65-69,8
8,2,3,0,5,2020-08-07,Male,70,70-74,8
8,0,3,0,3,2020-08-10,Male,59,55-64,5
8,1,2,0,3,2020-08-11,Male,58,55-64,5
8,2,5,2,9,2020-08-07,Male,66,65-69,4
8,0,6,0,6,2020-08-07,Female,53,45-54,5
8,4,1,0,5,2020-08-10,Male,28,25-34,3
8,0,1,0,1,2020-08-07,Male,50,45-54,5
8,3,0,0,3,2020-08-08,Male,19,15-19,4
8,3,0,0,3,2020-08-07,Male,2,1-4,5
8,1,2,0,3,2020-08-10,Female,69,65-69,7
8,1,6,0,7,2020-08-11,Male,67,65-69,8
8,1,0,0,1,2020-08-09,Male,13,10-14,4
8,3,2,0,5,2020-08-07,Female,65,65-69,3
8,1,0,0,1,2020-08-07,Male,34,25-34,6
8,1,0,9,10,2020-08-08,Female,48,45-54,5
8,0,0,0,0,2020-08-07,Male,36,35-44,7
8,1,18,0,19,2020-08-07,Female,54,45-54,4
8,0,0,0,0,2020-08-10,Female,42,35-44,5
8,0,0,0,0,2020-08-08,Male,7,5-9,4
8,0,0,0,0,2020-08-08,Male,51,45-54,5
8,4,0,0,4,2020-08-09,Female,31,25-34,6
8,2,0,0,2,2020-08-07,Male,9,5-9,3
8,3,3,0,6,2020-08-07,Male,68,65-69,4
8,1,0,0,1,2020-08-10,Male,62,55-64,4
8,1,0,0,1,2020-08-07,Male,54,45-54,8
8,1,0,0,1,2020-08-09,Female,41,35-44,5
8,2,0,0,2,2020-08-07,Female,70,70-74,7
8,0,0,0,0,2020-08-08,Female,65,65-69,4
8,3,0,0,3,2020-08-09,Male,18,15-19,8
8,1,2,0,3,2020-08-07,Male,54,45-54,5
8,1,0,0,1,2020-08-07,Female,35,35-44,4
8,0,0,0,0,2020-08-07,Male,22,20-24,6
8,1,0,0,1,2020-08-10,Male,30,25-34,5
8,1,1,0,2,2020-08-07,Female,20,20-24,5
8,3,0,0,3,2020-08-10,Female,55,55-64,8
8,3,0,0,3,2020-08-08,Female,66,65-69,8
8,0,2,0,2,2020-08-08,Male,64,55-64,7
8,2,1,0,3,2020-08-07,Male,64,55-64,5
8,2,0,0,2,2020-08-08,Male,48,45-54,5
8,0,0,0,0,2020-08-07,Male,59,55-64,6
8,0,3,8,11,2020-08-07,Male,30,25-34,5
8,1,6,23,30,2020-08-09,Female,56,55-64,3
8,0,1,0,1,2020-08-08,Female,25,25-34,6
8,2,3,0,5,2020-08-10,Female,27,25-34,5
8,0,0,100,100,2020-08-07,Male,40,35-44,5
8,0,2,0,2,2020-08-07,Male,65,65-69,8
8,0,1,0,1,2020-08-07,Male,56,55-64,5
8,0,0,0,0,2020-08-07,Female,65,65-69,8
8,0,1,2,3,2020-08-07,Male,46,45-54,5
8,0,1,0,1,2020-08-07,Female,65,65-69,5
8,0,0,1,1,2020-08-10,Male,45,45-54,6
8,1,0,0,1,2020-08-11,Female,67,65-69,5
8,0,0,0,0,2020-08-07,Female,64,55-64,8
8,1,0,0,1,2020-08-09,Male,58,55-64,8
8,0,2,0,2,2020-08-07,Male,51,45-54,8
8,2,27,0,29,2020-08-09,Female,77,75-79,6
8,2,1,0,3,2020-08-07,Male,71,70-74,6
8,0,3,0,3,2020-08-08,Female,38,35-44,8
8,0,0,0,0,2020-08-07,Male,18,15-19,8
8,0,1,0,1,2020-08-10,Male,67,65-69,5
8,1,0,0,1,2020-08-07,Female,66,65-69,4
8,0,0,0,0,2020-08-07,Female,68,65-69,7
8,1,0,0,1,2020-08-09,Female,19,15-19,4
8,0,2,0,2,2020-08-10,Female,28,25-34,6
8,4,0,0,4,2020-08-08,Female,32,25-34,6
8,1,0,0,1,2020-08-07,Female,63,55-64,5
8,0,0,0,0,2020-08-07,Female,32,25-34,4
8,1,0,0,1,2020-08-08,Female,46,45-54,5
8,1,0,0,1,2020-08-10,Male,32,25-34,5
8,1,0,0,1,2020-08-07,Male,65,65-69,4
8,0,1,0,1,2020-08-11,Female,67,65-69,8
8,5,8,0,13,2020-08-07,Female,19,15-19,5
8,5,0,0,5,2020-08-09,Female,17,15-19,7
8,0,1,0,1,2020-08-07,Male,22,20-24,6
8,0,0,0,0,2020-08-07,Male,59,55-64,5
8,0,0,0,0,2020-08-08,Male,42,35-44,4
8,0,0,0,0,2020-08-07,Male,31,25-34,5
8,1,3,0,4,2020-08-07,Female,67,65-69,5
8,1,4,0,5,2020-08-10,Male,43,35-44,8
8,0,0,0,0,2020-08-07,Male,52,45-54,3
8,3,2,30,35,2020-08-10,Male,30,25-34,8
8,3,0,0,3,2020-08-07,Female,0,<1,7
8,2,0,0,2,2020-08-07,Male,36,35-44,6
8,0,1,0,1,2020-08-07,Female,51,45-54,6
8,2,1,0,3,2020-08-07,Female,50,45-54,5
8,2,0,0,2,2020-08-11,Female,67,65-69,6
8,2,10,0,12,2020-08-11,Male,51,45-54,8
8,0,0,0,0,2020-08-07,Female,55,55-64,4
8,0,1,0,1,2020-08-10,Female,25,25-34,5
8,0,0,0,0,2020-08-08,Male,53,45-54,5
8,0,0,0,0,2020-08-11,Male,33,25-34,8
8,0,18,0,18,2020-08-07,Male,46,45-54,4
8,0,4,0,4,2020-08-07,Female,66,65-69,6
8,1,0,0,1,2020-08-09,Female,68,65-69,5
8,2,0,0,2,2020-08-08,Female,11,10-14,5
8,0,0,0,0,2020-08-10,Female,67,65-69,5
8,0,0,0,0,2020-08-09,Female,69,65-69,5
8,2,0,0,2,2020-08-07,Male,45,45-54,8
8,0,0,0,0,2020-08-08,Female,55,55-64,8
8,0,0,0,0,2020-08-11,Male,29,25-34,5
8,0,0,0,0,2020-08-07,Male,17,15-19,4
8,0,3,0,3,2020-08-07,Male,38,35-44,4
8,1,8,0,9,2020-08-11,Male,67,65-69,5
8,2,1,0,3,2020-08-08,Female,58,55-64,8
8,1,1,0,2,2020-08-08,Male,35,35-44,6
8,5,0,10,15,2020-08-09,Male,18,15-19,5
8,1,0,0,1,2020-08-08,Male,31,25-34,6
8,1,1,0,2,2020-08-07,Male,57,55-64,6
8,3,0,0,3,2020-08-10,Male,14,10-14,5
8,1,11,0,12,2020-08-09,Male,52,45-54,3
8,0,1,0,1,2020-08-07,Male,64,55-64,4
8,1,2,0,3,2020-08-10,Female,66,65-69,7
8,1,1,0,2,2020-08-08,Female,67,65-69,7
8,0,0,0,0,2020-08-07,Female,20,20-24,4
8,0,9,1,10,2020-08-07,Female,47,45-54,4
8,0,80,100,180,2020-08-11,Female,30,25-34,3
8,0,0,0,0,2020-08-07,Female,20,20-24,5
8,2,1,0,3,2020-08-07,Male,27,25-34,5
8,1,4,2,7,2020-08-11,Male,65,65-69,6
8,1,0,0,1,2020-08-07,Female,62,55-64,7
8,0,1,0,1,2020-08-07,Male,65,65-69,8
8,2,0,0,2,2020-08-08,Male,56,55-64,3
8,0,1,0,1,2020-08-07,Male,66,65-69,7
8,1,0,0,1,2020-08-07,Male,63,55-64,8
8,1,0,0,1,2020-08-10,Male,30,25-34,4
8,0,4,0,4,2020-08-09,Female,62,55-64,6
8,0,0,0,0,2020-08-07,Female,35,35-44,8
8,3,0,0,3,2020-08-07,Male,6,5-9,5
8,0,0,0,0,2020-08-10,Male,40,35-44,3
8,6,1,0,7,2020-08-07,Female,10,10-14,5
8,3,0,0,3,2020-08-07,Female,65,65-69,8
8,0,0,0,0,2020-08-07,Female,31,25-34,5
8,3,1,0,4,2020-08-08,Male,24,20-24,5
8,2,1,0,3,2020-08-08,Male,54,45-54,7
8,2,7,0,9,2020-08-07,Male,54,45-54,3
8,0,0,1,1,2020-08-07,Female,42,35-44,5
8,0,0,0,0,2020-08-07,Female,66,65-69,5
8,1,1,0,2,2020-08-07,Male,55,55-64,5
8,1,0,0,1,2020-08-07,Male,53,45-54,5
8,0,0,0,0,2020-08-07,Male,39,35-44,5
8,5,16,0,21,2020-08-07,Female,12,10-14,7
8,1,11,1,13,2020-08-07,Male,42,35-44,6
8,0,0,0,0,2020-08-07,Female,50,45-54,4
8,0,0,0,0,2020-08-07,Female,63,55-64,8
8,0,0,0,0,2020-08-07,Male,19,15-19,8
8,1,0,0,1,2020-08-09,Female,66,65-69,7
8,0,0,3,3,2020-08-08,Male,60,55-64,4
8,0,1,0,1,2020-08-07,Female,61,55-64,8
8,0,0,0,0,2020-08-07,Male,50,45-54,5
8,2,2,0,4,2020-08-07,Male,18,15-19,5
8,0,1,0,1,2020-08-07,Female,67,65-69,4
8,2,0,0,2,2020-08-07,Male,21,20-24,5
8,2,5,0,7,2020-08-08,Female,70,70-74,6
8,0,0,0,0,2020-08-07,Male,38,35-44,5
8,1,3,0,4,2020-08-08,Male,66,65-69,5
8,0,0,0,0,2020-08-08,Female,33,25-34,3
8,0,0,0,0,2020-08-11,Male,74,70-74,7
8,0,1,10,11,2020-08-07,Female,33,25-34,8
8,0,0,0,0,2020-08-10,Male,52,45-54,8
8,1,0,0,1,2020-08-07,Male,67,65-69,8
8,0,0,0,0,2020-08-10,Male,34,25-34,6
8,1,3,0,4,2020-08-08,Male,68,65-69,4
8,2,0,0,2,2020-08-07,Male,15,15-19,4
8,0,0,0,0,2020-08-07,Male,24,20-24,5
8,0,0,0,0,2020-08-07,Male,18,15-19,5
8,1,0,0,1,2020-08-07,Female,7,5-9,4
8,4,0,0,4,2020-08-10,Male,14,10-14,5
8,2,3,0,5,2020-08-07,Female,61,55-64,5
8,4,1,0,5,2020-08-10,Male,41,35-44,4
8,2,2,0,4,2020-08-07,Male,52,45-54,5
8,0,0,0,0,2020-08-07,Female,52,45-54,4
8,3,2,0,5,2020-08-08,Female,42,35-44,7
8,1,0,0,1,2020-08-07,Male,31,25-34,5
8,0,0,0,0,2020-08-11,Female,66,65-69,8
8,2,0,12,14,2020-08-10,Female,36,35-44,5
8,2,0,0,2,2020-08-09,Male,14,10-14,5
8,2,2,0,4,2020-08-07,Female,50,45-54,8
8,1,1,9,11,2020-08-07,Female,6,5-9,6
8,3,0,0,3,2020-08-07,Male,32,25-34,5
8,3,0,0,3,2020-08-08,Female,4,1-4,6
8,1,12,0,13,2020-08-08,Male,59,55-64,2
8,1,0,1,2,2020-08-07,Male,44,35-44,5
8,0,0,0,0,2020-08-07,Female,54,45-54,8
8,4,2,0,6,2020-08-11,Male,7,5-9,3
8,0,0,0,0,2020-08-08,Female,41,35-44,8
8,0,0,0,0,2020-08-07,Female,64,55-64,8
8,2,0,0,2,2020-08-07,Female,52,45-54,8
8,0,0,0,0,2020-08-07,Male,39,35-44,5
8,3,0,0,3,2020-08-09,Male,18,15-19,5
8,0,0,0,0,2020-08-10,Male,77,75-79,7
8,1,0,0,1,2020-08-07,Male,66,65-69,8
8,2,7,0,9,2020-08-07,Female,66,65-69,8
8,1,0,10,11,2020-08-07,Female,65,65-69,4
8,2,0,0,2,2020-08-07,Female,10,10-14,6
8,0,0,0,0,2020-08-11,Male,2,1-4,4
8,0,0,0,0,2020-08-07,Male,47,45-54,8
8,1,0,0,1,2020-08-08,Male,65,65-69,5
8,0,0,0,0,2020-08-10,Male,39,35-44,7
8,1,6,0,7,2020-08-07,Female,65,65-69,8
8,0,0,0,0,2020-08-07,Male,38,35-44,8
8,0,0,0,0,2020-08-07,Male,30,25-34,5
8,0,0,0,0,2020-08-07,Male,17,15-19,7
8,0,0,0,0,2020-08-07,Female,53,45-54,5
8,2,0,0,2,2020-08-11,Male,57,55-64,3
8,1,1,0,2,2020-08-08,Female,67,65-69,6
8,0,0,0,0,2020-08-07,Female,37,35-44,3
8,1,0,0,1,2020-08-08,Male,48,45-54,2
8,0,0,0,0,2020-08-11,Male,35,35-44,8
8,2,0,0,2,2020-08-07,Male,64,55-64,5
8,2,0,0,2,2020-08-09,Male,59,55-64,5
8,0,0,0,0,2020-08-08,Male,40,35-44,6
8,3,5,1,9,2020-08-11,Male,68,65-69,4
8,2,0,0,2,2020-08-07,Female,14,10-14,8
8,2,0,0,2,2020-08-09,Female,57,55-64,7
8,0,0,0,0,2020-08-07,Male,10,10-14,8
8,1,1,0,2,2020-08-07,Male,15,15-19,5
8,1,0,0,1,2020-08-07,Male,65,65-69,5
8,0,0,0,0,2020-08-10,Female,17,15-19,7
8,1,0,0,1,2020-08-11,Female,49,45-54,8
8,0,0,0,0,2020-08-11,Female,23,20-24,5
8,0,0,0,0,2020-08-07,Female,21,20-24,5
8,2,0,0,2,2020-08-08,Female,13,10-14,6
8,3,0,0,3,2020-08-07,Female,14,10-14,5
8,3,30,0,33,2020-08-11,Female,19,15-19,5
8,2,0,0,2,2020-08-08,Female,24,20-24,5
8,0,2,0,2,2020-08-11,Female,67,65-69,5
8,0,1,0,1,2020-08-07,Female,53,45-54,8
8,0,0,0,0,2020-08-07,Male,39,35-44,5
8,0,3,0,3,2020-08-10,Male,35,35-44,5
8,0,0,0,0,2020-08-07,Female,15,15-19,5
8,0,0,0,0,2020-08-10,Female,65,65-69,7
8,0,0,0,0,2020-08-07,Female,65,65-69,5
8,2,0,0,2,2020-08-09,Male,33,25-34,4
8,1,3,0,4,2020-08-11,Female,67,65-69,5
8,0,4,0,4,2020-08-08,Male,52,45-54,8
8,1,0,0,1,2020-08-10,Female,41,35-44,5
8,0,2,0,2,2020-08-07,Female,30,25-34,5
8,1,1,0,2,2020-08-07,Male,56,55-64,6
8,1,33,0,34,2020-08-07,Male,65,65-69,5
8,2,9,0,11,2020-08-07,Male,67,65-69,7
8,2,3,0,5,2020-08-09,Female,75,75-79,4
8,3,0,0,3,2020-08-10,Female,9,5-9,5
8,0,0,0,0,2020-08-07,Female,62,55-64,8
8,2,0,0,2,2020-08-07,Male,11,10-14,5
8,0,0,0,0,2020-08-07,Female,14,10-14,6
8,0,4,0,4,2020-08-08,Female,70,70-74,4
8,0,0,10,10,2020-08-11,Female,28,25-34,4
8,0,0,0,0,2020-08-07,Female,69,65-69,5
8,2,5,0,7,2020-08-10,Male,53,45-54,5
8,0,0,0,0,2020-08-07,Male,23,20-24,7
8,5,1,0,6,2020-08-07,Female,31,25-34,4
8,0,8,0,8,2020-08-07,Male,44,35-44,5
8,0,1,0,1,2020-08-10,Female,29,25-34,5
8,1,0,0,1,2020-08-07,Male,54,45-54,6
8,2,0,0,2,2020-08-07,Male,17,15-19,7
8,1,3,0,4,2020-08-07,Male,54,45-54,8
8,1,0,0,1,2020-08-07,Female,61,55-64,8
8,0,0,0,0,2020-08-07,Male,65,65-69,8
8,2,0,0,2,2020-08-10,Female,61,55-64,8
8,1,0,0,1,2020-08-08,Male,52,45-54,7
8,0,3,0,3,2020-08-08,Female,65,65-69,8
8,0,0,0,0,2020-08-07,Male,65,65-69,5
8,1,0,0,1,2020-08-08,Female,59,55-64,7
8,1,2,0,3,2020-08-08,Male,65,65-69,8
8,1,1,0,2,2020-08-07,Female,62,55-64,8
8,2,0,0,2,2020-08-09,Male,32,25-34,4
8,0,0,0,0,2020-08-08,Female,52,45-54,8
8,0,1,0,1,2020-08-08,Female,18,15-19,4
8,1,3,0,4,2020-08-07,Female,65,65-69,4
8,2,0,0,2,2020-08-08,Female,52,45-54,5
8,3,0,0,3,2020-08-08,Female,47,45-54,5
8,0,0,0,0,2020-08-10,Male,66,65-69,7
8,1,2,0,3,2020-08-07,Male,59,55-64,8
8,2,0,3,5,2020-08-07,Female,44,35-44,8
8,2,0,0,2,2020-08-09,Male,21,20-24,4
8,1,2,0,3,2020-08-07,Male,71,70-74,4
8,2,0,0,2,2020-08-10,Male,67,65-69,7
8,0,1,0,1,2020-08-09,Female,64,55-64,5
8,2,0,0,2,2020-08-07,Male,18,15-19,5
8,2,3,0,5,2020-08-08,Female,66,65-69,4
8,1,2,0,3,2020-08-08,Male,58,55-64,8
8,1,2,0,3,2020-08-08,Male,66,65-69,4
8,3,0,3,6,2020-08-07,Male,14,10-14,5
8,0,1,0,1,2020-08-10,Male,35,35-44,4
8,1,0,0,1,2020-08-09,Male,15,15-19,7
8,0,3,7,10,2020-08-08,Female,25,25-34,8
8,2,0,0,2,2020-08-07,Male,29,25-34,8
8,0,0,0,0,2020-08-07,Male,33,25-34,5
8,2,2,0,4,2020-08-08,Female,9,5-9,5
8,1,2,0,3,2020-08-08,Female,69,65-69,6
8,1,0,0,1,2020-08-08,Male,66,65-69,4
8,0,1,0,1,2020-08-10,Female,48,45-54,4
8,0,0,0,0,2020-08-07,Male,35,35-44,5
8,0,0,0,0,2020-08-08,Female,8,5-9,6
8,1,0,0,1,2020-08-07,Female,55,55-64,8
8,0,0,0,0,2020-08-07,Female,49,45-54,4
8,1,0,0,1,2020-08-07,Male,42,35-44,5
8,4,0,0,4,2020-08-09,Female,1,1-4,5
8,0,0,0,0,2020-08-07,Male,42,35-44,5
8,1,3,0,4,2020-08-11,Male,67,65-69,7
8,4,0,0,4,2020-08-08,Male,7,5-9,8
8,2,2,0,4,2020-08-10,Female,2,1-4,4
8,2,4,0,6,2020-08-07,Male,60,55-64,7
8,2,0,0,2,2020-08-07,Male,65,65-69,8
8,1,2,0,3,2020-08-08,Male,65,65-69,8
8,2,3,0,5,2020-08-07,Male,52,45-54,8
8,0,0,0,0,2020-08-08,Female,7,5-9,5
8,1,0,0,1,2020-08-08,Male,53,45-54,4
8,0,0,0,0,2020-08-07,Female,60,55-64,4
8,1,5,0,6,2020-08-08,Female,55,55-64,8
8,2,1,0,3,2020-08-08,Male,32,25-34,5
8,0,0,0,0,2020-08-07,Female,48,45-54,4
8,1,0,0,1,2020-08-07,Male,66,65-69,7
8,1,1,0,2,2020-08-08,Male,54,45-54,3
8,0,0,0,0,2020-08-10,Male,40,35-44,7
8,0,0,0,0,2020-08-10,Male,59,55-64,5
8,0,2,0,2,2020-08-09,Male,41,35-44,8
8,0,0,0,0,2020-08-07,Male,66,65-69,8
8,1,0,1,2,2020-08-07,Female,60,55-64,3
8,0,0,0,0,2020-08-10,Female,34,25-34,6
8,1,2,0,3,2020-08-07,Male,63,55-64,5
8,4,1,0,5,2020-08-11,Male,18,15-19,3
8,5,2,0,7,2020-08-10,Male,2,1-4,6
8,1,0,0,1,2020-08-10,Male,47,45-54,5
8,0,1,0,1,2020-08-07,Female,34,25-34,5
8,0,0,0,0,2020-08-07,Male,52,45-54,8
8,1,0,0,1,2020-08-07,Male,61,55-64,8
8,0,2,0,2,2020-08-10,Female,67,65-69,8
8,0,2,0,2,2020-08-07,Male,14,10-14,8
8,0,0,0,0,2020-08-07,Female,38,35-44,6
8,3,2,0,5,2020-08-10,Female,22,20-24,3
8,0,1,0,1,2020-08-07,Male,46,45-54,7
8,0,0,0,0,2020-08-08,Female,57,55-64,5
8,1,1,0,2,2020-08-07,Male,66,65-69,4
8,5,0,0,5,2020-08-07,Female,21,20-24,5
8,2,12,10,24,2020-08-08,Female,65,65-69,3
8,4,1,0,5,2020-08-08,Female,19,15-19,4
8,0,0,0,0,2020-08-07,Male,27,25-34,5
8,0,0,30,30,2020-08-07,Male,32,25-34,4
8,0,6,0,6,2020-08-11,Female,67,65-69,6
8,0,0,0,0,2020-08-08,Male,51,45-54,5
8,4,0,0,4,2020-08-07,Male,16,15-19,5
8,2,0,0,2,2020-08-10,Male,61,55-64,4
8,1,0,0,1,2020-08-07,Female,62,55-64,4
8,0,0,0,0,2020-08-07,Male,43,35-44,8
8,2,2,0,4,2020-08-07,Female,64,55-64,8
8,1,0,0,1,2020-08-07,Female,48,45-54,8
8,0,0,0,0,2020-08-10,Male,53,45-54,3
8,0,0,0,0,2020-08-07,Female,53,45-54,7
8,1,1,0,2,2020-08-11,Female,33,25-34,5
8,1,0,0,1,2020-08-10,Female,50,45-54,5
8,2,0,0,2,2020-08-08,Male,56,55-64,6
8,0,0,6,6,2020-08-07,Female,59,55-64,4
8,1,0,0,1,2020-08-09,Male,56,55-64,6
8,2,40,0,42,2020-08-07,Male,65,65-69,8
8,1,0,0,1,2020-08-08,Male,61,55-64,8
8,1,0,0,1,2020-08-08,Male,65,65-69,8
8,0,0,0,0,2020-08-11,Male,33,25-34,7
8,1,0,0,1,2020-08-07,Female,58,55-64,8
8,0,0,0,0,2020-08-07,Female,36,35-44,5
8,0,1,0,1,2020-08-08,Male,62,55-64,5
8,0,0,0,0,2020-08-07,Male,24,20-24,4
8,1,0,0,1,2020-08-11,Female,68,65-69,7
8,2,0,0,2,2020-08-07,Female,65,65-69,5
8,2,3,0,5,2020-08-07,Female,34,25-34,5
8,2,0,0,2,2020-08-07,Male,53,45-54,8
8,1,0,0,1,2020-08-08,Male,56,55-64,5
8,1,3,0,4,2020-08-08,Female,55,55-64,8
8,0,1,0,1,2020-08-07,Female,67,65-69,8
8,2,2,0,4,2020-08-08,Female,52,45-54,8
8,2,2,0,4,2020-08-11,Male,66,65-69,6
8,0,0,0,0,2020-08-07,Male,31,25-34,5
8,1,3,0,4,2020-08-07,Female,48,45-54,3
8,2,0,0,2,2020-08-10,Female,70,70-74,5
8,0,2,0,2,2020-08-07,Male,66,65-69,8
8,0,0,0,0,2020-08-07,Female,26,25-34,5
8,1,1,0,2,2020-08-10,Male,80,80-84,3
8,0,1,0,1,2020-08-11,Male,41,35-44,5
8,1,0,0,1,2020-08-07,Female,53,45-54,8
8,1,2,0,3,2020-08-07,Male,62,55-64,8
8,0,0,0,0,2020-08-07,Male,37,35-44,8
8,0,0,0,0,2020-08-07,Male,53,45-54,8
8,3,0,0,3,2020-08-07,Female,6,5-9,8
8,3,0,0,3,2020-08-08,Male,17,15-19,3
8,1,0,0,1,2020-08-07,Male,34,25-34,7
8,3,0,0,3,2020-08-07,Male,61,55-64,2
8,3,0,0,3,2020-08-09,Male,41,35-44,5
8,0,0,0,0,2020-08-07,Female,24,20-24,8
8,1,2,0,3,2020-08-07,Female,42,35-44,5
8,2,2,0,4,2020-08-09,Male,57,55-64,5
8,3,2,0,5,2020-08-08,Male,2,1-4,5
8,3,1,0,4,2020-08-07,Female,36,35-44,7
8,1,0,0,1,2020-08-07,Female,59,55-64,8
8,1,3,0,4,2020-08-08,Male,69,65-69,8
8,1,0,0,1,2020-08-07,Male,66,65-69,7
8,0,0,0,0,2020-08-07,Female,57,55-64,7
8,0,0,0,0,2020-08-07,Male,52,45-54,7
8,0,0,0,0,2020-08-07,Male,56,55-64,7
8,0,0,0,0,2020-08-07,Male,25,25-34,4
8,2,0,0,2,2020-08-07,Female,63,55-64,6
8,2,0,0,2,2020-08-09,Male,65,65-69,5
8,0,5,0,5,2020-08-07,Female,65,65-69,7
8,4,0,0,4,2020-08-09,Female,18,15-19,4
8,0,1,0,1,2020-08-08,Female,53,45-54,7
8,1,0,0,1,2020-08-07,Female,45,45-54,5
8,0,0,4,4,2020-08-10,Male,30,25-34,5
8,1,0,0,1,2020-08-07,Male,53,45-54,5
8,6,1,0,7,2020-08-07,Male,16,15-19,4
8,0,7,0,7,2020-08-08,Female,70,70-74,8
8,1,0,0,1,2020-08-07,Male,34,25-34,3
8,0,0,1,1,2020-08-07,Male,27,25-34,7
8,1,0,0,1,2020-08-08,Male,28,25-34,8
8,0,0,0,0,2020-08-07,Male,30,25-34,6
8,0,6,4,10,2020-08-11,Female,31,25-34,5
8,1,0,0,1,2020-08-08,Female,64,55-64,7
8,0,1,0,1,2020-08-11,Male,70,70-74,7
8,1,0,0,1,2020-08-10,Male,33,25-34,3
8,0,1,0,1,2020-08-10,Male,65,65-69,7
8,0,12,0,12,2020-08-07,Female,68,65-69,8
8,0,0,0,0,2020-08-09,Male,60,55-64,5
8,0,0,0,0,2020-08-07,Male,27,25-34,5
8,0,0,9,9,2020-08-07,Male,5,5-9,5
8,0,1,0,1,2020-08-07,Male,52,45-54,5
8,1,0,2,3,2020-08-07,Female,34,25-34,5
8,1,1,0,2,2020-08-11,Male,68,65-69,8
8,2,0,0,2,2020-08-08,Female,66,65-69,7
8,1,0,0,1,2020-08-11,Male,68,65-69,7
8,1,0,0,1,2020-08-08,Male,61,55-64,6
8,0,0,0,0,2020-08-07,Male,33,25-34,5
8,1,0,0,1,2020-08-07,Female,61,55-64,5
8,0,4,0,4,2020-08-07,Female,56,55-64,8
8,3,1,0,4,2020-08-07,Female,53,45-54,7
8,1,0,0,1,2020-08-09,Male,66,65-69,4
8,4,0,0,4,2020-08-10,Male,8,5-9,3
8,0,5,0,5,2020-08-07,Female,53,45-54,5
8,2,0,0,2,2020-08-08,Female,33,25-34,7
8,0,0,0,0,2020-08-07,Female,61,55-64,8
8,5,2,0,7,2020-08-11,Female,4,1-4,4
8,2,10,0,12,2020-08-07,Female,59,55-64,6
8,1,0,0,1,2020-08-10,Female,30,25-34,5
8,4,0,0,4,2020-08-07,Female,54,45-54,5
8,2,0,0,2,2020-08-07,Female,55,55-64,5
8,1,11,0,12,2020-08-07,Female,60,55-64,8
8,0,0,0,0,2020-08-09,Male,69,65-69,8
8,0,6,0,6,2020-08-08,Female,54,45-54,5
8,2,10,0,12,2020-08-07,Male,65,65-69,3
8,1,0,0,1,2020-08-07,Female,51,45-54,8
8,2,4,0,6,2020-08-11,Male,77,75-79,4
8,3,2,0,5,2020-08-10,Male,12,10-14,3
8,0,1,0,1,2020-08-07,Female,18,15-19,5
8,0,0,0,0,2020-08-08,Male,51,45-54,8
8,1,0,0,1,2020-08-09,Female,65,65-69,8
8,4,0,0,4,2020-08-07,Female,17,15-19,4
8,0,0,0,0,2020-08-07,Female,37,35-44,6
8,0,0,0,0,2020-08-09,Male,57,55-64,6
8,1,0,0,1,2020-08-10,Female,49,45-54,4
8,0,0,1,1,2020-08-10,Male,59,55-64,4
8,0,0,0,0,2020-08-07,Male,55,55-64,5
8,0,1,0,1,2020-08-07,Male,60,55-64,5
8,0,0,0,0,2020-08-07,Male,36,35-44,4
8,3,0,0,3,2020-08-08,Female,2,1-4,5
8,2,1,0,3,2020-08-07,Female,53,45-54,6
8,2,2,0,4,2020-08-07,Male,51,45-54,4
8,1,4,0,5,2020-08-07,Female,17,15-19,5
8,0,5,0,5,2020-08-08,Male,61,55-64,5
8,2,0,0,2,2020-08-07,Female,54,45-54,6
8,0,0,0,0,2020-08-07,Male,53,45-54,3
8,1,0,0,1,2020-08-07,Male,53,45-54,5
8,3,1,0,4,2020-08-07,Male,28,25-34,5
8,2,1,0,3,2020-08-07,Female,65,65-69,6
8,0,0,0,0,2020-08-09,Male,78,75-79,3
8,1,1,0,2,2020-08-08,Male,61,55-64,5
8,3,0,0,3,2020-08-10,Male,17,15-19,8
8,0,4,0,4,2020-08-07,Male,52,45-54,4
8,1,1,0,2,2020-08-10,Female,50,45-54,5
8,3,0,0,3,2020-08-07,Male,12,10-14,7
8,3,0,0,3,2020-08-07,Female,67,65-69,4
8,0,0,0,0,2020-08-08,Female,65,65-69,7
8,0,22,2,24,2020-08-07,Female,24,20-24,4
8,1,6,0,7,2020-08-10,Female,63,55-64,6
8,0,0,0,0,2020-08-11,Female,67,65-69,8
8,0,1,0,1,2020-08-07,Female,67,65-69,5
8,1,0,0,1,2020-08-07,Male,32,25-34,5
8,1,0,0,1,2020-08-07,Female,33,25-34,8
8,0,0,0,0,2020-08-10,Male,66,65-69,7
8,1,0,0,1,2020-08-10,Female,51,45-54,7
8,0,0,0,0,2020-08-07,Female,23,20-24,6
8,3,0,0,3,2020-08-09,Female,17,15-19,5
8,0,0,0,0,2020-08-07,Female,43,35-44,5
8,2,0,0,2,2020-08-08,Female,62,55-64,5
8,0,2,0,2,2020-08-09,Female,51,45-54,6
8,0,0,0,0,2020-08-10,Female,66,65-69,6
8,1,0,0,1,2020-08-08,Female,72,70-74,7
8,0,0,0,0,2020-08-07,Male,58,55-64,8
8,0,3,0,3,2020-08-10,Female,23,20-24,6
8,2,2,0,4,2020-08-10,Female,7,5-9,5
8,2,6,15,23,2020-08-08,Female,62,55-64,5
8,1,5,65,71,2020-08-07,Female,55,55-64,8
8,0,0,0,0,2020-08-07,Male,43,35-44,4
8,1,0,0,1,2020-08-07,Female,61,55-64,5
8,1,0,0,1,2020-08-07,Male,64,55-64,8
8,2,2,0,4,2020-08-07,Male,73,70-74,7
8,1,0,0,1,2020-08-07,Female,64,55-64,7
8,2,2,0,4,2020-08-07,Male,54,45-54,5
8,0,4,0,4,2020-08-07,Female,66,65-69,7
8,0,9,0,9,2020-08-09,Female,71,70-74,7
8,2,0,0,2,2020-08-07,Female,71,70-74,7
8,0,0,0,0,2020-08-07,Female,65,65-69,5
8,1,1,0,2,2020-08-07,Female,49,45-54,8
8,4,0,0,4,2020-08-10,Female,58,55-64,8
8,0,0,0,0,2020-08-07,Female,33,25-34,4
8,0,0,0,0,2020-08-10,Female,50,45-54,5
8,0,0,0,0,2020-08-07,Female,40,35-44,8
8,3,0,0,3,2020-08-07,Male,21,20-24,8
8,0,0,0,0,2020-08-07,Male,54,45-54,8
8,0,0,0,0,2020-08-07,Male,52,45-54,5
8,0,0,0,0,2020-08-07,Female,36,35-44,8
8,0,0,0,0,2020-08-07,Male,54,45-54,5
8,3,1,0,4,2020-08-07,Male,17,15-19,5
8,0,0,0,0,2020-08-11,Female,67,65-69,6
8,0,0,0,0,2020-08-07,Male,13,10-14,5
8,2,4,0,6,2020-08-07,Male,73,70-74,8
8,1,1,0,2,2020-08-08,Female,65,65-69,6
8,1,4,0,5,2020-08-11,Male,73,70-74,6
8,0,0,0,0,2020-08-07,Female,37,35-44,5
8,1,0,0,1,2020-08-08,Female,60,55-64,8
8,1,4,0,5,2020-08-10,Female,66,65-69,6
8,1,0,0,1,2020-08-10,Male,66,65-69,7
8,3,0,0,3,2020-08-10,Female,10,10-14,5
8,5,0,0,5,2020-08-09,Female,50,45-54,4
8,0,1,0,1,2020-08-11,Female,50,45-54,3
8,0,5,0,5,2020-08-07,Male,21,20-24,6
8,3,0,0,3,2020-08-07,Female,2,1-4,7
8,2,0,0,2,2020-08-11,Male,69,65-69,6
8,1,31,0,32,2020-08-07,Male,65,65-69,8
8,1,3,0,4,2020-08-10,Female,29,25-34,5
8,0,0,1,1,2020-08-10,Female,36,35-44,4
8,3,1,0,4,2020-08-07,Female,64,55-64,8
8,2,1,0,3,2020-08-11,Female,66,65-69,7
8,0,0,0,0,2020-08-08,Male,34,25-34,6
8,2,0,0,2,2020-08-09,Female,22,20-24,8
8,0,0,0,0,2020-08-10,Male,15,15-19,5
8,1,2,0,3,2020-08-07,Male,65,65-69,6
8,0,0,40,40,2020-08-08,Male,22,20-24,3
8,3,0,0,3,2020-08-07,Female,12,10-14,8
8,1,3,0,4,2020-08-07,Male,26,25-34,5
8,0,3,0,3,2020-08-09,Female,65,65-69,4
8,0,0,0,0,2020-08-09,Male,62,55-64,8
8,2,0,0,2,2020-08-07,Male,65,65-69,7
8,0,0,0,0,2020-08-09,Male,37,35-44,6
8,0,0,0,0,2020-08-10,Male,51,45-54,2
8,0,0,0,0,2020-08-10,Male,27,25-34,4
8,0,0,0,0,2020-08-07,Female,43,35-44,8
8,0,0,0,0,2020-08-10,Male,32,25-34,4
8,0,0,0,0,2020-08-07,Male,63,55-64,7
8,0,0,0,0,2020-08-07,Female,24,20-24,3
8,0,0,0,0,2020-08-10,Male,54,45-54,5
8,1,0,0,1,2020-08-07,Female,48,45-54,8
8,1,1,0,2,2020-08-09,Male,65,65-69,6
8,0,0,0,0,2020-08-08,Female,25,25-34,7
8,0,2,0,2,2020-08-08,Female,21,20-24,7
8,1,0,0,1,2020-08-07,Male,40,35-44,5
8,0,0,0,0,2020-08-08,Male,33,25-34,7
8,1,0,0,1,2020-08-07,Male,46,45-54,8
8,0,2,0,2,2020-08-07,Female,68,65-69,4
8,2,0,0,2,2020-08-10,Female,0,<1,5
8,2,0,0,2,2020-08-09,Male,7,5-9,8
8,1,0,0,1,2020-08-07,Female,24,20-24,4
8,0,0,0,0,2020-08-07,Male,55,55-64,7
8,2,1,0,3,2020-08-07,Female,47,45-54,8
8,3,1,0,4,2020-08-10,Female,18,15-19,4
8,1,0,0,1,2020-08-07,Male,64,55-64,7
8,0,0,0,0,2020-08-08,Female,19,15-19,5
8,5,1,0,6,2020-08-07,Male,30,25-34,5
8,1,0,0,1,2020-08-10,Male,45,45-54,4
8,2,1,0,3,2020-08-11,Female,32,25-34,7
8,1,0,0,1,2020-08-08,Male,57,55-64,8
8,2,0,0,2,2020-08-08,Male,63,55-64,8
8,1,3,0,4,2020-08-09,Female,62,55-64,7
8,1,1,0,2,2020-08-10,Female,63,55-64,7
8,3,2,2,7,2020-08-10,Female,43,35-44,5
8,2,2,0,4,2020-08-11,Female,68,65-69,8
8,3,10,0,13,2020-08-10,Male,49,45-54,7
8,1,3,0,4,2020-08-08,Female,67,65-69,6
8,1,0,0,1,2020-08-07,Male,6,5-9,3
8,0,0,0,0,2020-08-07,Male,15,15-19,8
8,0,1,0,1,2020-08-07,Female,65,65-69,4
8,0,3,0,3,2020-08-07,Male,13,10-14,4
8,0,0,0,0,2020-08-09,Male,32,25-34,5
8,3,1,0,4,2020-08-07,Male,8,5-9,3
8,0,0,0,0,2020-08-07,Male,41,35-44,7
8,1,0,0,1,2020-08-07,Female,64,55-64,5
8,1,2,0,3,2020-08-10,Male,67,65-69,8
8,3,0,0,3,2020-08-07,Male,13,10-14,5
8,1,2,0,3,2020-08-08,Female,58,55-64,8
8,0,0,0,0,2020-08-09,Female,25,25-34,5
8,2,0,0,2,2020-08-10,Female,32,25-34,5
8,5,0,0,5,2020-08-10,Female,14,10-14,7
8,1,3,9,13,2020-08-08,Female,25,25-34,5
8,1,0,0,1,2020-08-10,Female,34,25-34,5
8,2,0,0,2,2020-08-07,Male,10,10-14,7
8,0,0,0,0,2020-08-10,Male,25,25-34,5
8,0,0,0,0,2020-08-07,Male,17,15-19,5
8,2,0,0,2,2020-08-07,Male,51,45-54,5
8,0,3,0,3,2020-08-07,Male,39,35-44,5
8,0,0,0,0,2020-08-07,Female,34,25-34,6
8,1,0,0,1,2020-08-07,Male,45,45-54,5
8,1,2,0,3,2020-08-07,Female,65,65-69,6
8,3,37,0,40,2020-08-11,Female,10,10-14,4
8,0,0,0,0,2020-08-07,Female,27,25-34,5
8,0,0,0,0,2020-08-11,Female,68,65-69,7
8,0,1,0,1,2020-08-07,Female,19,15-19,4
8,1,0,0,1,2020-08-08,Female,30,25-34,5
8,5,3,0,8,2020-08-08,Male,12,10-14,7
8,2,3,0,5,2020-08-07,Female,54,45-54,5
8,2,0,0,2,2020-08-09,Male,47,45-54,8
8,0,0,0,0,2020-08-07,Female,52,45-54,8
8,1,0,0,1,2020-08-11,Female,68,65-69,7
8,5,0,0,5,2020-08-08,Female,20,20-24,5
8,0,1,0,1,2020-08-07,Male,48,45-54,5
8,1,0,0,1,2020-08-07,Male,63,55-64,5
8,1,0,0,1,2020-08-07,Male,35,35-44,5
8,2,0,0,2,2020-08-07,Female,53,45-54,5
8,2,21,16,39,2020-08-08,Female,47,45-54,7
8,2,1,0,3,2020-08-09,Female,18,15-19,7
8,1,0,0,1,2020-08-07,Female,51,45-54,5
8,1,0,0,1,2020-08-10,Female,31,25-34,7
8,0,1,0,1,2020-08-08,Male,47,45-54,5
8,2,1,1,4,2020-08-07,Male,56,55-64,3
8,2,1,0,3,2020-08-08,Female,66,65-69,5
8,0,0,0,0,2020-08-07,Male,50,45-54,8
8,0,2,0,2,2020-08-08,Male,21,20-24,2
8,0,1,0,1,2020-08-09,Male,23,20-24,4
8,2,1,2,5,2020-08-11,Female,68,65-69,4
8,0,0,0,0,2020-08-10,Male,31,25-34,7
8,0,1,0,1,2020-08-10,Male,66,65-69,5
8,0,0,0,0,2020-08-11,Male,74,70-74,7
8,1,1,0,2,2020-08-07,Male,30,25-34,6
8,2,0,0,2,2020-08-08,Male,65,65-69,7
8,0,0,0,0,2020-08-07,Male,42,35-44,7
8,2,0,0,2,2020-08-09,Female,79,75-79,7
8,0,0,0,0,2020-08-07,Female,69,65-69,8
8,0,0,0,0,2020-08-07,Female,36,35-44,6
8,0,4,0,4,2020-08-07,Male,61,55-64,7
8,4,5,6,15,2020-08-11,Female,13,10-14,7
8,0,15,0,15,2020-08-08,Male,66,65-69,3
8,1,0,0,1,2020-08-08,Female,29,25-34,7
8,3,0,0,3,2020-08-11,Female,8,5-9,6
8,3,0,0,3,2020-08-07,Male,13,10-14,4
8,0,0,0,0,2020-08-07,Male,34,25-34,8
8,4,0,0,4,2020-08-08,Male,17,15-19,5
9,2,0,0,2,2020-09-08,Female,33,25-34,5
9,2,0,0,2,2020-09-08,Female,66,65-69,9
9,0,2,0,2,2020-09-08,Female,71,70-74,5
9,1,0,0,1,2020-09-08,Female,72,70-74,9
9,0,0,0,0,2020-09-05,Male,29,25-34,6
9,0,0,0,0,2020-09-06,Female,53,45-54,6
9,0,0,0,0,2020-09-05,Female,67,65-69,6
9,2,1,0,3,2020-09-08,Male,34,25-34,9
9,2,2,0,4,2020-09-07,Female,35,35-44,6
9,0,0,0,0,2020-09-05,Male,42,35-44,3
9,0,0,0,0,2020-09-05,Male,32,25-34,8
9,0,0,0,0,2020-09-08,Male,66,65-69,6
9,1,0,0,1,2020-09-07,Male,62,55-64,9
9,2,0,0,2,2020-09-08,Male,11,10-14,6
9,0,0,0,0,2020-09-05,Male,48,45-54,6
9,2,2,0,4,2020-09-06,Male,58,55-64,5
9,2,0,0,2,2020-09-08,Female,70,70-74,8
9,5,0,0,5,2020-09-05,Male,20,20-24,5
9,1,0,0,1,2020-09-04,Female,52,45-54,6
9,0,0,0,0,2020-09-04,Male,41,35-44,9
9,1,1,0,2,2020-09-08,Female,56,55-64,9
9,0,0,0,0,2020-09-09,Male,85,85+,7
9,0,0,0,0,2020-09-04,Female,68,65-69,6
9,2,2,70,74,2020-09-05,Male,15,15-19,3
9,1,0,0,1,2020-09-08,Male,57,55-64,8
9,0,0,0,0,2020-09-09,Male,67,65-69,9
9,0,0,0,0,2020-09-04,Male,51,45-54,6
9,1,0,0,1,2020-09-05,Male,71,70-74,8
9,0,0,0,0,2020-09-08,Male,51,45-54,8
9,1,0,0,1,2020-09-04,Male,43,35-44,6
9,2,0,0,2,2020-09-04,Male,35,35-44,7
9,1,1,0,2,2020-09-07,Male,38,35-44,6
9,1,0,0,1,2020-09-08,Female,67,65-69,7
9,5,0,0,5,2020-09-05,Female,2,1-4,3
9,1,1,0,2,2020-09-07,Male,38,35-44,8
9,1,1,0,2,2020-09-04,Male,62,55-64,6
9,0,0,0,0,2020-09-09,Male,85,85+,4
9,2,2,2,6,2020-09-07,Male,54,45-54,9
9,0,0,0,0,2020-09-04,Male,31,25-34,3
9,1,2,0,3,2020-09-04,Male,70,70-74,6
9,2,0,0,2,2020-09-09,Female,70,70-74,5
9,2,2,0,4,2020-09-08,Male,66,65-69,4
9,2,0,0,2,2020-09-08,Male,68,65-69,8
9,2,1,0,3,2020-09-08,Male,68,65-69,6
9,0,0,0,0,2020-09-08,Male,34,25-34,6
9,1,2,0,3,2020-09-08,Male,67,65-69,7
9,2,0,0,2,2020-09-09,Male,69,65-69,3
9,0,0,0,0,2020-09-08,Male,42,35-44,6
9,3,0,0,3,2020-09-08,Female,5,5-9,6
9,0,0,0,0,2020-09-08,Male,33,25-34,5
9,1,9,0,10,2020-09-05,Male,69,65-69,9
9,0,0,0,0,2020-09-05,Female,3,1-4,7
9,4,0,0,4,2020-09-07,Female,16,15-19,6
9,5,4,0,9,2020-09-06,Male,18,15-19,7
9,0,0,0,0,2020-09-06,Male,48,45-54,8
9,1,2,0,3,2020-09-08,Male,22,20-24,3
9,2,0,0,2,2020-09-07,Female,27,25-34,6
9,1,3,0,4,2020-09-08,Female,63,55-64,8
9,0,1,0,1,2020-09-05,Female,30,25-34,6
9,1,1,0,2,2020-09-06,Female,30,25-34,8
9,0,0,0,0,2020-09-08,Female,62,55-64,8
9,0,0,0,0,2020-09-05,Male,17,15-19,5
9,0,0,0,0,2020-09-09,Male,68,65-69,4
9,0,3,0,3,2020-09-08,Male,54,45-54,6
9,0,0,0,0,2020-09-04,Male,33,25-34,6
9,2,0,0,2,2020-09-06,Male,29,25-34,3
9,0,1,0,1,2020-09-04,Female,32,25-34,9
9,0,0,0,0,2020-09-04,Male,7,5-9,4
9,2,2,0,4,2020-09-04,Female,33,25-34,6
9,0,0,0,0,2020-09-04,Male,37,35-44,8
9,1,3,0,4,2020-09-09,Female,62,55-64,6
9,0,0,0,0,2020-09-07,Male,63,55-64,8
9,0,0,0,0,2020-09-05,Male,29,25-34,4
9,0,0,0,0,2020-09-05,Female,25,25-34,5
9,3,4,0,7,2020-09-08,Female,68,65-69,7
9,0,1,0,1,2020-09-08,Male,69,65-69,5
9,3,0,0,3,2020-09-04,Male,32,25-34,6
9,2,0,0,2,2020-09-09,Male,35,35-44,8
9,3,2,0,5,2020-09-04,Female,13,10-14,6
9,0,1,0,1,2020-09-09,Female,79,75-79,6
9,1,3,0,4,2020-09-06,Male,56,55-64,8
9,3,0,0,3,2020-09-05,Male,42,35-44,3
9,2,9,0,11,2020-09-08,Female,56,55-64,6
9,1,0,0,1,2020-09-07,Female,23,20-24,4
9,0,0,0,0,2020-09-05,Male,57,55-64,9
9,1,2,2,5,2020-09-08,Male,70,70-74,6
9,2,1,0,3,2020-09-06,Male,33,25-34,9
9,1,0,0,1,2020-09-06,Female,52,45-54,9
9,0,0,0,0,2020-09-08,Male,28,25-34,6
9,3,0,0,3,2020-09-05,Male,9,5-9,5
9,3,0,0,3,2020-09-06,Male,65,65-69,6
9,0,2,0,2,2020-09-08,Female,58,55-64,6
9,0,1,0,1,2020-09-04,Male,70,70-74,9
9,2,2,0,4,2020-09-07,Male,22,20-24,6
9,1,0,0,1,2020-09-09,Male,74,70-74,8
9,1,0,0,1,2020-09-06,Female,3,1-4,2
9,1,0,0,1,2020-09-05,Female,31,25-34,6
9,3,0,0,3,2020-09-08,Female,21,20-24,5
9,1,6,0,7,2020-09-08,Male,33,25-34,4
9,2,1,0,3,2020-09-09,Male,68,65-69,2
9,1,0,0,1,2020-09-07,Female,49,45-54,6
9,1,0,0,1,2020-09-05,Female,29,25-34,6
9,0,0,0,0,2020-09-08,Male,10,10-14,5
9,2,5,0,7,2020-09-08,Male,16,15-19,6
9,0,2,0,2,2020-09-09,Male,64,55-64,4
9,1,1,0,2,2020-09-09,Male,68,65-69,7
9,1,3,0,4,2020-09-07,Male,52,45-54,9
9,1,0,0,1,2020-09-09,Female,57,55-64,8
9,0,0,0,0,2020-09-08,Male,50,45-54,8
9,2,2,0,4,2020-09-08,Female,59,55-64,5
9,0,0,0,0,2020-09-09,Male,71,70-74,8
9,0,1,0,1,2020-09-06,Male,40,35-44,4
9,2,0,0,2,2020-09-08,Female,69,65-69,9
9,3,0,0,3,2020-09-04,Male,19,15-19,6
9,2,1,0,3,2020-09-05,Female,7,5-9,5
9,1,0,0,1,2020-09-06,Female,59,55-64,9
9,2,0,0,2,2020-09-09,Male,73,70-74,6
9,2,3,0,5,2020-09-05,Female,52,45-54,8
9,1,0,0,1,2020-09-06,Male,34,25-34,8
9,3,1,0,4,2020-09-07,Male,4,1-4,6
9,2,0,0,2,2020-09-09,Male,67,65-69,8
9,1,2,0,3,2020-09-08,Male,70,70-74,5
9,0,5,0,5,2020-09-07,Male,33,25-34,2
9,2,0,0,2,2020-09-07,Female,18,15-19,4
9,1,0,0,1,2020-09-05,Female,56,55-64,8
9,0,0,0,0,2020-09-05,Female,58,55-64,6
9,0,0,0,0,2020-09-09,Female,66,65-69,8
9,1,1,0,2,2020-09-05,Female,60,55-64,9
9,1,0,0,1,2020-09-09,Female,53,45-54,9
9,0,0,0,0,2020-09-04,Male,33,25-34,6
9,0,0,0,0,2020-09-08,Female,65,65-69,9
9,2,0,0,2,2020-09-04,Male,27,25-34,7
9,1,3,0,4,2020-09-09,Male,73,70-74,7
9,1,1,0,2,2020-09-09,Male,79,75-79,4
9,0,0,0,0,2020-09-06,Male,38,35-44,6
9,2,0,0,2,2020-09-08,Female,55,55-64,9
9,1,0,0,1,2020-09-09,Male,69,65-69,8
9,2,1,0,3,2020-09-07,Male,18,15-19,5
9,0,4,0,4,2020-09-04,Male,36,35-44,9
9,1,2,0,3,2020-09-07,Male,40,35-44,9
9,2,0,0,2,2020-09-08,Female,61,55-64,6
9,0,1,0,1,2020-09-04,Male,22,20-24,7
9,2,3,0,5,2020-09-06,Female,23,20-24,5
9,0,0,9,9,2020-09-04,Male,6,5-9,6
9,2,0,0,2,2020-09-08,Male,72,70-74,4
9,0,0,0,0,2020-09-04,Male,36,35-44,4
9,0,2,0,2,2020-09-07,Male,19,15-19,5
9,0,0,0,0,2020-09-09,Male,76,75-79,3
9,0,0,0,0,2020-09-07,Male,46,45-54,3
9,1,2,0,3,2020-09-08,Male,52,45-54,6
9,0,2,0,2,2020-09-06,Female,70,70-74,5
9,2,2,0,4,2020-09-09,Female,68,65-69,4
9,0,10,0,10,2020-09-05,Male,32,25-34,5
9,3,1,0,4,2020-09-08,Male,69,65-69,5
9,3,0,2,5,2020-09-05,Male,19,15-19,6
9,2,0,0,2,2020-09-08,Male,64,55-64,6
9,0,0,0,0,2020-09-08,Female,60,55-64,5
9,0,0,0,0,2020-09-08,Male,15,15-19,3
9,1,0,0,1,2020-09-04,Female,65,65-69,6
9,1,0,0,1,2020-09-06,Male,66,65-69,9
9,2,2,0,4,2020-09-08,Female,67,65-69,8
9,1,1,0,2,2020-09-09,Male,75,75-79,9
9,0,2,0,2,2020-09-09,Male,65,65-69,4
9,2,1,0,3,2020-09-08,Male,70,70-74,3
9,3,2,0,5,2020-09-05,Female,19,15-19,5
9,0,1,0,1,2020-09-05,Male,52,45-54,5
9,0,0,0,0,2020-09-04,Male,17,15-19,6
9,5,0,0,5,2020-09-05,Male,27,25-34,5
9,0,0,0,0,2020-09-07,Male,33,25-34,8
9,3,0,0,3,2020-09-05,Female,4,1-4,4
9,0,0,0,0,2020-09-09,Male,81,80-84,8
9,1,0,0,1,2020-09-07,Male,48,45-54,8
9,0,0,0,0,2020-09-07,Male,24,20-24,6
9,2,0,0,2,2020-09-09,Male,71,70-74,7
9,0,0,0,0,2020-09-07,Male,35,35-44,8
9,0,0,0,0,2020-09-09,Female,34,25-34,6
9,0,2,0,2,2020-09-08,Female,23,20-24,9
9,3,0,0,3,2020-09-06,Male,23,20-24,7
9,6,0,0,6,2020-09-08,Female,4,1-4,5
9,2,0,0,2,2020-09-04,Male,41,35-44,9
9,0,0,1,1,2020-09-07,Female,29,25-34,3
9,0,1,0,1,2020-09-09,Female,85,85+,5
9,1,2,0,3,2020-09-09,Male,79,75-79,7
9,0,2,0,2,2020-09-07,Male,32,25-34,7
9,2,0,0,2,2020-09-09,Male,54,45-54,7
9,0,3,0,3,2020-09-09,Female,68,65-69,6
9,1,0,1,2,2020-09-07,Male,63,55-64,5
9,2,0,6,8,2020-09-09,Female,78,75-79,7
9,1,1,0,2,2020-09-08,Male,68,65-69,9
9,4,1,0,5,2020-09-08,Male,13,10-14,3
9,3,0,17,20,2020-09-05,Male,53,45-54,6
9,2,0,0,2,2020-09-08,Female,11,10-14,7
9,0,0,0,0,2020-09-06,Female,71,70-74,4
9,0,0,0,0,2020-09-05,Female,6,5-9,8
9,0,1,0,1,2020-09-04,Male,66,65-69,9
9,0,0,0,0,2020-09-08,Female,76,75-79,7
9,2,1,0,3,2020-09-08,Male,37,35-44,6
9,0,0,0,0,2020-09-06,Female,48,45-54,7
9,0,0,0,0,2020-09-09,Male,68,65-69,9
9,2,2,0,4,2020-09-06,Female,54,45-54,5
9,2,1,0,3,2020-09-05,Male,62,55-64,5
9,0,0,4,4,2020-09-07,Female,32,25-34,3
9,1,1,0,2,2020-09-08,Female,60,55-64,5
9,0,2,0,2,2020-09-09,Male,51,45-54,6
9,0,0,0,0,2020-09-08,Male,74,70-74,8
9,3,0,0,3,2020-09-08,Female,14,10-14,8
9,1,5,0,6,2020-09-04,Male,6,5-9,7
9,1,4,0,5,2020-09-08,Female,69,65-69,6
9,0,2,0,2,2020-09-08,Female,80,80-84,2
9,0,0,10,10,2020-09-08,Male,42,35-44,3
9,0,0,0,0,2020-09-07,Male,15,15-19,4
9,3,0,0,3,2020-09-05,Female,10,10-14,6
9,2,2,0,4,2020-09-08,Male,75,75-79,8
9,0,0,0,0,2020-09-06,Female,24,20-24,7
9,5,10,0,15,2020-09-08,Male,63,55-64,8
9,3,2,0,5,2020-09-07,Female,55,55-64,4
9,1,0,0,1,2020-09-08,Male,63,55-64,6
9,3,0,0,3,2020-09-08,Male,18,15-19,5
9,2,0,0,2,2020-09-07,Male,54,45-54,9
9,0,0,17,17,2020-09-04,Female,9,5-9,7
9,0,0,0,0,2020-09-08,Male,72,70-74,4
9,1,1,0,2,2020-09-09,Male,72,70-74,4
9,1,10,0,11,2020-09-08,Female,52,45-54,8
9,2,0,0,2,2020-09-05,Female,22,20-24,4
9,0,0,0,0,2020-09-05,Male,30,25-34,7
9,0,0,0,0,2020-09-04,Female,56,55-64,9
9,2,2,0,4,2020-09-05,Male,66,65-69,8
9,0,0,0,0,2020-09-05,Female,29,25-34,6
9,0,1,0,1,2020-09-07,Male,63,55-64,8
9,1,9,0,10,2020-09-08,Male,66,65-69,6
9,2,2,0,4,2020-09-09,Male,5,5-9,8
9,0,0,0,0,2020-09-06,Male,24,20-24,3
9,3,2,0,5,2020-09-05,Male,59,55-64,8
9,0,3,0,3,2020-09-08,Male,58,55-64,8
9,2,1,0,3,2020-09-08,Female,65,65-69,9
9,2,1,0,3,2020-09-07,Female,11,10-14,6
9,2,1,40,43,2020-09-07,Female,24,20-24,8
9,4,8,0,12,2020-09-04,Male,14,10-14,9
9,0,6,0,6,2020-09-05,Female,51,45-54,5
9,0,0,0,0,2020-09-09,Male,74,70-74,9
9,0,0,0,0,2020-09-08,Male,70,70-74,4
9,0,0,0,0,2020-09-04,Female,68,65-69,9
9,2,0,0,2,2020-09-08,Male,66,65-69,7
9,1,0,0,1,2020-09-05,Male,54,45-54,6
9,1,1,0,2,2020-09-09,Female,68,65-69,9
9,0,0,0,0,2020-09-07,Female,24,20-24,9
9,1,0,0,1,2020-09-07,Male,43,35-44,5
9,1,2,0,3,2020-09-06,Male,51,45-54,9
9,0,0,0,0,2020-09-04,Male,30,25-34,9
9,3,0,0,3,2020-09-05,Female,1,1-4,5
9,0,1,0,1,2020-09-06,Female,23,20-24,6
9,1,0,0,1,2020-09-04,Male,34,25-34,5
9,0,0,0,0,2020-09-07,Female,48,45-54,9
9,0,13,0,13,2020-09-04,Male,39,35-44,5
9,2,1,0,3,2020-09-07,Female,63,55-64,9
9,1,7,0,8,2020-09-07,Male,63,55-64,6
9,3,0,0,3,2020-09-05,Female,4,1-4,4
9,2,0,0,2,2020-09-04,Female,37,35-44,8
9,1,0,0,1,2020-09-08,Male,70,70-74,8
9,1,0,0,1,2020-09-07,Male,52,45-54,8
9,0,6,0,6,2020-09-08,Female,65,65-69,9
9,0,0,0,0,2020-09-09,Male,53,45-54,5
9,5,1,0,6,2020-09-07,Male,4,1-4,3
9,2,1,0,3,2020-09-08,Male,65,65-69,6
9,1,1,0,2,2020-09-08,Female,55,55-64,8
9,2,0,0,2,2020-09-08,Male,39,35-44,9
9,0,1,0,1,2020-09-07,Male,39,35-44,5
9,3,0,0,3,2020-09-09,Female,21,20-24,6
9,1,2,2,5,2020-09-08,Male,24,20-24,5
9,2,0,0,2,2020-09-06,Female,8,5-9,9
9,1,1,0,2,2020-09-05,Male,66,65-69,9
9,0,0,0,0,2020-09-08,Male,63,55-64,6
9,0,2,0,2,2020-09-04,Male,72,70-74,6
9,1,4,0,5,2020-09-06,Female,32,25-34,2
9,3,3,0,6,2020-09-08,Male,43,35-44,6
9,1,0,0,1,2020-09-09,Male,70,70-74,8
9,0,0,0,0,2020-09-04,Female,15,15-19,9
9,1,0,0,1,2020-09-06,Male,62,55-64,9
9,1,1,0,2,2020-09-08,Male,67,65-69,9
9,1,2,0,3,2020-09-09,Female,71,70-74,5
9,3,0,0,3,2020-09-08,Male,6,5-9,9
9,2,4,0,6,2020-09-07,Female,55,55-64,9
9,0,4,0,4,2020-09-07,Male,59,55-64,5
9,0,6,0,6,2020-09-05,Female,26,25-34,5
9,3,2,0,5,2020-09-07,Female,6,5-9,5
9,0,0,0,0,2020-09-07,Female,35,35-44,6
9,0,0,0,0,2020-09-04,Male,11,10-14,7
9,2,0,0,2,2020-09-05,Male,78,75-79,6
9,7,0,0,7,2020-09-04,Female,14,10-14,7
9,2,0,0,2,2020-09-04,Male,64,55-64,9
9,2,0,4,6,2020-09-07,Female,19,15-19,9
9,5,0,0,5,2020-09-09,Female,6,5-9,5
9,5,1,0,6,2020-09-07,Female,8,5-9,4
9,2,1,0,3,2020-09-07,Male,55,55-64,9
9,1,0,0,1,2020-09-05,Female,54,45-54,6
9,0,0,0,0,2020-09-08,Male,59,55-64,8
9,0,2,0,2,2020-09-08,Female,20,20-24,3
9,0,0,0,0,2020-09-05,Female,23,20-24,7
9,1,1,0,2,2020-09-08,Male,32,25-34,6
9,0,0,0,0,2020-09-07,Male,27,25-34,8
9,3,7,0,10,2020-09-08,Male,58,55-64,6
9,4,0,0,4,2020-09-09,Female,9,5-9,9
9,0,15,0,15,2020-09-04,Female,40,35-44,9
9,1,3,0,4,2020-09-08,Male,68,65-69,6
9,2,2,3,7,2020-09-07,Female,73,70-74,3
9,2,0,0,2,2020-09-07,Male,66,65-69,6
9,2,1,0,3,2020-09-08,Male,33,25-34,6
9,0,0,0,0,2020-09-08,Male,69,65-69,6
9,0,0,0,0,2020-09-05,Female,30,25-34,8
9,4,3,0,7,2020-09-05,Male,14,10-14,6
9,1,0,0,1,2020-09-08,Male,22,20-24,5
9,2,0,0,2,2020-09-05,Female,27,25-34,3
9,0,0,0,0,2020-09-09,Female,73,70-74,6
9,1,1,0,2,2020-09-05,Male,68,65-69,9
9,2,4,0,6,2020-09-08,Male,70,70-74,9
9,0,1,0,1,2020-09-08,Male,59,55-64,6
9,1,0,0,1,2020-09-07,Male,58,55-64,6
9,0,1,0,1,2020-09-07,Male,50,45-54,6
9,2,0,0,2,2020-09-04,Male,2,1-4,6
9,0,1,0,1,2020-09-04,Female,31,25-34,6
9,1,3,0,4,2020-09-04,Male,67,65-69,9
9,2,5,0,7,2020-09-09,Male,77,75-79,3
9,3,4,0,7,2020-09-06,Female,66,65-69,4
9,0,2,0,2,2020-09-05,Male,36,35-44,8
9,0,0,0,0,2020-09-05,Female,42,35-44,6
9,1,0,0,1,2020-09-06,Female,49,45-54,3
9,0,0,0,0,2020-09-08,Male,51,45-54,6
9,4,0,0,4,2020-09-05,Female,31,25-34,7
9,2,0,0,2,2020-09-05,Male,6,5-9,4
9,0,0,0,0,2020-09-07,Male,62,55-64,5
9,1,0,0,1,2020-09-05,Female,41,35-44,6
9,0,0,0,0,2020-09-08,Female,65,65-69,5
9,0,1,0,1,2020-09-08,Male,54,45-54,6
9,1,0,0,1,2020-09-08,Male,22,20-24,7
9,0,0,0,0,2020-09-04,Male,30,25-34,6
9,1,1,0,2,2020-09-06,Female,21,20-24,6
9,3,1,0,4,2020-09-09,Female,55,55-64,9
9,3,0,0,3,2020-09-05,Female,66,65-69,9
9,2,0,0,2,2020-09-08,Male,51,45-54,8
9,0,2,4,6,2020-09-04,Male,30,25-34,6
9,0,0,0,0,2020-09-08,Male,36,35-44,6
9,2,3,0,5,2020-09-05,Male,7,5-9,4
9,1,2,0,3,2020-09-09,Female,69,65-69,7
9,1,0,0,1,2020-09-08,Female,60,55-64,7
9,0,0,0,0,2020-09-07,Male,40,35-44,6
9,0,0,0,0,2020-09-05,Male,65,65-69,9
9,1,4,0,5,2020-09-05,Male,52,45-54,4
9,0,2,0,2,2020-09-08,Male,70,70-74,4
9,0,2,0,2,2020-09-07,Female,39,35-44,5
9,3,0,0,3,2020-09-04,Female,65,65-69,9
9,1,2,0,3,2020-09-08,Male,69,65-69,7
9,2,3,0,5,2020-09-09,Female,71,70-74,4
9,0,3,0,3,2020-09-08,Female,65,65-69,6
9,2,3,0,5,2020-09-08,Male,72,70-74,3
9,0,1,0,1,2020-09-04,Male,18,15-19,3
9,0,2,0,2,2020-09-08,Female,64,55-64,9
9,1,0,0,1,2020-09-04,Male,58,55-64,9
9,2,4,0,6,2020-09-09,Male,69,65-69,8
9,1,0,0,1,2020-09-05,Male,72,70-74,7
9,2,0,0,2,2020-09-09,Female,77,75-79,7
9,1,1,0,2,2020-09-08,Male,71,70-74,7
9,0,0,0,0,2020-09-05,Female,52,45-54,3
9,1,0,2,3,2020-09-08,Female,63,55-64,5
9,3,0,0,3,2020-09-09,Female,18,15-19,8
9,1,8,0,9,2020-09-06,Female,39,35-44,9
9,2,0,0,2,2020-09-09,Female,58,55-64,8
9,0,0,0,0,2020-09-04,Male,19,15-19,9
9,0,1,0,1,2020-09-09,Male,67,65-69,6
9,1,0,0,1,2020-09-08,Female,68,65-69,8
9,0,0,0,0,2020-09-04,Female,28,25-34,7
9,4,0,0,4,2020-09-05,Female,32,25-34,7
9,0,0,0,0,2020-09-07,Female,33,25-34,5
9,0,0,0,0,2020-09-06,Female,46,45-54,6
9,0,1,0,1,2020-09-08,Female,18,15-19,6
9,2,3,0,5,2020-09-07,Female,49,45-54,6
9,1,1,0,2,2020-09-06,Female,18,15-19,8
9,0,3,0,3,2020-09-06,Male,22,20-24,7
9,0,0,0,0,2020-09-05,Male,59,55-64,6
9,0,0,0,0,2020-09-05,Male,31,25-34,6
9,1,2,0,3,2020-09-08,Female,67,65-69,6
9,2,0,0,2,2020-09-06,Male,56,55-64,5
9,2,0,0,2,2020-09-09,Male,69,65-69,7
9,1,0,0,1,2020-09-08,Male,59,55-64,7
9,2,3,85,90,2020-09-07,Male,30,25-34,9
9,0,1,0,1,2020-09-05,Male,21,20-24,3
9,3,0,0,3,2020-09-07,Female,0,<1,8
9,1,7,4,12,2020-09-08,Male,4,1-4,4
9,0,0,0,0,2020-09-04,Male,36,35-44,7
9,2,0,0,2,2020-09-06,Female,23,20-24,4
9,2,0,0,2,2020-09-09,Female,67,65-69,7
9,0,0,0,0,2020-09-05,Female,24,20-24,6
9,0,1,0,1,2020-09-06,Female,55,55-64,5
9,0,0,0,0,2020-09-08,Male,70,70-74,7
9,1,0,0,1,2020-09-08,Male,67,65-69,6
9,2,0,0,2,2020-09-04,Female,60,55-64,8
9,1,0,0,1,2020-09-07,Male,40,35-44,5
9,1,1,0,2,2020-09-04,Female,30,25-34,8
9,0,0,0,0,2020-09-06,Male,33,25-34,9
9,1,0,0,1,2020-09-09,Male,68,65-69,4
9,0,0,0,0,2020-09-04,Female,66,65-69,7
9,2,1,0,3,2020-09-08,Female,14,10-14,6
9,0,0,0,0,2020-09-08,Female,67,65-69,6
9,0,1,0,1,2020-09-04,Female,69,65-69,6
9,2,0,0,2,2020-09-04,Male,45,45-54,9
9,0,0,0,0,2020-09-04,Female,55,55-64,9
9,1,0,0,1,2020-09-06,Female,29,25-34,4
9,0,1,0,1,2020-09-04,Male,29,25-34,6
9,1,7,0,8,2020-09-09,Male,67,65-69,6
9,1,1,0,2,2020-09-09,Male,28,25-34,4
9,2,2,0,4,2020-09-09,Male,67,65-69,3
9,0,0,0,0,2020-09-05,Female,20,20-24,2
9,1,1,0,2,2020-09-09,Male,31,25-34,7
9,3,2,5,10,2020-09-07,Male,10,10-14,6
9,3,0,0,3,2020-09-08,Male,10,10-14,5
9,0,0,0,0,2020-09-08,Male,65,65-69,5
9,1,0,0,1,2020-09-08,Female,30,25-34,8
9,2,1,0,3,2020-09-09,Male,80,80-84,4
9,0,0,0,0,2020-09-04,Female,20,20-24,5
9,0,10,4,14,2020-09-05,Female,47,45-54,5
9,1,4,0,5,2020-09-09,Male,71,70-74,5
9,0,0,0,0,2020-09-05,Female,57,55-64,4
9,0,0,0,0,2020-09-04,Female,21,20-24,6
9,1,1,0,2,2020-09-09,Male,27,25-34,6
9,1,0,0,1,2020-09-07,Male,65,65-69,7
9,0,0,0,0,2020-09-07,Male,57,55-64,4
9,0,0,0,0,2020-09-08,Male,66,65-69,8
9,1,0,0,1,2020-09-04,Male,63,55-64,9
9,0,18,0,18,2020-09-06,Female,69,65-69,5
9,2,1,0,3,2020-09-09,Female,68,65-69,5
9,2,0,0,2,2020-09-07,Female,30,25-34,4
9,1,0,0,1,2020-09-09,Male,72,70-74,7
9,2,0,0,2,2020-09-07,Female,46,45-54,5
9,0,0,0,0,2020-09-08,Female,63,55-64,7
9,0,0,0,0,2020-09-09,Female,35,35-44,9
9,5,3,0,8,2020-09-08,Male,8,5-9,6
9,2,0,0,2,2020-09-08,Male,70,70-74,4
9,6,1,0,7,2020-09-08,Female,12,10-14,6
9,3,1,0,4,2020-09-08,Female,65,65-69,9
9,0,0,0,0,2020-09-04,Female,31,25-34,6
9,0,1,0,1,2020-09-05,Male,20,20-24,6
9,2,0,0,2,2020-09-07,Male,54,45-54,4
9,0,0,0,0,2020-09-05,Female,42,35-44,6
9,1,0,7,8,2020-09-04,Female,22,20-24,5
9,1,1,0,2,2020-09-08,Male,53,45-54,6
9,5,9,5,19,2020-09-06,Female,28,25-34,5
9,0,4,0,4,2020-09-07,Male,39,35-44,6
9,3,2,0,5,2020-09-04,Female,12,10-14,8
9,1,3,0,4,2020-09-07,Male,43,35-44,7
9,0,0,0,0,2020-09-07,Female,50,45-54,5
9,1,0,0,1,2020-09-07,Male,40,35-44,5
9,0,0,0,0,2020-09-04,Female,63,55-64,9
9,0,0,0,0,2020-09-09,Male,19,15-19,9
9,2,11,40,53,2020-09-09,Female,61,55-64,7
9,0,1,0,1,2020-09-08,Female,61,55-64,9
9,2,1,0,3,2020-09-06,Male,44,35-44,8
9,2,1,0,3,2020-09-08,Male,19,15-19,6
9,1,3,0,4,2020-09-05,Male,70,70-74,5
9,0,3,0,3,2020-09-08,Female,67,65-69,5
9,2,0,0,2,2020-09-08,Male,69,65-69,5
9,0,2,35,37,2020-09-05,Male,22,20-24,6
9,0,2,0,2,2020-09-08,Female,70,70-74,7
9,0,0,1,1,2020-09-05,Male,6,5-9,6
9,2,4,0,6,2020-09-09,Male,67,65-69,6
9,1,0,0,1,2020-09-07,Male,66,65-69,6
9,0,0,0,0,2020-09-09,Male,69,65-69,5
9,0,0,0,0,2020-09-05,Female,33,25-34,4
9,0,2,0,2,2020-09-09,Male,74,70-74,8
9,0,0,0,0,2020-09-07,Female,33,25-34,9
9,0,0,0,0,2020-09-08,Male,52,45-54,9
9,0,0,0,0,2020-09-04,Male,67,65-69,9
9,0,0,1,1,2020-09-08,Female,52,45-54,5
9,0,0,45,45,2020-09-09,Male,30,25-34,5
9,2,2,0,4,2020-09-05,Male,78,75-79,4
9,1,1,0,2,2020-09-09,Male,68,65-69,5
9,0,0,0,0,2020-09-06,Male,7,5-9,3
9,0,3,0,3,2020-09-08,Male,24,20-24,6
9,3,0,0,3,2020-09-04,Male,15,15-19,6
9,1,0,0,1,2020-09-08,Female,14,10-14,5
9,4,5,1,10,2020-09-08,Male,14,10-14,6
9,2,4,0,6,2020-09-07,Female,61,55-64,6
9,3,5,0,8,2020-09-05,Male,41,35-44,5
9,0,0,0,0,2020-09-04,Female,22,20-24,6
9,2,5,0,7,2020-09-09,Male,78,75-79,4
9,2,0,0,2,2020-09-07,Male,52,45-54,6
9,1,0,0,1,2020-09-06,Female,33,25-34,4
9,1,0,0,1,2020-09-06,Male,51,45-54,5
9,3,2,0,5,2020-09-09,Female,42,35-44,8
9,3,0,0,3,2020-09-08,Female,70,70-74,7
9,1,0,0,1,2020-09-07,Female,24,20-24,8
9,0,1,0,1,2020-09-05,Male,31,25-34,6
9,0,0,0,0,2020-09-08,Female,68,65-69,9
9,2,1,0,3,2020-09-07,Male,10,10-14,6
9,0,0,0,0,2020-09-04,Male,32,25-34,6
9,4,0,0,4,2020-09-06,Female,10,10-14,7
9,3,0,0,3,2020-09-05,Female,1,1-4,7
9,1,1,0,2,2020-09-04,Male,38,35-44,3
9,1,0,0,1,2020-09-08,Female,58,55-64,8
9,3,2,0,5,2020-09-04,Female,23,20-24,3
9,0,0,0,0,2020-09-08,Female,41,35-44,9
9,4,0,0,4,2020-09-04,Female,17,15-19,4
9,1,0,0,1,2020-09-08,Female,52,45-54,9
9,0,1,0,1,2020-09-08,Male,39,35-44,6
9,0,7,0,7,2020-09-04,Female,43,35-44,7
9,0,0,0,0,2020-09-07,Male,17,15-19,6
9,0,1,0,1,2020-09-09,Male,77,75-79,8
9,1,0,0,1,2020-09-04,Male,43,35-44,4
9,1,0,0,1,2020-09-09,Male,66,65-69,9
9,1,1,0,2,2020-09-07,Male,34,25-34,5
9,2,0,0,2,2020-09-05,Female,66,65-69,9
9,2,0,0,2,2020-09-07,Female,10,10-14,7
9,1,8,0,9,2020-09-08,Female,65,65-69,9
9,0,0,0,0,2020-09-04,Male,30,25-34,6
9,2,0,0,2,2020-09-09,Male,72,70-74,3
9,0,0,0,0,2020-09-04,Female,53,45-54,6
9,1,1,0,2,2020-09-09,Female,67,65-69,7
9,1,4,0,5,2020-09-07,Male,48,45-54,3
9,2,2,0,4,2020-09-05,Male,13,10-14,3
9,1,0,0,1,2020-09-08,Male,35,35-44,9
9,2,1,0,3,2020-09-06,Male,64,55-64,6
9,2,0,0,2,2020-09-05,Male,60,55-64,6
9,0,0,0,0,2020-09-08,Male,41,35-44,7
9,4,0,9,13,2020-09-07,Male,3,1-4,3
9,0,0,0,0,2020-09-09,Male,34,25-34,4
9,2,0,0,2,2020-09-04,Female,14,10-14,9
9,0,0,0,0,2020-09-08,Female,58,55-64,7
9,2,2,0,4,2020-09-08,Female,52,45-54,7
9,1,6,0,7,2020-09-08,Female,34,25-34,5
9,0,0,0,0,2020-09-08,Female,59,55-64,7
9,0,0,0,0,2020-09-04,Male,14,10-14,9
9,2,0,0,2,2020-09-04,Male,15,15-19,6
9,1,0,0,1,2020-09-05,Male,65,65-69,6
9,2,0,0,2,2020-09-06,Female,13,10-14,7
9,3,0,0,3,2020-09-09,Female,12,10-14,6
9,0,0,0,0,2020-09-05,Female,24,20-24,6
9,0,1,0,1,2020-09-07,Female,7,5-9,6
9,0,0,0,0,2020-09-04,Male,39,35-44,6
9,0,0,0,0,2020-09-08,Female,15,15-19,6
9,0,0,0,0,2020-09-09,Female,67,65-69,6
9,0,0,0,0,2020-09-08,Male,52,45-54,9
9,1,0,0,1,2020-09-06,Female,41,35-44,6
9,0,0,0,0,2020-09-07,Female,30,25-34,6
9,1,0,0,1,2020-09-06,Male,57,55-64,7
9,2,13,0,15,2020-09-07,Male,67,65-69,8
9,3,0,0,3,2020-09-06,Female,7,5-9,6
9,1,0,0,1,2020-09-05,Female,62,55-64,9
9,2,0,0,2,2020-09-06,Male,10,10-14,6
9,0,0,0,0,2020-09-07,Female,28,25-34,5
9,0,0,0,0,2020-09-08,Female,69,65-69,6
9,2,0,0,2,2020-09-04,Male,73,70-74,5
9,3,1,0,4,2020-09-06,Male,24,20-24,5
9,0,2,0,2,2020-09-07,Male,44,35-44,6
9,0,0,0,0,2020-09-06,Female,29,25-34,6
9,2,0,0,2,2020-09-08,Male,15,15-19,8
9,0,0,0,0,2020-09-06,Male,30,25-34,5
9,1,1,0,2,2020-09-08,Female,68,65-69,8
9,1,8,0,9,2020-09-07,Male,54,45-54,9
9,2,0,0,2,2020-09-04,Female,61,55-64,9
9,1,0,0,1,2020-09-07,Male,52,45-54,8
9,0,0,0,0,2020-09-05,Female,66,65-69,9
9,0,0,0,0,2020-09-05,Male,65,65-69,6
9,1,9,0,10,2020-09-08,Female,59,55-64,8
9,1,0,0,1,2020-09-08,Male,65,65-69,9
9,2,0,0,2,2020-09-05,Male,32,25-34,5
9,0,1,0,1,2020-09-08,Female,10,10-14,5
9,1,1,0,2,2020-09-05,Male,32,25-34,5
9,1,6,0,7,2020-09-04,Female,65,65-69,5
9,2,0,0,2,2020-09-08,Female,52,45-54,6
9,2,0,0,2,2020-09-06,Female,47,45-54,6
9,1,10,0,11,2020-09-05,Male,58,55-64,3
9,1,6,5,12,2020-09-08,Male,59,55-64,9
9,0,0,0,0,2020-09-05,Female,44,35-44,9
9,2,0,0,2,2020-09-08,Female,67,65-69,8
9,0,1,0,1,2020-09-07,Female,64,55-64,6
9,2,4,0,6,2020-09-09,Male,19,15-19,6
9,1,2,0,3,2020-09-08,Male,58,55-64,9
9,1,0,0,1,2020-09-07,Male,66,65-69,5
9,3,0,0,3,2020-09-07,Male,12,10-14,6
9,4,0,0,4,2020-09-07,Male,1,1-4,5
9,0,1,0,1,2020-09-06,Male,35,35-44,5
9,0,0,2,2,2020-09-08,Male,56,55-64,5
9,2,33,0,35,2020-09-05,Female,25,25-34,9
9,1,0,0,1,2020-09-04,Male,29,25-34,9
9,0,0,0,0,2020-09-04,Male,34,25-34,6
9,2,1,0,3,2020-09-09,Male,33,25-34,3
9,2,2,0,4,2020-09-08,Female,14,10-14,6
9,0,1,0,1,2020-09-08,Female,69,65-69,7
9,1,0,0,1,2020-09-05,Male,66,65-69,5
9,0,0,0,0,2020-09-04,Male,35,35-44,6
9,2,1,0,3,2020-09-05,Female,6,5-9,7
9,0,0,0,0,2020-09-08,Female,66,65-69,9
9,0,0,0,0,2020-09-05,Female,50,45-54,5
9,0,0,0,0,2020-09-08,Male,42,35-44,6
9,3,0,17,20,2020-09-07,Female,1,1-4,6
9,1,1,0,2,2020-09-08,Female,61,55-64,4
9,1,3,0,4,2020-09-05,Male,67,65-69,8
9,4,1,0,5,2020-09-04,Male,7,5-9,9
9,2,2,0,4,2020-09-05,Female,4,1-4,5
9,3,0,0,3,2020-09-06,Female,29,25-34,5
9,2,0,0,2,2020-09-08,Male,51,45-54,5
9,1,4,0,5,2020-09-08,Female,61,55-64,6
9,1,4,0,5,2020-09-05,Male,65,65-69,9
9,1,1,0,2,2020-09-09,Female,39,35-44,5
9,0,0,0,0,2020-09-04,Female,9,5-9,6
9,1,10,0,11,2020-09-04,Male,53,45-54,5
9,2,1,0,3,2020-09-04,Male,32,25-34,6
9,0,0,0,0,2020-09-04,Female,49,45-54,5
9,4,1,0,5,2020-09-08,Female,41,35-44,5
9,1,2,0,3,2020-09-07,Male,54,45-54,4
9,0,0,0,0,2020-09-07,Male,40,35-44,8
9,0,0,0,0,2020-09-08,Male,59,55-64,6
9,0,1,0,1,2020-09-07,Male,41,35-44,9
9,0,0,0,0,2020-09-08,Male,66,65-69,9
9,0,0,0,0,2020-09-09,Female,60,55-64,4
9,0,0,0,0,2020-09-08,Female,34,25-34,7
9,4,1,0,5,2020-09-08,Male,3,1-4,7
9,0,0,0,0,2020-09-05,Male,55,55-64,6
9,0,0,0,0,2020-09-07,Male,47,45-54,6
9,0,0,0,0,2020-09-08,Female,34,25-34,6
9,1,1,0,2,2020-09-05,Male,61,55-64,9
9,0,4,0,4,2020-09-08,Female,67,65-69,9
9,3,4,0,7,2020-09-05,Male,12,10-14,9
9,2,0,6,8,2020-09-09,Male,77,75-79,7
9,1,2,0,3,2020-09-09,Male,66,65-69,5
9,0,0,0,0,2020-09-05,Male,27,25-34,6
9,0,0,0,0,2020-09-05,Male,32,25-34,5
9,0,0,0,0,2020-09-06,Female,67,65-69,7
9,0,0,0,0,2020-09-08,Male,51,45-54,6
9,0,0,0,0,2020-09-07,Male,66,65-69,5
9,3,0,0,3,2020-09-08,Male,17,15-19,6
9,2,1,0,3,2020-09-06,Female,11,10-14,4
9,2,0,0,2,2020-09-08,Male,10,10-14,8
9,2,3,0,5,2020-09-08,Female,62,55-64,5
9,0,0,0,0,2020-09-09,Male,43,35-44,9
9,2,0,0,2,2020-09-08,Female,64,55-64,9
9,0,0,1,1,2020-09-07,Female,53,45-54,8
9,1,0,0,1,2020-09-08,Female,50,45-54,6
9,1,0,0,1,2020-09-07,Female,21,20-24,3
9,2,1,0,3,2020-09-08,Male,56,55-64,7
9,0,1,0,1,2020-09-08,Female,62,55-64,5
9,2,0,0,2,2020-09-08,Male,65,65-69,9
9,1,0,0,1,2020-09-07,Female,54,45-54,4
9,6,3,0,9,2020-09-08,Female,9,5-9,4
9,2,1,0,3,2020-09-09,Male,70,70-74,3
9,2,0,0,2,2020-09-07,Male,33,25-34,8
9,2,2,0,4,2020-09-08,Male,73,70-74,5
9,2,2,0,4,2020-09-05,Male,66,65-69,5
9,2,0,0,2,2020-09-08,Male,33,25-34,4
9,0,0,0,0,2020-09-08,Male,62,55-64,6
9,0,0,0,0,2020-09-04,Male,24,20-24,5
9,2,2,0,4,2020-09-08,Female,65,65-69,6
9,3,3,0,6,2020-09-07,Female,34,25-34,6
9,1,0,0,1,2020-09-05,Male,56,55-64,6
9,0,0,0,0,2020-09-05,Female,67,65-69,9
9,1,1,0,2,2020-09-09,Female,72,70-74,3
9,0,0,0,0,2020-09-07,Male,31,25-34,6
9,0,0,0,0,2020-09-06,Male,71,70-74,4
9,0,0,0,0,2020-09-08,Female,48,45-54,4
9,2,0,0,2,2020-09-09,Female,70,70-74,6
9,0,1,0,1,2020-09-09,Female,71,70-74,7
9,0,0,0,0,2020-09-06,Male,66,65-69,9
9,2,0,0,2,2020-09-09,Male,80,80-84,4
9,1,0,0,1,2020-09-09,Female,53,45-54,9
9,1,0,0,1,2020-09-06,Female,28,25-34,8
9,0,0,0,0,2020-09-06,Female,12,10-14,6
9,2,0,0,2,2020-09-08,Female,2,1-4,9
9,1,0,0,1,2020-09-07,Male,34,25-34,8
9,0,0,0,0,2020-09-09,Female,71,70-74,7
9,1,0,0,1,2020-09-08,Male,50,45-54,3
9,3,3,0,6,2020-09-08,Male,41,35-44,6
9,1,0,0,1,2020-09-04,Female,53,45-54,9
9,1,0,0,1,2020-09-04,Male,32,25-34,7
9,0,0,0,0,2020-09-04,Female,42,35-44,6
9,1,1,0,2,2020-09-05,Male,58,55-64,5
9,2,2,0,4,2020-09-08,Male,57,55-64,6
9,3,2,0,5,2020-09-05,Male,1,1-4,6
9,3,2,0,5,2020-09-04,Female,36,35-44,8
9,1,0,0,1,2020-09-04,Male,66,65-69,8
9,0,0,0,0,2020-09-08,Female,57,55-64,8
9,0,0,0,0,2020-09-09,Male,75,75-79,4
9,0,0,0,0,2020-09-08,Male,52,45-54,8
9,0,1,0,1,2020-09-05,Male,25,25-34,5
9,2,0,0,2,2020-09-07,Male,65,65-69,6
9,3,0,0,3,2020-09-05,Female,18,15-19,6
9,0,4,0,4,2020-09-08,Female,45,45-54,5
9,0,6,0,6,2020-09-06,Female,66,65-69,8
9,2,0,0,2,2020-09-07,Female,46,45-54,6
9,0,1,0,1,2020-09-05,Male,31,25-34,6
9,1,3,0,4,2020-09-08,Male,70,70-74,5
9,0,0,0,0,2020-09-07,Male,53,45-54,6
9,0,1,0,1,2020-09-08,Female,62,55-64,7
9,1,2,0,3,2020-09-08,Female,70,70-74,9
9,2,1,9,12,2020-09-08,Male,32,25-34,4
9,0,0,0,0,2020-09-08,Male,27,25-34,8
9,1,2,0,3,2020-09-05,Male,28,25-34,9
9,0,1,0,1,2020-09-08,Male,70,70-74,8
9,0,6,0,6,2020-09-08,Male,65,65-69,8
9,0,1,0,1,2020-09-04,Female,68,65-69,9
9,0,2,0,2,2020-09-09,Female,65,65-69,6
9,0,0,0,0,2020-09-04,Male,60,55-64,6
9,0,0,0,0,2020-09-04,Male,9,5-9,6
9,1,3,0,4,2020-09-09,Male,68,65-69,9
9,1,11,0,12,2020-09-07,Male,68,65-69,8
9,0,13,0,13,2020-09-09,Male,17,15-19,3
9,1,0,0,1,2020-09-04,Female,62,55-64,6
9,0,0,0,0,2020-09-08,Female,56,55-64,9
9,3,1,0,4,2020-09-06,Female,53,45-54,8
9,1,4,0,5,2020-09-08,Male,66,65-69,5
9,3,0,0,3,2020-09-07,Male,7,5-9,4
9,0,0,0,0,2020-09-05,Female,59,55-64,9
9,3,0,0,3,2020-09-08,Female,3,1-4,5
9,2,1,0,3,2020-09-08,Female,59,55-64,7
9,1,3,0,4,2020-09-09,Female,30,25-34,6
9,2,0,0,2,2020-09-07,Female,56,55-64,6
9,1,2,0,3,2020-09-09,Female,60,55-64,9
9,0,1,0,1,2020-09-08,Male,69,65-69,9
9,3,1,0,4,2020-09-07,Male,69,65-69,4
9,3,2,0,5,2020-09-08,Male,71,70-74,5
9,2,0,0,2,2020-09-09,Male,77,75-79,5
9,1,2,0,3,2020-09-09,Male,69,65-69,7
9,0,2,0,2,2020-09-05,Female,18,15-19,6
9,0,0,0,0,2020-09-08,Male,51,45-54,9
9,1,0,0,1,2020-09-08,Female,65,65-69,9
9,0,0,0,0,2020-09-04,Female,37,35-44,7
9,0,2,0,2,2020-09-09,Male,67,65-69,5
9,0,0,0,0,2020-09-07,Female,55,55-64,6
9,0,1,0,1,2020-09-06,Male,64,55-64,6
9,0,0,0,0,2020-09-07,Male,36,35-44,5
9,3,1,0,4,2020-09-04,Female,4,1-4,6
9,2,0,0,2,2020-09-05,Male,63,55-64,5
9,2,7,0,9,2020-09-07,Female,73,70-74,3
9,1,18,0,19,2020-09-05,Female,18,15-19,6
9,0,6,0,6,2020-09-04,Male,61,55-64,6
9,1,0,0,1,2020-09-08,Male,53,45-54,6
9,3,1,0,4,2020-09-08,Male,28,25-34,6
9,2,3,0,5,2020-09-08,Female,65,65-69,7
9,1,10,0,11,2020-09-08,Male,61,55-64,6
9,3,0,0,3,2020-09-07,Male,15,15-19,9
9,0,2,0,2,2020-09-05,Male,52,45-54,5
9,3,0,0,3,2020-09-04,Male,13,10-14,8
9,0,0,0,0,2020-09-08,Female,66,65-69,8
9,0,0,0,0,2020-09-08,Male,37,35-44,8
9,0,1,0,1,2020-09-07,Female,67,65-69,6
9,0,0,0,0,2020-09-07,Male,33,25-34,6
9,1,0,0,1,2020-09-05,Female,33,25-34,9
9,0,0,9,9,2020-09-09,Male,66,65-69,8
9,1,0,0,1,2020-09-08,Female,51,45-54,8
9,0,0,0,0,2020-09-09,Female,23,20-24,7
9,1,3,0,4,2020-09-08,Female,25,25-34,2
9,1,0,0,1,2020-09-08,Male,66,65-69,4
9,2,0,0,2,2020-09-04,Female,62,55-64,6
9,0,3,0,3,2020-09-08,Female,51,45-54,7
9,0,0,0,0,2020-09-08,Male,58,55-64,9
9,0,2,0,2,2020-09-09,Female,23,20-24,7
9,2,0,0,2,2020-09-04,Male,43,35-44,5
9,2,3,10,15,2020-09-08,Female,62,55-64,6
9,1,1,0,2,2020-09-06,Female,52,45-54,6
9,3,2,0,5,2020-09-08,Female,61,55-64,3
9,1,3,0,4,2020-09-08,Female,61,55-64,6
9,1,1,20,22,2020-09-08,Male,64,55-64,9
9,2,0,0,2,2020-09-07,Male,54,45-54,6
9,0,0,0,0,2020-09-05,Female,31,25-34,4
9,1,0,0,1,2020-09-08,Female,49,45-54,9
9,0,0,0,0,2020-09-07,Female,33,25-34,5
9,0,0,0,0,2020-09-08,Female,40,35-44,9
9,6,0,0,6,2020-09-05,Male,21,20-24,9
9,0,0,0,0,2020-09-07,Male,55,55-64,9
9,0,28,0,28,2020-09-09,Female,36,35-44,9
9,0,0,0,0,2020-09-08,Male,54,45-54,6
9,3,1,0,4,2020-09-07,Male,19,15-19,6
9,2,0,0,2,2020-09-08,Male,70,70-74,2
9,2,2,0,4,2020-09-08,Female,56,55-64,5
9,0,1,0,1,2020-09-07,Male,14,10-14,6
9,0,3,0,3,2020-09-08,Female,70,70-74,8
9,2,3,0,5,2020-09-08,Male,73,70-74,9
9,3,1,0,4,2020-09-08,Male,10,10-14,7
9,1,3,0,4,2020-09-09,Male,73,70-74,7
9,0,0,0,0,2020-09-09,Female,37,35-44,6
9,3,0,0,3,2020-09-07,Female,14,10-14,6
9,3,3,0,6,2020-09-08,Female,14,10-14,2
9,5,0,0,5,2020-09-06,Female,51,45-54,5
9,0,3,0,3,2020-09-06,Male,21,20-24,7
9,1,0,0,1,2020-09-06,Female,29,25-34,6
9,0,1,0,1,2020-09-04,Male,31,25-34,5
9,4,0,0,4,2020-09-07,Female,10,10-14,4
9,3,1,0,4,2020-09-06,Female,64,55-64,9
9,2,2,0,4,2020-09-09,Female,66,65-69,8
9,1,4,0,5,2020-09-08,Female,75,75-79,8
9,0,0,0,0,2020-09-06,Male,32,25-34,8
9,3,0,0,3,2020-09-06,Male,34,25-34,7
9,0,0,0,0,2020-09-09,Male,35,35-44,4
9,0,0,0,0,2020-09-07,Male,19,15-19,6
9,1,1,0,2,2020-09-05,Male,65,65-69,7
9,3,2,0,5,2020-09-04,Female,14,10-14,9
9,0,0,0,0,2020-09-05,Male,62,55-64,9
9,0,0,0,0,2020-09-07,Female,43,35-44,9
9,1,6,0,7,2020-09-04,Female,30,25-34,4
9,2,2,0,4,2020-09-08,Male,74,70-74,2
9,0,0,0,0,2020-09-07,Female,25,25-34,8
9,0,0,0,0,2020-09-05,Female,21,20-24,8
9,1,0,0,1,2020-09-05,Male,40,35-44,6
9,0,0,0,0,2020-09-07,Male,34,25-34,8
9,1,0,0,1,2020-09-05,Male,46,45-54,9
9,0,0,0,0,2020-09-08,Female,68,65-69,5
9,1,0,0,1,2020-09-08,Male,67,65-69,8
9,2,0,0,2,2020-09-08,Male,8,5-9,9
9,0,0,0,0,2020-09-08,Male,55,55-64,8
9,2,2,0,4,2020-09-08,Male,70,70-74,4
9,1,0,0,1,2020-09-05,Female,28,25-34,2
9,2,2,0,4,2020-09-08,Female,60,55-64,7
9,5,0,0,5,2020-09-08,Female,33,25-34,5
9,0,0,0,0,2020-09-05,Male,45,45-54,4
9,2,0,0,2,2020-09-04,Male,64,55-64,8
9,0,0,0,0,2020-09-05,Female,19,15-19,6
9,2,1,0,3,2020-09-07,Female,47,45-54,7
9,5,0,0,5,2020-09-04,Male,39,35-44,6
9,0,0,0,0,2020-09-06,Female,34,25-34,5
9,2,1,0,3,2020-09-08,Female,32,25-34,8
9,1,0,5,6,2020-09-08,Male,57,55-64,9
9,2,0,0,2,2020-09-07,Male,63,55-64,9
9,1,1,0,2,2020-09-05,Female,62,55-64,8
9,0,0,0,0,2020-09-08,Female,43,35-44,6
9,2,0,0,2,2020-09-09,Female,68,65-69,9
9,0,0,0,0,2020-09-04,Male,50,45-54,8
9,1,4,0,5,2020-09-04,Female,67,65-69,7
9,0,0,0,0,2020-09-08,Male,15,15-19,9
9,2,1,0,3,2020-09-09,Male,59,55-64,8
9,2,0,0,2,2020-09-06,Female,38,35-44,6
9,1,0,0,1,2020-09-08,Male,33,25-34,6
9,0,0,0,0,2020-09-04,Male,41,35-44,8
9,1,0,0,1,2020-09-08,Female,65,65-69,6
9,1,2,0,3,2020-09-05,Male,68,65-69,9
9,3,0,0,3,2020-09-07,Male,11,10-14,6
9,1,0,0,1,2020-09-08,Female,58,55-64,9
9,0,0,0,0,2020-09-07,Female,25,25-34,6
9,2,0,0,2,2020-09-05,Female,32,25-34,6
9,0,0,0,0,2020-09-09,Female,11,10-14,8
9,1,0,0,1,2020-09-08,Female,38,35-44,6
9,0,1,0,1,2020-09-04,Female,19,15-19,4
9,2,0,0,2,2020-09-04,Male,51,45-54,6
9,0,2,0,2,2020-09-07,Male,39,35-44,6
9,0,0,0,0,2020-09-08,Female,34,25-34,7
9,0,0,0,0,2020-09-07,Male,19,15-19,4
9,1,1,0,2,2020-09-08,Female,52,45-54,5
9,3,2,0,5,2020-09-08,Female,12,10-14,5
9,0,1,0,1,2020-09-04,Female,27,25-34,6
9,0,3,0,3,2020-09-08,Female,67,65-69,7
9,0,1,0,1,2020-09-08,Female,69,65-69,8
9,4,4,0,8,2020-09-08,Male,9,5-9,4
9,2,2,0,4,2020-09-08,Female,54,45-54,6
9,2,0,0,2,2020-09-06,Male,47,45-54,9
9,0,0,0,0,2020-09-05,Female,52,45-54,9
9,2,2,48,52,2020-09-08,Female,51,45-54,3
9,1,0,0,1,2020-09-07,Female,47,45-54,8
9,5,1,0,6,2020-09-05,Female,16,15-19,8
9,1,0,0,1,2020-09-05,Female,51,45-54,6
9,0,0,0,0,2020-09-08,Male,50,45-54,9
9,0,2,0,2,2020-09-08,Male,23,20-24,5
9,0,0,0,0,2020-09-08,Male,74,70-74,8
9,2,4,8,14,2020-09-07,Female,10,10-14,4
9,0,2,0,2,2020-09-07,Male,30,25-34,7
9,0,1,0,1,2020-09-05,Male,42,35-44,8
9,1,2,0,3,2020-09-09,Female,69,65-69,7
9,0,2,0,2,2020-09-08,Female,69,65-69,9
9,1,2,0,3,2020-09-08,Male,70,70-74,8
9,0,0,0,0,2020-09-08,Male,61,55-64,8
9,1,0,0,1,2020-09-04,Female,7,5-9,7
9,3,0,0,3,2020-09-08,Male,14,10-14,5
9,2,0,0,2,2020-09-06,Male,19,15-19,6
10,1,12,0,13,2020-10-02,Male,68,65-69,5
10,2,1,0,3,2020-10-02,Female,66,65-69,10
10,0,1,0,1,2020-10-02,Female,71,70-74,6
10,0,0,0,0,2020-10-01,Female,50,45-54,6
10,1,0,0,1,2020-10-01,Female,72,70-74,10
10,0,0,0,0,2020-10-01,Male,30,25-34,7
10,2,2,0,4,2020-10-01,Male,34,25-34,10
10,1,0,0,1,2020-10-02,Female,59,55-64,6
10,0,2,0,2,2020-10-01,Female,35,35-44,7
10,3,0,0,3,2020-10-01,Female,57,55-64,8
10,0,0,0,0,2020-10-01,Male,42,35-44,4
10,0,0,0,0,2020-10-01,Male,32,25-34,9
10,1,2,0,3,2020-10-01,Male,62,55-64,10
10,0,0,0,0,2020-10-01,Male,48,45-54,7
10,1,0,0,1,2020-10-05,Male,34,25-34,6
10,0,2,0,2,2020-10-02,Male,53,45-54,5
10,0,0,0,0,2020-10-01,Female,70,70-74,9
10,1,0,0,1,2020-10-02,Male,68,65-69,9
10,1,2,0,3,2020-10-01,Female,52,45-54,7
10,2,2,0,4,2020-10-02,Female,69,65-69,7
10,0,0,0,0,2020-10-01,Male,41,35-44,10
10,1,1,0,2,2020-10-02,Male,58,55-64,6
10,1,1,0,2,2020-10-02,Female,56,55-64,10
10,2,0,0,2,2020-09-30,Female,21,20-24,8
10,0,0,0,0,2020-10-01,Male,85,85+,8
10,0,0,0,0,2020-10-01,Female,68,65-69,7
10,0,3,0,3,2020-10-02,Female,66,65-69,4
10,2,0,0,2,2020-10-02,Male,3,1-4,5
10,0,2,0,2,2020-10-01,Male,18,15-19,4
10,0,0,0,0,2020-10-02,Male,67,65-69,10
10,0,1,0,1,2020-10-01,Male,76,75-79,7
10,0,0,0,0,2020-10-02,Male,52,45-54,9
10,0,0,0,0,2020-10-02,Male,52,45-54,4
10,1,0,0,1,2020-10-02,Female,60,55-64,8
10,1,4,0,5,2020-10-01,Male,38,35-44,7
10,2,1,0,3,2020-10-01,Male,69,65-69,7
10,0,0,0,0,2020-10-01,Female,77,75-79,7
10,1,2,0,3,2020-10-01,Male,38,35-44,9
10,1,0,0,1,2020-10-01,Male,62,55-64,7
10,2,0,0,2,2020-10-01,Female,11,10-14,6
10,0,3,0,3,2020-10-01,Male,85,85+,5
10,2,2,0,4,2020-10-01,Female,71,70-74,6
10,2,3,0,5,2020-10-01,Male,70,70-74,7
10,0,0,0,0,2020-10-02,Female,71,70-74,6
10,1,2,0,3,2020-10-02,Female,65,65-69,9
10,3,2,0,5,2020-10-01,Male,11,10-14,4
10,2,0,0,2,2020-10-02,Male,67,65-69,9
10,0,0,0,0,2020-10-02,Female,22,20-24,5
10,1,0,0,1,2020-10-02,Male,16,15-19,2
10,0,0,0,0,2020-10-01,Male,33,25-34,6
10,1,9,0,10,2020-10-02,Male,69,65-69,10
10,2,0,0,2,2020-10-02,Female,60,55-64,8
10,4,2,0,6,2020-10-02,Male,16,15-19,8
10,0,3,0,3,2020-10-02,Female,52,45-54,8
10,0,0,0,0,2020-10-02,Male,48,45-54,9
10,0,1,0,1,2020-10-02,Male,69,65-69,5
10,0,3,0,3,2020-10-01,Female,63,55-64,9
10,0,1,0,1,2020-10-01,Female,30,25-34,9
10,1,2,0,3,2020-10-02,Female,67,65-69,6
10,0,0,0,0,2020-10-01,Female,70,70-74,7
10,0,0,0,0,2020-10-02,Male,68,65-69,5
10,0,2,0,2,2020-10-02,Male,54,45-54,7
10,2,0,0,2,2020-10-02,Female,66,65-69,7
10,0,0,0,0,2020-10-02,Male,29,25-34,4
10,1,0,0,1,2020-10-02,Female,73,70-74,7
10,0,0,0,0,2020-10-01,Male,32,25-34,10
10,0,0,0,0,2020-10-02,Male,65,65-69,5
10,0,1,0,1,2020-10-01,Female,33,25-34,7
10,0,0,0,0,2020-10-01,Male,37,35-44,9
10,1,1,0,2,2020-10-01,Female,62,55-64,7
10,0,0,0,0,2020-10-02,Male,29,25-34,5
10,0,1,0,1,2020-10-02,Male,69,65-69,5
10,1,0,0,1,2020-10-02,Female,67,65-69,8
10,2,0,0,2,2020-10-01,Male,58,55-64,9
10,0,0,0,0,2020-10-02,Female,62,55-64,6
10,0,1,0,1,2020-10-01,Male,69,65-69,6
10,3,0,3,6,2020-10-01,Male,32,25-34,7
10,2,0,0,2,2020-10-01,Male,35,35-44,9
10,2,0,0,2,2020-10-01,Male,70,70-74,4
10,0,0,0,0,2020-09-30,Male,18,15-19,6
10,3,0,0,3,2020-10-01,Female,10,10-14,7
10,1,0,0,1,2020-10-02,Male,65,65-69,8
10,1,0,0,1,2020-10-02,Female,79,75-79,7
10,1,0,0,1,2020-10-01,Female,28,25-34,7
10,0,0,0,0,2020-10-01,Male,23,20-24,4
10,2,0,0,2,2020-10-02,Female,56,55-64,7
10,1,0,0,1,2020-10-02,Female,23,20-24,5
10,1,2,2,5,2020-10-01,Male,70,70-74,7
10,2,3,0,5,2020-10-01,Male,29,25-34,10
10,0,1,0,1,2020-10-02,Female,58,55-64,7
10,0,4,0,4,2020-10-02,Female,66,65-69,9
10,0,0,0,0,2020-10-02,Male,70,70-74,10
10,0,0,0,0,2020-10-02,Female,71,70-74,6
10,0,0,0,0,2020-10-02,Male,50,45-54,4
10,0,0,0,0,2020-10-02,Male,53,45-54,6
10,0,0,0,0,2020-10-02,Male,14,10-14,6
10,0,0,0,0,2020-10-01,Male,71,70-74,9
10,0,1,0,1,2020-10-01,Male,48,45-54,5
10,2,0,0,2,2020-10-02,Female,69,65-69,10
10,2,3,0,5,2020-10-02,Female,72,70-74,4
10,1,0,0,1,2020-10-02,Female,59,55-64,10
10,0,0,0,0,2020-10-01,Male,43,35-44,9
10,0,0,0,0,2020-10-01,Male,27,25-34,6
10,2,0,0,2,2020-10-01,Male,31,25-34,7
10,0,6,0,6,2020-10-02,Female,23,20-24,5
10,2,0,0,2,2020-10-01,Male,73,70-74,7
10,1,2,0,3,2020-10-05,Male,66,65-69,3
10,2,6,0,8,2020-10-01,Female,52,45-54,9
10,1,0,0,1,2020-10-01,Male,34,25-34,9
10,0,0,0,0,2020-10-02,Male,48,45-54,5
10,0,0,0,0,2020-10-02,Male,65,65-69,9
10,2,4,0,6,2020-10-02,Male,67,65-69,9
10,1,5,0,6,2020-10-01,Male,70,70-74,6
10,0,0,0,0,2020-10-02,Male,43,35-44,3
10,0,0,0,0,2020-10-02,Female,66,65-69,9
10,0,0,0,0,2020-10-01,Female,40,35-44,9
10,0,2,0,2,2020-10-02,Female,63,55-64,5
10,1,1,0,2,2020-10-02,Female,61,55-64,10
10,2,0,0,2,2020-10-01,Male,49,45-54,6
10,1,2,0,3,2020-10-02,Female,53,45-54,10
10,0,0,0,0,2020-10-01,Male,34,25-34,7
10,0,0,0,0,2020-10-02,Male,55,55-64,6
10,0,0,0,0,2020-10-02,Female,65,65-69,10
10,2,0,0,2,2020-10-01,Male,11,10-14,8
10,1,2,0,3,2020-10-02,Male,73,70-74,8
10,1,0,0,1,2020-10-01,Male,79,75-79,5
10,0,0,0,0,2020-10-02,Female,66,65-69,5
10,1,0,25,26,2020-10-01,Male,48,45-54,5
10,0,2,0,2,2020-10-01,Male,36,35-44,10
10,1,0,0,1,2020-10-01,Male,39,35-44,10
10,2,0,0,2,2020-10-01,Female,61,55-64,7
10,0,1,0,1,2020-10-01,Male,32,25-34,8
10,2,1,10,13,2020-10-02,Male,62,55-64,9
10,0,0,0,0,2020-10-02,Male,68,65-69,9
10,0,0,0,0,2020-10-02,Male,76,75-79,4
10,0,2,2,4,2020-10-02,Male,46,45-54,4
10,1,3,0,4,2020-10-02,Male,52,45-54,7
10,1,0,0,1,2020-10-01,Male,32,25-34,6
10,5,10,0,15,2020-10-02,Female,69,65-69,8
10,3,0,0,3,2020-10-01,Male,18,15-19,7
10,1,0,0,1,2020-10-01,Female,66,65-69,5
10,1,3,0,4,2020-10-02,Male,75,75-79,6
10,1,0,0,1,2020-10-02,Male,53,45-54,5
10,0,0,0,0,2020-10-02,Male,65,65-69,9
10,0,0,0,0,2020-10-02,Female,67,65-69,9
10,1,0,0,1,2020-10-01,Female,44,35-44,4
10,3,0,0,3,2020-10-01,Female,16,15-19,6
10,0,0,0,0,2020-10-01,Female,47,45-54,4
10,0,1,0,1,2020-10-01,Male,52,45-54,6
10,0,0,3,3,2020-10-01,Male,15,15-19,7
10,0,0,0,0,2020-10-02,Female,51,45-54,8
10,5,0,0,5,2020-10-01,Male,11,10-14,7
10,0,0,0,0,2020-10-02,Male,10,10-14,9
10,1,1,0,2,2020-10-01,Male,81,80-84,9
10,2,0,9,11,2020-10-02,Male,59,55-64,6
10,0,0,0,0,2020-09-30,Male,24,20-24,7
10,2,0,0,2,2020-10-02,Male,71,70-74,8
10,0,0,0,0,2020-10-02,Male,35,35-44,9
10,0,0,0,0,2020-09-30,Female,21,20-24,6
10,0,0,0,0,2020-10-01,Female,66,65-69,6
10,3,0,0,3,2020-09-30,Male,23,20-24,8
10,0,0,0,0,2020-10-02,Female,4,1-4,6
10,0,0,0,0,2020-10-02,Male,67,65-69,8
10,2,0,0,2,2020-10-01,Male,41,35-44,10
10,1,2,0,3,2020-10-02,Male,65,65-69,8
10,0,1,0,1,2020-10-01,Female,85,85+,6
10,1,0,0,1,2020-10-01,Male,79,75-79,8
10,0,2,0,2,2020-10-01,Male,32,25-34,8
10,0,0,0,0,2020-10-01,Male,54,45-54,8
10,0,1,0,1,2020-10-02,Female,67,65-69,8
10,0,1,0,1,2020-10-02,Female,68,65-69,8
10,1,0,0,1,2020-10-02,Male,31,25-34,2
10,0,0,0,0,2020-10-01,Female,78,75-79,8
10,0,2,0,2,2020-10-01,Female,33,25-34,5
10,0,1,0,1,2020-10-02,Male,29,25-34,9
10,0,17,0,17,2020-10-01,Female,71,70-74,5
10,0,0,0,0,2020-10-01,Male,9,5-9,9
10,3,3,0,6,2020-10-02,Female,52,45-54,5
10,0,1,0,1,2020-10-02,Male,54,45-54,8
10,0,3,0,3,2020-10-02,Male,66,65-69,10
10,0,0,0,0,2020-10-01,Female,1,1-4,7
10,0,1,0,1,2020-10-01,Female,76,75-79,8
10,1,2,0,3,2020-10-01,Female,48,45-54,8
10,2,2,0,4,2020-10-01,Female,54,45-54,6
10,1,2,0,3,2020-10-02,Male,62,55-64,6
10,1,2,0,3,2020-10-02,Female,60,55-64,6
10,0,0,0,0,2020-10-01,Female,49,45-54,7
10,0,0,0,0,2020-10-01,Male,74,70-74,9
10,3,3,0,6,2020-10-01,Female,16,15-19,9
10,1,4,0,5,2020-10-01,Male,25,25-34,8
10,0,0,0,0,2020-10-02,Female,69,65-69,7
10,0,0,0,0,2020-10-02,Female,65,65-69,6
10,2,1,0,3,2020-10-02,Male,75,75-79,9
10,1,4,0,5,2020-10-01,Male,73,70-74,7
10,2,1,1,4,2020-10-01,Male,52,45-54,5
10,0,0,2,2,2020-09-30,Female,24,20-24,8
10,1,0,0,1,2020-10-02,Male,63,55-64,7
10,3,1,0,4,2020-10-02,Male,15,15-19,6
10,0,0,0,0,2020-10-01,Female,6,5-9,8
10,2,0,3,5,2020-10-01,Male,72,70-74,5
10,5,0,0,5,2020-10-01,Male,11,10-14,2
10,0,1,0,1,2020-10-01,Female,71,70-74,8
10,4,0,0,4,2020-10-02,Male,11,10-14,5
10,0,0,0,0,2020-10-02,Male,30,25-34,8
10,0,0,0,0,2020-10-02,Male,67,65-69,6
10,0,0,0,0,2020-10-01,Female,85,85+,6
10,2,0,0,2,2020-10-02,Male,66,65-69,9
10,0,1,0,1,2020-10-01,Male,45,45-54,7
10,1,1,0,2,2020-09-30,Female,24,20-24,4
10,2,3,5,10,2020-10-01,Female,47,45-54,4
10,1,9,0,10,2020-10-01,Male,66,65-69,7
10,2,2,0,4,2020-10-02,Male,5,5-9,9
10,0,2,0,2,2020-10-02,Male,65,65-69,6
10,0,1,0,1,2020-10-01,Male,58,55-64,9
10,2,0,0,2,2020-10-02,Female,65,65-69,10
10,4,6,20,30,2020-10-02,Male,14,10-14,10
10,0,1,0,1,2020-10-01,Male,74,70-74,10
10,0,1,0,1,2020-10-02,Female,66,65-69,5
10,0,0,0,0,2020-10-02,Male,70,70-74,5
10,1,0,0,1,2020-10-02,Male,54,45-54,8
10,2,0,3,5,2020-10-02,Male,68,65-69,5
10,0,4,0,4,2020-10-01,Male,77,75-79,6
10,0,2,0,2,2020-10-01,Male,85,85+,6
10,0,0,0,0,2020-10-01,Male,26,25-34,4
10,1,0,0,1,2020-10-02,Male,59,55-64,9
10,1,1,0,2,2020-10-02,Female,68,65-69,10
10,0,0,0,0,2020-10-01,Female,24,20-24,10
10,0,0,0,0,2020-10-01,Male,43,35-44,6
10,1,0,0,1,2020-10-02,Male,51,45-54,10
10,3,0,0,3,2020-10-01,Female,3,1-4,6
10,0,0,0,0,2020-09-30,Female,23,20-24,7
10,1,0,0,1,2020-10-01,Male,34,25-34,6
10,0,1,0,1,2020-10-01,Female,48,45-54,10
10,0,3,0,3,2020-10-02,Male,70,70-74,7
10,1,3,0,4,2020-10-02,Male,63,55-64,7
10,2,6,0,8,2020-10-02,Female,61,55-64,8
10,2,3,0,5,2020-10-02,Female,57,55-64,4
10,0,2,0,2,2020-10-01,Female,66,65-69,10
10,0,1,0,1,2020-10-02,Female,66,65-69,8
10,0,0,0,0,2020-10-02,Male,54,45-54,6
10,0,2,0,2,2020-10-02,Male,54,45-54,7
10,1,0,0,1,2020-10-01,Male,65,65-69,7
10,0,1,0,1,2020-10-01,Male,38,35-44,7
10,0,1,0,1,2020-10-01,Male,39,35-44,6
10,3,0,0,3,2020-10-01,Female,21,20-24,7
10,2,0,0,2,2020-10-02,Male,63,55-64,7
10,0,2,0,2,2020-10-01,Male,73,70-74,7
10,3,2,0,5,2020-10-01,Male,43,35-44,7
10,1,0,0,1,2020-10-01,Male,62,55-64,10
10,1,4,0,5,2020-10-01,Male,67,65-69,10
10,0,1,0,1,2020-10-02,Male,57,55-64,9
10,1,0,0,1,2020-10-01,Female,71,70-74,6
10,1,0,0,1,2020-10-02,Male,5,5-9,10
10,0,0,0,0,2020-10-02,Male,53,45-54,5
10,0,0,0,0,2020-09-30,Female,22,20-24,6
10,0,0,0,0,2020-10-01,Female,35,35-44,7
10,0,4,0,4,2020-10-01,Male,26,25-34,4
10,0,0,0,0,2020-10-02,Male,65,65-69,5
10,2,3,6,11,2020-10-01,Male,30,25-34,4
10,2,1,0,3,2020-10-02,Female,73,70-74,3
10,0,0,0,0,2020-10-01,Male,41,35-44,8
10,1,0,0,1,2020-10-01,Female,65,65-69,7
10,1,1,0,2,2020-10-02,Male,64,55-64,10
10,2,0,0,2,2020-10-01,Female,16,15-19,10
10,0,0,0,0,2020-10-01,Female,73,70-74,4
10,5,0,0,5,2020-10-01,Female,7,5-9,6
10,1,0,30,31,2020-10-01,Male,53,45-54,7
10,2,2,0,4,2020-10-02,Male,55,55-64,10
10,1,0,0,1,2020-10-02,Female,54,45-54,7
10,0,0,0,0,2020-10-01,Male,59,55-64,9
10,0,0,0,0,2020-09-30,Female,23,20-24,8
10,1,1,0,2,2020-10-01,Male,32,25-34,7
10,1,0,0,1,2020-10-01,Male,27,25-34,9
10,0,0,0,0,2020-10-01,Female,8,5-9,10
10,0,0,0,0,2020-10-01,Female,41,35-44,10
10,1,3,0,4,2020-10-02,Male,68,65-69,7
10,0,0,0,0,2020-10-01,Male,13,10-14,6
10,2,1,4,7,2020-10-01,Male,66,65-69,7
10,0,0,0,0,2020-10-01,Male,69,65-69,7
10,0,0,0,0,2020-10-01,Female,30,25-34,9
10,3,1,0,4,2020-10-01,Female,18,15-19,7
10,1,0,0,1,2020-10-01,Male,23,20-24,6
10,1,0,0,1,2020-10-01,Female,52,45-54,5
10,0,0,0,0,2020-10-01,Male,78,75-79,3
10,2,0,3,5,2020-10-01,Male,66,65-69,5
10,0,3,0,3,2020-10-02,Female,53,45-54,6
10,0,0,0,0,2020-10-02,Male,50,45-54,7
10,2,10,0,12,2020-10-02,Male,18,15-19,5
10,3,0,0,3,2020-10-01,Male,3,1-4,7
10,0,4,0,4,2020-10-02,Male,61,55-64,7
10,1,2,0,3,2020-10-02,Male,67,65-69,10
10,1,0,0,1,2020-10-01,Male,35,35-44,7
10,2,0,0,2,2020-10-01,Male,75,75-79,4
10,0,0,0,0,2020-10-02,Female,69,65-69,3
10,0,2,0,2,2020-10-01,Male,37,35-44,9
10,0,0,1,1,2020-10-02,Male,51,45-54,7
10,1,1,0,2,2020-10-01,Female,46,45-54,8
10,0,2,0,2,2020-10-02,Male,54,45-54,7
10,1,0,0,1,2020-09-30,Female,21,20-24,7
10,3,4,0,7,2020-10-01,Female,49,45-54,4
10,1,2,0,3,2020-10-02,Male,69,65-69,5
10,0,11,4,15,2020-10-01,Male,30,25-34,7
10,0,1,0,1,2020-10-01,Female,26,25-34,7
10,0,1,0,1,2020-10-02,Male,65,65-69,10
10,0,0,0,0,2020-10-02,Female,65,65-69,10
10,1,1,0,2,2020-10-02,Male,69,65-69,8
10,0,3,0,3,2020-10-01,Male,46,45-54,6
10,1,0,0,1,2020-10-01,Male,79,75-79,6
10,0,0,1,1,2020-10-01,Female,64,55-64,10
10,1,0,0,1,2020-10-01,Male,58,55-64,10
10,2,0,0,2,2020-10-02,Male,69,65-69,9
10,0,4,0,4,2020-10-02,Male,51,45-54,9
10,2,1,0,3,2020-10-01,Male,71,70-74,8
10,0,6,0,6,2020-10-02,Female,52,45-54,4
10,2,0,0,2,2020-10-02,Female,19,15-19,9
10,3,1,0,4,2020-10-02,Male,21,20-24,2
10,1,0,0,1,2020-10-02,Female,58,55-64,9
10,2,0,1,3,2020-10-01,Male,77,75-79,3
10,3,0,0,3,2020-10-01,Male,17,15-19,10
10,1,1,0,2,2020-10-02,Female,66,65-69,5
10,1,0,0,1,2020-10-02,Female,68,65-69,9
10,0,3,0,3,2020-10-01,Male,23,20-24,6
10,3,3,10,16,2020-10-01,Female,15,15-19,5
10,0,0,0,0,2020-10-01,Female,28,25-34,8
10,4,0,0,4,2020-10-02,Female,32,25-34,8
10,1,0,0,1,2020-10-02,Female,63,55-64,6
10,0,0,0,0,2020-10-01,Female,33,25-34,6
10,1,0,0,1,2020-10-02,Female,46,45-54,7
10,0,1,0,1,2020-10-01,Male,32,25-34,6
10,0,0,0,0,2020-10-02,Female,68,65-69,9
10,4,1,5,10,2020-10-01,Female,19,15-19,9
10,0,10,0,10,2020-10-02,Male,29,25-34,7
10,2,0,0,2,2020-09-30,Male,25,25-34,7
10,1,1,0,2,2020-10-01,Female,67,65-69,7
10,2,1,0,3,2020-10-01,Male,56,55-64,6
10,2,1,0,3,2020-10-02,Male,70,70-74,5
10,2,0,0,2,2020-10-02,Male,69,65-69,8
10,1,0,0,1,2020-10-02,Male,44,35-44,9
10,1,0,0,1,2020-10-02,Female,63,55-64,4
10,0,0,0,0,2020-10-01,Male,36,35-44,8
10,2,0,0,2,2020-10-02,Female,67,65-69,8
10,1,0,0,1,2020-10-02,Male,50,45-54,7
10,2,10,0,12,2020-10-01,Male,51,45-54,9
10,1,0,0,1,2020-10-01,Male,40,35-44,6
10,1,4,0,5,2020-10-01,Female,30,25-34,9
10,0,0,0,0,2020-10-01,Female,66,65-69,8
10,2,1,0,3,2020-10-02,Female,10,10-14,7
10,2,0,0,2,2020-10-01,Male,45,45-54,10
10,3,3,0,6,2020-10-01,Male,3,1-4,2
10,1,8,0,9,2020-10-02,Male,68,65-69,7
10,0,0,0,0,2020-10-02,Male,28,25-34,5
10,0,2,0,2,2020-10-01,Male,78,75-79,4
10,1,8,0,9,2020-10-01,Male,73,70-74,5
10,1,0,0,1,2020-09-30,Female,65,65-69,4
10,5,2,0,7,2020-10-02,Male,15,15-19,6
10,1,0,0,1,2020-10-02,Male,58,55-64,7
10,0,3,0,3,2020-10-01,Male,42,35-44,6
10,3,1,1,5,2020-10-02,Male,11,10-14,7
10,1,0,0,1,2020-10-01,Male,11,10-14,6
10,0,0,0,0,2020-10-02,Male,65,65-69,6
10,2,2,0,4,2020-10-01,Male,81,80-84,5
10,1,4,0,5,2020-10-02,Female,53,45-54,5
10,0,6,0,6,2020-10-01,Female,47,45-54,6
10,1,3,0,4,2020-10-01,Male,71,70-74,6
10,0,1,93,94,2020-10-01,Female,30,25-34,5
10,0,0,0,0,2020-09-30,Female,23,20-24,7
10,0,1,0,1,2020-10-02,Male,27,25-34,7
10,1,5,0,6,2020-10-02,Male,65,65-69,8
10,1,0,0,1,2020-10-01,Female,62,55-64,8
10,0,1,0,1,2020-10-01,Male,65,65-69,9
10,0,0,0,0,2020-10-01,Female,27,25-34,5
10,1,0,0,1,2020-10-01,Male,72,70-74,8
10,4,3,0,7,2020-10-01,Male,5,5-9,7
10,2,0,0,2,2020-10-01,Male,70,70-74,5
10,5,6,0,11,2020-10-02,Female,10,10-14,7
10,3,0,0,3,2020-10-02,Female,65,65-69,10
10,0,1,0,1,2020-10-02,Female,61,55-64,8
10,0,0,0,0,2020-10-01,Female,31,25-34,7
10,2,3,0,5,2020-10-02,Male,54,45-54,8
10,0,0,0,0,2020-10-01,Male,38,35-44,5
10,2,0,0,2,2020-10-02,Female,59,55-64,8
10,1,0,0,1,2020-09-30,Female,22,20-24,6
10,0,0,0,0,2020-10-01,Female,31,25-34,7
10,1,0,0,1,2020-10-02,Male,53,45-54,7
10,1,1,0,2,2020-10-01,Male,40,35-44,6
10,0,0,0,0,2020-09-30,Male,19,15-19,10
10,0,0,0,0,2020-10-02,Male,50,45-54,6
10,0,1,0,1,2020-10-01,Male,44,35-44,9
10,1,0,0,1,2020-10-02,Male,60,55-64,6
10,2,1,0,3,2020-10-02,Male,69,65-69,6
10,2,5,0,7,2020-10-01,Male,6,5-9,5
10,2,2,0,4,2020-10-02,Female,70,70-74,8
10,0,0,0,0,2020-10-02,Male,66,65-69,7
10,0,1,0,1,2020-10-02,Male,69,65-69,6
10,0,0,0,0,2020-10-01,Male,42,35-44,3
10,0,0,9,9,2020-10-02,Male,52,45-54,10
10,1,0,0,1,2020-10-01,Male,67,65-69,10
10,0,0,0,0,2020-10-01,Male,34,25-34,7
10,1,3,0,4,2020-10-02,Male,68,65-69,6
10,0,9,0,9,2020-09-30,Male,24,20-24,7
10,0,0,0,0,2020-10-01,Male,15,15-19,7
10,0,3,0,3,2020-10-02,Male,42,35-44,2
10,0,1,0,1,2020-09-30,Female,22,20-24,7
10,2,3,0,5,2020-10-01,Male,78,75-79,5
10,2,0,0,2,2020-10-01,Male,52,45-54,7
10,1,0,0,1,2020-10-01,Male,51,45-54,6
10,0,0,0,0,2020-10-02,Female,53,45-54,5
10,0,2,0,2,2020-10-02,Male,51,45-54,5
10,3,0,0,3,2020-10-01,Female,42,35-44,9
10,1,0,0,1,2020-10-01,Female,65,65-69,4
10,0,1,0,1,2020-10-01,Female,71,70-74,5
10,0,0,0,0,2020-10-02,Female,67,65-69,10
10,0,0,0,0,2020-10-02,Male,59,55-64,5
10,2,0,0,2,2020-10-02,Male,14,10-14,7
10,3,0,0,3,2020-10-01,Male,32,25-34,7
10,1,0,0,1,2020-10-01,Male,44,35-44,6
10,0,1,0,1,2020-10-02,Female,67,65-69,8
10,0,6,0,6,2020-10-02,Female,58,55-64,3
10,0,1,0,1,2020-10-02,Female,64,55-64,9
10,2,3,0,5,2020-10-02,Female,70,70-74,3
10,3,2,0,5,2020-09-30,Female,18,15-19,5
10,1,0,0,1,2020-10-01,Female,52,45-54,10
10,0,0,0,0,2020-10-01,Male,77,75-79,9
10,1,0,0,1,2020-10-01,Male,44,35-44,5
10,1,0,0,1,2020-10-02,Male,66,65-69,10
10,1,0,0,1,2020-10-01,Male,48,45-54,9
10,0,2,0,2,2020-10-01,Male,39,35-44,8
10,1,9,0,10,2020-10-02,Female,61,55-64,10
10,2,2,0,4,2020-10-02,Male,74,70-74,7
10,0,0,0,0,2020-10-01,Male,30,25-34,7
10,1,0,0,1,2020-10-02,Female,67,65-69,8
10,3,0,0,3,2020-10-01,Male,35,35-44,10
10,1,0,3,4,2020-10-02,Male,64,55-64,7
10,0,0,0,0,2020-10-01,Male,41,35-44,8
10,0,0,0,0,2020-10-01,Female,11,10-14,10
10,0,0,0,0,2020-10-02,Male,57,55-64,8
10,0,0,0,0,2020-10-01,Female,59,55-64,8
10,1,0,0,1,2020-10-02,Male,65,65-69,7
10,1,0,0,1,2020-10-02,Female,17,15-19,8
10,0,0,0,0,2020-09-30,Female,23,20-24,6
10,0,2,0,2,2020-10-02,Female,67,65-69,6
10,0,0,0,0,2020-10-01,Female,53,45-54,9
10,1,2,0,3,2020-10-01,Male,74,70-74,4
10,0,0,0,0,2020-10-01,Male,39,35-44,7
10,0,0,0,0,2020-10-01,Male,35,35-44,5
10,4,0,0,4,2020-10-01,Male,33,25-34,5
10,0,3,0,3,2020-10-02,Male,52,45-54,10
10,2,5,0,7,2020-10-02,Male,65,65-69,6
10,2,2,0,4,2020-10-02,Female,76,75-79,5
10,1,0,0,1,2020-10-01,Female,62,55-64,10
10,0,0,0,0,2020-09-30,Female,10,10-14,7
10,0,0,0,0,2020-10-02,Female,69,65-69,7
10,0,3,0,3,2020-10-01,Male,27,25-34,7
10,2,0,0,2,2020-10-01,Male,73,70-74,6
10,0,2,0,2,2020-10-02,Male,62,55-64,5
10,0,0,0,0,2020-09-30,Male,23,20-24,8
10,3,0,0,3,2020-10-02,Female,20,20-24,5
10,0,0,5,5,2020-10-02,Male,68,65-69,8
10,2,1,0,3,2020-10-02,Male,19,15-19,9
10,1,2,0,3,2020-10-02,Male,55,55-64,10
10,1,0,0,1,2020-10-02,Female,61,55-64,9
10,1,2,0,3,2020-10-01,Male,52,45-54,9
10,0,4,0,4,2020-10-02,Female,66,65-69,10
10,0,0,0,0,2020-10-01,Male,65,65-69,7
10,1,1,0,2,2020-10-02,Male,65,65-69,10
10,0,1,0,1,2020-10-02,Female,68,65-69,7
10,1,1,0,2,2020-10-01,Female,62,55-64,9
10,1,0,0,1,2020-10-01,Female,65,65-69,6
10,2,0,0,2,2020-10-02,Female,52,45-54,7
10,2,0,0,2,2020-10-01,Female,48,45-54,7
10,0,0,0,0,2020-10-02,Male,66,65-69,8
10,1,1,0,2,2020-10-01,Male,59,55-64,10
10,0,0,0,0,2020-10-01,Female,44,35-44,10
10,1,0,0,1,2020-10-01,Male,71,70-74,5
10,1,7,0,8,2020-10-01,Female,35,35-44,5
10,2,2,0,4,2020-10-02,Male,21,20-24,7
10,1,0,0,1,2020-10-01,Female,66,65-69,5
10,3,0,3,6,2020-10-02,Male,11,10-14,7
10,4,0,0,4,2020-10-01,Male,1,1-4,6
10,0,0,0,0,2020-10-02,Male,35,35-44,6
10,2,3,16,21,2020-09-30,Female,25,25-34,10
10,0,0,0,0,2020-10-01,Male,34,25-34,7
10,2,2,0,4,2020-10-01,Female,12,10-14,7
10,0,0,0,0,2020-10-02,Male,66,65-69,6
10,2,0,0,2,2020-10-01,Female,6,5-9,8
10,0,0,0,0,2020-10-02,Female,66,65-69,10
10,2,4,0,6,2020-10-01,Male,42,35-44,7
10,0,0,0,0,2020-10-01,Female,4,1-4,7
10,4,2,0,6,2020-10-02,Male,9,5-9,10
10,2,1,0,3,2020-10-01,Female,3,1-4,6
10,1,0,0,1,2020-10-02,Female,61,55-64,7
10,2,3,0,5,2020-10-02,Male,52,45-54,9
10,0,0,0,0,2020-10-02,Male,51,45-54,4
10,1,2,0,3,2020-10-02,Female,60,55-64,5
10,1,10,0,11,2020-10-02,Female,55,55-64,9
10,2,0,0,2,2020-10-01,Female,49,45-54,6
10,0,0,0,0,2020-10-02,Male,66,65-69,6
10,1,0,0,1,2020-10-02,Male,66,65-69,8
10,0,0,0,0,2020-10-01,Male,40,35-44,9
10,0,5,0,5,2020-10-01,Male,41,35-44,10
10,0,0,0,0,2020-10-01,Male,66,65-69,10
10,0,0,0,0,2020-10-02,Female,34,25-34,8
10,4,3,0,7,2020-10-01,Male,4,1-4,8
10,0,0,0,0,2020-10-01,Male,55,55-64,7
10,0,3,0,3,2020-10-02,Male,66,65-69,3
10,0,1,0,1,2020-10-05,Male,58,55-64,8
10,0,0,0,0,2020-10-05,Male,52,45-54,9
10,1,4,0,5,2020-10-02,Male,61,55-64,10
10,0,5,0,5,2020-10-02,Female,67,65-69,10
10,3,4,0,7,2020-10-02,Male,10,10-14,10
10,2,0,0,2,2020-10-01,Male,77,75-79,8
10,0,0,0,0,2020-10-01,Male,47,45-54,8
10,1,0,0,1,2020-10-02,Male,66,65-69,6
10,2,7,7,16,2020-10-01,Female,65,65-69,4
10,4,1,0,5,2020-10-02,Female,15,15-19,5
10,2,1,0,3,2020-10-01,Male,49,45-54,4
10,0,0,0,0,2020-10-02,Male,52,45-54,7
10,3,2,0,5,2020-10-02,Male,17,15-19,7
10,2,0,0,2,2020-10-02,Male,61,55-64,5
10,2,0,0,2,2020-10-02,Male,10,10-14,9
10,2,2,0,4,2020-10-02,Female,62,55-64,6
10,0,0,0,0,2020-10-05,Female,78,75-79,4
10,2,1,0,3,2020-10-02,Female,64,55-64,10
10,1,1,0,2,2020-10-02,Female,48,45-54,9
10,0,4,0,4,2020-10-01,Male,77,75-79,4
10,0,0,0,0,2020-10-01,Female,53,45-54,9
10,0,0,0,0,2020-10-01,Female,33,25-34,6
10,0,2,0,2,2020-10-01,Female,59,55-64,5
10,1,0,0,1,2020-10-01,Male,56,55-64,7
10,2,3,0,5,2020-10-02,Male,65,65-69,10
10,0,0,0,0,2020-10-01,Male,61,55-64,9
10,1,1,0,2,2020-10-01,Male,66,65-69,9
10,1,0,0,1,2020-10-01,Male,33,25-34,9
10,2,2,0,4,2020-10-01,Male,73,70-74,6
10,2,4,0,6,2020-10-01,Male,34,25-34,5
10,0,0,0,0,2020-10-01,Female,36,35-44,6
10,1,0,0,1,2020-10-01,Female,34,25-34,7
10,2,0,0,2,2020-10-02,Male,53,45-54,9
10,0,1,0,1,2020-10-02,Male,56,55-64,7
10,2,1,0,3,2020-10-01,Male,72,70-74,7
10,1,0,0,1,2020-10-01,Female,72,70-74,4
10,2,0,0,2,2020-10-01,Male,71,70-74,5
10,1,2,0,3,2020-10-01,Female,48,45-54,5
10,2,12,0,14,2020-10-02,Female,55,55-64,3
10,2,0,0,2,2020-10-01,Female,70,70-74,7
10,0,2,0,2,2020-10-01,Male,66,65-69,10
10,0,0,0,0,2020-10-01,Female,26,25-34,6
10,1,3,0,4,2020-10-01,Female,74,70-74,4
10,1,2,0,3,2020-10-02,Male,80,80-84,5
10,0,0,0,0,2020-10-01,Male,37,35-44,9
10,0,1,0,1,2020-10-02,Female,67,65-69,4
10,0,0,0,0,2020-10-02,Female,13,10-14,7
10,0,0,0,0,2020-10-02,Male,54,45-54,9
10,0,2,0,2,2020-10-02,Male,1,1-4,10
10,3,0,0,3,2020-10-01,Male,16,15-19,4
10,1,0,0,1,2020-10-01,Male,34,25-34,9
10,0,0,0,0,2020-10-01,Female,72,70-74,8
10,3,0,7,10,2020-10-01,Male,34,25-34,4
10,3,4,0,7,2020-10-01,Male,41,35-44,7
10,1,0,0,1,2020-09-30,Female,24,20-24,10
10,1,4,0,5,2020-10-02,Male,14,10-14,5
10,0,0,0,0,2020-10-01,Female,42,35-44,7
10,2,1,0,3,2020-10-01,Female,71,70-74,7
10,1,2,0,3,2020-10-01,Male,58,55-64,6
10,3,2,0,5,2020-10-01,Male,3,1-4,7
10,2,1,0,3,2020-10-01,Female,36,35-44,9
10,1,0,0,1,2020-10-02,Male,64,55-64,9
10,0,0,0,0,2020-10-01,Male,52,45-54,9
10,2,4,0,6,2020-10-01,Female,75,75-79,3
10,3,1,0,4,2020-10-01,Female,19,15-19,7
10,0,3,0,3,2020-10-01,Male,74,70-74,7
10,0,1,0,1,2020-10-01,Female,66,65-69,9
10,2,2,0,4,2020-10-01,Female,17,15-19,5
10,1,0,0,1,2020-10-01,Female,46,45-54,7
10,4,1,0,5,2020-10-01,Male,16,15-19,5
10,2,4,0,6,2020-10-01,Male,74,70-74,7
10,1,3,0,4,2020-10-01,Female,70,70-74,10
10,1,0,0,1,2020-10-01,Male,35,35-44,4
10,3,1,0,4,2020-10-02,Male,32,25-34,5
10,0,3,0,3,2020-10-02,Male,27,25-34,9
10,1,4,0,5,2020-10-01,Male,28,25-34,10
10,2,0,0,2,2020-10-01,Male,42,35-44,7
10,0,2,0,2,2020-10-01,Male,70,70-74,9
10,0,0,0,0,2020-10-02,Female,68,65-69,10
10,0,1,0,1,2020-10-02,Female,62,55-64,7
10,0,1,0,1,2020-10-02,Male,60,55-64,7
10,0,0,3,3,2020-10-01,Male,27,25-34,6
10,0,0,0,0,2020-10-01,Male,26,25-34,7
10,1,0,1,2,2020-10-01,Female,34,25-34,6
10,1,1,0,2,2020-10-02,Female,66,65-69,8
10,0,0,0,0,2020-10-01,Male,33,25-34,6
10,1,1,0,2,2020-10-01,Female,78,75-79,7
10,1,5,0,6,2020-10-01,Male,66,65-69,6
10,0,0,0,0,2020-10-01,Male,42,35-44,4
10,0,1,0,1,2020-10-02,Female,62,55-64,7
10,2,1,0,3,2020-10-01,Female,33,25-34,8
10,0,0,0,0,2020-10-02,Female,54,45-54,5
10,0,0,0,0,2020-10-01,Female,61,55-64,10
10,3,2,0,5,2020-10-01,Female,3,1-4,6
10,1,1,0,2,2020-10-02,Female,30,25-34,7
10,2,1,0,3,2020-10-02,Male,60,55-64,7
10,0,1,0,1,2020-10-01,Male,70,70-74,10
10,2,3,0,5,2020-10-02,Female,51,45-54,9
10,0,0,0,0,2020-10-02,Male,52,45-54,10
10,3,0,0,3,2020-10-02,Female,19,15-19,5
10,0,0,0,0,2020-10-01,Female,37,35-44,8
10,0,6,60,66,2020-10-01,Female,48,45-54,5
10,1,3,0,4,2020-10-02,Male,59,55-64,5
10,0,0,0,0,2020-09-30,Female,55,55-64,7
10,3,1,0,4,2020-10-01,Male,64,55-64,7
10,0,1,5,6,2020-10-02,Male,37,35-44,7
10,0,0,0,0,2020-10-01,Male,74,70-74,4
10,2,1,0,3,2020-10-01,Female,32,25-34,5
10,1,6,0,7,2020-10-01,Female,16,15-19,7
10,0,8,0,8,2020-10-02,Male,61,55-64,7
10,2,1,0,3,2020-10-02,Female,65,65-69,8
10,1,1,0,2,2020-10-02,Male,61,55-64,7
10,1,2,0,3,2020-10-02,Female,50,45-54,6
10,3,0,0,3,2020-10-01,Male,13,10-14,9
10,1,1,0,2,2020-10-01,Male,19,15-19,7
10,0,0,0,0,2020-10-02,Female,66,65-69,9
10,0,0,0,0,2020-10-01,Male,37,35-44,9
10,0,0,0,0,2020-10-02,Female,67,65-69,9
10,0,0,0,0,2020-10-01,Female,43,35-44,4
10,0,1,0,1,2020-10-01,Female,67,65-69,7
10,1,0,0,1,2020-10-02,Female,51,45-54,9
10,1,11,20,32,2020-09-30,Female,32,25-34,8
10,0,0,0,0,2020-10-02,Female,17,15-19,6
10,0,0,0,0,2020-10-02,Female,62,55-64,7
10,1,0,0,1,2020-10-02,Female,66,65-69,7
10,2,6,100,108,2020-10-01,Female,10,10-14,5
10,1,0,0,1,2020-10-01,Male,78,75-79,6
10,2,4,0,6,2020-10-01,Female,5,5-9,6
10,1,0,0,1,2020-10-02,Female,55,55-64,9
10,1,2,0,3,2020-10-01,Male,68,65-69,5
10,1,2,45,48,2020-10-02,Male,64,55-64,10
10,0,3,0,3,2020-10-02,Female,71,70-74,8
10,0,0,0,0,2020-10-01,Female,33,25-34,6
10,1,0,0,1,2020-10-01,Male,74,70-74,4
10,0,0,0,0,2020-09-30,Male,21,20-24,10
10,0,0,0,0,2020-10-01,Female,36,35-44,10
10,3,2,0,5,2020-10-01,Female,8,5-9,7
10,1,2,0,3,2020-10-01,Male,55,55-64,7
10,2,1,0,3,2020-10-02,Male,62,55-64,8
10,3,1,0,4,2020-10-01,Male,16,15-19,7
10,0,0,0,0,2020-10-02,Female,67,65-69,7
10,2,2,0,4,2020-10-02,Male,73,70-74,10
10,1,1,0,2,2020-10-02,Female,66,65-69,7
10,2,1,0,3,2020-10-01,Male,11,10-14,8
10,0,0,0,0,2020-10-01,Male,25,25-34,4
10,0,0,0,0,2020-10-01,Female,37,35-44,7
10,1,0,0,1,2020-10-02,Male,66,65-69,7
10,1,0,0,1,2020-10-02,Male,66,65-69,8
10,3,0,0,3,2020-10-02,Female,12,10-14,7
10,1,4,0,5,2020-10-02,Male,65,65-69,9
10,1,0,0,1,2020-10-02,Female,14,10-14,5
10,0,0,0,0,2020-09-30,Female,24,20-24,4
10,3,0,0,3,2020-10-01,Male,16,15-19,8
10,0,0,0,0,2020-10-01,Male,15,15-19,7
10,0,0,0,0,2020-10-02,Female,63,55-64,6
10,1,3,0,4,2020-10-02,Male,65,65-69,8
10,1,0,40,41,2020-09-30,Male,22,20-24,4
10,3,3,0,6,2020-10-01,Female,11,10-14,10
10,1,0,0,1,2020-10-01,Male,62,55-64,10
10,2,0,0,2,2020-10-01,Male,66,65-69,8
10,2,1,0,3,2020-10-02,Female,22,20-24,4
10,0,0,38,38,2020-10-01,Male,27,25-34,5
10,1,0,0,1,2020-10-02,Female,61,55-64,5
10,1,0,0,1,2020-10-02,Female,53,45-54,8
10,1,0,0,1,2020-10-02,Female,48,45-54,9
10,0,0,0,0,2020-10-02,Female,10,10-14,4
10,4,0,0,4,2020-10-05,Male,30,25-34,3
10,0,0,0,0,2020-10-01,Female,25,25-34,9
10,0,1,0,1,2020-10-01,Female,21,20-24,9
10,1,0,0,1,2020-10-01,Male,40,35-44,7
10,2,0,0,2,2020-10-01,Male,8,5-9,10
10,5,3,0,8,2020-10-02,Female,12,10-14,4
10,2,1,0,3,2020-10-01,Male,70,70-74,5
10,0,1,0,1,2020-10-01,Female,47,45-54,9
10,3,19,0,22,2020-10-01,Female,9,5-9,4
10,2,3,0,5,2020-10-02,Female,63,55-64,8
10,0,0,0,0,2020-10-01,Female,53,45-54,7
10,0,1,0,1,2020-10-02,Female,70,70-74,4
10,1,0,0,1,2020-10-02,Male,45,45-54,5
10,0,1,0,1,2020-10-01,Female,34,25-34,6
10,2,1,0,3,2020-10-02,Female,33,25-34,9
10,0,0,0,0,2020-10-01,Male,58,55-64,10
10,2,0,0,2,2020-10-02,Male,63,55-64,10
10,1,1,0,2,2020-10-02,Female,63,55-64,8
10,3,0,0,3,2020-10-01,Female,43,35-44,7
10,2,1,0,3,2020-10-02,Female,71,70-74,10
10,2,0,0,2,2020-10-02,Female,63,55-64,5
10,1,3,0,4,2020-10-01,Female,67,65-69,8
10,0,0,0,0,2020-10-02,Male,17,15-19,10
10,0,1,0,1,2020-10-02,Female,65,65-69,5
10,2,10,0,12,2020-10-02,Male,59,55-64,9
10,2,0,0,2,2020-10-02,Female,38,35-44,7
10,1,0,0,1,2020-10-01,Male,33,25-34,7
10,1,0,0,1,2020-10-02,Female,65,65-69,7
10,1,2,0,3,2020-10-01,Male,68,65-69,10
10,0,0,0,0,2020-10-01,Male,10,10-14,7
10,1,0,0,1,2020-10-02,Female,58,55-64,10
10,0,0,0,0,2020-09-30,Female,25,25-34,7
10,0,0,0,0,2020-10-01,Female,27,25-34,9
10,1,0,0,1,2020-10-01,Male,51,45-54,7
10,0,0,0,0,2020-10-02,Female,34,25-34,8
10,1,0,0,1,2020-10-01,Male,45,45-54,6
10,0,0,0,0,2020-10-02,Female,52,45-54,6
10,0,1,0,1,2020-10-01,Female,27,25-34,7
10,2,2,0,4,2020-10-01,Female,73,70-74,6
10,2,0,0,2,2020-10-02,Male,10,10-14,6
10,0,0,0,0,2020-10-02,Female,67,65-69,8
10,4,7,0,11,2020-10-02,Male,9,5-9,5
10,5,4,0,9,2020-10-02,Male,14,10-14,8
10,1,1,0,2,2020-10-02,Female,69,65-69,8
10,1,0,0,1,2020-10-02,Male,54,45-54,5
10,0,1,0,1,2020-10-01,Male,48,45-54,6
10,1,2,10,13,2020-10-02,Male,63,55-64,6
10,0,0,0,0,2020-10-01,Male,27,25-34,5
10,2,0,0,2,2020-10-01,Male,35,35-44,6
10,0,0,0,0,2020-10-01,Male,49,45-54,7
10,2,0,2,4,2020-10-01,Male,68,65-69,8
10,5,2,0,7,2020-09-30,Female,18,15-19,9
10,1,1,0,2,2020-10-01,Female,54,45-54,8
10,2,3,0,5,2020-10-01,Male,14,10-14,3
10,1,10,0,11,2020-10-01,Female,33,25-34,5
10,0,0,0,0,2020-10-02,Male,50,45-54,10
10,0,0,0,0,2020-10-01,Male,31,25-34,8
10,0,4,0,4,2020-10-01,Female,28,25-34,3
10,0,0,0,0,2020-10-01,Male,74,70-74,9
10,0,2,0,2,2020-10-01,Male,30,25-34,8
10,0,0,0,0,2020-10-01,Male,42,35-44,9
10,1,0,0,1,2020-10-02,Female,69,65-69,8
10,0,0,0,0,2020-10-02,Female,69,65-69,10
10,0,0,0,0,2020-10-01,Male,13,10-14,4
10,0,1,0,1,2020-10-02,Male,61,55-64,9
10,1,10,0,11,2020-10-01,Female,29,25-34,8
10,3,0,0,3,2020-10-01,Male,10,10-14,6
10,0,1,0,1,2020-10-01,Male,34,25-34,9
11,0,0,0,0,2020-10-16,Male,59,55-64,7
11,1,0,0,1,2020-10-15,Male,68,65-69,6
11,1,1,0,2,2020-10-20,Female,58,55-64,6
11,1,0,0,1,2020-10-16,Female,69,65-69,6
11,1,0,0,1,2020-10-20,Male,62,55-64,3
11,2,0,0,2,2020-10-16,Female,66,65-69,11
11,0,1,0,1,2020-10-16,Female,71,70-74,7
11,0,0,0,0,2020-10-15,Female,50,45-54,7
11,1,0,0,1,2020-10-16,Female,72,70-74,11
11,0,0,0,0,2020-10-15,Male,30,25-34,8
11,0,0,0,0,2020-10-16,Female,53,45-54,7
11,2,0,0,2,2020-10-15,Male,34,25-34,11
11,0,0,0,0,2020-10-16,Female,59,55-64,7
11,1,3,12,16,2020-10-17,Female,61,55-64,5
11,0,0,0,0,2020-10-18,Male,51,45-54,8
11,1,0,0,1,2020-10-15,Male,50,45-54,6
11,2,3,0,5,2020-10-16,Female,35,35-44,8
11,3,0,0,3,2020-10-15,Female,57,55-64,9
11,0,0,0,0,2020-10-16,Female,10,10-14,8
11,0,0,0,0,2020-10-15,Male,42,35-44,5
11,0,0,0,0,2020-10-15,Male,32,25-34,10
11,1,2,0,3,2020-10-19,Male,66,65-69,5
11,0,0,1,1,2020-10-16,Male,66,65-69,7
11,1,2,0,3,2020-10-17,Male,62,55-64,11
11,0,0,0,0,2020-10-15,Male,13,10-14,7
11,1,1,0,2,2020-10-16,Male,16,15-19,9
11,0,0,0,0,2020-10-15,Male,48,45-54,8
11,2,0,0,2,2020-10-15,Male,58,55-64,6
11,1,0,0,1,2020-10-19,Male,34,25-34,7
11,0,1,0,1,2020-10-16,Male,53,45-54,6
11,1,0,0,1,2020-10-16,Female,70,70-74,10
11,2,1,0,3,2020-10-16,Male,68,65-69,10
11,2,0,0,2,2020-10-19,Male,20,20-24,6
11,2,0,0,2,2020-10-15,Female,52,45-54,8
11,1,6,0,7,2020-10-15,Female,69,65-69,8
11,0,0,0,0,2020-10-15,Male,41,35-44,11
11,1,0,0,1,2020-10-20,Male,58,55-64,7
11,1,1,0,2,2020-10-15,Female,56,55-64,11
11,2,0,0,2,2020-10-14,Female,21,20-24,9
11,2,0,0,2,2020-10-16,Male,51,45-54,9
11,0,0,0,0,2020-10-15,Male,85,85+,9
11,0,1,0,1,2020-10-15,Female,68,65-69,8
11,0,2,0,2,2020-10-16,Female,66,65-69,5
11,3,1,0,4,2020-10-19,Female,10,10-14,4
11,0,0,0,0,2020-10-15,Male,17,15-19,5
11,1,0,0,1,2020-10-16,Male,58,55-64,9
11,0,0,0,0,2020-10-15,Male,67,65-69,11
11,0,0,0,0,2020-10-19,Male,51,45-54,7
11,1,2,0,3,2020-10-15,Male,72,70-74,4
11,0,2,0,2,2020-10-16,Male,76,75-79,8
11,1,0,0,1,2020-10-15,Male,71,70-74,9
11,0,0,0,0,2020-10-15,Male,52,45-54,10
11,0,0,0,0,2020-10-16,Male,52,45-54,5
11,1,0,1,2,2020-10-15,Male,43,35-44,7
11,1,0,0,1,2020-10-16,Female,60,55-64,9
11,0,0,0,0,2020-10-18,Male,25,25-34,5
11,1,0,0,1,2020-10-15,Male,38,35-44,8
11,2,3,0,5,2020-10-15,Male,69,65-69,8
11,0,3,0,3,2020-10-16,Female,77,75-79,8
11,0,1,0,1,2020-10-16,Male,2,1-4,5
11,1,0,0,1,2020-10-14,Female,67,65-69,8
11,0,5,0,5,2020-10-16,Female,52,45-54,5
11,5,4,0,9,2020-10-19,Female,3,1-4,4
11,1,2,0,3,2020-10-15,Male,38,35-44,10
11,1,1,0,2,2020-10-14,Male,62,55-64,8
11,3,0,0,3,2020-10-20,Female,14,10-14,7
11,0,1,0,1,2020-10-20,Male,72,70-74,4
11,0,0,0,0,2020-10-17,Male,37,35-44,2
11,0,2,0,2,2020-10-16,Male,85,85+,6
11,2,1,0,3,2020-10-16,Female,71,70-74,7
11,2,3,0,5,2020-10-16,Male,54,45-54,10
11,0,1,0,1,2020-10-19,Male,31,25-34,4
11,1,2,0,3,2020-10-15,Male,70,70-74,8
11,2,0,0,2,2020-10-16,Female,70,70-74,7
11,2,1,0,3,2020-10-17,Male,66,65-69,5
11,1,1,0,2,2020-10-16,Female,65,65-69,10
11,2,0,0,2,2020-10-15,Male,67,65-69,10
11,0,0,0,0,2020-10-16,Male,69,65-69,7
11,2,0,0,2,2020-10-15,Male,34,25-34,7
11,4,0,0,4,2020-10-18,Female,13,10-14,5
11,1,0,100,101,2020-10-15,Male,40,35-44,3
11,1,0,0,1,2020-10-15,Male,67,65-69,8
11,0,0,3,3,2020-10-15,Female,23,20-24,6
11,0,0,0,0,2020-10-15,Male,43,35-44,7
11,0,0,0,0,2020-10-15,Female,6,5-9,7
11,1,9,0,10,2020-10-16,Female,43,35-44,4
11,4,0,0,4,2020-10-15,Male,17,15-19,3
11,0,0,0,0,2020-10-15,Male,33,25-34,7
11,1,7,0,8,2020-10-15,Male,69,65-69,11
11,0,0,0,0,2020-10-17,Female,2,1-4,8
11,2,0,0,2,2020-10-19,Female,60,55-64,9
11,4,1,0,5,2020-10-15,Male,19,15-19,9
11,1,1,0,2,2020-10-16,Male,31,25-34,6
11,0,2,0,2,2020-10-16,Female,52,45-54,9
11,0,0,0,0,2020-10-15,Male,48,45-54,10
11,0,2,0,2,2020-10-17,Male,69,65-69,6
11,0,3,0,3,2020-10-20,Male,65,65-69,2
11,1,0,0,1,2020-10-16,Female,66,65-69,4
11,0,3,0,3,2020-10-16,Female,63,55-64,10
11,0,1,0,1,2020-10-15,Female,20,20-24,7
11,1,2,0,3,2020-10-15,Female,30,25-34,10
11,2,2,0,4,2020-10-17,Female,67,65-69,7
11,2,3,0,5,2020-10-16,Male,17,15-19,4
11,1,0,0,1,2020-10-15,Female,62,55-64,9
11,1,0,0,1,2020-10-15,Female,46,45-54,8
11,0,0,0,0,2020-10-20,Male,68,65-69,6
11,0,0,0,0,2020-10-15,Male,54,45-54,8
11,0,0,0,0,2020-10-17,Male,33,25-34,7
11,0,1,0,1,2020-10-15,Male,29,25-34,5
11,1,1,0,2,2020-10-15,Male,57,55-64,7
11,1,0,0,1,2020-10-16,Female,73,70-74,8
11,0,1,0,1,2020-10-15,Female,32,25-34,11
11,0,1,0,1,2020-10-16,Male,65,65-69,6
11,2,9,10,21,2020-10-18,Female,45,45-54,3
11,0,0,0,0,2020-10-15,Female,30,25-34,5
11,0,2,0,2,2020-10-16,Male,35,35-44,2
11,2,1,5,8,2020-10-18,Female,66,65-69,2
11,0,2,0,2,2020-10-16,Female,33,25-34,8
11,1,2,0,3,2020-10-18,Female,62,55-64,8
11,1,0,0,1,2020-10-15,Male,65,65-69,6
11,0,2,0,2,2020-10-16,Male,53,45-54,9
11,4,2,0,6,2020-10-16,Male,6,5-9,4
11,0,0,0,0,2020-10-15,Male,29,25-34,6
11,0,1,0,1,2020-10-17,Female,55,55-64,6
11,1,1,0,2,2020-10-18,Female,26,25-34,6
11,0,2,0,2,2020-10-15,Male,69,65-69,6
11,1,1,0,2,2020-10-16,Female,67,65-69,9
11,2,0,0,2,2020-10-15,Male,42,35-44,6
11,2,0,0,2,2020-10-16,Male,58,55-64,10
11,2,1,0,3,2020-10-15,Female,41,35-44,4
11,0,1,0,1,2020-10-16,Female,62,55-64,7
11,3,2,0,5,2020-10-18,Female,68,65-69,8
11,0,0,0,0,2020-10-15,Male,69,65-69,7
11,0,0,3,3,2020-10-20,Female,40,35-44,4
11,3,0,0,3,2020-10-19,Male,32,25-34,8
11,2,0,0,2,2020-10-18,Male,35,35-44,10
11,2,2,0,4,2020-10-16,Male,70,70-74,5
11,0,0,0,0,2020-10-14,Male,15,15-19,7
11,3,0,0,3,2020-10-20,Female,13,10-14,8
11,1,0,0,1,2020-10-16,Male,64,55-64,9
11,1,3,0,4,2020-10-16,Female,69,65-69,2
11,1,1,0,2,2020-10-20,Female,24,20-24,1
11,1,0,0,1,2020-10-16,Female,79,75-79,8
11,1,3,0,4,2020-10-17,Male,56,55-64,9
11,0,1,0,1,2020-10-15,Female,19,15-19,3
11,1,0,0,1,2020-10-19,Female,28,25-34,8
11,2,0,0,2,2020-10-16,Female,66,65-69,7
11,0,0,0,0,2020-10-16,Female,23,20-24,6
11,1,0,0,1,2020-10-20,Male,52,45-54,8
11,0,0,0,0,2020-10-19,Male,52,45-54,4
11,0,0,0,0,2020-10-16,Male,57,55-64,10
11,1,3,2,6,2020-10-16,Male,70,70-74,8
11,2,4,0,6,2020-10-15,Male,27,25-34,11
11,0,1,0,1,2020-10-15,Female,52,45-54,10
11,0,0,0,0,2020-10-17,Male,28,25-34,7
11,3,5,0,8,2020-10-15,Male,8,5-9,6
11,2,2,0,4,2020-10-16,Male,65,65-69,7
11,0,0,0,0,2020-10-15,Female,58,55-64,8
11,0,4,0,4,2020-10-16,Female,66,65-69,10
11,0,2,0,2,2020-10-19,Female,60,55-64,7
11,0,1,0,1,2020-10-15,Male,70,70-74,11
11,2,1,0,3,2020-10-19,Male,24,20-24,7
11,0,3,0,3,2020-10-18,Female,71,70-74,7
11,1,3,0,4,2020-10-16,Male,74,70-74,9
11,2,1,0,3,2020-10-16,Female,64,55-64,6
11,0,0,0,0,2020-10-16,Male,50,45-54,5
11,1,0,0,1,2020-10-16,Female,31,25-34,7
11,1,0,0,1,2020-10-16,Female,54,45-54,9
11,3,0,0,3,2020-10-17,Female,21,20-24,6
11,0,0,0,0,2020-10-19,Male,33,25-34,5
11,0,0,0,0,2020-10-16,Male,53,45-54,7
11,0,0,0,0,2020-10-17,Male,51,45-54,8
11,1,6,0,7,2020-10-15,Male,68,65-69,3
11,4,8,0,12,2020-10-21,Male,18,15-19,1
11,1,0,0,1,2020-10-15,Female,49,45-54,7
11,0,0,0,0,2020-10-15,Female,29,25-34,7
11,2,8,0,10,2020-10-16,Male,19,15-19,7
11,2,4,0,6,2020-10-15,Female,68,65-69,4
11,2,0,0,2,2020-10-17,Male,66,65-69,8
11,0,0,0,0,2020-10-16,Male,65,65-69,5
11,1,1,0,2,2020-10-15,Male,68,65-69,8
11,1,1,0,2,2020-10-15,Male,52,45-54,10
11,1,0,0,1,2020-10-17,Female,57,55-64,9
11,0,0,0,0,2020-10-16,Male,50,45-54,9
11,3,0,30,33,2020-10-16,Male,14,10-14,8
11,2,0,0,2,2020-10-19,Female,59,55-64,6
11,0,0,0,0,2020-10-16,Male,71,70-74,10
11,2,0,0,2,2020-10-15,Female,69,65-69,11
11,0,4,0,4,2020-10-16,Male,38,35-44,5
11,3,0,0,3,2020-10-15,Male,20,20-24,7
11,1,0,0,1,2020-10-19,Female,9,5-9,6
11,3,5,0,8,2020-10-20,Male,21,20-24,1
11,1,0,0,1,2020-10-16,Female,72,70-74,5
11,0,2,0,2,2020-10-16,Male,51,45-54,5
11,1,0,0,1,2020-10-16,Female,57,55-64,8
11,1,0,0,1,2020-10-16,Female,59,55-64,11
11,0,0,0,0,2020-10-15,Male,43,35-44,10
11,1,0,0,1,2020-10-16,Male,62,55-64,3
11,2,1,0,3,2020-10-15,Female,63,55-64,7
11,2,0,0,2,2020-10-17,Male,31,25-34,8
11,2,0,0,2,2020-10-16,Male,73,70-74,8
11,1,3,0,4,2020-10-16,Male,66,65-69,4
11,2,3,0,5,2020-10-16,Female,52,45-54,10
11,0,0,0,0,2020-10-15,Male,34,25-34,10
11,1,2,0,3,2020-10-20,Female,23,20-24,1
11,0,0,0,0,2020-10-15,Male,48,45-54,6
11,4,0,0,4,2020-10-15,Male,69,65-69,6
11,0,0,0,0,2020-10-15,Male,65,65-69,10
11,3,0,0,3,2020-10-15,Male,8,5-9,7
11,1,4,0,5,2020-10-19,Male,67,65-69,10
11,0,3,0,3,2020-10-16,Male,61,55-64,7
11,1,2,0,3,2020-10-20,Male,70,70-74,7
11,0,4,0,4,2020-10-15,Male,33,25-34,3
11,0,0,0,0,2020-10-16,Male,46,45-54,4
11,1,1,0,2,2020-10-15,Female,56,55-64,9
11,0,1,0,1,2020-10-19,Female,58,55-64,7
11,3,0,0,3,2020-10-20,Male,22,20-24,1
11,0,0,0,0,2020-10-16,Female,66,65-69,10
11,0,0,0,0,2020-10-15,Female,40,35-44,10
11,0,3,0,3,2020-10-17,Female,63,55-64,6
11,1,2,0,3,2020-10-16,Female,61,55-64,11
11,1,0,0,1,2020-10-20,Male,60,55-64,4
11,1,0,0,1,2020-10-16,Female,53,45-54,11
11,0,2,0,2,2020-10-16,Male,55,55-64,7
11,1,0,0,1,2020-10-15,Female,37,35-44,3
11,0,0,0,0,2020-10-16,Female,65,65-69,11
11,2,0,0,2,2020-10-15,Male,31,25-34,9
11,1,0,0,1,2020-10-19,Male,73,70-74,9
11,4,1,0,5,2020-10-16,Female,6,5-9,5
11,3,9,0,12,2020-10-15,Male,5,5-9,5
11,1,1,0,2,2020-10-16,Male,79,75-79,6
11,0,1,0,1,2020-10-20,Female,66,65-69,6
11,0,0,0,0,2020-10-15,Male,38,35-44,7
11,2,0,0,2,2020-10-15,Female,18,15-19,5
11,0,0,0,0,2020-10-15,Female,55,55-64,10
11,0,1,93,94,2020-10-16,Male,53,45-54,7
11,1,0,0,1,2020-10-15,Male,69,65-69,9
11,0,1,0,1,2020-10-15,Male,16,15-19,6
11,0,3,0,3,2020-10-15,Male,36,35-44,11
11,2,0,0,2,2020-10-16,Male,65,65-69,3
11,1,4,0,5,2020-10-15,Male,40,35-44,11
11,2,0,0,2,2020-10-16,Female,61,55-64,8
11,0,1,0,1,2020-10-15,Male,32,25-34,9
11,2,1,0,3,2020-10-16,Male,62,55-64,10
11,0,0,9,9,2020-10-20,Female,7,5-9,1
11,0,3,0,3,2020-10-15,Female,70,70-74,7
11,1,3,0,4,2020-10-15,Male,68,65-69,4
11,0,0,3,3,2020-10-15,Male,6,5-9,7
11,1,5,0,6,2020-10-19,Male,72,70-74,5
11,0,0,0,0,2020-10-15,Male,68,65-69,10
11,3,0,0,3,2020-10-15,Female,63,55-64,3
11,0,2,0,2,2020-10-15,Male,28,25-34,9
11,0,1,0,1,2020-10-16,Female,53,45-54,8
11,0,0,0,0,2020-10-14,Male,37,35-44,3
11,3,2,0,5,2020-10-16,Male,6,5-9,8
11,1,1,0,2,2020-10-16,Male,76,75-79,5
11,0,0,0,0,2020-10-20,Male,46,45-54,5
11,1,2,0,3,2020-10-16,Male,52,45-54,8
11,0,1,0,1,2020-10-18,Female,70,70-74,6
11,1,0,0,1,2020-10-17,Male,32,25-34,7
11,3,1,0,4,2020-10-20,Male,69,65-69,6
11,1,10,0,11,2020-10-15,Female,69,65-69,9
11,0,0,0,0,2020-10-15,Male,18,15-19,8
11,2,0,0,2,2020-10-16,Male,65,65-69,7
11,0,1,0,1,2020-10-15,Male,49,45-54,8
11,1,2,0,3,2020-10-20,Male,66,65-69,6
11,3,0,0,3,2020-10-15,Female,66,65-69,6
11,1,1,0,2,2020-10-16,Male,50,45-54,4
11,0,0,0,0,2020-10-16,Female,60,55-64,6
11,0,0,0,0,2020-10-20,Male,19,15-19,4
11,0,1,0,1,2020-10-15,Male,22,20-24,6
11,1,0,0,1,2020-10-15,Male,66,65-69,10
11,0,0,0,0,2020-10-16,Male,65,65-69,10
11,2,6,0,8,2020-10-14,Female,67,65-69,10
11,0,0,0,0,2020-10-14,Male,67,65-69,9
11,1,11,0,12,2020-10-16,Male,40,35-44,4
11,0,0,0,0,2020-10-15,Female,7,5-9,5
11,0,1,0,1,2020-10-16,Male,65,65-69,5
11,0,0,0,0,2020-10-20,Female,19,15-19,1
11,1,9,0,10,2020-10-15,Female,44,35-44,5
11,2,0,0,2,2020-10-15,Male,70,70-74,4
11,3,0,0,3,2020-10-18,Male,18,15-19,7
11,0,0,0,0,2020-10-16,Female,47,45-54,5
11,2,1,0,3,2020-10-16,Male,18,15-19,8
11,0,1,9,10,2020-10-15,Male,52,45-54,7
11,0,0,0,0,2020-10-15,Female,19,15-19,8
11,0,0,0,0,2020-10-19,Female,51,45-54,9
11,5,0,0,5,2020-10-15,Male,12,10-14,8
11,5,0,0,5,2020-10-18,Male,58,55-64,6
11,0,1,0,1,2020-10-17,Female,60,55-64,7
11,0,0,0,0,2020-10-15,Male,10,10-14,10
11,3,2,1,6,2020-10-15,Female,4,1-4,5
11,0,0,3,3,2020-10-17,Male,47,45-54,4
11,0,1,1,2,2020-10-16,Male,81,80-84,10
11,5,0,0,5,2020-10-20,Female,9,5-9,1
11,2,2,0,4,2020-10-15,Female,53,45-54,7
11,0,0,0,0,2020-10-17,Female,9,5-9,6
11,2,3,0,5,2020-10-17,Male,59,55-64,7
11,0,0,0,0,2020-10-15,Male,49,45-54,9
11,1,0,0,1,2020-10-16,Female,52,45-54,7
11,0,1,0,1,2020-10-15,Male,24,20-24,8
11,0,0,0,0,2020-10-15,Male,21,20-24,7
11,2,2,0,4,2020-10-16,Male,71,70-74,9
11,0,0,0,0,2020-10-15,Male,35,35-44,10
11,2,0,0,2,2020-10-14,Female,21,20-24,7
11,0,0,0,0,2020-10-19,Female,45,45-54,4
11,0,0,0,0,2020-10-16,Female,23,20-24,10
11,0,0,0,0,2020-10-16,Female,66,65-69,7
11,3,0,0,3,2020-10-19,Male,23,20-24,9
11,6,1,0,7,2020-10-15,Female,1,1-4,7
11,1,0,0,1,2020-10-14,Female,67,65-69,5
11,0,0,0,0,2020-10-15,Male,67,65-69,9
11,0,0,0,0,2020-10-20,Male,22,20-24,3
11,2,0,0,2,2020-10-15,Male,41,35-44,11
11,1,0,2,3,2020-10-16,Male,65,65-69,9
11,3,1,0,4,2020-10-18,Male,49,45-54,7
11,0,5,0,5,2020-10-15,Male,71,70-74,5
11,0,0,0,0,2020-10-17,Female,85,85+,7
11,2,0,1,3,2020-10-15,Male,58,55-64,7
11,2,1,0,3,2020-10-19,Male,75,75-79,7
11,1,3,0,4,2020-10-16,Male,79,75-79,9
11,0,10,0,10,2020-10-16,Male,32,25-34,9
11,0,0,0,0,2020-10-16,Male,54,45-54,9
11,0,2,0,2,2020-10-15,Female,68,65-69,7
11,2,1,0,3,2020-10-16,Male,64,55-64,5
11,1,0,1,2,2020-10-16,Male,63,55-64,6
11,0,2,0,2,2020-10-16,Female,67,65-69,9
11,2,8,0,10,2020-10-20,Female,24,20-24,1
11,0,1,0,1,2020-10-19,Female,68,65-69,9
11,2,0,0,2,2020-10-16,Male,31,25-34,3
11,2,4,0,6,2020-10-16,Female,78,75-79,9
11,0,0,0,0,2020-10-16,Female,66,65-69,6
11,0,5,25,30,2020-10-16,Female,63,55-64,6
11,1,1,0,2,2020-10-15,Male,68,65-69,10
11,4,0,4,8,2020-10-15,Male,12,10-14,4
11,0,1,0,1,2020-10-15,Female,33,25-34,6
11,3,2,0,5,2020-10-18,Male,53,45-54,7
11,2,0,0,2,2020-10-17,Female,11,10-14,8
11,0,0,0,0,2020-10-19,Female,68,65-69,2
11,1,2,0,3,2020-10-19,Male,37,35-44,5
11,0,1,0,1,2020-10-20,Male,29,25-34,10
11,0,6,0,6,2020-10-18,Female,71,70-74,6
11,3,1,0,4,2020-10-16,Female,52,45-54,6
11,2,1,0,3,2020-10-17,Male,61,55-64,8
11,1,0,0,1,2020-10-18,Female,19,15-19,2
11,2,0,0,2,2020-10-19,Female,66,65-69,9
11,0,0,0,0,2020-10-16,Female,78,75-79,7
11,0,0,0,0,2020-10-16,Male,54,45-54,9
11,0,0,0,0,2020-10-15,Male,66,65-69,11
11,1,0,0,1,2020-10-15,Female,69,65-69,8
11,0,1,0,1,2020-10-15,Female,76,75-79,9
11,1,0,0,1,2020-10-15,Male,37,35-44,7
11,0,1,0,1,2020-10-15,Female,48,45-54,9
11,1,1,0,2,2020-10-17,Male,61,55-64,5
11,1,2,0,3,2020-10-16,Female,50,45-54,6
11,4,0,72,76,2020-10-20,Male,20,20-24,1
11,0,1,0,1,2020-10-20,Female,18,15-19,1
11,1,0,0,1,2020-10-19,Male,68,65-69,10
11,0,0,1,1,2020-10-19,Male,57,55-64,5
11,1,1,0,2,2020-10-18,Female,54,45-54,7
11,1,2,0,3,2020-10-16,Male,62,55-64,7
11,0,1,0,1,2020-10-16,Female,65,65-69,6
11,0,0,0,0,2020-10-20,Female,32,25-34,4
11,0,1,0,1,2020-10-16,Male,21,20-24,5
11,1,1,1,3,2020-10-15,Female,60,55-64,7
11,0,8,0,8,2020-10-15,Male,51,45-54,7
11,0,0,0,0,2020-10-15,Female,49,45-54,8
11,2,0,0,2,2020-10-20,Male,66,65-69,5
11,0,0,0,0,2020-10-16,Male,74,70-74,10
11,1,2,0,3,2020-10-15,Female,15,15-19,10
11,3,0,0,3,2020-10-15,Female,11,10-14,9
11,1,4,0,5,2020-10-15,Male,10,10-14,9
11,1,0,0,1,2020-10-15,Female,69,65-69,8
11,3,1,0,4,2020-10-15,Female,10,10-14,7
11,0,0,0,0,2020-10-16,Female,65,65-69,7
11,1,0,0,1,2020-10-15,Female,26,25-34,8
11,2,2,0,4,2020-10-16,Male,75,75-79,10
11,1,0,0,1,2020-10-16,Male,73,70-74,8
11,2,1,0,3,2020-10-17,Male,52,45-54,6
11,0,0,0,0,2020-10-15,Male,38,35-44,4
11,0,0,0,0,2020-10-15,Male,30,25-34,6
11,0,1,0,1,2020-10-15,Female,24,20-24,9
11,5,10,0,15,2020-10-15,Male,63,55-64,9
11,2,0,0,2,2020-10-19,Male,29,25-34,6
11,3,1,0,4,2020-10-17,Female,55,55-64,5
11,1,0,0,1,2020-10-19,Male,63,55-64,8
11,3,1,0,4,2020-10-16,Male,15,15-19,7
11,2,1,0,3,2020-10-17,Male,54,45-54,10
11,0,0,0,0,2020-10-19,Male,60,55-64,3
11,0,0,0,0,2020-10-15,Female,5,5-9,9
11,2,0,0,2,2020-10-16,Male,72,70-74,6
11,2,1,0,3,2020-10-16,Male,72,70-74,5
11,1,10,0,11,2020-10-16,Female,52,45-54,9
11,0,0,0,0,2020-10-17,Male,85,85+,3
11,0,3,0,3,2020-10-16,Female,71,70-74,9
11,0,0,0,0,2020-10-15,Male,10,10-14,6
11,0,0,0,0,2020-10-16,Male,30,25-34,9
11,2,0,0,2,2020-10-17,Female,19,15-19,4
11,5,3,0,8,2020-10-17,Male,1,1-4,2
11,0,0,0,0,2020-10-17,Female,56,55-64,10
11,0,0,0,0,2020-10-15,Male,67,65-69,7
11,0,0,0,0,2020-10-20,Female,85,85+,7
11,0,0,0,0,2020-10-16,Male,51,45-54,8
11,0,4,0,4,2020-10-15,Male,54,45-54,8
11,2,1,0,3,2020-10-17,Female,7,5-9,8
11,2,1,0,3,2020-10-16,Male,66,65-69,10
11,0,3,0,3,2020-10-18,Female,69,65-69,5
11,2,0,0,2,2020-10-18,Male,50,45-54,7
11,0,0,0,0,2020-10-19,Female,29,25-34,7
11,0,1,0,1,2020-10-15,Male,45,45-54,8
11,2,0,0,2,2020-10-16,Female,68,65-69,6
11,2,0,0,2,2020-10-18,Male,54,45-54,4
11,2,2,0,4,2020-10-15,Female,47,45-54,5
11,2,0,0,2,2020-10-16,Male,3,1-4,6
11,0,0,0,0,2020-10-16,Male,63,55-64,9
11,1,7,0,8,2020-10-17,Male,66,65-69,8
11,2,1,0,3,2020-10-15,Male,6,5-9,10
11,5,1,0,6,2020-10-14,Female,17,15-19,4
11,0,3,0,3,2020-10-15,Male,25,25-34,4
11,3,10,0,13,2020-10-18,Male,60,55-64,9
11,0,0,0,0,2020-10-16,Male,58,55-64,10
11,1,2,0,3,2020-10-16,Female,65,65-69,11
11,0,0,0,0,2020-10-16,Female,72,70-74,3
11,4,6,0,10,2020-10-15,Male,12,10-14,11
11,2,2,0,4,2020-10-16,Male,50,45-54,9
11,0,0,0,0,2020-10-16,Male,74,70-74,11
11,1,5,0,6,2020-10-20,Male,15,15-19,1
11,0,3,0,3,2020-10-16,Female,66,65-69,6
11,0,0,0,0,2020-10-15,Male,70,70-74,6
11,1,2,0,3,2020-10-16,Male,54,45-54,9
11,0,0,0,0,2020-10-15,Female,68,65-69,10
11,0,0,0,0,2020-10-15,Male,77,75-79,7
11,1,0,0,1,2020-10-16,Male,85,85+,7
11,1,4,0,5,2020-10-19,Female,55,55-64,7
11,0,0,0,0,2020-10-15,Female,9,5-9,5
11,1,1,0,2,2020-10-16,Female,64,55-64,5
11,2,1,0,3,2020-10-20,Female,67,65-69,3
11,2,0,0,2,2020-10-16,Male,66,65-69,8
11,1,0,0,1,2020-10-16,Male,59,55-64,10
11,1,0,0,1,2020-10-15,Male,54,45-54,7
11,0,0,0,0,2020-10-19,Female,68,65-69,11
11,0,0,0,0,2020-10-14,Female,24,20-24,11
11,0,0,0,0,2020-10-15,Male,43,35-44,7
11,1,0,0,1,2020-10-16,Male,51,45-54,11
11,0,0,0,0,2020-10-17,Female,66,65-69,5
11,0,0,0,0,2020-10-15,Male,30,25-34,10
11,3,0,0,3,2020-10-18,Female,1,1-4,7
11,0,1,0,1,2020-10-15,Female,23,20-24,8
11,1,0,0,1,2020-10-15,Male,34,25-34,7
11,0,0,0,0,2020-10-15,Female,48,45-54,11
11,0,0,0,0,2020-10-15,Male,70,70-74,8
11,2,0,0,2,2020-10-15,Female,63,55-64,10
11,1,2,0,3,2020-10-17,Male,63,55-64,8
11,3,0,0,3,2020-10-16,Female,5,5-9,5
11,2,2,0,4,2020-10-16,Female,37,35-44,9
11,3,0,0,3,2020-10-20,Female,22,20-24,1
11,2,4,0,6,2020-10-16,Female,61,55-64,9
11,1,0,0,1,2020-10-15,Male,70,70-74,9
11,1,0,0,1,2020-10-16,Female,57,55-64,5
11,2,0,0,2,2020-10-16,Male,51,45-54,6
11,0,4,0,4,2020-10-16,Female,66,65-69,11
11,0,2,0,2,2020-10-17,Female,66,65-69,9
11,0,3,0,3,2020-10-15,Female,69,65-69,5
11,3,0,0,3,2020-10-17,Female,8,5-9,6
11,0,1,0,1,2020-10-19,Female,53,45-54,7
11,0,1,0,1,2020-10-18,Male,54,45-54,7
11,3,0,0,3,2020-10-19,Female,46,45-54,9
11,0,4,0,4,2020-10-16,Male,54,45-54,8
11,2,0,0,2,2020-10-16,Male,65,65-69,8
11,0,1,0,1,2020-10-16,Male,57,55-64,6
11,1,0,0,1,2020-10-16,Female,55,55-64,9
11,2,0,0,2,2020-10-16,Male,40,35-44,10
11,0,1,0,1,2020-10-15,Male,38,35-44,8
11,0,1,0,1,2020-10-15,Male,39,35-44,7
11,2,5,0,7,2020-10-16,Female,44,35-44,2
11,3,0,0,3,2020-10-14,Female,21,20-24,8
11,1,2,0,3,2020-10-18,Male,24,20-24,6
11,2,2,0,4,2020-10-16,Female,62,55-64,6
11,3,0,0,3,2020-10-20,Female,15,15-19,4
11,2,0,0,2,2020-10-19,Female,56,55-64,5
11,2,1,0,3,2020-10-17,Female,8,5-9,10
11,1,2,0,3,2020-10-15,Male,66,65-69,10
11,0,1,0,1,2020-10-17,Male,61,55-64,7
11,2,11,0,13,2020-10-15,Male,63,55-64,8
11,1,0,0,1,2020-10-17,Female,64,55-64,4
11,0,2,0,2,2020-10-15,Male,73,70-74,8
11,1,10,0,11,2020-10-16,Female,32,25-34,3
11,0,0,0,0,2020-10-16,Female,57,55-64,8
11,3,0,0,3,2020-10-16,Male,43,35-44,8
11,0,1,0,1,2020-10-15,Male,70,70-74,9
11,0,0,0,0,2020-10-16,Female,15,15-19,10
11,1,0,0,1,2020-10-16,Male,62,55-64,11
11,1,0,0,1,2020-10-15,Male,67,65-69,11
11,0,0,0,0,2020-10-16,Male,57,55-64,10
11,1,0,0,1,2020-10-16,Female,71,70-74,7
11,0,2,10,12,2020-10-19,Male,51,45-54,4
11,0,7,41,48,2020-10-16,Female,60,55-64,3
11,3,0,0,3,2020-10-19,Male,5,5-9,11
11,2,14,0,16,2020-10-18,Female,55,55-64,10
11,0,4,0,4,2020-10-19,Male,59,55-64,6
11,0,0,0,0,2020-10-20,Female,26,25-34,6
11,3,0,0,3,2020-10-16,Female,9,5-9,6
11,0,0,0,0,2020-10-19,Male,53,45-54,6
11,0,0,0,0,2020-10-14,Female,22,20-24,7
11,0,0,0,0,2020-10-15,Female,35,35-44,8
11,2,4,0,6,2020-10-19,Male,55,55-64,6
11,1,0,0,1,2020-10-16,Male,62,55-64,7
11,0,4,0,4,2020-10-15,Male,26,25-34,5
11,0,0,0,0,2020-10-16,Female,11,10-14,7
11,0,0,0,0,2020-10-17,Male,53,45-54,6
11,2,0,0,2,2020-10-17,Female,73,70-74,4
11,0,0,0,0,2020-10-15,Male,37,35-44,9
11,2,0,0,2,2020-10-16,Male,78,75-79,7
11,0,0,1,1,2020-10-20,Female,19,15-19,1
11,2,2,0,4,2020-10-18,Male,13,10-14,5
11,1,0,0,1,2020-10-15,Male,64,55-64,11
11,1,0,0,1,2020-10-19,Female,51,45-54,8
11,2,0,0,2,2020-10-16,Female,18,15-19,11
11,0,1,0,1,2020-10-16,Female,73,70-74,5
11,5,0,0,5,2020-10-15,Female,6,5-9,7
11,3,3,32,38,2020-10-20,Male,59,55-64,3
11,1,10,0,11,2020-10-17,Female,56,55-64,5
11,4,2,10,16,2020-10-20,Male,18,15-19,1
11,2,2,0,4,2020-10-16,Male,55,55-64,11
11,1,0,0,1,2020-10-16,Female,54,45-54,8
11,0,0,0,0,2020-10-15,Male,59,55-64,10
11,0,3,0,3,2020-10-16,Female,59,55-64,9
11,0,2,0,2,2020-10-16,Female,66,65-69,3
11,0,0,0,0,2020-10-15,Female,23,20-24,9
11,1,10,0,11,2020-10-15,Male,32,25-34,8
11,0,0,0,0,2020-10-14,Male,27,25-34,10
11,3,8,0,11,2020-10-17,Male,58,55-64,7
11,0,0,0,0,2020-10-15,Female,5,5-9,11
11,0,0,0,0,2020-10-15,Female,41,35-44,11
11,1,4,0,5,2020-10-15,Male,68,65-69,8
11,0,0,0,0,2020-10-18,Female,26,25-34,5
11,1,5,0,6,2020-10-16,Male,73,70-74,4
11,2,0,0,2,2020-10-15,Female,73,70-74,4
11,0,0,0,0,2020-10-15,Male,14,10-14,7
11,2,0,0,2,2020-10-16,Male,66,65-69,8
11,2,0,0,2,2020-10-20,Male,13,10-14,1
11,2,1,0,3,2020-10-18,Male,33,25-34,7
11,1,10,0,11,2020-10-16,Female,61,55-64,6
11,3,2,0,5,2020-10-16,Female,65,65-69,5
11,0,0,0,0,2020-10-15,Male,69,65-69,8
11,0,0,1,1,2020-10-15,Female,30,25-34,10
11,3,1,0,4,2020-10-15,Male,17,15-19,8
11,0,0,0,0,2020-10-16,Female,73,70-74,7
11,0,0,0,0,2020-10-16,Male,59,55-64,7
11,1,0,0,1,2020-10-20,Female,52,45-54,6
11,1,4,0,5,2020-10-15,Male,68,65-69,10
11,0,0,0,0,2020-10-16,Male,78,75-79,4
11,2,0,0,2,2020-10-16,Male,70,70-74,10
11,0,2,0,2,2020-10-15,Male,59,55-64,7
11,1,0,0,1,2020-10-15,Male,58,55-64,7
11,2,0,0,2,2020-10-18,Male,66,65-69,6
11,0,1,0,1,2020-10-16,Female,53,45-54,7
11,0,1,0,1,2020-10-16,Male,50,45-54,8
11,2,2,0,4,2020-10-15,Male,15,15-19,6
11,3,0,0,3,2020-10-15,Male,4,1-4,8
11,0,1,0,1,2020-10-16,Female,31,25-34,7
11,0,2,0,2,2020-10-16,Male,61,55-64,8
11,0,2,0,2,2020-10-16,Female,69,65-69,8
11,0,1,0,1,2020-10-14,Male,67,65-69,11
11,2,2,0,4,2020-10-18,Male,77,75-79,4
11,3,1,0,4,2020-10-16,Female,66,65-69,5
11,1,0,0,1,2020-10-18,Male,35,35-44,8
11,1,2,0,3,2020-10-17,Female,21,20-24,2
11,2,0,0,2,2020-10-15,Female,23,20-24,5
11,1,0,0,1,2020-10-16,Female,48,45-54,6
11,0,1,0,1,2020-10-16,Male,59,55-64,8
11,0,0,0,0,2020-10-15,Male,37,35-44,10
11,0,1,0,1,2020-10-19,Female,42,35-44,7
11,0,0,0,0,2020-10-15,Male,8,5-9,5
11,0,0,0,0,2020-10-15,Male,51,45-54,8
11,2,0,0,2,2020-10-16,Male,5,5-9,5
11,1,1,0,2,2020-10-15,Female,46,45-54,9
11,2,2,0,4,2020-10-15,Male,68,65-69,5
11,0,0,20,20,2020-10-15,Male,42,35-44,4
11,0,2,0,2,2020-10-16,Male,62,55-64,6
11,1,3,0,4,2020-10-17,Male,55,55-64,9
11,1,1,0,2,2020-10-15,Female,41,35-44,7
11,1,0,0,1,2020-10-16,Female,52,45-54,5
11,2,0,0,2,2020-10-16,Female,70,70-74,8
11,0,0,0,0,2020-10-17,Female,65,65-69,6
11,3,0,0,3,2020-10-16,Male,18,15-19,9
11,0,1,0,1,2020-10-16,Male,54,45-54,8
11,3,0,0,3,2020-10-16,Female,59,55-64,7
11,1,0,0,1,2020-10-15,Female,36,35-44,5
11,0,2,0,2,2020-10-16,Male,59,55-64,4
11,3,0,0,3,2020-10-17,Female,51,45-54,4
11,1,0,0,1,2020-10-19,Male,22,20-24,8
11,0,0,0,0,2020-10-15,Male,30,25-34,7
11,1,1,0,2,2020-10-14,Female,21,20-24,8
11,3,0,0,3,2020-10-16,Female,66,65-69,10
11,0,0,0,0,2020-10-16,Male,51,45-54,9
11,0,0,0,0,2020-10-16,Female,59,55-64,3
11,0,1,0,1,2020-10-16,Male,65,65-69,8
11,3,0,4,7,2020-10-15,Female,49,45-54,5
11,0,0,0,0,2020-10-16,Male,59,55-64,7
11,1,2,0,3,2020-10-15,Male,69,65-69,6
11,0,10,10,20,2020-10-15,Male,30,25-34,8
11,0,0,0,0,2020-10-18,Male,36,35-44,7
11,2,1,0,3,2020-10-15,Female,28,25-34,5
11,2,2,0,4,2020-10-15,Female,69,65-69,8
11,0,0,0,0,2020-10-15,Female,26,25-34,8
11,1,0,0,1,2020-10-16,Female,60,55-64,8
11,0,0,100,100,2020-10-15,Male,40,35-44,7
11,0,2,0,2,2020-10-16,Male,65,65-69,11
11,1,4,0,5,2020-10-17,Male,52,45-54,5
11,0,0,0,0,2020-10-15,Male,70,70-74,5
11,0,1,1,2,2020-10-18,Male,56,55-64,6
11,1,10,4,15,2020-10-15,Female,65,65-69,11
11,1,2,0,3,2020-10-15,Male,69,65-69,9
11,1,2,0,3,2020-10-16,Female,71,70-74,5
11,2,0,0,2,2020-10-16,Male,62,55-64,6
11,0,0,0,0,2020-10-16,Male,46,45-54,7
11,0,3,0,3,2020-10-16,Female,65,65-69,7
11,1,1,0,2,2020-10-16,Male,79,75-79,7
11,1,2,0,3,2020-10-16,Male,72,70-74,4
11,0,0,1,1,2020-10-15,Male,67,65-69,7
11,1,0,0,1,2020-10-14,Female,67,65-69,6
11,0,6,0,6,2020-10-20,Female,22,20-24,1
11,0,0,0,0,2020-10-16,Female,64,55-64,11
11,1,0,0,1,2020-10-16,Male,58,55-64,11
11,2,0,0,2,2020-10-15,Male,69,65-69,10
11,0,3,4,7,2020-10-15,Male,51,45-54,10
11,3,3,100,106,2020-10-19,Male,9,5-9,3
11,1,0,0,1,2020-10-19,Male,72,70-74,8
11,2,3,0,5,2020-10-16,Female,77,75-79,8
11,2,1,0,3,2020-10-16,Male,71,70-74,9
11,1,0,0,1,2020-10-16,Female,63,55-64,6
11,2,0,0,2,2020-10-15,Female,15,15-19,10
11,1,3,0,4,2020-10-15,Female,39,35-44,10
11,1,0,0,1,2020-10-16,Female,58,55-64,10
11,0,0,0,0,2020-10-16,Male,77,75-79,4
11,3,0,0,3,2020-10-15,Male,15,15-19,11
11,0,3,0,3,2020-10-15,Male,40,35-44,8
11,1,2,0,3,2020-10-19,Male,77,75-79,3
11,0,1,0,1,2020-10-15,Male,67,65-69,7
11,1,0,0,1,2020-10-15,Female,66,65-69,6
11,1,0,0,1,2020-10-16,Female,68,65-69,10
11,3,0,0,3,2020-10-15,Female,15,15-19,6
11,0,0,0,0,2020-10-15,Female,28,25-34,9
11,4,0,0,4,2020-10-15,Female,32,25-34,9
11,1,0,0,1,2020-10-16,Female,63,55-64,7
11,0,0,0,0,2020-10-19,Female,33,25-34,7
11,2,3,0,5,2020-10-16,Female,48,45-54,5
11,0,0,0,0,2020-10-15,Female,46,45-54,8
11,1,0,0,1,2020-10-15,Male,65,65-69,5
11,0,0,0,0,2020-10-15,Female,68,65-69,10
11,2,2,0,4,2020-10-15,Female,17,15-19,7
11,1,0,0,1,2020-10-17,Male,62,55-64,5
11,1,0,0,1,2020-10-16,Female,16,15-19,10
11,0,0,0,0,2020-10-19,Male,23,20-24,8
11,0,2,0,2,2020-10-16,Male,59,55-64,7
11,0,1,1,2,2020-10-15,Male,43,35-44,5
11,7,0,0,7,2020-10-20,Male,2,1-4,1
11,1,0,0,1,2020-10-16,Male,59,55-64,8
11,0,0,0,0,2020-10-17,Male,31,25-34,7
11,2,0,0,2,2020-10-14,Male,26,25-34,8
11,1,2,0,3,2020-10-15,Female,67,65-69,8
11,2,0,17,19,2020-10-20,Female,23,20-24,1
11,2,1,0,3,2020-10-16,Male,56,55-64,7
11,2,3,0,5,2020-10-16,Male,70,70-74,6
11,0,0,0,0,2020-10-15,Male,69,65-69,9
11,1,0,0,1,2020-10-19,Male,59,55-64,8
11,1,0,0,1,2020-10-15,Male,44,35-44,10
11,0,0,0,0,2020-10-16,Male,52,45-54,4
11,3,12,65,80,2020-10-16,Male,30,25-34,10
11,1,5,0,6,2020-10-17,Male,21,20-24,4
11,3,0,0,3,2020-10-15,Female,0,<1,9
11,1,0,0,1,2020-10-16,Female,63,55-64,5
11,0,1,0,1,2020-10-16,Male,42,35-44,8
11,1,1,0,2,2020-10-19,Male,2,1-4,5
11,0,0,0,0,2020-10-16,Male,36,35-44,9
11,2,0,0,2,2020-10-18,Female,24,20-24,5
11,3,0,0,3,2020-10-19,Male,14,10-14,7
11,2,0,0,2,2020-10-15,Female,67,65-69,9
11,1,0,0,1,2020-10-16,Male,50,45-54,8
11,1,0,0,1,2020-10-19,Male,32,25-34,4
11,0,3,0,3,2020-10-20,Female,24,20-24,7
11,1,2,0,3,2020-10-20,Female,22,20-24,1
11,1,10,0,11,2020-10-16,Male,51,45-54,10
11,0,1,0,1,2020-10-16,Female,55,55-64,6
11,0,0,0,0,2020-10-16,Female,25,25-34,6
11,1,0,0,1,2020-10-16,Male,70,70-74,8
11,1,0,0,1,2020-10-15,Male,67,65-69,7
11,2,0,0,2,2020-10-15,Female,60,55-64,9
11,1,0,0,1,2020-10-15,Male,40,35-44,7
11,0,0,0,0,2020-10-15,Male,53,45-54,6
11,0,0,0,0,2020-10-15,Female,30,25-34,10
11,0,0,0,0,2020-10-15,Male,33,25-34,10
11,0,0,0,0,2020-10-18,Male,46,45-54,5
11,1,0,0,1,2020-10-17,Female,54,45-54,8
11,0,0,0,0,2020-10-15,Female,66,65-69,9
11,1,0,0,1,2020-10-19,Female,68,65-69,6
11,0,0,0,0,2020-10-15,Female,67,65-69,7
11,1,9,0,10,2020-10-20,Male,22,20-24,1
11,0,1,0,1,2020-10-15,Female,69,65-69,7
11,2,0,0,2,2020-10-15,Male,45,45-54,11
11,0,0,0,0,2020-10-16,Female,55,55-64,10
11,3,2,0,5,2020-10-19,Male,2,1-4,3
11,1,0,0,1,2020-10-18,Female,29,25-34,5
11,0,2,4,6,2020-10-15,Male,29,25-34,7
11,1,0,0,1,2020-10-19,Male,59,55-64,3
11,3,0,0,3,2020-10-18,Male,16,15-19,5
11,1,10,0,11,2020-10-15,Male,68,65-69,8
11,0,0,0,0,2020-10-15,Male,28,25-34,6
11,3,1,0,4,2020-10-19,Female,55,55-64,3
11,3,0,0,3,2020-10-19,Female,16,15-19,5
11,1,0,0,1,2020-10-19,Male,78,75-79,5
11,2,0,0,2,2020-10-18,Male,11,10-14,8
11,1,0,0,1,2020-10-17,Female,45,45-54,6
11,2,1,0,3,2020-10-16,Male,67,65-69,4
11,0,0,0,0,2020-10-19,Male,47,45-54,5
11,1,2,0,3,2020-10-16,Male,73,70-74,6
11,2,0,0,2,2020-10-15,Female,58,55-64,9
11,0,2,0,2,2020-10-15,Male,35,35-44,7
11,5,1,0,6,2020-10-16,Male,16,15-19,7
11,1,1,0,2,2020-10-16,Male,31,25-34,8
11,1,1,0,2,2020-10-15,Male,58,55-64,8
11,0,3,0,3,2020-10-16,Male,42,35-44,7
11,5,4,0,9,2020-10-19,Female,4,1-4,2
11,3,3,0,6,2020-10-15,Male,14,10-14,8
11,3,27,0,30,2020-10-19,Male,12,10-14,7
11,0,0,0,0,2020-10-16,Male,65,65-69,7
11,1,0,0,1,2020-10-16,Female,66,65-69,8
11,1,0,0,1,2020-10-16,Female,67,65-69,9
11,2,4,0,6,2020-10-16,Male,81,80-84,6
11,2,0,0,2,2020-10-20,Male,50,45-54,6
11,1,2,0,3,2020-10-20,Female,53,45-54,6
11,0,4,6,10,2020-10-19,Female,47,45-54,7
11,1,0,0,1,2020-10-16,Male,71,70-74,7
11,0,0,0,0,2020-10-14,Female,23,20-24,8
11,0,1,0,1,2020-10-16,Male,27,25-34,8
11,0,1,0,1,2020-10-16,Male,65,65-69,9
11,1,0,0,1,2020-10-20,Female,14,10-14,4
11,2,0,0,2,2020-10-15,Female,69,65-69,2
11,1,0,0,1,2020-10-16,Female,62,55-64,9
11,1,2,0,3,2020-10-16,Female,52,45-54,5
11,0,0,0,0,2020-10-16,Male,65,65-69,10
11,0,0,0,0,2020-10-16,Male,57,55-64,5
11,0,0,0,0,2020-10-15,Male,66,65-69,9
11,1,0,0,1,2020-10-16,Male,63,55-64,10
11,0,4,0,4,2020-10-16,Female,69,65-69,6
11,2,0,0,2,2020-10-20,Female,68,65-69,6
11,1,3,0,4,2020-10-15,Male,30,25-34,5
11,0,1,0,1,2020-10-15,Female,28,25-34,6
11,1,0,0,1,2020-10-16,Male,72,70-74,9
11,2,1,0,3,2020-10-15,Female,46,45-54,6
11,0,0,0,0,2020-10-16,Female,63,55-64,8
11,0,0,0,0,2020-10-16,Female,35,35-44,10
11,6,0,0,6,2020-10-19,Male,9,5-9,8
11,2,0,0,2,2020-10-15,Male,70,70-74,6
11,5,5,0,10,2020-10-15,Female,13,10-14,8
11,3,3,0,6,2020-10-16,Female,65,65-69,11
11,0,0,0,0,2020-10-15,Female,61,55-64,9
11,0,0,0,0,2020-10-15,Female,31,25-34,8
11,2,0,0,2,2020-10-15,Male,54,45-54,9
11,2,0,0,2,2020-10-17,Male,54,45-54,5
11,0,0,0,0,2020-10-18,Female,42,35-44,7
11,0,2,80,82,2020-10-19,Female,66,65-69,6
11,2,0,0,2,2020-10-16,Female,59,55-64,9
11,1,0,0,1,2020-10-14,Female,22,20-24,7
11,1,1,0,2,2020-10-15,Male,55,55-64,6
11,0,0,0,0,2020-10-15,Female,31,25-34,8
11,1,0,0,1,2020-10-16,Male,53,45-54,8
11,0,0,0,0,2020-10-18,Male,60,55-64,6
11,6,1,0,7,2020-10-16,Female,28,25-34,6
11,1,5,0,6,2020-10-15,Male,39,35-44,7
11,3,2,9,14,2020-10-16,Female,10,10-14,9
11,0,10,0,10,2020-10-15,Male,43,35-44,8
11,1,1,0,2,2020-10-15,Male,40,35-44,7
11,3,0,0,3,2020-10-16,Male,18,15-19,5
11,4,1,0,5,2020-10-19,Male,65,65-69,4
11,0,0,0,0,2020-10-16,Female,63,55-64,10
11,0,0,0,0,2020-10-14,Male,19,15-19,11
11,1,0,0,1,2020-10-15,Female,66,65-69,8
11,2,4,0,6,2020-10-17,Female,61,55-64,8
11,0,1,0,1,2020-10-15,Male,60,55-64,5
11,0,2,0,2,2020-10-16,Female,61,55-64,10
11,0,0,0,0,2020-10-16,Male,50,45-54,7
11,1,0,0,1,2020-10-20,Male,44,35-44,10
11,0,1,0,1,2020-10-15,Male,18,15-19,7
11,1,0,0,1,2020-10-15,Male,70,70-74,6
11,0,0,0,0,2020-10-15,Female,68,65-69,7
11,1,2,0,3,2020-10-15,Male,69,65-69,7
11,3,2,0,5,2020-10-19,Male,39,35-44,4
11,1,2,0,3,2020-10-15,Male,7,5-9,6
11,1,1,0,2,2020-10-15,Female,70,70-74,9
11,0,0,0,0,2020-10-19,Male,7,5-9,7
11,2,1,0,3,2020-10-14,Male,67,65-69,7
11,1,0,0,1,2020-10-16,Male,66,65-69,8
11,0,0,0,0,2020-10-20,Female,22,20-24,1
11,0,1,0,1,2020-10-16,Female,57,55-64,7
11,0,0,0,0,2020-10-15,Male,69,65-69,7
11,0,0,0,0,2020-10-19,Female,33,25-34,5
11,0,0,0,0,2020-10-15,Male,42,35-44,4
11,0,0,0,0,2020-10-15,Male,74,70-74,9
11,0,1,0,1,2020-10-16,Female,33,25-34,10
11,1,0,0,1,2020-10-15,Male,67,65-69,11
11,0,0,0,0,2020-10-19,Male,34,25-34,8
11,2,1,0,3,2020-10-16,Male,78,75-79,5
11,4,0,0,4,2020-10-15,Female,43,35-44,5
11,1,3,0,4,2020-10-15,Male,68,65-69,7
11,2,0,0,2,2020-10-19,Male,15,15-19,5
11,0,0,0,0,2020-10-16,Male,8,5-9,4
11,0,2,0,2,2020-10-19,Male,24,20-24,8
11,0,0,0,0,2020-10-15,Male,19,15-19,8
11,1,0,0,1,2020-10-16,Female,11,10-14,6
11,3,0,0,3,2020-10-18,Female,6,5-9,5
11,0,1,0,1,2020-10-15,Male,42,35-44,3
11,1,8,13,22,2020-10-16,Female,56,55-64,4
11,4,0,0,4,2020-10-19,Male,10,10-14,7
11,2,2,0,4,2020-10-17,Female,61,55-64,7
11,2,0,0,2,2020-10-16,Female,35,35-44,4
11,0,0,0,0,2020-10-14,Female,22,20-24,8
11,2,2,0,4,2020-10-15,Male,78,75-79,6
11,2,0,0,2,2020-10-16,Male,52,45-54,8
11,2,1,0,3,2020-10-16,Male,66,65-69,5
11,1,0,0,1,2020-10-16,Male,51,45-54,7
11,0,1,0,1,2020-10-16,Male,51,45-54,6
11,3,1,0,4,2020-10-15,Female,42,35-44,10
11,3,0,0,3,2020-10-15,Female,70,70-74,8
11,1,1,0,2,2020-10-16,Female,24,20-24,9
11,0,1,0,1,2020-10-16,Female,71,70-74,6
11,0,0,0,0,2020-10-15,Male,31,25-34,7
11,0,0,0,0,2020-10-15,Female,68,65-69,11
11,0,0,0,0,2020-10-19,Male,59,55-64,6
11,2,0,2,4,2020-10-19,Female,36,35-44,6
11,2,0,0,2,2020-10-15,Male,11,10-14,8
11,2,2,24,28,2020-10-20,Male,24,20-24,1
11,2,0,0,2,2020-10-15,Male,69,65-69,4
11,2,1,0,3,2020-10-16,Female,50,45-54,9
11,0,1,0,1,2020-10-17,Female,69,65-69,5
11,3,0,0,3,2020-10-15,Male,32,25-34,8
11,3,2,0,5,2020-10-16,Female,14,10-14,8
11,3,0,0,3,2020-10-16,Female,2,1-4,8
11,1,3,0,4,2020-10-16,Male,59,55-64,3
11,0,0,0,0,2020-10-15,Male,44,35-44,7
11,0,2,0,2,2020-10-19,Female,67,65-69,9
11,1,0,0,1,2020-10-16,Female,58,55-64,9
11,0,1,0,1,2020-10-16,Female,66,65-69,4
11,0,1,0,1,2020-10-16,Female,54,45-54,9
11,0,0,0,0,2020-10-20,Female,58,55-64,4
11,0,0,0,0,2020-10-15,Female,41,35-44,10
11,0,0,0,0,2020-10-15,Female,64,55-64,10
11,3,0,0,3,2020-10-15,Male,40,35-44,6
11,2,2,0,4,2020-10-20,Female,70,70-74,4
11,0,2,0,2,2020-10-19,Male,22,20-24,5
11,1,0,0,1,2020-10-16,Female,52,45-54,11
11,0,0,0,0,2020-10-15,Male,40,35-44,7
11,1,0,0,1,2020-10-20,Male,36,35-44,4
11,3,0,0,3,2020-10-15,Male,19,15-19,7
11,0,0,0,0,2020-10-16,Male,77,75-79,10
11,0,0,0,0,2020-10-19,Male,44,35-44,6
11,1,0,0,1,2020-10-16,Male,66,65-69,11
11,0,0,0,0,2020-10-19,Female,29,25-34,4
11,2,0,0,2,2020-10-15,Female,66,65-69,10
11,1,1,0,2,2020-10-16,Female,65,65-69,5
11,2,0,0,2,2020-10-19,Female,12,10-14,8
11,0,0,0,0,2020-10-15,Male,3,1-4,5
11,0,0,0,0,2020-10-15,Male,48,45-54,10
11,1,0,0,1,2020-10-16,Male,65,65-69,6
11,2,0,0,2,2020-10-20,Female,67,65-69,4
11,0,1,0,1,2020-10-17,Male,39,35-44,9
11,1,10,0,11,2020-10-16,Female,65,65-69,11
11,0,1,0,1,2020-10-15,Male,44,35-44,9
11,0,0,0,0,2020-10-15,Female,39,35-44,5
11,2,3,0,5,2020-10-16,Male,74,70-74,8
11,0,0,0,0,2020-10-15,Male,30,25-34,8
11,2,0,0,2,2020-10-15,Female,62,55-64,8
11,0,0,0,0,2020-10-15,Female,54,45-54,7
11,1,1,0,2,2020-10-14,Female,67,65-69,9
11,1,1,1,3,2020-10-16,Male,48,45-54,4
11,0,0,0,0,2020-10-15,Male,35,35-44,11
11,1,2,0,3,2020-10-20,Female,19,15-19,1
11,1,0,0,1,2020-10-16,Male,64,55-64,8
11,2,0,0,2,2020-10-18,Male,60,55-64,7
11,0,0,0,0,2020-10-15,Male,41,35-44,9
11,0,0,0,0,2020-10-15,Male,34,25-34,5
11,3,3,0,6,2020-10-15,Male,69,65-69,5
11,2,0,0,2,2020-10-15,Female,14,10-14,11
11,0,0,0,0,2020-10-16,Female,58,55-64,9
11,1,0,0,1,2020-10-15,Female,34,25-34,6
11,0,0,0,0,2020-10-16,Female,59,55-64,9
11,2,0,0,2,2020-10-15,Male,16,15-19,7
11,1,0,0,1,2020-10-16,Male,65,65-69,8
11,0,0,0,0,2020-10-15,Female,16,15-19,9
11,0,0,0,0,2020-10-19,Female,49,45-54,9
11,0,0,0,0,2020-10-16,Female,54,45-54,7
11,1,5,0,6,2020-10-20,Male,23,20-24,1
11,0,0,0,0,2020-10-16,Female,21,20-24,6
11,1,0,2,3,2020-10-15,Female,13,10-14,8
11,0,2,0,2,2020-10-20,Male,43,35-44,6
11,3,1,0,4,2020-10-19,Female,19,15-19,6
11,0,2,0,2,2020-10-15,Female,24,20-24,7
11,0,2,0,2,2020-10-16,Female,53,45-54,10
11,1,3,0,4,2020-10-16,Male,74,70-74,5
11,0,0,0,0,2020-10-15,Male,39,35-44,8
11,0,0,0,0,2020-10-15,Male,35,35-44,6
11,4,1,0,5,2020-10-19,Male,16,15-19,5
11,2,1,0,3,2020-10-14,Male,67,65-69,5
11,0,0,0,0,2020-10-17,Female,16,15-19,7
11,1,0,0,1,2020-10-18,Male,66,65-69,8
11,0,0,0,0,2020-10-19,Female,65,65-69,8
11,0,1,0,1,2020-10-15,Female,11,10-14,3
11,0,0,0,0,2020-10-18,Female,65,65-69,6
11,0,0,0,0,2020-10-17,Male,33,25-34,6
11,1,0,0,1,2020-10-20,Female,67,65-69,7
11,0,2,0,2,2020-10-16,Male,52,45-54,11
11,0,1,0,1,2020-10-15,Female,31,25-34,7
11,1,1,0,2,2020-10-15,Male,57,55-64,8
11,2,18,0,20,2020-10-16,Male,67,65-69,9
11,2,0,0,2,2020-10-17,Female,76,75-79,6
11,2,0,0,2,2020-10-16,Female,5,5-9,7
11,2,2,0,4,2020-10-20,Male,62,55-64,6
11,1,0,0,1,2020-10-15,Female,62,55-64,11
11,0,0,0,0,2020-10-14,Female,12,10-14,8
11,0,1,0,1,2020-10-16,Female,70,70-74,5
11,0,0,0,0,2020-10-19,Female,28,25-34,6
11,0,0,0,0,2020-10-15,Female,69,65-69,8
11,0,5,0,5,2020-10-14,Male,27,25-34,8
11,1,0,0,1,2020-10-16,Female,55,55-64,3
11,2,0,0,2,2020-10-15,Male,73,70-74,7
11,1,2,0,3,2020-10-16,Male,62,55-64,6
11,0,0,0,0,2020-10-20,Female,21,20-24,1
11,4,3,0,7,2020-10-16,Female,5,5-9,6
11,0,1,0,1,2020-10-16,Male,62,55-64,6
11,4,2,0,6,2020-10-16,Male,20,20-24,6
11,0,0,0,0,2020-10-15,Male,68,65-69,9
11,0,2,0,2,2020-10-20,Female,28,25-34,3
11,0,2,0,2,2020-10-15,Male,44,35-44,7
11,1,10,0,11,2020-10-16,Male,55,55-64,7
11,2,0,0,2,2020-10-15,Male,19,15-19,10
11,2,1,0,3,2020-10-15,Female,69,65-69,6
11,2,3,0,5,2020-10-17,Female,62,55-64,7
11,2,0,0,2,2020-10-16,Female,73,70-74,3
11,1,1,0,2,2020-10-15,Female,68,65-69,9
11,1,0,0,1,2020-10-16,Male,55,55-64,11
11,1,0,0,1,2020-10-16,Female,61,55-64,10
11,0,1,0,1,2020-10-18,Male,66,65-69,9
11,0,0,0,0,2020-10-19,Male,54,45-54,4
11,2,0,0,2,2020-10-18,Female,61,55-64,10
11,1,3,0,4,2020-10-16,Male,52,45-54,10
11,0,0,0,0,2020-10-19,Female,71,70-74,3
11,0,7,0,7,2020-10-16,Female,66,65-69,11
11,0,0,0,0,2020-10-15,Male,65,65-69,8
11,1,0,0,1,2020-10-18,Female,59,55-64,9
11,1,0,0,1,2020-10-16,Male,65,65-69,11
11,0,0,0,0,2020-10-16,Female,68,65-69,8
11,2,0,0,2,2020-10-15,Female,43,35-44,7
11,2,0,0,2,2020-10-17,Male,14,10-14,5
11,1,1,0,2,2020-10-16,Female,62,55-64,10
11,2,0,0,2,2020-10-16,Male,32,25-34,6
11,0,1,0,1,2020-10-16,Female,52,45-54,9
11,0,0,0,0,2020-10-15,Female,65,65-69,7
11,2,2,0,4,2020-10-18,Female,52,45-54,8
11,2,0,0,2,2020-10-16,Female,48,45-54,8
11,1,2,0,3,2020-10-16,Male,66,65-69,9
11,0,0,0,0,2020-10-19,Female,67,65-69,3
11,0,0,15,15,2020-10-15,Male,29,25-34,8
11,0,0,0,0,2020-10-16,Male,58,55-64,4
11,1,3,0,4,2020-10-15,Male,59,55-64,11
11,0,0,0,0,2020-10-15,Female,44,35-44,11
11,1,2,0,3,2020-10-16,Male,71,70-74,6
11,2,0,0,2,2020-10-15,Female,67,65-69,9
11,0,1,0,1,2020-10-18,Female,64,55-64,7
11,2,4,6,12,2020-10-17,Male,73,70-74,7
11,1,3,0,4,2020-10-19,Female,35,35-44,6
11,2,0,0,2,2020-10-14,Male,22,20-24,8
11,1,0,0,1,2020-10-17,Female,66,65-69,6
11,0,2,0,2,2020-10-16,Male,58,55-64,10
11,1,0,0,1,2020-10-15,Male,66,65-69,6
11,3,0,0,3,2020-10-16,Male,12,10-14,8
11,3,0,5,8,2020-10-15,Male,4,1-4,7
11,0,0,0,0,2020-10-16,Male,35,35-44,7
11,1,0,0,1,2020-10-16,Female,58,55-64,5
11,0,1,0,1,2020-10-15,Male,15,15-19,8
11,0,0,0,0,2020-10-14,Male,67,65-69,2
11,0,3,0,3,2020-10-20,Male,56,55-64,6
11,2,2,0,4,2020-10-14,Female,25,25-34,11
11,0,0,0,0,2020-10-15,Male,34,25-34,8
11,2,1,0,3,2020-10-17,Male,33,25-34,4
11,2,2,0,4,2020-10-15,Female,11,10-14,8
11,1,1,0,2,2020-10-15,Female,69,65-69,8
11,1,3,0,4,2020-10-14,Male,66,65-69,4
11,0,3,0,3,2020-10-16,Male,66,65-69,7
11,1,0,0,1,2020-10-18,Female,49,45-54,5
11,2,1,0,3,2020-10-15,Female,68,65-69,4
11,0,0,0,0,2020-10-15,Male,35,35-44,7
11,2,0,0,2,2020-10-15,Female,9,5-9,9
11,0,0,0,0,2020-10-14,Female,66,65-69,11
11,0,0,0,0,2020-10-16,Female,50,45-54,6
11,0,0,0,0,2020-10-15,Male,42,35-44,8
11,1,1,0,2,2020-10-19,Female,76,75-79,2
11,4,1,11,16,2020-10-15,Female,4,1-4,8
11,1,3,0,4,2020-10-16,Female,61,55-64,5
11,1,0,0,1,2020-10-14,Male,67,65-69,9
11,3,0,0,3,2020-10-15,Male,5,5-9,11
11,4,3,0,7,2020-10-18,Male,23,20-24,5
11,3,0,0,3,2020-10-16,Female,30,25-34,6
11,2,0,0,2,2020-10-16,Male,51,45-54,6
11,1,2,0,3,2020-10-19,Female,68,65-69,6
11,2,4,0,6,2020-10-16,Male,61,55-64,8
11,1,4,0,5,2020-10-15,Female,61,55-64,8
11,0,5,0,5,2020-10-17,Male,51,45-54,8
11,1,0,0,1,2020-10-16,Male,65,65-69,10
11,1,1,0,2,2020-10-19,Female,39,35-44,6
11,2,3,0,5,2020-10-17,Male,52,45-54,10
11,1,0,0,1,2020-10-16,Male,51,45-54,5
11,0,0,0,0,2020-10-15,Female,6,5-9,7
11,1,10,0,11,2020-10-17,Male,53,45-54,6
11,1,2,0,3,2020-10-17,Female,60,55-64,6
11,1,1,0,2,2020-10-19,Female,18,15-19,4
11,1,0,0,1,2020-10-16,Female,55,55-64,10
11,2,0,0,2,2020-10-15,Male,32,25-34,7
11,1,2,0,3,2020-10-15,Female,49,45-54,7
11,4,2,0,6,2020-10-15,Female,41,35-44,6
11,0,0,0,0,2020-10-19,Male,66,65-69,7
11,1,0,0,1,2020-10-16,Male,66,65-69,9
11,0,0,0,0,2020-10-18,Male,54,45-54,5
11,0,0,0,0,2020-10-15,Male,40,35-44,10
11,0,0,0,0,2020-10-18,Male,59,55-64,7
11,0,2,0,2,2020-10-15,Male,41,35-44,11
11,0,1,0,1,2020-10-16,Male,66,65-69,11
11,0,1,0,1,2020-10-15,Male,33,25-34,4
11,0,0,0,0,2020-10-16,Female,34,25-34,9
11,1,4,0,5,2020-10-16,Male,63,55-64,6
11,0,0,0,0,2020-10-19,Female,69,65-69,7
11,4,6,32,42,2020-10-15,Male,3,1-4,9
11,0,0,0,0,2020-10-17,Male,55,55-64,8
11,0,1,0,1,2020-10-20,Male,66,65-69,4
11,0,0,0,0,2020-10-16,Male,58,55-64,9
11,1,2,0,3,2020-10-15,Male,47,45-54,7
11,0,1,0,1,2020-10-15,Female,34,25-34,7
11,0,0,0,0,2020-10-19,Male,52,45-54,10
11,1,0,0,1,2020-10-16,Male,61,55-64,2
11,1,0,0,1,2020-10-15,Male,61,55-64,11
11,3,1,18,22,2020-10-20,Female,23,20-24,1
11,0,5,0,5,2020-10-15,Female,67,65-69,11
11,3,4,0,7,2020-10-15,Male,10,10-14,11
11,3,0,0,3,2020-10-15,Female,38,35-44,7
11,2,0,0,2,2020-10-16,Male,77,75-79,9
11,0,0,0,0,2020-10-20,Female,38,35-44,7
11,1,0,0,1,2020-10-16,Female,22,20-24,4
11,0,0,0,0,2020-10-20,Female,15,15-19,8
11,0,5,0,5,2020-10-16,Male,47,45-54,9
11,0,0,0,0,2020-10-20,Female,57,55-64,6
11,1,0,0,1,2020-10-15,Male,66,65-69,7
11,4,0,0,4,2020-10-15,Male,45,45-54,4
11,0,0,0,0,2020-10-19,Female,23,20-24,6
11,4,0,0,4,2020-10-20,Female,16,15-19,1
11,2,8,5,15,2020-10-16,Female,65,65-69,5
11,0,0,0,0,2020-10-14,Male,27,25-34,7
11,0,1,0,1,2020-10-18,Male,47,45-54,8
11,1,0,0,1,2020-10-15,Male,32,25-34,6
11,2,0,0,2,2020-10-15,Male,49,45-54,5
11,0,0,0,0,2020-10-16,Male,52,45-54,8
11,0,1,0,1,2020-10-20,Male,71,70-74,3
11,3,3,0,6,2020-10-16,Male,19,15-19,8
11,5,0,0,5,2020-10-16,Female,3,1-4,3
11,2,3,0,5,2020-10-17,Female,10,10-14,5
11,2,0,0,2,2020-10-16,Male,61,55-64,6
11,2,0,0,2,2020-10-19,Male,14,10-14,10
11,2,1,0,3,2020-10-16,Female,62,55-64,7
11,1,2,0,3,2020-10-16,Male,45,45-54,4
11,0,0,25,25,2020-10-16,Male,43,35-44,10
11,2,3,0,5,2020-10-17,Female,64,55-64,11
11,1,1,0,2,2020-10-16,Female,73,70-74,10
11,0,1,0,1,2020-10-20,Male,53,45-54,4
11,0,2,0,2,2020-10-19,Male,77,75-79,5
11,0,0,0,0,2020-10-16,Female,53,45-54,10
11,0,0,0,0,2020-10-15,Female,33,25-34,7
11,1,0,0,1,2020-10-18,Male,6,5-9,7
11,2,2,0,4,2020-10-16,Female,11,10-14,7
11,1,0,0,1,2020-10-16,Female,50,45-54,7
11,0,0,0,0,2020-10-15,Female,21,20-24,4
11,2,0,0,2,2020-10-19,Male,56,55-64,8
11,0,1,0,1,2020-10-15,Female,62,55-64,6
11,0,0,0,0,2020-10-20,Female,59,55-64,6
11,2,3,0,5,2020-10-17,Male,65,65-69,11
11,6,3,75,84,2020-10-16,Female,8,5-9,5
11,2,0,0,2,2020-10-15,Male,70,70-74,4
11,1,1,0,2,2020-10-15,Male,61,55-64,10
11,1,1,0,2,2020-10-16,Male,66,65-69,10
11,0,0,0,0,2020-10-15,Male,33,25-34,10
11,1,0,0,1,2020-10-16,Female,58,55-64,9
11,2,0,0,2,2020-10-15,Male,73,70-74,7
11,2,0,0,2,2020-10-15,Male,66,65-69,6
11,0,0,0,0,2020-10-16,Male,34,25-34,6
11,0,0,0,0,2020-10-15,Female,36,35-44,7
11,1,1,0,2,2020-10-16,Male,62,55-64,6
11,1,3,0,4,2020-10-15,Female,47,45-54,5
11,0,1,0,1,2020-10-16,Male,62,55-64,7
11,0,0,0,0,2020-10-15,Male,2,1-4,5
11,0,3,0,3,2020-10-15,Female,68,65-69,8
11,2,0,0,2,2020-10-17,Female,65,65-69,7
11,1,1,0,2,2020-10-16,Female,34,25-34,8
11,2,0,0,2,2020-10-16,Male,53,45-54,10
11,1,1,0,2,2020-10-15,Female,35,35-44,5
11,0,1,0,1,2020-10-16,Male,56,55-64,8
11,1,2,0,3,2020-10-16,Female,55,55-64,9
11,0,1,0,1,2020-10-17,Female,67,65-69,10
11,0,0,0,0,2020-10-16,Male,41,35-44,3
11,2,1,0,3,2020-10-15,Male,72,70-74,8
11,1,0,0,1,2020-10-20,Male,66,65-69,7
11,1,0,0,1,2020-10-16,Female,72,70-74,5
11,1,0,0,1,2020-10-15,Male,31,25-34,7
11,3,0,0,3,2020-10-17,Female,58,55-64,6
11,2,0,0,2,2020-10-16,Male,71,70-74,6
11,1,1,0,2,2020-10-15,Female,48,45-54,6
11,2,3,0,5,2020-10-16,Female,55,55-64,4
11,2,0,0,2,2020-10-17,Female,70,70-74,8
11,0,0,0,0,2020-10-15,Male,66,65-69,11
11,1,0,0,1,2020-10-16,Male,67,65-69,5
11,0,0,0,0,2020-10-15,Female,26,25-34,7
11,0,0,0,0,2020-10-16,Female,55,55-64,4
11,1,1,0,2,2020-10-16,Male,80,80-84,6
11,0,1,0,1,2020-10-16,Male,60,55-64,6
11,1,0,0,1,2020-10-16,Female,53,45-54,10
11,1,1,0,2,2020-10-16,Male,63,55-64,9
11,0,0,0,0,2020-10-15,Male,37,35-44,10
11,0,4,0,4,2020-10-19,Female,67,65-69,5
11,1,2,0,3,2020-10-17,Female,28,25-34,9
11,5,0,0,5,2020-10-20,Female,47,45-54,4
11,0,0,0,0,2020-10-15,Female,11,10-14,8
11,0,0,0,0,2020-10-15,Male,54,45-54,10
11,0,2,9,11,2020-10-16,Male,14,10-14,11
11,2,0,0,2,2020-10-16,Male,16,15-19,5
11,1,0,0,1,2020-10-15,Male,34,25-34,10
11,0,4,0,4,2020-10-16,Female,72,70-74,9
11,3,0,2,5,2020-10-15,Male,25,25-34,5
11,3,3,0,6,2020-10-15,Male,41,35-44,8
11,1,0,2,3,2020-10-15,Female,24,20-24,11
11,0,3,0,3,2020-10-16,Male,13,10-14,6
11,0,0,0,0,2020-10-15,Female,42,35-44,8
11,2,1,0,3,2020-10-19,Female,71,70-74,8
11,1,2,0,3,2020-10-17,Male,58,55-64,7
11,2,0,0,2,2020-10-16,Male,57,55-64,7
11,3,3,0,6,2020-10-20,Male,4,1-4,8
11,3,1,0,4,2020-10-15,Female,36,35-44,10
11,1,0,0,1,2020-10-15,Female,59,55-64,9
11,1,0,0,1,2020-10-15,Male,66,65-69,10
11,5,0,0,5,2020-10-19,Male,14,10-14,4
11,0,0,0,0,2020-10-17,Female,57,55-64,9
11,0,3,0,3,2020-10-16,Male,75,75-79,5
11,0,0,0,0,2020-10-16,Male,52,45-54,10
11,0,0,0,0,2020-10-18,Male,56,55-64,8
11,2,0,0,2,2020-10-15,Female,75,75-79,4
11,2,1,0,3,2020-10-19,Male,25,25-34,6
11,1,0,0,1,2020-10-17,Female,63,55-64,7
11,2,0,0,2,2020-10-16,Male,65,65-69,7
11,3,10,0,13,2020-10-16,Male,19,15-19,5
11,4,0,0,4,2020-10-20,Female,23,20-24,1
11,1,1,0,2,2020-10-17,Male,47,45-54,2
11,3,0,0,3,2020-10-17,Female,18,15-19,8
11,0,0,0,0,2020-10-16,Male,74,70-74,8
11,0,0,0,0,2020-10-16,Female,66,65-69,10
11,0,4,0,4,2020-10-18,Female,54,45-54,8
11,1,0,0,1,2020-10-15,Female,46,45-54,8
11,1,3,0,4,2020-10-15,Male,70,70-74,6
11,0,0,0,0,2020-10-16,Male,53,45-54,7
11,0,0,0,0,2020-10-15,Female,62,55-64,8
11,0,0,0,0,2020-10-15,Female,23,20-24,2
11,2,0,0,2,2020-10-16,Male,74,70-74,8
11,1,2,0,3,2020-10-15,Female,70,70-74,11
11,1,0,2,3,2020-10-15,Male,35,35-44,5
11,0,0,0,0,2020-10-16,Female,62,55-64,5
11,2,5,40,47,2020-10-16,Male,73,70-74,4
11,0,1,0,1,2020-10-17,Male,32,25-34,6
11,0,0,0,0,2020-10-14,Male,27,25-34,10
11,1,1,0,2,2020-10-15,Male,28,25-34,11
11,0,3,0,3,2020-10-15,Female,31,25-34,6
11,0,0,0,0,2020-10-16,Female,65,65-69,8
11,2,1,0,3,2020-10-15,Male,42,35-44,8
11,0,2,0,2,2020-10-15,Male,70,70-74,10
11,1,0,0,1,2020-10-17,Male,39,35-44,3
11,0,0,0,0,2020-10-17,Male,65,65-69,9
11,0,1,0,1,2020-10-15,Female,68,65-69,11
11,0,1,0,1,2020-10-16,Female,62,55-64,8
11,3,7,0,10,2020-10-20,Female,21,20-24,1
11,0,0,0,0,2020-10-15,Male,60,55-64,8
11,1,0,9,10,2020-10-15,Male,7,5-9,8
11,0,1,0,1,2020-10-15,Female,34,25-34,7
11,1,2,0,3,2020-10-15,Male,68,65-69,10
11,2,3,0,5,2020-10-17,Male,67,65-69,6
11,1,12,0,13,2020-10-15,Male,68,65-69,9
11,1,0,0,1,2020-10-17,Male,61,55-64,7
11,0,0,0,0,2020-10-20,Male,18,15-19,1
11,0,0,0,0,2020-10-15,Male,33,25-34,7
11,3,2,0,5,2020-10-20,Male,18,15-19,5
11,0,0,0,0,2020-10-15,Female,62,55-64,8
11,0,0,0,0,2020-10-16,Female,56,55-64,10
11,3,0,0,3,2020-10-16,Female,3,1-4,8
11,1,0,0,1,2020-10-15,Male,66,65-69,7
11,1,0,0,1,2020-10-19,Male,55,55-64,6
11,3,0,0,3,2020-10-15,Male,8,5-9,5
11,0,2,0,2,2020-10-17,Female,62,55-64,8
11,2,11,0,13,2020-10-19,Female,33,25-34,9
11,0,0,0,0,2020-10-16,Female,54,45-54,6
11,0,0,0,0,2020-10-16,Female,59,55-64,11
11,3,0,0,3,2020-10-15,Female,4,1-4,7
11,1,0,0,1,2020-10-20,Female,59,55-64,8
11,3,1,0,4,2020-10-20,Male,8,5-9,4
11,4,0,0,4,2020-10-16,Female,54,45-54,6
11,2,0,0,2,2020-10-15,Female,56,55-64,7
11,1,1,0,2,2020-10-16,Female,60,55-64,10
11,2,2,0,4,2020-10-16,Male,60,55-64,8
11,0,0,0,0,2020-10-16,Male,70,70-74,11
11,0,2,0,2,2020-10-17,Female,54,45-54,6
11,1,2,0,3,2020-10-16,Male,61,55-64,4
11,2,0,0,2,2020-10-16,Male,66,65-69,4
11,2,4,0,6,2020-10-16,Female,51,45-54,10
11,1,0,0,1,2020-10-15,Male,69,65-69,5
11,2,3,0,5,2020-10-18,Male,71,70-74,6
11,2,2,0,4,2020-10-19,Male,77,75-79,6
11,2,0,0,2,2020-10-15,Female,67,65-69,5
11,2,0,0,2,2020-10-16,Male,51,45-54,4
11,1,1,0,2,2020-10-19,Male,69,65-69,8
11,0,1,0,1,2020-10-16,Female,18,15-19,7
11,0,0,0,0,2020-10-15,Male,52,45-54,11
11,3,0,0,3,2020-10-19,Female,17,15-19,8
11,1,0,0,1,2020-10-17,Female,65,65-69,10
11,0,0,0,0,2020-10-15,Female,37,35-44,9
11,3,0,0,3,2020-10-15,Female,14,10-14,3
11,4,0,0,4,2020-10-15,Male,11,10-14,3
11,0,1,0,1,2020-10-17,Male,57,55-64,7
11,0,1,0,1,2020-10-17,Male,67,65-69,6
11,0,3,15,18,2020-10-15,Female,48,45-54,6
11,0,1,0,1,2020-10-16,Female,59,55-64,2
11,0,0,0,0,2020-10-16,Female,55,55-64,8
11,0,1,0,1,2020-10-16,Male,63,55-64,8
11,0,0,0,0,2020-10-19,Male,36,35-44,6
11,0,1,0,1,2020-10-15,Male,37,35-44,8
11,2,2,0,4,2020-10-16,Female,53,45-54,7
11,2,0,0,2,2020-10-15,Male,63,55-64,6
11,2,2,0,4,2020-10-17,Male,51,45-54,5
11,0,0,0,0,2020-10-18,Male,74,70-74,5
11,2,5,0,7,2020-10-17,Female,51,45-54,5
11,1,1,0,2,2020-10-15,Female,32,25-34,6
11,1,5,0,6,2020-10-15,Female,19,15-19,8
11,0,6,0,6,2020-10-16,Male,61,55-64,8
11,2,0,0,2,2020-10-16,Female,52,45-54,5
11,1,0,0,1,2020-10-16,Male,53,45-54,7
11,3,1,0,4,2020-10-15,Male,28,25-34,7
11,2,1,0,3,2020-10-15,Female,65,65-69,9
11,0,0,0,0,2020-10-16,Male,78,75-79,4
11,1,0,0,1,2020-10-15,Male,61,55-64,8
11,3,0,0,3,2020-10-16,Male,15,15-19,10
11,2,1,0,3,2020-10-20,Male,16,15-19,1
11,0,1,0,1,2020-10-15,Male,52,45-54,6
11,1,1,0,2,2020-10-17,Male,50,45-54,7
11,0,0,0,0,2020-10-16,Female,60,55-64,8
11,3,0,0,3,2020-10-15,Male,13,10-14,10
11,1,0,0,1,2020-10-15,Male,16,15-19,8
11,3,1,20,24,2020-10-17,Female,59,55-64,3
11,3,0,0,3,2020-10-17,Female,68,65-69,5
11,3,0,0,3,2020-10-20,Male,32,25-34,4
11,1,0,0,1,2020-10-16,Female,66,65-69,10
11,0,0,0,0,2020-10-19,Male,64,55-64,3
11,2,1,0,3,2020-10-17,Male,67,65-69,8
11,0,0,0,0,2020-10-16,Female,24,20-24,5
11,0,0,0,0,2020-10-19,Female,65,65-69,3
11,0,0,0,0,2020-10-20,Female,67,65-69,10
11,0,0,0,0,2020-10-15,Female,43,35-44,5
11,1,1,0,2,2020-10-15,Female,40,35-44,8
11,0,2,0,2,2020-10-15,Female,67,65-69,8
11,1,4,0,5,2020-10-15,Male,37,35-44,3
11,1,0,0,1,2020-10-16,Female,37,35-44,6
11,0,0,0,0,2020-10-15,Female,5,5-9,4
11,0,1,0,1,2020-10-19,Male,66,65-69,9
11,1,0,0,1,2020-10-15,Female,51,45-54,10
11,0,0,0,0,2020-10-16,Female,23,20-24,9
11,0,0,0,0,2020-10-16,Female,16,15-19,7
11,0,0,1,1,2020-10-15,Female,43,35-44,6
11,2,0,0,2,2020-10-16,Female,62,55-64,8
11,0,0,0,0,2020-10-16,Female,66,65-69,8
11,1,0,0,1,2020-10-16,Female,72,70-74,8
11,0,0,0,0,2020-10-15,Male,58,55-64,10
11,2,0,0,2,2020-10-17,Female,13,10-14,6
11,1,2,0,3,2020-10-16,Male,78,75-79,7
11,2,3,0,5,2020-10-15,Female,8,5-9,7
11,2,5,0,7,2020-10-19,Male,43,35-44,6
11,2,2,6,10,2020-10-16,Female,62,55-64,7
11,2,2,0,4,2020-10-15,Male,68,65-69,8
11,1,0,0,1,2020-10-16,Female,55,55-64,10
11,2,3,0,5,2020-10-16,Female,61,55-64,4
11,0,0,0,0,2020-10-15,Male,43,35-44,5
11,1,5,0,6,2020-10-15,Male,68,65-69,6
11,1,2,40,43,2020-10-16,Male,64,55-64,11
11,2,2,0,4,2020-10-17,Male,73,70-74,8
11,1,0,0,1,2020-10-16,Female,64,55-64,8
11,2,0,0,2,2020-10-16,Male,54,45-54,7
11,0,2,0,2,2020-10-16,Female,66,65-69,8
11,4,0,0,4,2020-10-18,Male,18,15-19,2
11,0,4,0,4,2020-10-18,Female,71,70-74,9
11,2,11,0,13,2020-10-17,Female,71,70-74,8
11,0,1,0,1,2020-10-16,Female,66,65-69,6
11,1,0,0,1,2020-10-16,Female,49,45-54,10
11,4,0,0,4,2020-10-16,Female,58,55-64,9
11,0,0,0,0,2020-10-15,Female,33,25-34,7
11,1,0,0,1,2020-10-16,Male,74,70-74,5
11,2,2,0,4,2020-10-15,Female,3,1-4,4
11,1,1,0,2,2020-10-19,Female,51,45-54,6
11,0,0,0,0,2020-10-15,Female,40,35-44,10
11,0,0,0,0,2020-10-15,Male,21,20-24,11
11,0,0,0,0,2020-10-15,Male,55,55-64,10
11,0,0,0,0,2020-10-19,Male,52,45-54,6
11,0,0,0,0,2020-10-20,Female,36,35-44,11
11,0,0,0,0,2020-10-16,Male,55,55-64,8
11,2,3,0,5,2020-10-16,Male,62,55-64,9
11,2,2,0,4,2020-10-20,Female,20,20-24,1
11,3,2,0,5,2020-10-16,Male,15,15-19,8
11,2,4,0,6,2020-10-15,Female,56,55-64,6
11,1,0,0,1,2020-10-16,Female,67,65-69,8
11,0,1,3,4,2020-10-15,Female,23,20-24,7
11,0,1,0,1,2020-10-16,Female,85,85+,2
11,0,2,0,2,2020-10-15,Female,70,70-74,9
11,2,0,0,2,2020-10-16,Male,73,70-74,11
11,1,1,0,2,2020-10-16,Female,66,65-69,8
11,3,1,0,4,2020-10-18,Male,14,10-14,9
11,1,2,10,13,2020-10-17,Male,73,70-74,8
11,0,0,0,0,2020-10-19,Female,36,35-44,5
11,1,2,0,3,2020-10-14,Male,67,65-69,4
11,0,0,0,0,2020-10-15,Female,37,35-44,8
11,0,0,0,0,2020-10-15,Female,7,5-9,4
11,1,0,0,1,2020-10-15,Male,66,65-69,8
11,1,0,0,1,2020-10-16,Female,60,55-64,9
11,2,1,0,3,2020-10-20,Male,27,25-34,4
11,1,0,0,1,2020-10-16,Male,66,65-69,9
11,3,0,0,3,2020-10-16,Female,11,10-14,8
11,5,1,0,6,2020-10-16,Female,51,45-54,6
11,1,2,0,3,2020-10-15,Male,65,65-69,10
11,0,3,0,3,2020-10-20,Female,29,25-34,7
11,0,1,0,1,2020-10-15,Male,31,25-34,6
11,0,0,0,0,2020-10-15,Female,11,10-14,6
11,3,1,0,4,2020-10-17,Female,64,55-64,10
11,2,1,0,3,2020-10-16,Female,66,65-69,9
11,0,2,0,2,2020-10-17,Female,75,75-79,9
11,2,0,0,2,2020-10-15,Female,44,35-44,4
11,2,0,0,2,2020-10-20,Male,32,25-34,9
11,3,0,0,3,2020-10-16,Male,16,15-19,9
11,2,0,0,2,2020-10-18,Female,23,20-24,9
11,0,3,0,3,2020-10-15,Male,35,35-44,5
11,0,0,0,0,2020-10-15,Male,19,15-19,8
11,0,0,0,0,2020-10-16,Female,63,55-64,7
11,0,3,0,3,2020-10-20,Female,68,65-69,3
11,1,2,0,3,2020-10-16,Male,65,65-69,9
11,3,0,0,3,2020-10-15,Female,14,10-14,11
11,0,3,21,24,2020-10-16,Female,65,65-69,5
11,1,2,0,3,2020-10-16,Male,54,45-54,7
11,1,1,0,2,2020-10-20,Male,21,20-24,1
11,1,0,0,1,2020-10-18,Male,58,55-64,5
11,1,0,0,1,2020-10-15,Male,62,55-64,11
11,2,1,0,3,2020-10-15,Male,66,65-69,9
11,0,0,0,0,2020-10-17,Male,38,35-44,7
11,2,3,0,5,2020-10-16,Female,66,65-69,7
11,0,0,0,0,2020-10-16,Female,30,25-34,4
11,0,0,0,0,2020-10-14,Male,27,25-34,6
11,0,0,0,0,2020-10-16,Female,43,35-44,10
11,0,10,8,18,2020-10-14,Male,67,65-69,5
11,1,0,28,29,2020-10-16,Female,61,55-64,6
11,1,1,0,2,2020-10-17,Female,30,25-34,5
11,1,0,0,1,2020-10-16,Female,53,45-54,9
11,0,0,0,0,2020-10-19,Male,54,45-54,6
11,0,0,0,0,2020-10-17,Female,73,70-74,3
11,0,0,0,0,2020-10-15,Female,10,10-14,5
11,1,10,0,11,2020-10-16,Male,66,65-69,7
11,2,0,0,2,2020-10-15,Male,30,25-34,4
11,0,0,0,0,2020-10-20,Female,25,25-34,10
11,1,0,0,1,2020-10-15,Male,40,35-44,8
11,0,0,0,0,2020-10-15,Male,34,25-34,9
11,1,0,0,1,2020-10-16,Male,62,55-64,8
11,0,0,0,0,2020-10-15,Female,68,65-69,6
11,1,0,0,1,2020-10-16,Male,67,65-69,9
11,2,0,0,2,2020-10-15,Male,8,5-9,11
11,1,2,0,3,2020-10-18,Female,24,20-24,5
11,2,1,0,3,2020-10-20,Female,12,10-14,5
11,0,0,0,0,2020-10-16,Male,55,55-64,9
11,2,2,0,4,2020-10-15,Male,70,70-74,6
11,0,1,0,1,2020-10-15,Female,47,45-54,10
11,2,1,0,3,2020-10-20,Female,29,25-34,3
11,2,0,29,31,2020-10-16,Female,60,55-64,8
11,5,0,0,5,2020-10-15,Female,33,25-34,6
11,0,0,0,0,2020-10-15,Male,45,45-54,5
11,0,1,0,1,2020-10-19,Female,19,15-19,7
11,2,0,0,2,2020-10-20,Male,4,1-4,1
11,2,2,0,4,2020-10-16,Female,63,55-64,9
11,2,1,0,3,2020-10-15,Female,67,65-69,3
11,0,0,0,0,2020-10-15,Male,44,35-44,8
11,0,1,0,1,2020-10-20,Female,70,70-74,5
11,1,0,0,1,2020-10-15,Male,45,45-54,6
11,0,0,0,0,2020-10-15,Female,34,25-34,7
11,0,0,0,0,2020-10-16,Male,58,55-64,11
11,2,0,0,2,2020-10-15,Male,63,55-64,11
11,1,1,0,2,2020-10-15,Female,62,55-64,9
11,1,1,0,2,2020-10-16,Female,63,55-64,9
11,3,0,0,3,2020-10-15,Female,43,35-44,8
11,2,1,0,3,2020-10-16,Female,68,65-69,11
11,1,4,0,5,2020-10-15,Male,52,45-54,7
11,3,2,0,5,2020-10-15,Male,50,45-54,9
11,2,0,0,2,2020-10-16,Female,63,55-64,6
11,1,0,0,1,2020-10-15,Female,67,65-69,9
11,0,0,0,0,2020-10-16,Male,19,15-19,11
11,0,1,0,1,2020-10-16,Female,65,65-69,6
11,2,2,0,4,2020-10-17,Male,59,55-64,10
11,2,0,0,2,2020-10-15,Female,38,35-44,8
11,0,0,0,0,2020-10-15,Male,33,25-34,8
11,0,0,0,0,2020-10-15,Male,41,35-44,9
11,1,5,0,6,2020-10-15,Male,68,65-69,11
11,3,0,0,3,2020-10-15,Male,12,10-14,8
11,2,0,0,2,2020-10-16,Male,76,75-79,6
11,1,1,0,2,2020-10-16,Female,58,55-64,11
11,2,0,0,2,2020-10-15,Female,32,25-34,7
11,1,1,0,2,2020-10-15,Female,31,25-34,10
11,1,0,0,1,2020-10-19,Female,25,25-34,6
11,1,10,0,11,2020-10-16,Male,62,55-64,4
11,2,2,0,4,2020-10-14,Male,67,65-69,3
11,2,1,0,3,2020-10-17,Female,66,65-69,3
11,1,3,0,4,2020-10-15,Female,68,65-69,5
11,1,0,0,1,2020-10-15,Female,34,25-34,7
11,2,3,0,5,2020-10-20,Male,14,10-14,8
11,0,3,0,3,2020-10-14,Female,19,15-19,5
11,2,0,0,2,2020-10-16,Male,23,20-24,3
11,0,0,0,0,2020-10-15,Male,14,10-14,6
11,0,2,0,2,2020-10-18,Female,39,35-44,7
11,2,0,0,2,2020-10-15,Male,51,45-54,8
11,0,3,0,3,2020-10-15,Male,39,35-44,7
11,1,2,0,3,2020-10-15,Female,21,20-24,2
11,0,0,0,0,2020-10-15,Female,34,25-34,9
11,0,0,0,0,2020-10-15,Female,67,65-69,4
11,1,0,0,1,2020-10-15,Male,45,45-54,7
11,1,5,0,6,2020-10-20,Female,65,65-69,7
11,2,0,0,2,2020-10-17,Female,76,75-79,4
11,0,1,0,1,2020-10-16,Female,52,45-54,7
11,0,0,0,0,2020-10-19,Male,71,70-74,5
11,3,1,0,4,2020-10-19,Male,26,25-34,5
11,3,0,0,3,2020-10-19,Female,10,10-14,6
11,0,0,0,0,2020-10-15,Female,27,25-34,8
11,2,0,0,2,2020-10-16,Female,73,70-74,7
11,0,0,0,0,2020-10-15,Female,67,65-69,9
11,2,0,0,2,2020-10-19,Female,67,65-69,3
11,0,0,0,0,2020-10-15,Female,69,65-69,9
11,2,5,0,7,2020-10-20,Female,28,25-34,5
11,5,0,0,5,2020-10-19,Male,10,10-14,9
11,2,2,0,4,2020-10-16,Female,55,55-64,7
11,2,0,0,2,2020-10-15,Male,48,45-54,10
11,0,0,0,0,2020-10-17,Female,52,45-54,10
11,0,2,0,2,2020-10-20,Female,38,35-44,7
11,0,0,0,0,2020-10-15,Male,54,45-54,6
11,0,1,0,1,2020-10-15,Male,48,45-54,7
11,1,0,0,1,2020-10-16,Male,63,55-64,7
11,0,0,0,0,2020-10-15,Male,27,25-34,6
11,1,0,0,1,2020-10-15,Male,35,35-44,7
11,1,0,0,1,2020-10-15,Male,49,45-54,8
11,2,10,0,12,2020-10-16,Female,68,65-69,7
11,2,1,25,28,2020-10-16,Female,51,45-54,4
11,1,0,1,2,2020-10-16,Female,53,45-54,6
11,2,1,0,3,2020-10-15,Male,68,65-69,9
11,1,1,18,20,2020-10-15,Female,48,45-54,9
11,5,2,0,7,2020-10-19,Female,19,15-19,10
11,3,1,0,4,2020-10-16,Male,85,85+,6
11,2,12,0,14,2020-10-15,Male,10,10-14,4
11,2,3,0,5,2020-10-16,Female,71,70-74,3
11,0,1,0,1,2020-10-19,Male,47,45-54,6
11,1,1,0,2,2020-10-15,Female,33,25-34,6
11,2,1,0,3,2020-10-17,Female,66,65-69,6
11,0,0,0,0,2020-10-16,Male,50,45-54,11
11,0,2,0,2,2020-10-20,Male,23,20-24,6
11,0,0,0,0,2020-10-19,Female,70,70-74,2
11,0,0,0,0,2020-10-18,Male,60,55-64,6
11,1,2,0,3,2020-10-15,Male,12,10-14,5
11,0,0,0,0,2020-10-17,Male,26,25-34,6
11,0,7,4,11,2020-10-17,Female,28,25-34,4
11,2,1,0,3,2020-10-16,Male,74,70-74,10
11,2,2,4,8,2020-10-15,Female,12,10-14,5
11,2,0,0,2,2020-10-16,Male,65,65-69,8
11,0,0,0,0,2020-10-15,Male,42,35-44,10
11,2,2,0,4,2020-10-20,Female,20,20-24,1
11,2,0,0,2,2020-10-18,Female,79,75-79,8
11,1,4,0,5,2020-10-15,Female,69,65-69,9
11,0,0,0,0,2020-10-15,Female,69,65-69,11
11,1,1,0,2,2020-10-16,Male,71,70-74,9
11,0,0,0,0,2020-10-16,Male,61,55-64,10
11,1,0,0,1,2020-10-20,Male,73,70-74,2
11,4,2,0,6,2020-10-19,Female,12,10-14,8
11,1,7,0,8,2020-10-15,Female,29,25-34,9
11,4,0,0,4,2020-10-15,Female,5,5-9,8
11,3,0,0,3,2020-10-15,Male,12,10-14,7
11,0,1,0,1,2020-10-15,Male,34,25-34,10
11,2,1,0,3,2020-10-19,Male,19,15-19,4
11,2,0,0,2,2020-10-15,Male,19,15-19,7
12,0,2,0,2,2020-11-01,Male,60,55-64,8
12,1,1,0,2,2020-10-30,Male,68,65-69,7
12,1,1,0,2,2020-11-01,Female,58,55-64,7
12,1,2,0,3,2020-10-30,Female,69,65-69,7
12,2,0,0,2,2020-10-29,Female,66,65-69,12
12,0,0,0,0,2020-11-01,Female,71,70-74,8
12,0,0,0,0,2020-10-29,Female,50,45-54,8
12,1,0,0,1,2020-10-29,Female,72,70-74,12
12,0,0,0,0,2020-10-30,Male,30,25-34,9
12,0,3,2,5,2020-10-30,Female,52,45-54,5
12,1,0,0,1,2020-10-29,Female,53,45-54,8
12,0,0,0,0,2020-10-30,Female,67,65-69,7
12,2,0,0,2,2020-10-29,Male,34,25-34,12
12,1,4,0,5,2020-10-30,Female,59,55-64,8
12,1,3,3,7,2020-11-01,Female,61,55-64,6
12,0,0,0,0,2020-10-31,Male,51,45-54,9
12,1,0,0,1,2020-10-30,Male,50,45-54,7
12,2,0,0,2,2020-10-29,Female,35,35-44,9
12,3,0,0,3,2020-10-29,Female,57,55-64,10
12,0,0,0,0,2020-10-30,Female,10,10-14,9
12,0,0,0,0,2020-10-30,Male,42,35-44,6
12,0,0,0,0,2020-10-29,Male,32,25-34,11
12,1,2,0,3,2020-10-30,Male,66,65-69,6
12,0,3,0,3,2020-10-29,Male,62,55-64,12
12,2,3,0,5,2020-10-30,Female,43,35-44,3
12,0,0,0,0,2020-10-29,Male,13,10-14,8
12,1,0,0,1,2020-10-30,Male,15,15-19,10
12,0,0,0,0,2020-10-30,Male,48,45-54,9
12,2,0,0,2,2020-10-31,Male,58,55-64,7
12,0,0,0,0,2020-10-30,Male,53,45-54,7
12,1,0,0,1,2020-10-30,Female,70,70-74,11
12,0,1,0,1,2020-10-30,Male,68,65-69,11
12,0,0,0,0,2020-10-29,Male,20,20-24,7
12,1,1,0,2,2020-10-29,Female,52,45-54,9
12,1,1,0,2,2020-10-30,Female,69,65-69,9
12,0,0,0,0,2020-10-29,Male,41,35-44,12
12,1,1,0,2,2020-10-30,Male,58,55-64,8
12,1,1,0,2,2020-10-31,Female,56,55-64,12
12,2,0,0,2,2020-10-30,Female,21,20-24,10
12,2,0,0,2,2020-10-30,Male,51,45-54,10
12,0,0,0,0,2020-10-30,Male,85,85+,10
12,0,1,0,1,2020-10-30,Female,68,65-69,9
12,3,2,0,5,2020-11-02,Female,12,10-14,5
12,4,2,41,47,2020-10-30,Male,19,15-19,6
12,1,0,0,1,2020-10-29,Male,58,55-64,10
12,0,0,0,0,2020-10-30,Male,67,65-69,12
12,0,0,0,0,2020-10-30,Male,51,45-54,8
12,1,4,0,5,2020-10-30,Male,72,70-74,5
12,1,2,0,3,2020-10-30,Male,71,70-74,10
12,0,2,0,2,2020-10-31,Male,52,45-54,11
12,0,0,1,1,2020-11-02,Male,37,35-44,4
12,0,0,0,0,2020-10-30,Male,52,45-54,6
12,0,0,0,0,2020-10-29,Male,27,25-34,6
12,2,0,0,2,2020-10-29,Male,35,35-44,8
12,1,3,0,4,2020-10-30,Male,38,35-44,9
12,2,0,0,2,2020-10-30,Male,69,65-69,9
12,0,1,0,1,2020-10-31,Female,77,75-79,9
12,4,0,0,4,2020-10-31,Male,4,1-4,6
12,1,0,0,1,2020-10-30,Female,67,65-69,9
12,0,1,0,1,2020-10-31,Female,52,45-54,6
12,1,2,0,3,2020-10-30,Male,38,35-44,11
12,1,2,0,3,2020-10-30,Male,67,65-69,9
12,1,2,0,3,2020-10-31,Female,13,10-14,8
12,0,3,3,6,2020-10-30,Male,72,70-74,5
12,0,2,0,2,2020-10-30,Male,85,85+,7
12,2,1,0,3,2020-10-30,Female,71,70-74,8
12,2,3,0,5,2020-10-30,Male,54,45-54,11
12,0,0,0,0,2020-10-30,Male,31,25-34,5
12,0,0,0,0,2020-10-29,Male,70,70-74,9
12,2,0,0,2,2020-10-30,Female,71,70-74,8
12,2,1,0,3,2020-10-30,Male,66,65-69,6
12,1,0,0,1,2020-10-29,Female,65,65-69,11
12,3,2,10,15,2020-10-30,Male,11,10-14,5
12,2,0,0,2,2020-10-30,Male,70,70-74,11
12,0,0,0,0,2020-10-30,Male,69,65-69,8
12,0,0,0,0,2020-10-30,Male,34,25-34,8
12,1,0,52,53,2020-10-30,Male,40,35-44,4
12,1,1,0,2,2020-11-02,Male,67,65-69,9
12,0,0,0,0,2020-11-01,Female,24,20-24,7
12,0,3,0,3,2020-10-29,Male,43,35-44,8
12,3,0,0,3,2020-10-30,Female,8,5-9,8
12,1,4,0,5,2020-10-31,Female,43,35-44,5
12,1,0,0,1,2020-10-30,Female,74,70-74,2
12,0,0,0,0,2020-10-30,Male,70,70-74,8
12,1,8,0,9,2020-10-30,Male,69,65-69,12
12,0,0,0,0,2020-11-01,Female,2,1-4,9
12,2,0,0,2,2020-10-29,Female,67,65-69,10
12,4,0,0,4,2020-10-31,Male,16,15-19,10
12,1,0,0,1,2020-11-02,Male,31,25-34,7
12,0,1,0,1,2020-10-30,Female,52,45-54,10
12,0,0,0,0,2020-10-29,Male,48,45-54,11
12,0,3,0,3,2020-10-30,Male,69,65-69,7
12,1,0,0,1,2020-10-30,Female,66,65-69,5
12,0,4,0,4,2020-10-29,Female,63,55-64,11
12,0,1,0,1,2020-10-30,Female,30,25-34,8
12,0,0,0,0,2020-10-30,Female,29,25-34,4
12,0,0,0,0,2020-10-30,Male,75,75-79,4
12,1,1,0,2,2020-10-31,Female,30,25-34,11
12,0,0,0,0,2020-10-30,Female,67,65-69,8
12,2,0,0,2,2020-10-30,Male,18,15-19,5
12,1,0,0,1,2020-10-29,Female,62,55-64,10
12,0,0,0,0,2020-10-30,Male,68,65-69,7
12,0,0,0,0,2020-10-31,Male,54,45-54,9
12,2,0,0,2,2020-11-02,Female,66,65-69,8
12,0,0,0,0,2020-10-29,Male,33,25-34,8
12,0,0,0,0,2020-10-31,Male,29,25-34,6
12,1,0,0,1,2020-10-30,Male,57,55-64,8
12,1,0,0,1,2020-11-01,Female,73,70-74,9
12,0,0,0,0,2020-10-30,Male,31,25-34,12
12,0,0,0,0,2020-10-29,Male,65,65-69,7
12,0,0,0,0,2020-10-29,Female,30,25-34,6
12,0,0,0,0,2020-10-31,Male,35,35-44,3
12,0,0,1,1,2020-10-30,Male,5,5-9,5
12,0,6,0,6,2020-10-31,Female,33,25-34,9
12,1,1,0,2,2020-10-29,Female,62,55-64,9
12,1,1,0,2,2020-10-29,Male,65,65-69,7
12,0,0,0,0,2020-10-29,Male,63,55-64,10
12,0,1,0,1,2020-10-29,Male,29,25-34,7
12,0,0,0,0,2020-10-30,Female,55,55-64,7
12,2,1,0,3,2020-10-29,Female,26,25-34,7
12,0,3,0,3,2020-10-31,Male,69,65-69,7
12,1,1,0,2,2020-10-30,Female,67,65-69,10
12,2,0,0,2,2020-10-30,Male,42,35-44,7
12,2,0,0,2,2020-10-30,Male,58,55-64,11
12,0,0,0,0,2020-10-29,Female,62,55-64,8
12,1,0,0,1,2020-10-30,Male,69,65-69,8
12,0,8,3,11,2020-10-31,Female,40,35-44,5
12,2,0,0,2,2020-10-31,Male,35,35-44,11
12,2,0,0,2,2020-10-31,Male,70,70-74,6
12,3,0,0,3,2020-10-29,Male,24,20-24,4
12,0,0,0,0,2020-10-29,Male,17,15-19,8
12,3,0,0,3,2020-10-30,Female,13,10-14,9
12,1,0,0,1,2020-10-30,Male,65,65-69,10
12,0,0,0,0,2020-11-01,Female,24,20-24,2
12,1,0,3,4,2020-10-30,Female,73,70-74,3
12,1,1,0,2,2020-11-02,Female,79,75-79,9
12,1,0,0,1,2020-11-02,Female,28,25-34,9
12,1,0,0,1,2020-10-30,Female,66,65-69,8
12,0,1,0,1,2020-11-02,Female,56,55-64,8
12,1,0,0,1,2020-10-30,Male,52,45-54,9
12,0,0,0,0,2020-10-31,Male,52,45-54,5
12,1,1,0,2,2020-10-30,Male,27,25-34,5
12,1,2,1,4,2020-10-30,Male,70,70-74,9
12,0,3,0,3,2020-10-30,Male,27,25-34,12
12,0,0,0,0,2020-10-29,Female,52,45-54,11
12,0,0,0,0,2020-10-31,Male,28,25-34,8
12,3,0,0,3,2020-10-30,Male,9,5-9,7
12,3,0,0,3,2020-10-29,Male,65,65-69,8
12,0,0,0,0,2020-10-30,Female,58,55-64,9
12,0,3,0,3,2020-11-01,Female,66,65-69,11
12,1,1,1,3,2020-10-30,Female,60,55-64,8
12,0,0,0,0,2020-10-30,Female,66,65-69,5
12,0,0,0,0,2020-10-30,Male,70,70-74,12
12,2,57,0,59,2020-10-30,Male,22,20-24,8
12,1,0,0,1,2020-10-30,Male,74,70-74,10
12,2,1,0,3,2020-10-30,Female,72,70-74,7
12,0,0,0,0,2020-10-30,Male,50,45-54,6
12,1,0,0,1,2020-10-31,Female,31,25-34,8
12,1,0,0,1,2020-10-30,Female,54,45-54,10
12,1,0,0,1,2020-10-30,Male,33,25-34,6
12,0,0,0,0,2020-10-30,Male,53,45-54,8
12,1,0,0,1,2020-10-30,Male,51,45-54,9
12,0,0,0,0,2020-10-30,Female,24,20-24,4
12,1,0,0,1,2020-10-31,Female,49,45-54,8
12,2,0,0,2,2020-11-01,Male,25,25-34,2
12,0,0,0,0,2020-10-31,Male,44,35-44,7
12,2,3,100,105,2020-10-31,Male,17,15-19,8
12,1,2,0,3,2020-10-30,Female,68,65-69,5
12,2,0,0,2,2020-10-29,Male,66,65-69,9
12,0,1,0,1,2020-11-02,Male,65,65-69,6
12,1,3,0,4,2020-10-30,Male,68,65-69,9
12,1,0,0,1,2020-10-31,Female,57,55-64,10
12,0,0,0,0,2020-10-30,Male,50,45-54,10
12,0,0,0,0,2020-10-30,Male,13,10-14,9
12,2,1,0,3,2020-11-01,Female,59,55-64,7
12,0,1,0,1,2020-10-29,Male,71,70-74,11
12,0,1,0,1,2020-10-30,Male,40,35-44,6
12,2,0,0,2,2020-10-30,Female,69,65-69,12
12,0,4,0,4,2020-10-30,Male,38,35-44,6
12,2,0,0,2,2020-10-31,Female,34,25-34,2
12,1,6,0,7,2020-10-31,Female,7,5-9,7
12,4,3,0,7,2020-10-30,Male,21,20-24,2
12,0,2,0,2,2020-10-31,Male,51,45-54,6
12,1,2,0,3,2020-10-31,Female,57,55-64,9
12,1,0,0,1,2020-10-30,Female,59,55-64,12
12,0,0,0,0,2020-10-29,Male,43,35-44,11
12,1,0,0,1,2020-10-31,Male,62,55-64,4
12,2,0,0,2,2020-10-31,Female,63,55-64,8
12,2,0,0,2,2020-10-31,Male,31,25-34,9
12,0,4,0,4,2020-11-02,Female,23,20-24,6
12,2,0,0,2,2020-10-30,Male,73,70-74,9
12,2,10,0,12,2020-10-30,Female,52,45-54,11
12,2,4,0,6,2020-10-30,Male,69,65-69,8
12,1,0,0,1,2020-10-29,Male,34,25-34,11
12,0,0,0,0,2020-10-30,Male,48,45-54,7
12,3,0,0,3,2020-10-31,Male,69,65-69,7
12,0,0,0,0,2020-10-29,Male,65,65-69,11
12,3,0,0,3,2020-11-01,Male,5,5-9,8
12,2,2,100,104,2020-10-31,Male,67,65-69,11
12,0,4,0,4,2020-10-29,Male,61,55-64,8
12,1,2,0,3,2020-10-30,Male,70,70-74,8
12,0,1,3,4,2020-10-30,Male,33,25-34,4
12,2,0,0,2,2020-11-01,Female,16,15-19,5
12,0,0,0,0,2020-10-31,Male,43,35-44,5
12,0,0,0,0,2020-10-30,Female,56,55-64,10
12,0,1,0,1,2020-10-30,Female,58,55-64,8
12,3,0,0,3,2020-10-29,Male,22,20-24,2
12,0,0,0,0,2020-10-30,Female,66,65-69,11
12,0,0,0,0,2020-10-30,Female,40,35-44,11
12,0,2,0,2,2020-10-31,Female,25,25-34,4
12,0,4,0,4,2020-11-02,Female,63,55-64,7
12,1,2,0,3,2020-10-30,Female,61,55-64,12
12,1,4,0,5,2020-10-31,Male,61,55-64,7
12,0,0,0,0,2020-10-30,Male,49,45-54,7
12,1,2,0,3,2020-10-30,Female,53,45-54,12
12,0,0,0,0,2020-10-29,Male,34,25-34,8
12,0,1,0,1,2020-11-02,Male,56,55-64,8
12,0,0,0,0,2020-10-29,Female,65,65-69,12
12,1,0,0,1,2020-10-30,Male,73,70-74,10
12,3,0,0,3,2020-10-31,Female,8,5-9,6
12,4,1,0,5,2020-10-30,Male,9,5-9,6
12,1,0,0,1,2020-10-30,Male,79,75-79,7
12,0,1,0,1,2020-10-30,Female,66,65-69,7
12,0,0,0,0,2020-11-01,Male,38,35-44,8
12,2,3,0,5,2020-10-29,Female,15,15-19,6
12,0,0,0,0,2020-10-30,Female,55,55-64,11
12,0,0,0,0,2020-10-30,Male,53,45-54,8
12,1,0,30,31,2020-11-02,Male,48,45-54,6
12,1,0,0,1,2020-10-30,Male,69,65-69,10
12,2,1,2,5,2020-10-31,Male,16,15-19,7
12,0,3,0,3,2020-10-29,Male,36,35-44,12
12,2,2,0,4,2020-11-01,Female,49,45-54,5
12,1,0,0,1,2020-10-29,Male,40,35-44,12
12,2,0,0,2,2020-10-30,Female,71,70-74,9
12,2,0,0,2,2020-10-30,Male,62,55-64,11
12,1,0,0,1,2020-10-30,Female,2,1-4,2
12,1,4,0,5,2020-10-30,Female,68,65-69,7
12,3,3,0,6,2020-11-02,Female,23,20-24,6
12,0,4,0,4,2020-10-30,Female,70,70-74,8
12,1,1,0,2,2020-10-30,Male,68,65-69,5
12,0,1,0,1,2020-10-31,Male,8,5-9,8
12,1,0,0,1,2020-10-30,Female,33,25-34,8
12,2,2,0,4,2020-10-30,Female,71,70-74,6
12,0,0,0,0,2020-10-31,Male,68,65-69,11
12,4,0,0,4,2020-10-31,Female,63,55-64,4
12,0,0,0,0,2020-10-30,Male,37,35-44,5
12,0,1,0,1,2020-10-29,Male,28,25-34,10
12,0,1,0,1,2020-10-29,Female,53,45-54,9
12,0,0,0,0,2020-11-01,Female,18,15-19,4
12,0,2,0,2,2020-10-31,Male,46,45-54,6
12,1,2,0,3,2020-10-30,Male,52,45-54,9
12,0,1,0,1,2020-10-30,Female,70,70-74,7
12,1,10,0,11,2020-10-29,Male,32,25-34,8
12,3,0,0,3,2020-10-30,Male,69,65-69,7
12,1,0,0,1,2020-10-30,Female,69,65-69,10
12,0,0,0,0,2020-10-30,Male,16,15-19,9
12,2,0,0,2,2020-10-30,Male,65,65-69,8
12,0,1,0,1,2020-10-30,Male,49,45-54,9
12,1,12,0,13,2020-10-30,Male,66,65-69,7
12,2,0,0,2,2020-10-29,Female,66,65-69,7
12,0,10,0,10,2020-10-31,Female,60,55-64,7
12,0,6,9,15,2020-10-30,Male,15,15-19,5
12,1,11,0,12,2020-10-29,Female,65,65-69,7
12,2,2,0,4,2020-10-30,Male,22,20-24,7
12,1,0,0,1,2020-10-30,Male,66,65-69,11
12,0,0,0,0,2020-10-30,Male,65,65-69,11
12,0,1,0,1,2020-10-29,Female,67,65-69,11
12,1,2,0,3,2020-10-30,Male,67,65-69,10
12,1,0,1,2,2020-10-30,Male,50,45-54,5
12,1,0,0,1,2020-10-31,Male,75,75-79,10
12,0,0,0,0,2020-10-30,Female,8,5-9,6
12,0,2,0,2,2020-10-30,Male,65,65-69,6
12,2,0,0,2,2020-10-30,Male,70,70-74,5
12,3,0,0,3,2020-10-29,Female,19,15-19,8
12,2,4,0,6,2020-10-31,Female,61,55-64,4
12,3,1,0,4,2020-10-30,Male,16,15-19,9
12,0,1,0,1,2020-10-30,Male,52,45-54,8
12,0,0,9,9,2020-10-30,Female,51,45-54,10
12,5,0,0,5,2020-10-30,Male,13,10-14,9
12,0,0,0,0,2020-11-01,Female,60,55-64,8
12,0,0,0,0,2020-10-30,Male,34,25-34,11
12,0,0,0,0,2020-10-31,Male,47,45-54,5
12,1,3,0,4,2020-10-30,Male,81,80-84,11
12,5,7,0,12,2020-10-29,Female,8,5-9,2
12,3,0,0,3,2020-10-31,Female,53,45-54,8
12,0,0,0,0,2020-11-01,Female,58,55-64,6
12,0,0,0,0,2020-10-29,Female,12,10-14,7
12,1,0,0,1,2020-10-30,Female,52,45-54,8
12,0,1,0,1,2020-10-29,Male,24,20-24,9
12,0,0,0,0,2020-10-30,Male,19,15-19,8
12,2,0,0,2,2020-10-30,Male,71,70-74,10
12,0,0,0,0,2020-11-02,Male,35,35-44,11
12,2,0,0,2,2020-10-30,Female,21,20-24,8
12,1,3,0,4,2020-11-01,Female,34,25-34,7
12,0,0,0,0,2020-10-30,Female,23,20-24,11
12,0,0,0,0,2020-10-31,Female,66,65-69,8
12,3,0,0,3,2020-10-29,Male,23,20-24,10
12,6,0,0,6,2020-10-30,Female,1,1-4,8
12,1,1,0,2,2020-10-31,Female,67,65-69,6
12,0,0,0,0,2020-10-30,Male,67,65-69,10
12,0,0,0,0,2020-10-29,Male,22,20-24,4
12,2,0,0,2,2020-10-29,Male,41,35-44,12
12,1,1,2,4,2020-10-30,Male,65,65-69,10
12,0,0,0,0,2020-10-30,Male,71,70-74,6
12,2,0,0,2,2020-10-29,Male,58,55-64,8
12,3,1,0,4,2020-10-31,Female,67,65-69,3
12,2,0,0,2,2020-10-31,Male,75,75-79,8
12,1,0,0,1,2020-10-30,Male,79,75-79,10
12,0,0,0,0,2020-10-30,Male,78,75-79,10
12,0,4,1,5,2020-10-31,Female,68,65-69,8
12,3,60,0,63,2020-10-29,Male,64,55-64,6
12,1,0,1,2,2020-10-29,Male,63,55-64,7
12,0,3,0,3,2020-11-01,Female,67,65-69,10
12,2,1,0,3,2020-10-29,Female,24,20-24,2
12,0,1,0,1,2020-10-30,Female,68,65-69,10
12,0,0,0,0,2020-11-02,Male,28,25-34,2
12,0,0,0,0,2020-10-30,Female,78,75-79,10
12,0,0,13,13,2020-10-29,Female,63,55-64,7
12,1,3,0,4,2020-10-30,Male,68,65-69,11
12,0,0,0,0,2020-10-30,Male,11,10-14,5
12,0,1,0,1,2020-10-30,Female,33,25-34,7
12,2,0,0,2,2020-10-31,Female,12,10-14,9
12,1,2,0,3,2020-10-29,Male,37,35-44,6
12,0,1,0,1,2020-10-30,Male,29,25-34,11
12,0,0,0,0,2020-10-30,Female,41,35-44,10
12,3,0,0,3,2020-10-30,Female,52,45-54,7
12,2,1,0,3,2020-10-31,Female,52,45-54,9
12,2,0,0,2,2020-11-01,Female,66,65-69,10
12,2,0,0,2,2020-10-31,Female,78,75-79,8
12,0,1,0,1,2020-10-30,Male,66,65-69,12
12,2,0,0,2,2020-11-02,Female,4,1-4,8
12,0,0,0,0,2020-10-31,Female,76,75-79,10
12,0,0,0,0,2020-10-30,Female,48,45-54,10
12,1,3,0,4,2020-10-29,Male,61,55-64,6
12,1,0,0,1,2020-10-31,Female,50,45-54,7
12,0,0,0,0,2020-10-29,Male,13,10-14,2
12,0,1,1,2,2020-10-29,Male,20,20-24,2
12,4,0,1,5,2020-11-01,Female,18,15-19,2
12,1,0,0,1,2020-10-31,Male,68,65-69,11
12,0,0,0,0,2020-10-31,Male,57,55-64,6
12,2,3,0,5,2020-10-30,Female,54,45-54,8
12,1,2,0,3,2020-10-30,Male,62,55-64,8
12,0,0,0,0,2020-10-30,Female,65,65-69,7
12,0,2,0,2,2020-10-29,Female,60,55-64,4
12,0,1,9,10,2020-10-29,Male,36,35-44,6
12,1,2,0,3,2020-10-30,Female,60,55-64,8
12,0,1,0,1,2020-11-02,Male,51,45-54,8
12,0,0,0,0,2020-10-31,Female,49,45-54,9
12,1,10,5,16,2020-10-30,Male,65,65-69,2
12,0,0,0,0,2020-10-30,Male,74,70-74,11
12,1,4,0,5,2020-10-29,Female,19,15-19,11
12,3,0,0,3,2020-10-30,Female,12,10-14,10
12,1,3,0,4,2020-10-30,Male,12,10-14,10
12,1,2,0,3,2020-10-30,Female,69,65-69,9
12,1,0,0,1,2020-10-30,Female,14,10-14,8
12,0,0,0,0,2020-10-29,Female,65,65-69,8
12,1,0,2,3,2020-10-31,Female,26,25-34,9
12,2,0,0,2,2020-11-02,Male,76,75-79,11
12,1,0,0,1,2020-10-30,Male,73,70-74,9
12,0,0,0,0,2020-10-30,Male,30,25-34,7
12,0,0,0,0,2020-10-29,Female,24,20-24,10
12,4,10,0,14,2020-10-30,Male,63,55-64,10
12,3,1,0,4,2020-10-30,Female,55,55-64,6
12,1,0,0,1,2020-10-30,Male,63,55-64,9
12,1,0,0,1,2020-10-29,Male,18,15-19,8
12,2,0,0,2,2020-10-31,Male,54,45-54,11
12,0,0,0,0,2020-11-01,Male,60,55-64,4
12,0,0,0,0,2020-10-29,Female,6,5-9,10
12,2,0,0,2,2020-10-30,Male,72,70-74,7
12,1,0,0,1,2020-10-31,Male,72,70-74,6
12,1,10,0,11,2020-10-30,Female,52,45-54,10
12,0,0,0,0,2020-10-30,Male,18,15-19,5
12,0,1,0,1,2020-11-01,Male,85,85+,4
12,0,2,0,2,2020-10-31,Female,71,70-74,10
12,0,0,0,0,2020-10-30,Male,11,10-14,7
12,0,0,0,0,2020-10-31,Male,30,25-34,10
12,2,0,0,2,2020-10-31,Female,18,15-19,5
12,0,0,0,0,2020-10-31,Female,56,55-64,11
12,0,0,0,0,2020-10-30,Male,67,65-69,8
12,0,0,0,0,2020-10-31,Female,85,85+,8
12,2,0,0,2,2020-10-30,Female,69,65-69,3
12,0,0,0,0,2020-10-30,Male,51,45-54,9
12,0,2,0,2,2020-10-30,Male,54,45-54,9
12,0,0,0,0,2020-11-01,Female,9,5-9,9
12,2,1,0,3,2020-10-29,Male,66,65-69,11
12,0,1,0,1,2020-10-29,Female,69,65-69,6
12,0,0,0,0,2020-10-30,Male,50,45-54,8
12,1,1,0,2,2020-10-30,Female,69,65-69,4
12,0,0,0,0,2020-10-30,Female,29,25-34,8
12,0,1,0,1,2020-10-30,Male,45,45-54,9
12,0,11,0,11,2020-10-31,Male,37,35-44,5
12,2,0,0,2,2020-10-30,Female,68,65-69,7
12,1,0,0,1,2020-10-30,Male,54,45-54,5
12,1,1,0,2,2020-10-29,Female,24,20-24,5
12,1,3,0,4,2020-10-31,Female,47,45-54,6
12,2,0,0,2,2020-11-01,Male,3,1-4,7
12,2,0,0,2,2020-10-30,Male,63,55-64,10
12,1,6,0,7,2020-10-31,Male,66,65-69,9
12,2,0,0,2,2020-10-30,Male,9,5-9,11
12,0,0,0,0,2020-10-31,Female,16,15-19,5
12,3,11,0,14,2020-10-29,Male,60,55-64,10
12,0,2,1,3,2020-10-30,Male,65,65-69,7
12,0,0,0,0,2020-10-30,Male,58,55-64,11
12,1,0,0,1,2020-10-29,Female,65,65-69,12
12,2,0,0,2,2020-10-31,Male,1,1-4,6
12,2,0,0,2,2020-10-29,Male,51,45-54,4
12,2,3,0,5,2020-10-29,Female,14,10-14,7
12,2,5,0,7,2020-11-02,Female,24,20-24,9
12,4,6,0,10,2020-10-29,Male,13,10-14,12
12,2,0,0,2,2020-10-30,Male,50,45-54,10
12,0,0,0,0,2020-10-31,Female,51,45-54,6
12,0,1,0,1,2020-10-30,Male,74,70-74,12
12,0,3,0,3,2020-10-29,Male,19,15-19,2
12,0,2,0,2,2020-10-31,Female,66,65-69,7
12,0,0,0,0,2020-10-31,Male,70,70-74,7
12,1,0,0,1,2020-10-30,Male,54,45-54,10
12,0,0,0,0,2020-10-30,Female,68,65-69,11
12,0,0,0,0,2020-10-30,Male,77,75-79,8
12,0,4,0,4,2020-10-31,Male,85,85+,8
12,0,0,0,0,2020-10-30,Male,21,20-24,6
12,2,0,0,2,2020-10-31,Female,77,75-79,4
12,2,0,0,2,2020-10-31,Male,66,65-69,9
12,1,2,0,3,2020-10-30,Male,59,55-64,11
12,1,0,0,1,2020-10-30,Male,54,45-54,8
12,1,2,0,3,2020-10-30,Female,68,65-69,12
12,0,0,0,0,2020-10-30,Male,35,35-44,8
12,1,0,0,1,2020-11-01,Male,51,45-54,12
12,0,0,0,0,2020-10-31,Female,66,65-69,6
12,0,0,0,0,2020-10-30,Male,30,25-34,11
12,3,0,0,3,2020-10-31,Female,3,1-4,8
12,0,0,0,0,2020-10-31,Female,23,20-24,9
12,1,0,0,1,2020-10-30,Male,34,25-34,8
12,0,0,0,0,2020-10-30,Female,48,45-54,12
12,0,9,0,9,2020-10-29,Male,40,35-44,6
12,0,1,0,1,2020-10-30,Male,70,70-74,9
12,2,0,0,2,2020-10-29,Female,63,55-64,11
12,0,1,0,1,2020-10-30,Male,63,55-64,9
12,3,0,0,3,2020-10-31,Female,5,5-9,6
12,2,4,0,6,2020-10-30,Female,37,35-44,10
12,1,0,0,1,2020-10-30,Male,8,5-9,2
12,1,0,0,1,2020-10-31,Female,47,45-54,2
12,1,1,0,2,2020-10-30,Female,22,20-24,2
12,2,7,0,9,2020-10-30,Female,61,55-64,10
12,1,0,0,1,2020-10-30,Male,70,70-74,10
12,1,3,0,4,2020-10-30,Female,57,55-64,6
12,1,0,0,1,2020-10-30,Male,52,45-54,9
12,2,0,0,2,2020-10-30,Male,51,45-54,7
12,0,2,0,2,2020-10-31,Female,66,65-69,12
12,0,2,0,2,2020-10-30,Female,66,65-69,10
12,0,5,0,5,2020-10-29,Female,69,65-69,6
12,3,0,0,3,2020-10-30,Female,7,5-9,7
12,0,4,0,4,2020-11-01,Female,53,45-54,8
12,2,3,0,5,2020-10-30,Female,32,25-34,2
12,0,0,0,0,2020-10-29,Male,54,45-54,8
12,0,3,0,3,2020-10-30,Male,54,45-54,9
12,2,0,0,2,2020-10-29,Male,65,65-69,9
12,0,0,0,0,2020-11-01,Male,57,55-64,7
12,1,0,0,1,2020-10-31,Female,55,55-64,10
12,2,0,0,2,2020-10-30,Male,40,35-44,11
12,0,2,0,2,2020-11-02,Male,38,35-44,9
12,5,0,0,5,2020-10-30,Female,18,15-19,4
12,0,1,0,1,2020-10-29,Male,39,35-44,8
12,1,0,0,1,2020-11-02,Female,44,35-44,3
12,3,0,0,3,2020-10-30,Female,21,20-24,9
12,1,0,0,1,2020-10-30,Male,24,20-24,7
12,2,4,2,8,2020-10-31,Female,62,55-64,7
12,2,1,10,13,2020-10-31,Female,56,55-64,6
12,2,1,0,3,2020-10-31,Female,8,5-9,11
12,1,1,0,2,2020-10-30,Male,66,65-69,11
12,1,0,1,2,2020-10-30,Male,30,25-34,4
12,0,0,0,0,2020-10-30,Male,61,55-64,8
12,0,0,0,0,2020-10-29,Male,63,55-64,9
12,1,0,0,1,2020-10-31,Female,64,55-64,5
12,0,2,0,2,2020-10-30,Male,73,70-74,9
12,1,12,6,19,2020-10-30,Female,32,25-34,4
12,0,0,0,0,2020-10-30,Female,57,55-64,9
12,3,0,0,3,2020-10-31,Male,43,35-44,9
12,2,0,0,2,2020-10-30,Male,70,70-74,10
12,5,0,0,5,2020-10-29,Female,19,15-19,11
12,1,0,0,1,2020-10-30,Male,62,55-64,12
12,1,0,0,1,2020-10-29,Male,67,65-69,12
12,0,0,0,0,2020-10-31,Male,57,55-64,11
12,1,0,0,1,2020-10-30,Female,71,70-74,8
12,0,4,0,4,2020-10-30,Female,60,55-64,4
12,2,0,0,2,2020-10-30,Male,6,5-9,12
12,2,0,0,2,2020-10-29,Female,55,55-64,11
12,0,7,1,8,2020-10-31,Male,58,55-64,7
12,0,0,0,0,2020-11-01,Female,26,25-34,7
12,3,0,0,3,2020-11-02,Female,8,5-9,7
12,0,0,0,0,2020-10-30,Male,53,45-54,7
12,0,0,0,0,2020-10-29,Female,22,20-24,8
12,0,0,0,0,2020-10-31,Female,35,35-44,9
12,2,7,0,9,2020-10-31,Male,55,55-64,7
12,1,2,0,3,2020-10-30,Male,62,55-64,8
12,0,3,0,3,2020-11-01,Male,26,25-34,6
12,0,0,0,0,2020-10-29,Male,65,65-69,6
12,2,0,0,2,2020-10-30,Female,73,70-74,5
12,0,0,0,0,2020-10-29,Male,13,10-14,10
12,0,0,0,0,2020-11-01,Female,19,15-19,2
12,1,0,0,1,2020-11-02,Female,65,65-69,8
12,1,1,0,2,2020-10-29,Male,64,55-64,12
12,1,1,0,2,2020-10-30,Female,51,45-54,9
12,2,0,0,2,2020-10-29,Female,17,15-19,12
12,0,1,0,1,2020-10-30,Female,73,70-74,6
12,4,0,0,4,2020-10-30,Female,8,5-9,8
12,1,0,0,1,2020-10-30,Female,56,55-64,6
12,0,2,9,11,2020-10-30,Male,52,45-54,2
12,1,0,31,32,2020-11-01,Male,53,45-54,8
12,5,1,0,6,2020-10-29,Female,6,5-9,5
12,2,2,0,4,2020-10-30,Male,55,55-64,12
12,0,11,0,11,2020-10-29,Female,22,20-24,2
12,1,0,0,1,2020-11-01,Female,54,45-54,9
12,0,0,0,0,2020-10-29,Male,59,55-64,11
12,0,2,0,2,2020-10-30,Female,59,55-64,10
12,0,1,0,1,2020-11-01,Female,20,20-24,4
12,0,1,0,1,2020-10-30,Female,66,65-69,4
12,0,0,0,0,2020-10-29,Female,23,20-24,10
12,1,10,0,11,2020-10-30,Male,32,25-34,9
12,0,0,0,0,2020-10-29,Male,27,25-34,11
12,3,2,0,5,2020-11-01,Male,58,55-64,8
12,0,0,0,0,2020-10-29,Male,47,45-54,8
12,4,0,0,4,2020-10-30,Male,0,<1,2
12,0,0,0,0,2020-10-29,Female,41,35-44,12
12,1,2,0,3,2020-10-30,Male,68,65-69,9
12,1,0,0,1,2020-10-30,Female,26,25-34,6
12,0,4,0,4,2020-11-02,Male,73,70-74,5
12,2,1,0,3,2020-10-30,Female,73,70-74,5
12,0,0,1,1,2020-10-31,Male,14,10-14,8
12,2,3,3,8,2020-10-30,Male,66,65-69,9
12,3,1,0,4,2020-10-31,Male,10,10-14,2
12,2,4,0,6,2020-10-31,Female,56,55-64,3
12,1,6,0,7,2020-10-31,Male,33,25-34,8
12,1,2,0,3,2020-10-30,Female,61,55-64,7
12,3,0,0,3,2020-10-29,Female,65,65-69,6
12,0,0,0,0,2020-10-30,Male,69,65-69,9
12,0,0,1,1,2020-10-30,Female,30,25-34,11
12,2,2,0,4,2020-10-30,Male,20,20-24,9
12,1,2,0,3,2020-10-31,Male,62,55-64,6
12,5,0,0,5,2020-10-29,Female,18,15-19,4
12,0,0,0,0,2020-10-31,Female,73,70-74,8
12,0,0,0,0,2020-11-01,Male,59,55-64,8
12,0,0,0,0,2020-10-31,Female,52,45-54,7
12,1,0,0,1,2020-10-29,Male,68,65-69,11
12,0,0,0,0,2020-10-31,Male,78,75-79,5
12,2,2,0,4,2020-10-31,Male,70,70-74,11
12,1,0,0,1,2020-10-30,Male,58,55-64,8
12,2,1,0,3,2020-10-29,Male,66,65-69,7
12,0,2,0,2,2020-10-30,Female,53,45-54,8
12,0,1,0,1,2020-10-30,Male,50,45-54,9
12,2,0,0,2,2020-10-31,Male,17,15-19,7
12,3,3,0,6,2020-10-29,Male,1,1-4,9
12,0,0,0,0,2020-11-02,Female,31,25-34,8
12,0,3,0,3,2020-10-31,Male,61,55-64,9
12,1,5,0,6,2020-10-30,Female,69,65-69,9
12,1,1,0,2,2020-10-30,Male,67,65-69,12
12,2,2,0,4,2020-10-31,Male,77,75-79,5
12,3,0,0,3,2020-10-29,Female,66,65-69,6
12,2,0,0,2,2020-10-31,Male,75,75-79,5
12,2,0,0,2,2020-11-02,Female,23,20-24,6
12,4,0,1,5,2020-11-02,Male,27,25-34,6
12,0,0,0,0,2020-10-30,Female,69,65-69,4
12,0,1,0,1,2020-10-30,Male,59,55-64,9
12,0,0,0,0,2020-10-30,Male,37,35-44,11
12,0,3,0,3,2020-10-30,Female,42,35-44,8
12,0,0,0,0,2020-10-30,Male,8,5-9,6
12,0,0,0,0,2020-10-29,Male,51,45-54,9
12,4,0,0,4,2020-10-30,Female,31,25-34,8
12,2,0,0,2,2020-10-31,Male,5,5-9,6
12,1,1,0,2,2020-10-29,Female,46,45-54,10
12,3,3,0,6,2020-10-31,Male,68,65-69,6
12,0,0,0,0,2020-10-30,Male,42,35-44,5
12,0,2,0,2,2020-10-30,Male,52,45-54,3
12,1,0,0,1,2020-10-31,Male,55,55-64,10
12,1,0,0,1,2020-10-31,Female,41,35-44,8
12,1,0,0,1,2020-10-30,Female,52,45-54,6
12,2,1,0,3,2020-10-29,Female,70,70-74,9
12,6,2,0,8,2020-11-02,Male,4,1-4,3
12,0,0,0,0,2020-10-31,Female,65,65-69,7
12,3,0,0,3,2020-10-30,Male,16,15-19,10
12,0,1,0,1,2020-10-29,Male,54,45-54,9
12,2,0,0,2,2020-10-30,Female,59,55-64,8
12,1,0,1,2,2020-10-30,Female,36,35-44,6
12,0,0,0,0,2020-10-30,Male,59,55-64,5
12,2,1,1,4,2020-10-31,Female,51,45-54,5
12,1,0,0,1,2020-10-29,Female,21,20-24,9
12,3,0,0,3,2020-10-30,Female,66,65-69,11
12,2,1,0,3,2020-10-30,Male,51,45-54,10
12,1,0,0,1,2020-10-30,Female,59,55-64,4
12,0,1,0,1,2020-10-30,Male,65,65-69,9
12,1,0,0,1,2020-10-30,Male,48,45-54,6
12,0,1,0,1,2020-10-30,Male,59,55-64,8
12,1,3,0,4,2020-10-30,Male,69,65-69,7
12,0,2,2,4,2020-10-30,Male,30,25-34,9
12,0,0,0,0,2020-11-01,Male,36,35-44,8
12,1,4,0,5,2020-11-01,Female,30,25-34,3
12,0,0,0,0,2020-10-31,Female,69,65-69,9
12,1,5,0,6,2020-10-30,Female,56,55-64,4
12,0,1,0,1,2020-10-30,Female,26,25-34,9
12,1,0,0,1,2020-10-30,Female,60,55-64,9
12,0,3,0,3,2020-10-29,Male,65,65-69,12
12,1,1,0,2,2020-10-29,Male,52,45-54,6
12,0,0,0,0,2020-10-30,Male,70,70-74,6
12,1,0,0,1,2020-10-30,Male,57,55-64,7
12,0,0,0,0,2020-10-29,Female,65,65-69,12
12,1,1,0,2,2020-10-30,Male,69,65-69,10
12,2,2,0,4,2020-10-29,Male,62,55-64,7
12,0,3,0,3,2020-10-29,Female,65,65-69,8
12,1,1,0,2,2020-10-30,Male,79,75-79,8
12,2,0,0,2,2020-10-30,Male,72,70-74,5
12,0,1,0,1,2020-10-31,Male,67,65-69,8
12,1,0,0,1,2020-10-30,Female,67,65-69,7
12,0,0,0,0,2020-11-02,Female,22,20-24,2
12,0,7,0,7,2020-10-30,Female,64,55-64,12
12,1,0,0,1,2020-10-30,Male,58,55-64,12
12,2,2,0,4,2020-10-30,Male,69,65-69,11
12,0,3,0,3,2020-10-30,Male,51,45-54,11
12,3,1,0,4,2020-10-31,Male,8,5-9,4
12,1,0,0,1,2020-10-31,Male,72,70-74,9
12,2,1,0,3,2020-10-30,Male,71,70-74,10
12,0,0,0,0,2020-11-02,Female,52,45-54,5
12,1,0,0,1,2020-10-31,Female,63,55-64,7
12,2,0,0,2,2020-10-30,Female,16,15-19,11
12,5,0,0,5,2020-11-03,Male,21,20-24,3
12,2,0,0,2,2020-10-29,Male,0,<1,4
12,0,12,0,12,2020-10-30,Female,39,35-44,11
12,1,0,0,1,2020-10-30,Female,58,55-64,11
12,2,0,2,4,2020-10-30,Male,77,75-79,5
12,3,0,0,3,2020-10-30,Male,18,15-19,12
12,0,0,0,0,2020-10-30,Male,40,35-44,9
12,1,3,0,4,2020-10-31,Male,77,75-79,4
12,0,1,0,1,2020-10-31,Male,67,65-69,8
12,1,1,0,2,2020-10-30,Female,66,65-69,7
12,0,0,0,0,2020-10-30,Female,68,65-69,11
12,3,2,0,5,2020-10-31,Female,18,15-19,7
12,0,0,0,0,2020-10-29,Female,28,25-34,10
12,4,0,0,4,2020-10-30,Female,32,25-34,10
12,1,0,1,2,2020-10-29,Female,63,55-64,8
12,4,1,0,5,2020-10-31,Female,21,20-24,2
12,0,0,0,0,2020-10-29,Female,33,25-34,8
12,0,0,0,0,2020-10-30,Male,17,15-19,4
12,0,0,0,0,2020-10-30,Female,46,45-54,9
12,0,0,0,0,2020-10-30,Male,32,25-34,7
12,1,0,0,1,2020-10-29,Male,65,65-69,6
12,0,0,0,0,2020-10-30,Female,68,65-69,11
12,2,1,0,3,2020-10-31,Female,19,15-19,8
12,0,0,0,0,2020-10-30,Female,19,15-19,11
12,0,0,0,0,2020-10-29,Male,23,20-24,9
12,0,0,0,0,2020-10-30,Male,59,55-64,8
12,7,0,0,7,2020-10-30,Male,14,10-14,2
12,1,0,0,1,2020-10-30,Male,59,55-64,9
12,2,0,0,2,2020-10-31,Male,26,25-34,9
12,1,4,0,5,2020-10-29,Female,67,65-69,9
12,2,1,0,3,2020-11-01,Male,56,55-64,8
12,2,2,0,4,2020-10-30,Male,70,70-74,7
12,0,0,1,1,2020-10-31,Male,69,65-69,10
12,1,2,0,3,2020-10-30,Male,59,55-64,9
12,3,0,0,3,2020-11-01,Male,63,55-64,3
12,1,0,0,1,2020-10-30,Male,44,35-44,11
12,0,0,0,0,2020-10-30,Male,52,45-54,5
12,2,3,0,5,2020-10-31,Male,21,20-24,5
12,1,0,0,1,2020-10-29,Female,63,55-64,6
12,0,1,0,1,2020-10-30,Male,42,35-44,9
12,1,1,0,2,2020-11-02,Male,7,5-9,6
12,0,0,0,0,2020-10-29,Male,36,35-44,10
12,2,0,0,2,2020-10-31,Female,24,20-24,6
12,3,0,0,3,2020-10-30,Male,11,10-14,8
12,0,0,0,0,2020-10-30,Female,51,45-54,7
12,5,2,0,7,2020-10-31,Female,68,65-69,4
12,2,2,0,4,2020-10-31,Female,50,45-54,6
12,0,1,0,1,2020-10-30,Female,67,65-69,10
12,1,0,0,1,2020-10-30,Male,63,55-64,9
12,1,1,0,2,2020-10-31,Male,32,25-34,5
12,1,4,0,5,2020-10-31,Female,22,20-24,2
12,1,10,0,11,2020-10-30,Male,51,45-54,11
12,0,2,0,2,2020-10-31,Female,55,55-64,7
12,0,0,0,0,2020-10-30,Female,25,25-34,7
12,0,0,0,0,2020-10-30,Male,70,70-74,9
12,2,0,0,2,2020-11-01,Male,67,65-69,8
12,2,0,0,2,2020-10-30,Female,60,55-64,10
12,1,0,0,1,2020-11-01,Male,40,35-44,8
12,0,0,0,0,2020-10-30,Male,53,45-54,7
12,1,0,0,1,2020-11-02,Female,30,25-34,11
12,4,6,0,10,2020-10-30,Female,1,1-4,3
12,0,0,0,0,2020-10-30,Male,33,25-34,11
12,0,15,0,15,2020-10-30,Male,46,45-54,6
12,0,0,0,0,2020-10-29,Female,66,65-69,10
12,1,0,0,1,2020-10-30,Female,68,65-69,7
12,1,0,0,1,2020-10-30,Male,22,20-24,2
12,0,1,0,1,2020-10-31,Female,69,65-69,8
12,2,0,0,2,2020-10-29,Male,45,45-54,12
12,2,3,0,5,2020-10-31,Female,59,55-64,2
12,0,0,0,0,2020-10-29,Female,65,65-69,11
12,1,2,0,3,2020-10-29,Female,29,25-34,6
12,0,1,0,1,2020-10-29,Male,29,25-34,8
12,1,3,0,4,2020-11-01,Male,59,55-64,4
12,0,3,0,3,2020-10-29,Male,39,35-44,5
12,1,12,0,13,2020-10-29,Male,68,65-69,9
12,0,0,7,7,2020-10-29,Male,14,10-14,5
12,0,4,0,4,2020-11-01,Male,23,20-24,5
12,4,0,0,4,2020-11-02,Female,17,15-19,6
12,2,0,0,2,2020-10-30,Male,78,75-79,6
12,1,6,0,7,2020-10-29,Male,62,55-64,6
12,2,0,0,2,2020-11-01,Male,14,10-14,9
12,2,0,0,2,2020-11-02,Male,68,65-69,5
12,0,5,0,5,2020-10-31,Male,73,70-74,7
12,1,0,0,1,2020-10-30,Female,26,25-34,5
12,0,1,0,1,2020-10-30,Male,35,35-44,8
12,5,0,1,6,2020-10-30,Male,18,15-19,8
12,2,0,0,2,2020-10-30,Male,75,75-79,6
12,1,3,0,4,2020-10-29,Male,31,25-34,9
12,1,0,0,1,2020-10-29,Male,14,10-14,3
12,1,1,0,2,2020-10-31,Female,67,65-69,5
12,1,1,0,2,2020-10-30,Male,58,55-64,9
12,2,0,0,2,2020-10-30,Male,29,25-34,3
12,0,3,0,3,2020-10-30,Male,42,35-44,8
12,0,0,0,0,2020-10-29,Male,16,15-19,5
12,3,1,0,4,2020-10-30,Male,10,10-14,9
12,3,0,0,3,2020-10-30,Male,10,10-14,8
12,0,0,0,0,2020-10-29,Male,65,65-69,8
12,1,1,0,2,2020-10-29,Female,66,65-69,9
12,1,0,0,1,2020-10-31,Female,67,65-69,10
12,2,2,0,4,2020-10-31,Male,81,80-84,7
12,2,10,0,12,2020-10-30,Male,50,45-54,7
12,1,1,0,2,2020-11-02,Female,53,45-54,7
12,2,2,13,17,2020-10-31,Female,67,65-69,7
12,0,5,0,5,2020-10-29,Female,47,45-54,8
12,1,4,0,5,2020-10-30,Male,71,70-74,8
12,0,0,0,0,2020-10-30,Female,30,25-34,6
12,0,0,0,0,2020-10-29,Female,21,20-24,9
12,0,0,0,0,2020-10-30,Male,27,25-34,9
12,1,0,2,3,2020-11-02,Male,65,65-69,10
12,1,0,0,1,2020-10-29,Female,62,55-64,10
12,1,0,0,1,2020-10-30,Female,52,45-54,6
12,0,0,0,0,2020-10-29,Male,65,65-69,11
12,0,0,0,0,2020-10-30,Male,76,75-79,6
12,0,0,0,0,2020-10-30,Male,66,65-69,10
12,1,0,0,1,2020-10-29,Male,63,55-64,11
12,0,1,0,1,2020-11-02,Female,69,65-69,7
12,2,1,0,3,2020-10-30,Female,68,65-69,7
12,0,0,0,0,2020-10-31,Female,27,25-34,7
12,1,0,0,1,2020-10-30,Male,72,70-74,10
12,0,0,0,0,2020-10-29,Female,63,55-64,9
12,0,0,0,0,2020-10-30,Female,35,35-44,11
12,5,0,0,5,2020-10-29,Male,9,5-9,9
12,0,2,0,2,2020-10-31,Male,45,45-54,3
12,2,0,0,2,2020-10-30,Male,70,70-74,7
12,5,2,0,7,2020-10-30,Female,11,10-14,9
12,3,0,0,3,2020-10-29,Female,65,65-69,12
12,0,0,0,0,2020-10-30,Female,61,55-64,10
12,0,0,0,0,2020-10-30,Female,31,25-34,9
12,0,0,0,0,2020-11-03,Male,26,25-34,7
12,2,2,0,4,2020-10-30,Male,54,45-54,10
12,1,0,0,1,2020-11-01,Male,54,45-54,6
12,0,80,0,80,2020-10-30,Female,66,65-69,7
12,2,0,0,2,2020-10-30,Female,59,55-64,10
12,0,0,0,0,2020-10-30,Female,22,20-24,8
12,1,1,0,2,2020-10-30,Male,55,55-64,7
12,0,0,0,0,2020-10-30,Female,31,25-34,9
12,1,0,0,1,2020-10-31,Male,53,45-54,9
12,0,0,0,0,2020-10-31,Male,60,55-64,7
12,9,2,0,11,2020-11-01,Female,28,25-34,7
12,2,6,0,8,2020-10-30,Male,56,55-64,7
12,1,2,0,3,2020-10-29,Male,39,35-44,8
12,3,2,0,5,2020-10-30,Female,12,10-14,10
12,1,21,0,22,2020-10-31,Male,43,35-44,9
12,1,1,0,2,2020-10-30,Male,40,35-44,8
12,3,0,0,3,2020-10-29,Male,18,15-19,6
12,2,0,0,2,2020-10-30,Male,65,65-69,5
12,0,0,0,0,2020-10-30,Female,63,55-64,11
12,0,0,0,0,2020-10-29,Male,19,15-19,12
12,1,0,0,1,2020-10-29,Female,66,65-69,9
12,1,6,0,7,2020-10-29,Female,61,55-64,9
12,0,1,0,1,2020-10-30,Female,61,55-64,11
12,1,0,0,1,2020-10-30,Male,50,45-54,8
12,0,0,0,0,2020-11-01,Male,44,35-44,11
12,1,0,0,1,2020-10-31,Male,60,55-64,7
12,2,2,0,4,2020-10-30,Male,15,15-19,8
12,1,1,0,2,2020-10-30,Male,70,70-74,7
12,0,6,0,6,2020-11-01,Female,67,65-69,6
12,0,0,0,0,2020-10-30,Female,68,65-69,8
12,2,2,0,4,2020-10-30,Male,69,65-69,8
12,2,2,0,4,2020-10-30,Male,5,5-9,7
12,1,1,0,2,2020-10-30,Female,70,70-74,10
12,0,0,0,0,2020-10-30,Male,7,5-9,8
12,2,0,0,2,2020-10-30,Male,67,65-69,8
12,1,0,0,1,2020-10-31,Male,66,65-69,9
12,0,0,0,0,2020-10-31,Female,22,20-24,2
12,0,2,0,2,2020-10-30,Female,57,55-64,8
12,0,0,0,0,2020-10-30,Male,69,65-69,8
12,0,2,0,2,2020-10-30,Male,74,70-74,10
12,0,2,0,2,2020-10-30,Female,33,25-34,11
12,0,0,0,0,2020-10-30,Male,52,45-54,11
12,1,0,0,1,2020-10-30,Male,67,65-69,12
12,0,0,0,0,2020-10-30,Male,34,25-34,9
12,0,1,0,1,2020-10-31,Female,52,45-54,6
12,1,1,0,2,2020-10-30,Male,78,75-79,6
12,4,0,0,4,2020-10-30,Female,14,10-14,6
12,1,0,0,1,2020-11-02,Male,68,65-69,8
12,2,0,0,2,2020-11-02,Male,15,15-19,6
12,0,0,0,0,2020-10-30,Male,7,5-9,5
12,0,2,0,2,2020-10-30,Male,24,20-24,9
12,0,0,0,0,2020-10-30,Male,15,15-19,9
12,1,0,0,1,2020-10-29,Female,11,10-14,7
12,3,1,0,4,2020-10-31,Female,8,5-9,6
12,0,2,0,2,2020-10-31,Male,42,35-44,4
12,3,6,0,9,2020-10-30,Male,10,10-14,8
12,0,0,0,0,2020-10-30,Female,61,55-64,8
12,0,0,0,0,2020-10-31,Female,35,35-44,5
12,2,1,0,3,2020-10-30,Male,78,75-79,7
12,2,0,0,2,2020-10-29,Male,52,45-54,9
12,1,6,0,7,2020-11-01,Female,33,25-34,5
12,1,1,0,2,2020-10-29,Male,66,65-69,6
12,1,0,0,1,2020-10-30,Male,51,45-54,8
12,0,0,0,0,2020-10-30,Female,53,45-54,6
12,0,0,0,0,2020-10-30,Male,51,45-54,7
12,3,1,0,4,2020-10-30,Female,42,35-44,11
12,2,0,0,2,2020-10-31,Female,70,70-74,9
12,1,0,0,1,2020-11-01,Female,65,65-69,5
12,1,10,0,11,2020-10-29,Female,24,20-24,10
12,0,0,0,0,2020-10-30,Female,71,70-74,7
12,0,0,0,0,2020-10-30,Male,31,25-34,8
12,0,0,0,0,2020-10-30,Female,68,65-69,12
12,0,0,0,0,2020-10-30,Male,59,55-64,7
12,2,0,0,2,2020-10-30,Male,14,10-14,9
12,2,0,0,2,2020-10-29,Male,24,20-24,2
12,0,3,0,3,2020-10-30,Male,69,65-69,5
12,2,1,0,3,2020-10-30,Female,50,45-54,10
12,0,0,0,0,2020-10-30,Female,69,65-69,6
12,0,0,0,0,2020-10-29,Male,32,25-34,9
12,4,2,0,6,2020-10-31,Female,14,10-14,9
12,0,0,0,0,2020-11-02,Female,32,25-34,3
12,3,0,0,3,2020-10-31,Female,4,1-4,9
12,2,0,0,2,2020-11-01,Female,0,<1,2
12,1,1,0,2,2020-10-30,Male,59,55-64,4
12,1,0,0,1,2020-10-29,Male,38,35-44,4
12,0,1,0,1,2020-10-30,Female,67,65-69,10
12,1,0,0,1,2020-10-30,Female,58,55-64,10
12,0,1,0,1,2020-10-30,Female,66,65-69,5
12,0,1,0,1,2020-11-01,Female,54,45-54,10
12,3,0,3,6,2020-10-31,Male,69,65-69,8
12,0,0,0,0,2020-10-30,Female,41,35-44,11
12,0,1,0,1,2020-10-30,Female,64,55-64,11
12,3,0,0,3,2020-10-29,Male,40,35-44,7
12,2,3,0,5,2020-10-31,Female,70,70-74,5
12,3,2,0,5,2020-10-29,Female,10,10-14,6
12,2,1,0,3,2020-10-29,Male,64,55-64,5
12,1,0,0,1,2020-10-29,Female,52,45-54,12
12,0,0,0,0,2020-10-31,Male,40,35-44,8
12,1,1,0,2,2020-10-31,Male,78,75-79,5
12,2,0,0,2,2020-11-02,Male,15,15-19,8
12,0,2,0,2,2020-10-30,Male,77,75-79,11
12,1,0,0,1,2020-10-29,Male,66,65-69,12
12,0,0,0,0,2020-10-30,Female,29,25-34,5
12,1,0,0,1,2020-10-31,Male,34,25-34,6
12,0,0,0,0,2020-10-29,Female,66,65-69,11
12,0,0,0,0,2020-10-31,Female,65,65-69,6
12,2,0,0,2,2020-11-02,Male,8,5-9,6
12,0,0,0,0,2020-10-30,Male,48,45-54,11
12,2,3,0,5,2020-10-31,Male,19,15-19,7
12,1,1,0,2,2020-10-31,Male,65,65-69,7
12,0,1,0,1,2020-10-30,Male,39,35-44,10
12,1,11,0,12,2020-10-31,Female,65,65-69,12
12,0,1,0,1,2020-10-30,Male,38,35-44,10
12,2,2,0,4,2020-10-30,Male,74,70-74,9
12,0,0,0,0,2020-10-30,Male,30,25-34,9
12,2,2,0,4,2020-10-30,Female,62,55-64,9
12,0,0,0,0,2020-10-29,Female,54,45-54,8
12,2,0,0,2,2020-10-31,Male,67,65-69,4
12,1,0,0,1,2020-10-30,Female,67,65-69,10
12,0,0,0,0,2020-10-30,Female,38,35-44,4
12,3,2,3,8,2020-10-30,Female,5,5-9,7
12,1,3,0,4,2020-10-29,Male,48,45-54,5
12,0,1,0,1,2020-10-31,Female,37,35-44,4
12,0,0,0,0,2020-10-30,Male,75,75-79,12
12,0,1,0,1,2020-10-30,Female,19,15-19,2
12,0,0,0,0,2020-10-29,Female,37,35-44,3
12,0,0,0,0,2020-10-30,Male,64,55-64,9
12,1,0,0,1,2020-10-30,Male,60,55-64,8
12,0,0,0,0,2020-10-29,Male,41,35-44,10
12,4,0,0,4,2020-10-29,Male,2,1-4,4
12,0,0,0,0,2020-10-30,Male,34,25-34,6
12,2,3,0,5,2020-10-30,Male,69,65-69,6
12,0,0,0,0,2020-10-30,Female,10,10-14,12
12,1,0,3,4,2020-10-31,Male,67,65-69,3
12,0,0,0,0,2020-10-29,Female,58,55-64,10
12,2,2,0,4,2020-10-30,Female,52,45-54,8
12,0,0,0,0,2020-10-29,Female,34,25-34,7
12,0,0,0,0,2020-10-30,Female,59,55-64,10
12,1,0,3,4,2020-10-31,Male,17,15-19,8
12,1,4,0,5,2020-10-29,Female,62,55-64,3
12,1,0,0,1,2020-10-29,Male,65,65-69,9
12,0,0,0,0,2020-10-29,Female,16,15-19,10
12,1,0,0,1,2020-11-01,Female,49,45-54,10
12,0,0,0,0,2020-10-31,Female,23,20-24,7
12,0,3,0,3,2020-10-30,Male,23,20-24,2
12,0,0,0,0,2020-10-29,Female,21,20-24,7
12,0,2,0,2,2020-10-31,Male,43,35-44,7
12,3,12,0,15,2020-10-30,Female,19,15-19,7
12,0,3,0,3,2020-10-30,Female,69,65-69,6
12,0,3,0,3,2020-10-31,Female,67,65-69,7
12,0,0,0,0,2020-10-30,Female,53,45-54,11
12,1,2,0,3,2020-10-30,Male,74,70-74,6
12,0,0,0,0,2020-10-29,Male,39,35-44,9
12,0,1,0,1,2020-10-30,Male,35,35-44,6
12,2,0,0,2,2020-10-30,Male,67,65-69,6
12,0,0,0,0,2020-10-30,Female,17,15-19,8
12,1,1,0,2,2020-11-01,Male,66,65-69,9
12,7,3,0,10,2020-10-31,Female,4,1-4,3
12,3,1,6,10,2020-10-31,Male,14,10-14,3
12,0,0,0,0,2020-10-30,Female,65,65-69,9
12,3,4,0,7,2020-10-30,Female,13,10-14,4
12,0,0,0,0,2020-10-31,Female,65,65-69,7
12,1,0,0,1,2020-10-30,Female,67,65-69,8
12,0,3,0,3,2020-10-30,Male,52,45-54,12
12,1,0,0,1,2020-10-31,Female,41,35-44,7
12,0,0,0,0,2020-10-30,Female,31,25-34,8
12,1,0,0,1,2020-10-30,Male,57,55-64,9
12,2,3,0,5,2020-10-29,Male,65,65-69,7
12,2,14,0,16,2020-10-29,Male,67,65-69,10
12,1,0,0,1,2020-11-01,Female,76,75-79,7
12,2,1,0,3,2020-10-30,Female,9,5-9,8
12,2,0,0,2,2020-11-02,Male,62,55-64,7
12,1,3,0,4,2020-10-30,Male,39,35-44,3
12,1,0,0,1,2020-10-30,Female,62,55-64,12
12,1,0,0,1,2020-11-01,Female,28,25-34,6
12,0,0,0,0,2020-10-30,Male,10,10-14,7
12,0,0,0,0,2020-10-29,Female,10,10-14,9
12,0,3,0,3,2020-10-30,Female,69,65-69,9
12,2,0,0,2,2020-10-29,Male,54,45-54,6
12,0,5,0,5,2020-10-30,Male,27,25-34,9
12,3,1,0,4,2020-10-31,Female,55,55-64,4
12,0,0,0,0,2020-10-30,Male,73,70-74,8
12,2,1,0,3,2020-10-29,Female,21,20-24,2
12,4,2,0,6,2020-11-02,Male,2,1-4,7
12,0,1,0,1,2020-10-29,Male,62,55-64,7
12,3,1,0,4,2020-10-31,Male,24,20-24,7
12,0,0,1,1,2020-10-29,Male,23,20-24,9
12,2,0,0,2,2020-10-30,Male,68,65-69,10
12,0,0,0,0,2020-11-02,Female,29,25-34,4
12,0,3,0,3,2020-10-30,Male,44,35-44,8
12,0,2,0,2,2020-11-02,Female,29,25-34,7
12,1,2,0,3,2020-10-30,Male,55,55-64,8
12,2,1,0,3,2020-10-30,Male,15,15-19,11
12,0,0,0,0,2020-10-31,Female,69,65-69,7
12,2,3,0,5,2020-10-31,Female,62,55-64,8
12,0,1,0,1,2020-10-30,Female,73,70-74,4
12,1,0,0,1,2020-10-30,Female,68,65-69,10
12,1,0,0,1,2020-10-30,Male,55,55-64,12
12,1,0,0,1,2020-10-30,Female,61,55-64,11
12,0,0,0,0,2020-11-02,Male,66,65-69,10
12,0,0,0,0,2020-10-29,Female,4,1-4,3
12,0,0,0,0,2020-10-30,Male,54,45-54,5
12,2,0,0,2,2020-10-30,Female,61,55-64,11
12,1,2,0,3,2020-10-30,Male,52,45-54,11
12,0,0,0,0,2020-10-30,Female,71,70-74,4
12,0,2,0,2,2020-10-30,Female,66,65-69,12
12,3,2,0,5,2020-10-31,Female,45,45-54,6
12,0,0,0,0,2020-10-30,Male,65,65-69,9
12,0,0,0,0,2020-10-31,Female,68,65-69,9
12,0,0,0,0,2020-10-30,Female,42,35-44,8
12,2,1,0,3,2020-11-01,Male,11,10-14,6
12,1,1,0,2,2020-10-29,Female,62,55-64,11
12,0,1,0,1,2020-10-29,Female,52,45-54,10
12,0,0,0,0,2020-10-31,Female,18,15-19,6
12,0,1,0,1,2020-10-29,Female,65,65-69,8
12,2,0,0,2,2020-10-31,Female,52,45-54,9
12,0,0,0,0,2020-10-29,Female,48,45-54,9
12,0,1,0,1,2020-11-02,Male,58,55-64,5
12,1,2,0,3,2020-10-30,Male,70,70-74,12
12,0,0,0,0,2020-10-29,Female,44,35-44,12
12,0,0,0,0,2020-11-02,Male,21,20-24,5
12,1,1,0,2,2020-10-30,Male,71,70-74,7
12,2,0,0,2,2020-10-30,Female,67,65-69,10
12,1,2,0,3,2020-11-01,Female,35,35-44,7
12,2,3,5,10,2020-10-30,Male,22,20-24,9
12,1,1,0,2,2020-10-30,Female,66,65-69,7
12,1,2,0,3,2020-10-30,Male,58,55-64,11
12,1,1,0,2,2020-10-30,Male,66,65-69,7
12,3,0,0,3,2020-10-30,Male,11,10-14,9
12,3,0,0,3,2020-10-30,Male,2,1-4,8
12,1,0,0,1,2020-10-30,Female,58,55-64,6
12,1,1,0,2,2020-10-30,Male,17,15-19,9
12,0,1,0,1,2020-10-30,Male,49,45-54,8
12,0,7,0,7,2020-10-30,Male,69,65-69,4
12,2,0,44,46,2020-10-29,Female,25,25-34,12
12,2,0,0,2,2020-10-29,Male,29,25-34,10
12,2,1,0,3,2020-10-30,Male,71,70-74,5
12,2,2,0,4,2020-10-29,Female,10,10-14,9
12,1,2,1,4,2020-10-30,Female,69,65-69,9
12,1,0,0,1,2020-10-30,Male,66,65-69,5
12,0,0,0,0,2020-10-30,Male,66,65-69,8
12,0,2,0,2,2020-11-01,Female,49,45-54,6
12,2,0,0,2,2020-10-31,Female,68,65-69,5
12,0,0,0,0,2020-10-30,Male,35,35-44,8
12,2,0,0,2,2020-10-30,Female,9,5-9,10
12,0,0,0,0,2020-10-30,Female,66,65-69,12
12,0,0,0,0,2020-10-29,Male,42,35-44,9
12,0,6,0,6,2020-10-30,Female,76,75-79,3
12,2,1,0,3,2020-10-29,Female,2,1-4,9
12,0,1,1,2,2020-10-30,Male,40,35-44,7
12,1,1,0,2,2020-10-29,Female,61,55-64,6
12,1,0,0,1,2020-10-30,Male,67,65-69,10
12,4,2,0,6,2020-10-30,Male,6,5-9,12
12,3,0,0,3,2020-10-30,Male,21,20-24,3
12,4,0,0,4,2020-10-30,Female,1,1-4,3
12,2,2,4,8,2020-10-31,Female,3,1-4,7
12,3,0,0,3,2020-10-30,Female,25,25-34,7
12,2,0,0,2,2020-10-30,Male,51,45-54,7
12,1,0,0,1,2020-10-31,Female,68,65-69,7
12,2,4,0,6,2020-10-29,Male,61,55-64,9
12,1,2,0,3,2020-10-30,Female,61,55-64,9
12,0,0,0,0,2020-10-30,Male,51,45-54,9
12,1,2,0,3,2020-10-30,Male,65,65-69,11
12,1,1,0,2,2020-10-30,Female,39,35-44,7
12,2,4,0,6,2020-10-30,Male,52,45-54,11
12,0,0,0,0,2020-10-30,Male,51,45-54,6
12,1,0,0,1,2020-10-30,Male,53,45-54,7
12,1,0,0,1,2020-11-01,Female,60,55-64,7
12,0,0,0,0,2020-10-30,Female,16,15-19,5
12,1,0,0,1,2020-10-30,Female,55,55-64,11
12,2,0,0,2,2020-10-29,Male,32,25-34,8
12,0,0,0,0,2020-10-31,Female,49,45-54,8
12,0,0,0,0,2020-10-30,Male,66,65-69,8
12,1,0,0,1,2020-10-29,Male,66,65-69,10
12,1,3,0,4,2020-11-02,Male,54,45-54,6
12,0,0,0,0,2020-10-30,Male,40,35-44,11
12,2,0,0,2,2020-10-30,Male,59,55-64,8
12,0,4,0,4,2020-10-30,Male,41,35-44,12
12,0,0,0,0,2020-10-30,Male,66,65-69,12
12,0,0,80,80,2020-10-30,Male,33,25-34,5
12,1,0,0,1,2020-10-29,Male,63,55-64,7
12,0,0,0,0,2020-10-31,Female,69,65-69,8
12,2,2,0,4,2020-10-30,Male,15,15-19,4
12,4,15,0,19,2020-10-30,Male,3,1-4,10
12,0,0,0,0,2020-11-02,Male,55,55-64,9
12,0,0,0,0,2020-10-30,Male,58,55-64,10
12,1,0,0,1,2020-11-02,Male,47,45-54,8
12,0,1,0,1,2020-10-30,Female,34,25-34,8
12,0,0,100,100,2020-10-31,Male,52,45-54,11
12,1,1,0,2,2020-10-30,Male,61,55-64,12
12,2,3,0,5,2020-10-30,Female,23,20-24,2
12,0,2,0,2,2020-10-30,Female,67,65-69,12
12,3,12,0,15,2020-10-30,Male,58,55-64,5
12,0,2,0,2,2020-10-30,Male,10,10-14,12
12,3,0,0,3,2020-10-30,Female,38,35-44,8
12,0,0,0,0,2020-10-29,Female,43,35-44,8
12,1,0,0,1,2020-10-31,Female,63,55-64,4
12,2,0,0,2,2020-10-31,Female,15,15-19,9
12,0,1,0,1,2020-10-30,Male,47,45-54,10
12,0,0,0,0,2020-10-31,Female,57,55-64,7
12,1,0,0,1,2020-10-30,Male,66,65-69,8
12,4,0,0,4,2020-10-30,Female,16,15-19,5
12,0,0,0,0,2020-10-29,Female,17,15-19,2
12,2,3,2,7,2020-10-30,Female,65,65-69,6
12,0,0,0,0,2020-10-29,Male,27,25-34,8
12,0,1,0,1,2020-10-29,Male,47,45-54,9
12,0,0,10,10,2020-10-31,Male,32,25-34,7
12,2,0,0,2,2020-10-30,Male,49,45-54,6
12,0,0,0,0,2020-10-30,Male,52,45-54,9
12,1,1,0,2,2020-10-31,Male,71,70-74,4
12,3,0,0,3,2020-10-30,Male,16,15-19,9
12,2,2,0,4,2020-10-30,Female,10,10-14,6
12,0,0,0,0,2020-10-30,Male,61,55-64,7
12,2,0,0,2,2020-10-29,Male,10,10-14,11
12,2,2,0,4,2020-10-29,Female,62,55-64,8
12,0,0,0,0,2020-11-02,Male,45,45-54,5
12,0,0,0,0,2020-10-30,Male,43,35-44,11
12,2,1,0,3,2020-10-29,Female,64,55-64,12
12,1,0,0,1,2020-10-30,Female,73,70-74,11
12,0,1,0,1,2020-11-02,Male,53,45-54,5
12,0,2,0,2,2020-10-31,Male,77,75-79,6
12,3,0,0,3,2020-10-30,Male,4,1-4,4
12,1,0,0,1,2020-10-30,Female,33,25-34,8
12,2,0,0,2,2020-10-30,Female,11,10-14,8
12,1,0,0,1,2020-10-30,Female,50,45-54,8
12,0,0,0,0,2020-10-29,Female,21,20-24,5
12,2,0,0,2,2020-10-30,Male,56,55-64,9
12,0,7,0,7,2020-10-29,Female,62,55-64,7
12,0,2,0,2,2020-11-02,Female,42,35-44,2
12,0,0,0,0,2020-10-30,Female,59,55-64,7
12,1,2,0,3,2020-10-30,Male,56,55-64,8
12,2,0,0,2,2020-10-30,Male,65,65-69,12
12,0,0,0,0,2020-10-29,Female,33,25-34,2
12,4,2,100,106,2020-10-31,Female,6,5-9,6
12,2,0,0,2,2020-10-30,Male,70,70-74,5
12,1,10,0,11,2020-10-29,Male,61,55-64,11
12,1,1,0,2,2020-10-30,Male,66,65-69,11
12,0,0,0,0,2020-10-29,Female,56,55-64,3
12,1,0,0,1,2020-10-30,Male,33,25-34,11
12,1,0,0,1,2020-10-30,Female,58,55-64,10
12,2,0,0,2,2020-10-30,Male,73,70-74,8
12,2,0,0,2,2020-10-31,Male,73,70-74,7
12,2,0,0,2,2020-10-31,Male,34,25-34,7
12,0,0,0,0,2020-10-29,Female,36,35-44,8
12,1,0,0,1,2020-10-30,Male,62,55-64,7
12,1,0,0,1,2020-10-30,Female,47,45-54,6
12,3,1,1,5,2020-10-30,Female,22,20-24,6
12,0,1,0,1,2020-10-29,Male,62,55-64,8
12,0,1,1,2,2020-10-31,Male,25,25-34,6
12,1,0,0,1,2020-10-30,Female,68,65-69,9
12,2,0,0,2,2020-10-29,Female,65,65-69,8
12,1,1,0,2,2020-11-01,Female,34,25-34,9
12,0,0,0,0,2020-10-31,Male,53,45-54,11
12,0,3,0,3,2020-10-31,Female,35,35-44,6
12,0,1,0,1,2020-10-30,Male,56,55-64,9
12,1,1,0,2,2020-10-30,Female,55,55-64,10
12,0,2,0,2,2020-10-30,Female,67,65-69,11
12,2,3,1,6,2020-10-31,Male,41,35-44,4
12,1,4,0,5,2020-10-30,Male,66,65-69,8
12,1,0,0,1,2020-11-01,Female,72,70-74,6
12,0,0,0,0,2020-10-30,Male,31,25-34,8
12,3,0,0,3,2020-10-31,Female,58,55-64,7
12,1,0,0,1,2020-10-30,Male,71,70-74,7
12,1,2,0,3,2020-10-30,Female,48,45-54,7
12,1,0,0,1,2020-11-01,Female,55,55-64,5
12,2,0,0,2,2020-10-30,Female,70,70-74,9
12,0,0,0,0,2020-10-30,Female,71,70-74,8
12,0,0,0,0,2020-10-29,Male,66,65-69,12
12,1,0,0,1,2020-10-30,Male,67,65-69,6
12,0,0,0,0,2020-10-29,Female,26,25-34,8
12,0,0,0,0,2020-10-30,Female,55,55-64,5
12,0,3,0,3,2020-11-01,Female,74,70-74,5
12,1,1,0,2,2020-10-31,Male,80,80-84,7
12,0,0,0,0,2020-10-30,Male,65,65-69,7
12,1,0,0,1,2020-10-31,Female,53,45-54,11
12,0,1,0,1,2020-11-01,Male,28,25-34,4
12,1,2,0,3,2020-10-30,Male,63,55-64,10
12,0,0,0,0,2020-10-30,Male,37,35-44,11
12,0,0,0,0,2020-10-30,Female,67,65-69,6
12,1,0,0,1,2020-10-29,Female,28,25-34,10
12,4,4,0,8,2020-10-30,Female,12,10-14,9
12,0,0,0,0,2020-10-31,Male,54,45-54,11
12,3,2,0,5,2020-10-30,Male,13,10-14,12
12,2,0,0,2,2020-10-29,Male,17,15-19,6
12,1,0,0,1,2020-10-29,Male,34,25-34,11
12,0,0,0,0,2020-10-30,Female,72,70-74,10
12,0,0,0,0,2020-10-31,Female,26,25-34,4
12,1,0,1,2,2020-10-30,Male,17,15-19,6
12,3,1,0,4,2020-10-29,Male,41,35-44,9
12,1,0,0,1,2020-10-30,Female,24,20-24,12
12,1,0,0,1,2020-10-31,Male,32,25-34,8
12,0,3,0,3,2020-10-30,Female,42,35-44,9
12,2,2,0,4,2020-10-29,Female,71,70-74,9
12,1,2,0,3,2020-10-30,Male,58,55-64,8
12,1,0,0,1,2020-10-30,Male,66,65-69,8
12,3,4,0,7,2020-10-29,Male,1,1-4,9
12,3,2,0,5,2020-10-29,Female,36,35-44,11
12,1,0,0,1,2020-10-29,Female,59,55-64,10
12,1,3,0,4,2020-11-01,Male,69,65-69,9
12,1,0,0,1,2020-10-29,Male,66,65-69,11
12,0,0,0,0,2020-10-30,Female,57,55-64,10
12,0,3,0,3,2020-10-30,Male,75,75-79,6
12,0,0,0,0,2020-10-30,Male,52,45-54,11
12,1,7,0,8,2020-10-31,Female,75,75-79,5
12,0,0,0,0,2020-10-30,Male,66,65-69,4
12,1,0,0,1,2020-10-31,Female,63,55-64,8
12,2,0,0,2,2020-10-30,Male,65,65-69,8
12,0,0,0,0,2020-10-29,Female,23,20-24,2
12,3,1,0,4,2020-10-31,Female,16,15-19,9
12,0,0,0,0,2020-10-30,Male,74,70-74,9
12,0,2,0,2,2020-10-30,Female,66,65-69,11
12,1,1,0,2,2020-10-30,Female,46,45-54,9
12,1,3,0,4,2020-10-30,Male,70,70-74,7
12,0,7,0,7,2020-10-30,Male,53,45-54,8
12,5,2,0,7,2020-10-31,Male,19,15-19,6
12,0,0,0,0,2020-10-30,Female,62,55-64,9
12,0,0,0,0,2020-10-29,Female,23,20-24,3
12,2,0,0,2,2020-10-30,Male,74,70-74,9
12,1,1,0,2,2020-10-30,Female,70,70-74,12
12,1,0,0,1,2020-10-29,Male,35,35-44,6
12,0,0,0,0,2020-10-30,Female,62,55-64,6
12,1,4,0,5,2020-10-30,Male,73,70-74,5
12,0,0,0,0,2020-10-29,Male,27,25-34,11
12,2,0,0,2,2020-10-31,Female,77,75-79,2
12,1,0,0,1,2020-10-29,Male,28,25-34,12
12,0,2,0,2,2020-11-02,Female,31,25-34,7
12,0,0,0,0,2020-10-30,Female,65,65-69,9
12,1,0,0,1,2020-10-30,Male,42,35-44,9
12,0,0,0,0,2020-10-30,Male,70,70-74,11
12,1,0,0,1,2020-10-31,Male,39,35-44,4
12,0,3,0,3,2020-10-31,Male,65,65-69,10
12,0,2,0,2,2020-10-30,Female,68,65-69,12
12,0,1,0,1,2020-10-30,Female,72,70-74,9
12,1,1,0,2,2020-10-31,Male,72,70-74,3
12,0,1,0,1,2020-10-30,Male,60,55-64,9
12,0,0,0,0,2020-10-30,Male,27,25-34,7
12,1,1,0,2,2020-10-30,Female,48,45-54,8
12,1,1,0,2,2020-10-30,Male,68,65-69,11
12,0,0,0,0,2020-10-31,Male,67,65-69,7
12,2,0,0,2,2020-10-30,Female,66,65-69,9
12,1,1,0,2,2020-10-29,Male,68,65-69,10
12,1,0,0,1,2020-10-29,Male,61,55-64,8
12,3,6,31,40,2020-10-29,Male,15,15-19,4
12,0,0,0,0,2020-10-30,Male,33,25-34,8
12,3,1,0,4,2020-10-30,Male,17,15-19,6
12,1,0,0,1,2020-10-29,Female,78,75-79,9
12,0,1,0,1,2020-10-30,Female,56,55-64,11
12,3,0,0,3,2020-10-30,Female,53,45-54,9
12,1,3,0,4,2020-10-30,Male,66,65-69,8
12,1,0,0,1,2020-10-31,Male,55,55-64,7
12,3,0,0,3,2020-11-02,Male,7,5-9,6
12,1,0,0,1,2020-10-29,Male,42,35-44,5
12,0,0,0,0,2020-11-01,Female,53,45-54,6
12,0,0,0,0,2020-11-02,Female,33,25-34,10
12,0,0,0,0,2020-10-30,Female,54,45-54,7
12,0,0,0,0,2020-10-29,Female,61,55-64,12
12,3,0,0,3,2020-10-29,Female,4,1-4,8
12,1,0,0,1,2020-10-30,Female,59,55-64,9
12,1,1,0,2,2020-10-31,Female,30,25-34,8
12,3,6,0,9,2020-10-30,Male,9,5-9,5
12,4,0,0,4,2020-11-02,Female,54,45-54,7
12,2,0,0,2,2020-10-30,Female,56,55-64,8
12,1,2,0,3,2020-10-30,Female,60,55-64,11
12,2,0,0,2,2020-10-29,Male,60,55-64,9
12,0,0,0,0,2020-10-30,Male,70,70-74,12
12,4,80,0,84,2020-10-29,Male,47,45-54,3
12,0,2,0,2,2020-10-30,Female,54,45-54,7
12,1,0,0,1,2020-10-29,Male,61,55-64,5
12,1,1,0,2,2020-10-30,Female,51,45-54,11
12,0,2,0,2,2020-10-31,Male,69,65-69,6
12,3,3,0,6,2020-10-30,Male,71,70-74,7
12,2,8,0,10,2020-10-31,Male,77,75-79,7
12,2,7,0,9,2020-10-31,Female,67,65-69,6
12,2,2,0,4,2020-10-30,Male,51,45-54,5
12,1,1,0,2,2020-11-01,Male,69,65-69,9
12,0,3,0,3,2020-10-30,Female,18,15-19,8
12,0,0,0,0,2020-10-30,Male,52,45-54,12
12,3,0,0,3,2020-10-30,Female,17,15-19,9
12,1,0,0,1,2020-10-29,Female,65,65-69,11
12,0,0,0,0,2020-10-29,Female,16,15-19,6
12,0,0,0,0,2020-10-29,Female,37,35-44,10
12,4,1,0,5,2020-11-02,Male,14,10-14,4
12,2,0,0,2,2020-10-31,Male,54,45-54,3
12,1,1,0,2,2020-10-30,Male,59,55-64,6
12,1,0,0,1,2020-10-29,Male,21,20-24,9
12,0,1,0,1,2020-10-30,Male,64,55-64,9
12,0,0,0,0,2020-10-30,Male,36,35-44,7
12,0,1,5,6,2020-11-02,Male,37,35-44,9
12,1,1,2,4,2020-10-31,Female,53,45-54,8
12,2,0,0,2,2020-10-29,Male,63,55-64,7
12,2,3,0,5,2020-10-30,Male,51,45-54,6
12,1,1,0,2,2020-10-30,Male,74,70-74,6
12,2,4,0,6,2020-10-30,Female,51,45-54,6
12,2,7,0,9,2020-10-30,Female,73,70-74,4
12,1,3,0,4,2020-10-29,Female,15,15-19,9
12,0,8,0,8,2020-10-30,Male,61,55-64,9
12,1,0,0,1,2020-10-30,Female,52,45-54,6
12,1,2,0,3,2020-11-01,Male,53,45-54,4
12,1,0,0,1,2020-10-30,Male,53,45-54,8
12,2,0,0,2,2020-10-29,Female,65,65-69,10
12,0,1,0,1,2020-10-31,Male,78,75-79,5
12,1,0,0,1,2020-10-30,Male,61,55-64,9
12,3,0,0,3,2020-10-31,Male,15,15-19,11
12,4,0,0,4,2020-10-31,Male,17,15-19,2
12,0,1,0,1,2020-10-31,Male,52,45-54,7
12,1,1,0,2,2020-10-30,Female,50,45-54,8
12,0,0,0,0,2020-10-31,Female,60,55-64,9
12,3,0,0,3,2020-10-29,Male,13,10-14,11
12,2,2,0,4,2020-10-31,Female,68,65-69,6
12,1,0,0,1,2020-10-30,Female,66,65-69,11
12,2,2,0,4,2020-10-30,Male,67,65-69,9
12,0,0,0,0,2020-10-31,Male,37,35-44,10
12,0,0,0,0,2020-10-30,Female,24,20-24,6
12,1,2,0,3,2020-10-31,Female,64,55-64,7
12,0,0,0,0,2020-11-02,Female,67,65-69,11
12,0,0,0,0,2020-10-29,Female,43,35-44,6
12,0,1,0,1,2020-10-29,Female,67,65-69,9
12,0,0,0,0,2020-10-30,Male,33,25-34,7
12,1,1,0,2,2020-10-31,Male,37,35-44,4
12,1,0,0,1,2020-10-30,Female,37,35-44,7
12,1,0,0,1,2020-11-02,Female,33,25-34,10
12,0,0,0,0,2020-11-01,Male,66,65-69,10
12,1,0,0,1,2020-10-29,Female,51,45-54,11
12,1,0,3,4,2020-10-30,Female,23,20-24,10
12,3,0,0,3,2020-10-29,Female,17,15-19,8
12,0,1,0,1,2020-10-30,Female,43,35-44,7
12,1,0,0,1,2020-10-30,Male,66,65-69,5
12,2,0,0,2,2020-10-30,Female,62,55-64,9
12,0,0,0,0,2020-10-31,Female,66,65-69,9
12,1,0,0,1,2020-10-30,Female,72,70-74,9
12,1,0,0,1,2020-10-29,Male,36,35-44,3
12,0,0,0,0,2020-10-30,Male,58,55-64,11
12,2,0,0,2,2020-11-01,Female,10,10-14,7
12,1,0,0,1,2020-10-30,Male,78,75-79,8
12,2,3,0,5,2020-11-01,Female,8,5-9,8
12,2,1,0,3,2020-10-29,Male,43,35-44,7
12,0,0,0,0,2020-10-29,Female,52,45-54,7
12,2,3,0,5,2020-10-31,Male,68,65-69,9
12,3,2,0,5,2020-10-31,Female,61,55-64,5
12,1,0,0,1,2020-10-29,Female,61,55-64,7
12,1,3,0,4,2020-10-30,Male,68,65-69,7
12,1,0,0,1,2020-10-30,Male,64,55-64,12
12,1,1,0,2,2020-10-31,Male,73,70-74,9
12,1,0,0,1,2020-10-29,Female,64,55-64,9
12,2,2,0,4,2020-10-30,Male,54,45-54,8
12,0,1,0,1,2020-10-30,Female,66,65-69,9
12,0,2,0,2,2020-10-30,Female,71,70-74,10
12,2,2,0,4,2020-10-29,Female,71,70-74,9
12,1,1,0,2,2020-10-30,Female,49,45-54,11
12,4,0,0,4,2020-10-30,Female,58,55-64,10
12,0,0,0,0,2020-10-31,Female,33,25-34,8
12,1,0,0,1,2020-10-31,Male,74,70-74,6
12,2,0,0,2,2020-10-30,Female,2,1-4,5
12,1,0,0,1,2020-10-30,Female,51,45-54,7
12,0,0,0,0,2020-10-30,Female,40,35-44,11
12,0,0,0,0,2020-10-31,Male,21,20-24,12
12,0,1,0,1,2020-10-30,Male,55,55-64,11
12,0,0,0,0,2020-10-31,Male,23,20-24,7
12,3,6,0,9,2020-10-30,Female,6,5-9,8
12,0,0,0,0,2020-10-30,Male,55,55-64,9
12,2,2,0,4,2020-10-30,Male,62,55-64,10
12,2,1,0,3,2020-11-01,Female,20,20-24,2
12,3,1,0,4,2020-10-30,Male,18,15-19,9
12,1,32,0,33,2020-10-30,Female,56,55-64,7
12,1,0,0,1,2020-10-30,Female,67,65-69,9
12,5,1,0,6,2020-10-30,Female,14,10-14,8
12,0,1,0,1,2020-10-31,Female,85,85+,3
12,0,1,0,1,2020-10-31,Female,70,70-74,10
12,1,2,0,3,2020-10-30,Male,73,70-74,12
12,1,0,0,1,2020-10-31,Female,66,65-69,9
12,3,1,0,4,2020-10-30,Male,14,10-14,10
12,1,3,0,4,2020-10-30,Male,73,70-74,9
12,0,0,0,0,2020-10-30,Male,35,35-44,5
12,0,0,0,0,2020-10-30,Female,36,35-44,6
12,0,2,0,2,2020-10-30,Female,37,35-44,9
12,3,2,0,5,2020-10-30,Female,5,5-9,5
12,1,0,0,1,2020-10-31,Male,66,65-69,9
12,1,0,0,1,2020-10-30,Female,60,55-64,10
12,1,5,0,6,2020-10-29,Female,66,65-69,7
12,0,0,0,0,2020-11-02,Male,27,25-34,5
12,1,0,0,1,2020-10-29,Male,66,65-69,10
12,3,0,0,3,2020-10-30,Female,13,10-14,9
12,0,2,0,2,2020-10-31,Female,51,45-54,7
12,0,0,3,3,2020-11-01,Male,21,20-24,8
12,3,0,1,4,2020-10-31,Female,2,1-4,8
12,1,1,0,2,2020-10-29,Male,65,65-69,11
12,1,0,0,1,2020-10-30,Female,29,25-34,8
12,0,1,0,1,2020-10-29,Male,31,25-34,7
12,2,0,0,2,2020-10-29,Female,11,10-14,7
12,0,0,0,0,2020-11-01,Female,24,20-24,5
12,3,0,0,3,2020-10-29,Female,64,55-64,11
12,2,0,0,2,2020-10-30,Female,66,65-69,10
12,0,1,0,1,2020-10-31,Female,75,75-79,10
12,2,0,0,2,2020-10-30,Female,44,35-44,5
12,2,0,0,2,2020-11-01,Male,32,25-34,10
12,3,0,0,3,2020-10-30,Male,19,15-19,10
12,0,0,0,0,2020-10-29,Male,34,25-34,8
12,0,0,0,0,2020-10-31,Male,35,35-44,6
12,0,0,0,0,2020-10-30,Male,17,15-19,9
12,1,0,0,1,2020-10-30,Female,63,55-64,8
12,0,3,0,3,2020-10-30,Female,68,65-69,4
12,1,2,0,3,2020-10-29,Male,65,65-69,10
12,3,0,0,3,2020-10-30,Female,10,10-14,12
12,0,6,0,6,2020-10-30,Female,65,65-69,6
12,1,0,0,1,2020-10-30,Male,76,75-79,8
12,0,1,0,1,2020-10-29,Male,21,20-24,2
12,1,0,0,1,2020-10-31,Male,58,55-64,6
12,1,0,0,1,2020-10-29,Male,62,55-64,12
12,2,0,0,2,2020-10-30,Male,66,65-69,10
12,0,1,0,1,2020-10-30,Female,37,35-44,2
12,0,0,0,0,2020-10-31,Male,38,35-44,8
12,0,0,0,0,2020-10-29,Male,27,25-34,7
12,0,0,0,0,2020-10-30,Female,43,35-44,11
12,1,0,24,25,2020-10-31,Female,62,55-64,7
12,1,5,0,6,2020-10-31,Female,30,25-34,6
12,1,8,0,9,2020-10-31,Female,53,45-54,10
12,1,0,0,1,2020-10-30,Female,48,45-54,10
12,0,2,0,2,2020-10-31,Female,73,70-74,4
12,1,1,0,2,2020-10-31,Male,66,65-69,8
12,1,6,0,7,2020-11-02,Female,31,25-34,3
12,1,1,0,2,2020-10-29,Male,30,25-34,5
12,0,0,0,0,2020-11-03,Female,24,20-24,11
12,1,0,0,1,2020-10-30,Male,40,35-44,9
12,0,0,0,0,2020-10-30,Male,34,25-34,10
12,1,0,0,1,2020-10-31,Male,62,55-64,9
12,0,1,0,1,2020-10-30,Female,68,65-69,7
12,1,0,0,1,2020-10-30,Male,67,65-69,10
12,2,0,0,2,2020-10-30,Male,5,5-9,12
12,1,1,0,2,2020-10-31,Female,24,20-24,6
12,1,5,0,6,2020-10-30,Female,11,10-14,6
12,2,1,0,3,2020-10-30,Male,70,70-74,7
12,1,1,0,2,2020-10-29,Female,47,45-54,11
12,2,0,0,2,2020-11-01,Female,29,25-34,4
12,2,0,0,2,2020-10-30,Female,60,55-64,9
12,0,0,0,0,2020-10-31,Male,45,45-54,6
12,1,1,0,2,2020-10-29,Male,64,55-64,9
12,0,0,0,0,2020-10-31,Female,19,15-19,8
12,1,0,0,1,2020-10-29,Male,1,1-4,2
12,2,5,0,7,2020-10-30,Female,63,55-64,10
12,2,3,1,6,2020-10-30,Female,67,65-69,4
12,1,0,0,1,2020-10-29,Female,68,65-69,9
12,0,1,0,1,2020-10-31,Female,70,70-74,6
12,1,7,0,8,2020-10-30,Male,45,45-54,7
12,0,1,0,1,2020-10-31,Female,34,25-34,8
12,2,1,0,3,2020-11-02,Female,33,25-34,10
12,1,0,0,1,2020-10-30,Male,58,55-64,12
12,2,0,0,2,2020-10-29,Male,63,55-64,12
12,1,1,0,2,2020-10-29,Female,62,55-64,10
12,1,1,0,2,2020-10-30,Female,63,55-64,10
12,3,0,3,6,2020-10-29,Female,43,35-44,9
12,2,1,0,3,2020-10-30,Female,68,65-69,12
12,1,0,0,1,2020-11-02,Male,52,45-54,8
12,2,0,0,2,2020-10-29,Male,50,45-54,10
12,0,0,0,0,2020-10-30,Female,63,55-64,7
12,1,3,0,4,2020-10-30,Female,67,65-69,10
12,1,0,0,1,2020-10-30,Male,7,5-9,4
12,0,0,0,0,2020-10-30,Male,19,15-19,12
12,1,0,0,1,2020-10-30,Male,59,55-64,11
12,2,0,0,2,2020-10-30,Female,38,35-44,9
12,3,1,0,4,2020-10-29,Male,11,10-14,5
12,0,0,0,0,2020-10-30,Male,33,25-34,9
12,3,2,0,5,2020-11-02,Male,8,5-9,4
12,0,0,0,0,2020-10-30,Male,41,35-44,10
12,1,0,0,1,2020-10-29,Female,65,65-69,8
12,3,0,0,3,2020-10-31,Male,66,65-69,2
12,1,4,0,5,2020-10-29,Male,68,65-69,12
12,3,0,0,3,2020-10-30,Male,13,10-14,9
12,2,1,3,6,2020-10-29,Male,76,75-79,7
12,1,1,0,2,2020-11-01,Female,58,55-64,12
12,2,0,0,2,2020-10-30,Female,32,25-34,8
12,0,2,1,3,2020-10-31,Male,35,35-44,2
12,0,1,1,2,2020-10-29,Female,16,15-19,11
12,1,1,0,2,2020-11-01,Female,66,65-69,4
12,0,0,0,0,2020-11-01,Female,68,65-69,6
12,1,0,0,1,2020-10-30,Female,34,25-34,8
12,3,2,0,5,2020-10-30,Male,10,10-14,9
12,0,1,0,1,2020-10-29,Female,19,15-19,6
12,2,0,0,2,2020-10-30,Male,23,20-24,4
12,3,3,0,6,2020-10-29,Male,10,10-14,2
12,0,0,0,0,2020-10-30,Male,2,1-4,7
12,0,0,0,0,2020-10-30,Male,16,15-19,6
12,2,0,0,2,2020-10-29,Male,51,45-54,9
12,0,3,0,3,2020-10-30,Male,49,45-54,8
12,0,0,0,0,2020-10-29,Female,21,20-24,3
12,0,0,0,0,2020-10-30,Female,34,25-34,10
12,1,13,0,14,2020-10-31,Female,30,25-34,2
12,1,0,0,1,2020-10-30,Male,45,45-54,8
12,1,2,0,3,2020-10-30,Female,65,65-69,8
12,0,1,0,1,2020-10-30,Female,76,75-79,5
12,0,3,0,3,2020-10-31,Female,52,45-54,8
12,2,0,0,2,2020-10-30,Male,26,25-34,6
12,3,0,0,3,2020-11-02,Female,10,10-14,7
12,0,1,0,1,2020-10-30,Female,27,25-34,9
12,2,1,0,3,2020-10-30,Female,73,70-74,8
12,0,4,0,4,2020-10-29,Female,67,65-69,10
12,2,0,0,2,2020-10-29,Female,67,65-69,4
12,0,0,0,0,2020-10-30,Female,69,65-69,10
12,4,0,0,4,2020-10-29,Male,8,5-9,6
12,5,4,0,9,2020-10-30,Male,12,10-14,10
12,2,3,0,5,2020-10-30,Female,55,55-64,8
12,0,2,0,2,2020-11-01,Female,27,25-34,8
12,2,0,0,2,2020-10-30,Male,48,45-54,11
12,0,0,0,0,2020-10-31,Female,52,45-54,11
12,0,0,0,0,2020-11-01,Female,38,35-44,8
12,0,0,0,0,2020-11-02,Male,54,45-54,7
12,2,3,0,5,2020-10-30,Male,67,65-69,6
12,0,1,0,1,2020-10-30,Male,48,45-54,8
12,1,3,0,4,2020-10-29,Male,63,55-64,8
12,0,0,0,0,2020-10-29,Male,27,25-34,7
12,1,0,0,1,2020-10-29,Male,35,35-44,8
12,1,0,0,1,2020-10-30,Male,49,45-54,9
12,0,0,0,0,2020-10-31,Female,53,45-54,7
12,2,0,0,2,2020-10-31,Male,68,65-69,10
12,2,2,0,4,2020-11-02,Female,48,45-54,10
12,2,1,0,3,2020-11-01,Female,65,65-69,2
12,3,0,0,3,2020-10-30,Male,85,85+,7
12,1,3,0,4,2020-10-31,Female,54,45-54,9
12,2,0,0,2,2020-10-29,Male,14,10-14,5
12,2,3,0,5,2020-10-31,Female,71,70-74,4
12,0,2,0,2,2020-10-30,Male,47,45-54,7
12,2,0,0,2,2020-10-30,Female,66,65-69,7
12,0,0,0,0,2020-10-30,Male,50,45-54,12
12,0,1,0,1,2020-10-31,Male,23,20-24,7
12,0,0,0,0,2020-11-02,Male,28,25-34,9
12,0,0,0,0,2020-11-02,Male,66,65-69,7
12,1,0,0,1,2020-11-01,Male,13,10-14,6
12,0,2,0,2,2020-10-30,Female,28,25-34,5
12,2,0,0,2,2020-10-30,Male,74,70-74,11
12,0,2,0,2,2020-11-01,Male,30,25-34,9
12,2,0,0,2,2020-10-30,Male,65,65-69,9
12,2,1,0,3,2020-11-03,Female,67,65-69,4
12,0,0,0,0,2020-10-30,Female,20,20-24,2
12,2,4,0,6,2020-10-30,Female,79,75-79,9
12,1,3,0,4,2020-10-30,Female,69,65-69,10
12,0,0,0,0,2020-10-30,Female,69,65-69,12
12,1,0,0,1,2020-10-30,Male,71,70-74,10
12,0,0,0,0,2020-10-30,Female,36,35-44,7
12,0,0,0,0,2020-10-29,Male,13,10-14,5
12,0,0,0,0,2020-10-29,Male,61,55-64,11
12,0,2,0,2,2020-10-29,Male,66,65-69,4
12,1,5,0,6,2020-10-31,Female,29,25-34,10
12,0,0,0,0,2020-10-31,Female,7,5-9,9
12,3,0,0,3,2020-10-31,Male,12,10-14,8
12,0,0,0,0,2020-10-30,Male,34,25-34,11
12,0,1,0,1,2020-10-30,Male,19,15-19,5
12,3,3,1,7,2020-10-30,Male,1,1-4,2
12,2,0,0,2,2020-10-31,Male,19,15-19,8
13,0,6,0,6,2020-11-05,Male,60,55-64,9
13,1,3,0,4,2020-11-07,Male,68,65-69,8
13,1,0,0,1,2020-11-08,Female,58,55-64,8
13,2,0,0,2,2020-11-06,Female,69,65-69,8
13,2,0,0,2,2020-11-05,Female,66,65-69,13
13,0,2,0,2,2020-11-05,Female,71,70-74,9
13,0,0,0,0,2020-11-05,Female,50,45-54,9
13,1,0,0,1,2020-11-05,Female,72,70-74,13
13,0,0,0,0,2020-11-05,Male,30,25-34,10
13,0,3,0,3,2020-11-06,Female,52,45-54,6
13,0,0,0,0,2020-11-05,Female,53,45-54,9
13,0,0,0,0,2020-11-06,Female,67,65-69,8
13,0,4,0,4,2020-11-05,Male,34,25-34,13
13,0,0,0,0,2020-11-09,Female,59,55-64,9
13,1,0,9,10,2020-11-09,Male,19,15-19,3
13,1,5,10,16,2020-11-07,Female,61,55-64,7
13,0,0,0,0,2020-11-05,Male,51,45-54,10
13,1,0,0,1,2020-11-05,Male,50,45-54,8
13,2,0,0,2,2020-11-05,Female,35,35-44,10
13,3,1,0,4,2020-11-05,Female,57,55-64,11
13,2,0,0,2,2020-11-06,Female,13,10-14,10
13,0,0,9,9,2020-11-05,Male,42,35-44,7
13,1,2,0,3,2020-11-07,Male,66,65-69,7
13,0,1,0,1,2020-11-05,Male,66,65-69,8
13,0,3,0,3,2020-11-05,Male,62,55-64,13
13,2,4,22,28,2020-11-10,Female,43,35-44,4
13,0,1,0,1,2020-11-05,Male,15,15-19,11
13,0,0,0,0,2020-11-05,Male,48,45-54,10
13,1,0,0,1,2020-11-06,Male,58,55-64,8
13,1,0,0,1,2020-11-09,Male,35,35-44,8
13,0,5,0,5,2020-11-05,Male,53,45-54,8
13,0,0,0,0,2020-11-06,Female,70,70-74,12
13,0,1,0,1,2020-11-06,Male,68,65-69,12
13,0,0,0,0,2020-11-08,Male,20,20-24,8
13,1,0,0,1,2020-11-06,Female,69,65-69,10
13,0,0,0,0,2020-11-05,Male,41,35-44,13
13,1,0,0,1,2020-11-06,Male,58,55-64,9
13,1,2,0,3,2020-11-06,Female,56,55-64,13
13,2,0,0,2,2020-11-06,Female,21,20-24,11
13,2,0,0,2,2020-11-05,Male,52,45-54,11
13,0,0,0,0,2020-11-05,Male,85,85+,11
13,0,0,0,0,2020-11-06,Female,68,65-69,10
13,0,0,0,0,2020-11-05,Male,19,15-19,7
13,1,0,0,1,2020-11-09,Male,58,55-64,11
13,0,0,0,0,2020-11-06,Male,67,65-69,13
13,1,0,0,1,2020-11-06,Male,72,70-74,6
13,0,5,0,5,2020-11-05,Male,76,75-79,9
13,1,0,0,1,2020-11-05,Male,71,70-74,11
13,0,5,0,5,2020-11-10,Male,43,35-44,6
13,0,2,0,2,2020-11-07,Male,52,45-54,12
13,0,0,1,1,2020-11-09,Male,37,35-44,5
13,0,0,0,0,2020-11-05,Male,53,45-54,7
13,1,1,18,20,2020-11-09,Male,3,1-4,2
13,0,0,0,0,2020-11-05,Male,28,25-34,7
13,0,2,1,3,2020-11-10,Female,11,10-14,3
13,1,0,0,1,2020-11-05,Male,39,35-44,10
13,2,4,0,6,2020-11-09,Male,69,65-69,10
13,0,1,0,1,2020-11-05,Female,77,75-79,10
13,0,4,0,4,2020-11-05,Male,2,1-4,2
13,1,0,0,1,2020-11-06,Female,67,65-69,10
13,0,2,0,2,2020-11-05,Female,52,45-54,7
13,5,4,0,9,2020-11-08,Female,3,1-4,5
13,1,2,0,3,2020-11-06,Male,38,35-44,12
13,1,1,0,2,2020-11-05,Male,68,65-69,10
13,0,0,0,0,2020-11-06,Female,12,10-14,9
13,0,3,0,3,2020-11-05,Male,72,70-74,6
13,0,1,0,1,2020-11-05,Male,85,85+,8
13,2,0,0,2,2020-11-05,Female,71,70-74,9
13,2,3,0,5,2020-11-07,Male,54,45-54,12
13,0,1,0,1,2020-11-05,Male,31,25-34,6
13,1,0,0,1,2020-11-05,Male,70,70-74,10
13,2,0,0,2,2020-11-05,Female,72,70-74,9
13,2,1,0,3,2020-11-06,Male,66,65-69,7
13,1,3,0,4,2020-11-05,Female,65,65-69,12
13,3,2,0,5,2020-11-06,Male,12,10-14,6
13,2,0,0,2,2020-11-06,Male,70,70-74,12
13,1,1,0,2,2020-11-06,Male,69,65-69,9
13,4,0,0,4,2020-11-09,Female,13,10-14,6
13,0,0,0,0,2020-11-06,Male,40,35-44,5
13,1,0,0,1,2020-11-09,Male,67,65-69,10
13,2,2,0,4,2020-11-09,Male,70,70-74,4
13,0,0,0,0,2020-11-05,Male,43,35-44,9
13,3,1,0,4,2020-11-05,Female,6,5-9,9
13,1,0,2,3,2020-11-05,Female,43,35-44,6
13,0,0,0,0,2020-11-05,Female,74,70-74,3
13,0,0,0,0,2020-11-05,Male,70,70-74,9
13,1,7,0,8,2020-11-06,Male,69,65-69,13
13,0,0,0,0,2020-11-06,Female,2,1-4,10
13,2,0,0,2,2020-11-06,Female,67,65-69,11
13,3,0,0,3,2020-11-05,Male,19,15-19,11
13,1,1,0,2,2020-11-05,Male,31,25-34,8
13,0,3,0,3,2020-11-06,Female,52,45-54,11
13,0,0,0,0,2020-11-06,Male,48,45-54,12
13,0,1,0,1,2020-11-07,Male,69,65-69,8
13,1,0,0,1,2020-11-09,Female,66,65-69,6
13,0,1,0,1,2020-11-06,Female,30,25-34,9
13,1,0,0,1,2020-11-05,Female,31,25-34,12
13,2,2,0,4,2020-11-08,Female,67,65-69,9
13,0,0,0,0,2020-11-07,Male,18,15-19,6
13,1,0,0,1,2020-11-06,Female,62,55-64,11
13,0,0,0,0,2020-11-09,Male,17,15-19,6
13,0,0,0,0,2020-11-06,Female,47,45-54,9
13,0,0,0,0,2020-11-06,Male,68,65-69,8
13,0,0,0,0,2020-11-08,Male,54,45-54,10
13,0,0,0,0,2020-11-05,Male,29,25-34,7
13,1,0,0,1,2020-11-07,Male,57,55-64,9
13,1,0,0,1,2020-11-05,Female,73,70-74,10
13,0,0,0,0,2020-11-05,Female,31,25-34,13
13,0,0,0,0,2020-11-05,Male,65,65-69,8
13,0,1,0,1,2020-11-05,Female,30,25-34,7
13,0,1,0,1,2020-11-08,Female,66,65-69,3
13,0,0,0,0,2020-11-10,Male,8,5-9,6
13,0,1,0,1,2020-11-05,Female,33,25-34,10
13,0,0,0,0,2020-11-05,Male,37,35-44,10
13,1,1,0,2,2020-11-06,Female,62,55-64,10
13,1,1,0,2,2020-11-05,Male,65,65-69,8
13,0,0,0,0,2020-11-06,Male,63,55-64,11
13,0,0,0,0,2020-11-06,Female,55,55-64,8
13,0,1,0,1,2020-11-06,Female,26,25-34,8
13,0,1,0,1,2020-11-06,Male,69,65-69,8
13,2,0,0,2,2020-11-05,Male,42,35-44,8
13,2,0,0,2,2020-11-06,Male,58,55-64,12
13,0,0,0,0,2020-11-05,Female,62,55-64,9
13,1,0,0,1,2020-11-06,Male,69,65-69,9
13,3,0,0,3,2020-11-09,Male,32,25-34,9
13,2,0,0,2,2020-11-07,Male,35,35-44,12
13,0,0,0,0,2020-11-05,Male,70,70-74,7
13,0,0,0,0,2020-11-05,Male,24,20-24,5
13,3,0,0,3,2020-11-05,Female,13,10-14,10
13,1,0,0,1,2020-11-06,Male,65,65-69,11
13,1,3,0,4,2020-11-09,Female,69,65-69,3
13,0,0,0,0,2020-11-06,Female,24,20-24,3
13,1,1,0,2,2020-11-05,Female,79,75-79,10
13,1,0,0,1,2020-11-07,Male,56,55-64,10
13,0,1,1,2,2020-11-05,Female,47,45-54,4
13,1,0,0,1,2020-11-07,Female,28,25-34,10
13,1,1,0,2,2020-11-05,Female,66,65-69,9
13,1,0,0,1,2020-11-05,Female,24,20-24,7
13,1,0,0,1,2020-11-05,Male,52,45-54,10
13,0,0,0,0,2020-11-05,Male,52,45-54,6
13,1,3,0,4,2020-11-10,Female,38,35-44,2
13,1,2,0,3,2020-11-05,Male,70,70-74,10
13,2,4,0,6,2020-11-05,Male,25,25-34,13
13,0,0,0,0,2020-11-05,Female,52,45-54,12
13,0,0,0,0,2020-11-09,Male,28,25-34,9
13,3,0,0,3,2020-11-05,Male,9,5-9,8
13,3,0,0,3,2020-11-05,Male,65,65-69,9
13,0,2,0,2,2020-11-07,Female,58,55-64,10
13,0,0,0,0,2020-11-06,Female,66,65-69,12
13,1,2,0,3,2020-11-05,Female,60,55-64,9
13,0,1,0,1,2020-11-05,Male,70,70-74,13
13,2,1,0,3,2020-11-06,Male,20,20-24,9
13,0,1,0,1,2020-11-07,Female,71,70-74,8
13,1,0,0,1,2020-11-05,Male,74,70-74,11
13,2,1,0,3,2020-11-10,Female,73,70-74,8
13,0,0,0,0,2020-11-10,Male,50,45-54,7
13,3,0,0,3,2020-11-06,Female,31,25-34,9
13,1,0,0,1,2020-11-05,Female,55,55-64,11
13,1,0,0,1,2020-11-07,Male,33,25-34,7
13,0,0,0,0,2020-11-05,Male,54,45-54,9
13,1,0,0,1,2020-11-06,Male,51,45-54,10
13,1,0,0,1,2020-11-05,Female,49,45-54,9
13,1,0,0,1,2020-11-09,Female,29,25-34,8
13,0,0,0,0,2020-11-07,Male,39,35-44,8
13,2,1,0,3,2020-11-05,Male,19,15-19,9
13,2,0,0,2,2020-11-06,Female,68,65-69,6
13,0,0,0,0,2020-11-06,Male,65,65-69,7
13,1,2,0,3,2020-11-05,Male,68,65-69,10
13,1,1,0,2,2020-11-05,Male,52,45-54,11
13,1,0,0,1,2020-11-08,Female,58,55-64,11
13,0,0,0,0,2020-11-05,Male,50,45-54,11
13,3,0,30,33,2020-11-06,Male,12,10-14,10
13,2,0,0,2,2020-11-05,Female,59,55-64,8
13,0,1,0,1,2020-11-05,Male,71,70-74,12
13,0,0,0,0,2020-11-05,Male,40,35-44,7
13,2,0,0,2,2020-11-05,Female,69,65-69,13
13,0,1,0,1,2020-11-05,Male,38,35-44,7
13,0,0,0,0,2020-11-09,Female,34,25-34,3
13,1,3,0,4,2020-11-06,Female,5,5-9,8
13,0,1,0,1,2020-11-05,Male,21,20-24,3
13,2,0,0,2,2020-11-05,Female,73,70-74,6
13,0,1,0,1,2020-11-05,Male,51,45-54,7
13,1,1,0,2,2020-11-09,Female,57,55-64,10
13,1,0,0,1,2020-11-06,Female,59,55-64,13
13,0,0,0,0,2020-11-06,Male,43,35-44,12
13,2,0,0,2,2020-11-09,Male,63,55-64,5
13,2,0,0,2,2020-11-06,Female,63,55-64,9
13,2,0,0,2,2020-11-05,Male,73,70-74,10
13,2,0,0,2,2020-11-09,Female,52,45-54,12
13,2,0,0,2,2020-11-05,Male,69,65-69,9
13,1,0,0,1,2020-11-05,Male,34,25-34,12
13,1,0,0,1,2020-11-07,Female,23,20-24,2
13,0,0,0,0,2020-11-05,Male,48,45-54,8
13,4,0,0,4,2020-11-06,Male,69,65-69,8
13,0,0,0,0,2020-11-06,Male,65,65-69,12
13,3,0,0,3,2020-11-09,Male,7,5-9,9
13,2,2,0,4,2020-11-10,Male,68,65-69,12
13,0,4,0,4,2020-11-06,Male,61,55-64,9
13,0,0,0,0,2020-11-05,Male,33,25-34,5
13,0,0,0,0,2020-11-07,Male,43,35-44,6
13,0,0,0,0,2020-11-05,Female,56,55-64,11
13,0,0,0,0,2020-11-06,Female,58,55-64,9
13,3,0,0,3,2020-11-05,Male,23,20-24,3
13,0,0,0,0,2020-11-06,Female,66,65-69,12
13,0,0,0,0,2020-11-05,Female,40,35-44,12
13,1,0,0,1,2020-11-09,Female,25,25-34,5
13,0,2,0,2,2020-11-08,Female,63,55-64,8
13,1,2,0,3,2020-11-05,Female,61,55-64,13
13,0,0,0,0,2020-11-05,Male,49,45-54,8
13,1,2,0,3,2020-11-05,Female,54,45-54,13
13,0,0,0,0,2020-11-05,Male,34,25-34,9
13,0,1,0,1,2020-11-06,Male,56,55-64,9
13,0,0,0,0,2020-11-05,Female,65,65-69,13
13,2,0,0,2,2020-11-06,Male,32,25-34,10
13,1,0,0,1,2020-11-05,Male,73,70-74,11
13,3,0,0,3,2020-11-07,Female,7,5-9,7
13,0,2,0,2,2020-11-05,Male,6,5-9,7
13,1,0,0,1,2020-11-05,Male,79,75-79,8
13,0,0,0,0,2020-11-06,Female,67,65-69,8
13,0,0,0,0,2020-11-05,Male,38,35-44,9
13,2,25,0,27,2020-11-05,Female,18,15-19,7
13,1,1,0,2,2020-11-07,Male,48,45-54,7
13,1,0,0,1,2020-11-05,Male,69,65-69,11
13,2,1,2,5,2020-11-05,Male,15,15-19,8
13,0,2,0,2,2020-11-05,Male,36,35-44,13
13,2,2,0,4,2020-11-07,Female,49,45-54,6
13,0,1,0,1,2020-11-06,Male,65,65-69,4
13,1,1,0,2,2020-11-05,Male,40,35-44,13
13,2,0,0,2,2020-11-05,Female,71,70-74,10
13,0,1,0,1,2020-11-05,Male,40,35-44,10
13,2,0,0,2,2020-11-06,Male,62,55-64,12
13,1,0,0,1,2020-11-05,Female,20,20-24,3
13,1,3,0,4,2020-11-06,Female,68,65-69,8
13,3,2,0,5,2020-11-05,Female,23,20-24,7
13,0,3,0,3,2020-11-06,Female,70,70-74,9
13,1,1,0,2,2020-11-09,Male,68,65-69,6
13,0,1,0,1,2020-11-06,Female,8,5-9,9
13,1,0,0,1,2020-11-05,Female,33,25-34,9
13,2,12,0,14,2020-11-05,Female,71,70-74,7
13,0,0,0,0,2020-11-06,Male,68,65-69,12
13,4,0,0,4,2020-11-10,Female,63,55-64,5
13,0,0,0,0,2020-11-09,Male,37,35-44,6
13,0,1,0,1,2020-11-06,Male,28,25-34,11
13,0,0,0,0,2020-11-07,Female,53,45-54,10
13,3,1,0,4,2020-11-08,Male,6,5-9,9
13,0,0,0,0,2020-11-05,Male,76,75-79,6
13,0,1,0,1,2020-11-07,Male,47,45-54,7
13,1,2,0,3,2020-11-05,Male,52,45-54,10
13,0,0,0,0,2020-11-05,Female,70,70-74,8
13,1,3,0,4,2020-11-06,Female,69,65-69,5
13,3,0,0,3,2020-11-05,Male,69,65-69,8
13,2,10,0,12,2020-11-06,Female,69,65-69,11
13,0,0,0,0,2020-11-05,Male,16,15-19,10
13,2,0,0,2,2020-11-05,Male,65,65-69,9
13,0,1,0,1,2020-11-05,Male,49,45-54,10
13,1,3,0,4,2020-11-05,Male,75,75-79,7
13,0,1,0,1,2020-11-05,Male,50,45-54,5
13,0,0,0,0,2020-11-05,Male,17,15-19,6
13,1,4,0,5,2020-11-06,Female,65,65-69,8
13,2,2,0,4,2020-11-09,Male,22,20-24,8
13,1,0,0,1,2020-11-06,Male,66,65-69,12
13,0,0,0,0,2020-11-09,Male,65,65-69,12
13,2,1,0,3,2020-11-06,Female,67,65-69,12
13,1,0,0,1,2020-11-06,Male,68,65-69,11
13,1,2,28,31,2020-11-05,Male,50,45-54,6
13,1,0,0,1,2020-11-05,Male,75,75-79,11
13,3,0,0,3,2020-11-06,Female,5,5-9,7
13,0,1,0,1,2020-11-07,Male,65,65-69,7
13,1,1,0,2,2020-11-06,Female,44,35-44,6
13,2,0,0,2,2020-11-05,Male,70,70-74,6
13,3,2,0,5,2020-11-05,Female,15,15-19,9
13,1,0,0,1,2020-11-07,Female,61,55-64,5
13,0,1,0,1,2020-11-06,Male,14,10-14,10
13,0,1,1,2,2020-11-09,Male,52,45-54,9
13,0,0,0,0,2020-11-05,Female,51,45-54,11
13,5,0,0,5,2020-11-07,Male,12,10-14,10
13,5,0,0,5,2020-11-05,Male,27,25-34,7
13,0,0,0,0,2020-11-07,Female,60,55-64,9
13,0,0,0,0,2020-11-06,Male,30,25-34,12
13,3,0,0,3,2020-11-08,Female,1,1-4,6
13,0,0,0,0,2020-11-07,Male,47,45-54,6
13,0,0,0,0,2020-11-05,Male,81,80-84,12
13,5,3,0,8,2020-11-07,Female,5,5-9,3
13,3,0,0,3,2020-11-09,Female,53,45-54,9
13,0,0,0,0,2020-11-09,Female,58,55-64,7
13,0,0,0,0,2020-11-05,Female,8,5-9,8
13,1,0,0,1,2020-11-05,Female,52,45-54,9
13,0,0,0,0,2020-11-06,Female,28,25-34,3
13,0,1,0,1,2020-11-05,Male,24,20-24,10
13,0,0,0,0,2020-11-05,Male,17,15-19,9
13,2,3,0,5,2020-11-06,Male,71,70-74,11
13,0,0,0,0,2020-11-06,Male,35,35-44,12
13,1,0,0,1,2020-11-08,Female,23,20-24,12
13,0,0,0,0,2020-11-05,Female,66,65-69,9
13,6,0,0,6,2020-11-05,Female,1,1-4,9
13,1,0,0,1,2020-11-09,Female,67,65-69,7
13,0,0,0,0,2020-11-06,Male,67,65-69,11
13,0,0,0,0,2020-11-07,Male,22,20-24,5
13,2,0,0,2,2020-11-05,Male,41,35-44,13
13,1,0,0,1,2020-11-07,Male,65,65-69,11
13,0,0,0,0,2020-11-06,Female,29,25-34,4
13,0,0,0,0,2020-11-05,Male,71,70-74,7
13,5,1,0,6,2020-11-09,Female,85,85+,8
13,2,0,0,2,2020-11-05,Male,58,55-64,9
13,2,0,0,2,2020-11-09,Male,75,75-79,9
13,1,1,0,2,2020-11-09,Male,79,75-79,11
13,0,0,0,0,2020-11-05,Male,78,75-79,11
13,0,3,2,5,2020-11-05,Female,68,65-69,9
13,2,60,0,62,2020-11-06,Male,64,55-64,7
13,1,0,1,2,2020-11-06,Male,63,55-64,8
13,0,0,0,0,2020-11-09,Female,67,65-69,11
13,3,1,0,4,2020-11-06,Male,11,10-14,6
13,2,0,0,2,2020-11-05,Female,24,20-24,3
13,0,1,0,1,2020-11-06,Female,68,65-69,11
13,0,0,0,0,2020-11-09,Male,28,25-34,3
13,0,0,0,0,2020-11-05,Female,78,75-79,11
13,0,0,0,0,2020-11-08,Female,66,65-69,7
13,0,0,0,0,2020-11-06,Female,64,55-64,8
13,1,0,0,1,2020-11-05,Male,69,65-69,12
13,0,0,0,0,2020-11-05,Female,33,25-34,8
13,2,0,0,2,2020-11-05,Female,13,10-14,10
13,0,0,0,0,2020-11-09,Female,68,65-69,3
13,1,0,0,1,2020-11-05,Male,37,35-44,7
13,0,1,0,1,2020-11-06,Male,29,25-34,12
13,0,2,0,2,2020-11-06,Female,71,70-74,7
13,0,0,0,0,2020-11-05,Female,7,5-9,11
13,3,0,0,3,2020-11-05,Female,52,45-54,8
13,2,1,0,3,2020-11-06,Female,52,45-54,10
13,1,0,0,1,2020-11-05,Male,19,15-19,3
13,2,0,0,2,2020-11-05,Female,66,65-69,11
13,2,0,0,2,2020-11-05,Female,78,75-79,9
13,2,0,0,2,2020-11-08,Female,27,25-34,6
13,0,0,0,0,2020-11-06,Male,54,45-54,10
13,0,0,0,0,2020-11-06,Male,66,65-69,13
13,2,0,0,2,2020-11-09,Female,1,1-4,9
13,1,1,0,2,2020-11-06,Female,69,65-69,9
13,0,0,0,0,2020-11-05,Female,76,75-79,11
13,1,1,0,2,2020-11-05,Male,37,35-44,8
13,1,0,0,1,2020-11-06,Female,48,45-54,11
13,1,1,0,2,2020-11-06,Male,61,55-64,7
13,0,0,0,0,2020-11-09,Male,13,10-14,3
13,0,0,0,0,2020-11-06,Female,18,15-19,3
13,1,0,0,1,2020-11-05,Male,68,65-69,12
13,2,2,0,4,2020-11-06,Female,54,45-54,9
13,0,0,0,0,2020-11-06,Male,62,55-64,9
13,0,3,0,3,2020-11-06,Female,65,65-69,8
13,1,1,0,2,2020-11-06,Female,39,35-44,7
13,1,1,0,2,2020-11-05,Female,61,55-64,9
13,0,1,0,1,2020-11-09,Male,51,45-54,9
13,0,0,0,0,2020-11-06,Female,49,45-54,10
13,1,10,2,13,2020-11-07,Male,65,65-69,3
13,0,0,0,0,2020-11-05,Male,74,70-74,12
13,2,4,0,6,2020-11-05,Female,16,15-19,12
13,2,2,0,4,2020-11-09,Male,66,65-69,5
13,3,1,0,4,2020-11-06,Female,10,10-14,11
13,1,3,0,4,2020-11-06,Male,6,5-9,11
13,1,0,0,1,2020-11-05,Female,70,70-74,10
13,0,1,0,1,2020-11-09,Female,80,80-84,3
13,3,2,0,5,2020-11-06,Female,14,10-14,9
13,0,0,0,0,2020-11-06,Female,65,65-69,9
13,1,0,0,1,2020-11-05,Female,26,25-34,10
13,2,0,0,2,2020-11-09,Male,76,75-79,12
13,1,2,0,3,2020-11-06,Male,73,70-74,10
13,0,0,0,0,2020-11-09,Male,52,45-54,7
13,0,0,0,0,2020-11-05,Male,30,25-34,8
13,0,0,0,0,2020-11-05,Female,24,20-24,11
13,1,0,0,1,2020-11-06,Female,22,20-24,6
13,3,10,0,13,2020-11-06,Male,63,55-64,11
13,3,1,0,4,2020-11-06,Female,55,55-64,7
13,1,0,0,1,2020-11-07,Male,63,55-64,10
13,3,0,0,3,2020-11-06,Male,15,15-19,9
13,0,0,0,0,2020-11-06,Male,54,45-54,12
13,0,1,0,1,2020-11-07,Male,60,55-64,5
13,0,0,0,0,2020-11-05,Female,7,5-9,11
13,0,0,0,0,2020-11-05,Male,72,70-74,8
13,0,0,0,0,2020-11-05,Male,72,70-74,7
13,1,1,0,2,2020-11-05,Female,52,45-54,11
13,0,0,0,0,2020-11-05,Male,85,85+,5
13,0,3,0,3,2020-11-05,Female,71,70-74,11
13,0,0,0,0,2020-11-10,Male,14,10-14,8
13,0,0,0,0,2020-11-06,Male,30,25-34,11
13,2,3,0,5,2020-11-05,Female,18,15-19,6
13,0,0,0,0,2020-11-06,Female,57,55-64,12
13,0,0,0,0,2020-11-09,Male,67,65-69,9
13,0,0,0,0,2020-11-05,Female,85,85+,9
13,0,0,0,0,2020-11-05,Male,51,45-54,10
13,0,2,0,2,2020-11-05,Male,54,45-54,10
13,0,0,0,0,2020-11-06,Female,9,5-9,10
13,2,0,0,2,2020-11-05,Male,66,65-69,12
13,0,2,0,2,2020-11-09,Female,69,65-69,7
13,2,0,0,2,2020-11-08,Male,50,45-54,9
13,0,0,0,0,2020-11-10,Female,69,65-69,5
13,0,0,0,0,2020-11-05,Female,29,25-34,9
13,0,1,0,1,2020-11-07,Male,45,45-54,10
13,0,3,84,87,2020-11-05,Male,37,35-44,6
13,2,0,0,2,2020-11-07,Female,69,65-69,8
13,1,4,0,5,2020-11-06,Male,54,45-54,6
13,0,0,0,0,2020-11-05,Female,25,25-34,6
13,2,0,0,2,2020-11-05,Female,3,1-4,8
13,0,0,0,0,2020-11-05,Male,63,55-64,11
13,1,7,0,8,2020-11-06,Male,66,65-69,10
13,2,0,0,2,2020-11-07,Male,9,5-9,12
13,0,0,0,0,2020-11-06,Male,25,25-34,5
13,0,2,0,2,2020-11-05,Male,58,55-64,12
13,1,1,0,2,2020-11-06,Female,65,65-69,13
13,0,1,0,1,2020-11-06,Male,2,1-4,7
13,0,0,0,0,2020-11-09,Male,51,45-54,5
13,2,3,0,5,2020-11-05,Female,53,45-54,4
13,3,0,0,3,2020-11-09,Female,8,5-9,6
13,2,28,0,30,2020-11-05,Female,11,10-14,8
13,0,0,0,0,2020-11-06,Female,72,70-74,4
13,2,0,0,2,2020-11-05,Female,24,20-24,10
13,4,5,0,9,2020-11-05,Male,13,10-14,13
13,2,0,0,2,2020-11-06,Male,50,45-54,11
13,0,1,0,1,2020-11-05,Male,74,70-74,13
13,1,0,0,1,2020-11-05,Male,19,15-19,3
13,0,1,0,1,2020-11-06,Female,66,65-69,8
13,0,0,0,0,2020-11-05,Male,70,70-74,8
13,1,0,0,1,2020-11-06,Male,54,45-54,11
13,0,1,0,1,2020-11-08,Female,68,65-69,12
13,0,1,0,1,2020-11-05,Male,77,75-79,9
13,0,0,0,0,2020-11-05,Male,85,85+,9
13,1,61,0,62,2020-11-07,Female,55,55-64,8
13,0,0,0,0,2020-11-05,Male,7,5-9,6
13,1,1,0,2,2020-11-09,Female,77,75-79,5
13,2,1,0,3,2020-11-06,Male,66,65-69,10
13,1,0,0,1,2020-11-06,Male,59,55-64,12
13,1,0,0,1,2020-11-05,Male,54,45-54,9
13,0,0,0,0,2020-11-05,Female,24,20-24,12
13,1,0,0,1,2020-11-05,Male,35,35-44,9
13,0,0,0,0,2020-11-05,Male,51,45-54,13
13,0,0,0,0,2020-11-09,Male,30,25-34,12
13,3,0,0,3,2020-11-06,Female,2,1-4,9
13,0,1,0,1,2020-11-05,Female,23,20-24,10
13,1,0,0,1,2020-11-05,Male,34,25-34,9
13,0,0,0,0,2020-11-05,Female,49,45-54,13
13,0,4,0,4,2020-11-05,Male,40,35-44,7
13,0,0,0,0,2020-11-05,Male,70,70-74,10
13,2,0,0,2,2020-11-05,Female,63,55-64,12
13,1,1,0,2,2020-11-05,Male,63,55-64,10
13,3,0,0,3,2020-11-06,Female,7,5-9,7
13,2,1,0,3,2020-11-05,Female,37,35-44,11
13,2,0,0,2,2020-11-08,Male,9,5-9,3
13,1,0,0,1,2020-11-05,Female,47,45-54,3
13,1,1,0,2,2020-11-05,Female,22,20-24,3
13,2,0,0,2,2020-11-05,Female,61,55-64,11
13,1,2,0,3,2020-11-06,Female,57,55-64,7
13,1,0,0,1,2020-11-05,Male,53,45-54,10
13,0,5,0,5,2020-11-05,Female,66,65-69,13
13,0,3,0,3,2020-11-06,Female,66,65-69,11
13,0,2,0,2,2020-11-06,Female,69,65-69,7
13,3,0,0,3,2020-11-05,Female,8,5-9,8
13,0,2,0,2,2020-11-06,Female,53,45-54,9
13,0,0,0,0,2020-11-06,Male,54,45-54,9
13,0,3,0,3,2020-11-05,Male,54,45-54,10
13,2,2,0,4,2020-11-05,Male,65,65-69,10
13,0,1,0,1,2020-11-06,Male,57,55-64,8
13,1,12,0,13,2020-11-07,Female,55,55-64,11
13,2,0,0,2,2020-11-06,Male,40,35-44,12
13,0,1,0,1,2020-11-05,Male,38,35-44,10
13,0,1,0,1,2020-11-05,Male,39,35-44,9
13,1,1,0,2,2020-11-09,Female,44,35-44,4
13,2,0,0,2,2020-11-06,Female,21,20-24,10
13,1,0,0,1,2020-11-06,Male,24,20-24,8
13,2,0,0,2,2020-11-10,Female,6,5-9,12
13,2,2,0,4,2020-11-05,Male,40,35-44,2
13,0,0,0,0,2020-11-06,Male,66,65-69,12
13,0,0,0,0,2020-11-06,Male,61,55-64,9
13,0,0,0,0,2020-11-06,Male,63,55-64,10
13,1,0,0,1,2020-11-07,Female,64,55-64,6
13,0,1,0,1,2020-11-05,Male,73,70-74,10
13,0,0,0,0,2020-11-06,Female,57,55-64,10
13,3,0,0,3,2020-11-08,Male,43,35-44,10
13,1,1,0,2,2020-11-06,Male,70,70-74,11
13,0,0,0,0,2020-11-06,Female,17,15-19,12
13,1,0,0,1,2020-11-06,Male,62,55-64,13
13,1,0,0,1,2020-11-05,Male,67,65-69,13
13,2,1,0,3,2020-11-07,Male,77,75-79,4
13,1,0,0,1,2020-11-05,Female,71,70-74,9
13,0,8,41,49,2020-11-06,Female,60,55-64,5
13,1,0,0,1,2020-11-06,Male,9,5-9,13
13,2,0,0,2,2020-11-08,Female,55,55-64,12
13,0,10,0,10,2020-11-08,Male,58,55-64,8
13,3,0,8,11,2020-11-05,Female,6,5-9,8
13,0,0,0,0,2020-11-10,Male,53,45-54,8
13,0,0,0,0,2020-11-05,Female,22,20-24,9
13,2,1,0,3,2020-11-05,Female,67,65-69,3
13,0,0,0,0,2020-11-05,Female,35,35-44,10
13,2,7,25,34,2020-11-06,Male,55,55-64,8
13,1,2,0,3,2020-11-05,Male,62,55-64,9
13,0,0,0,0,2020-11-06,Male,65,65-69,7
13,1,2,0,3,2020-11-06,Female,8,5-9,6
13,0,0,0,0,2020-11-06,Female,12,10-14,8
13,0,0,1,1,2020-11-05,Male,53,45-54,7
13,0,0,0,0,2020-11-05,Male,44,35-44,11
13,0,1,2,3,2020-11-05,Female,19,15-19,3
13,1,10,0,11,2020-11-06,Female,23,20-24,2
13,1,0,0,1,2020-11-05,Female,65,65-69,9
13,7,0,0,7,2020-11-05,Female,10,10-14,8
13,1,0,0,1,2020-11-05,Male,64,55-64,13
13,1,2,0,3,2020-11-05,Female,51,45-54,10
13,2,0,1,3,2020-11-05,Female,15,15-19,13
13,0,1,0,1,2020-11-09,Female,73,70-74,7
13,0,0,0,0,2020-11-05,Female,7,5-9,9
13,1,1,0,2,2020-11-09,Female,56,55-64,7
13,1,0,6,7,2020-11-05,Male,53,45-54,9
13,2,2,0,4,2020-11-06,Male,55,55-64,13
13,0,0,0,0,2020-11-05,Male,59,55-64,12
13,0,5,0,5,2020-11-06,Female,59,55-64,11
13,0,1,0,1,2020-11-08,Female,20,20-24,5
13,0,1,0,1,2020-11-06,Female,67,65-69,5
13,0,0,0,0,2020-11-05,Female,23,20-24,11
13,1,10,0,11,2020-11-05,Male,32,25-34,10
13,0,0,0,0,2020-11-05,Male,28,25-34,12
13,3,6,0,9,2020-11-07,Male,58,55-64,9
13,0,1,0,1,2020-11-05,Male,47,45-54,9
13,4,0,0,4,2020-11-05,Male,0,<1,3
13,0,0,0,0,2020-11-05,Female,7,5-9,12
13,0,0,0,0,2020-11-05,Female,41,35-44,13
13,1,2,0,3,2020-11-05,Male,68,65-69,10
13,1,0,0,1,2020-11-05,Female,26,25-34,7
13,1,2,0,3,2020-11-08,Male,73,70-74,6
13,2,1,0,3,2020-11-05,Female,73,70-74,6
13,0,0,0,0,2020-11-06,Male,10,10-14,9
13,2,1,10,13,2020-11-05,Male,66,65-69,10
13,3,0,0,3,2020-11-05,Male,10,10-14,3
13,2,0,0,2,2020-11-05,Male,33,25-34,9
13,1,10,0,11,2020-11-06,Female,61,55-64,8
13,2,0,0,2,2020-11-06,Female,65,65-69,7
13,0,0,0,0,2020-11-05,Male,69,65-69,10
13,0,0,0,0,2020-11-05,Female,31,25-34,12
13,1,3,1,5,2020-11-05,Male,62,55-64,7
13,0,0,0,0,2020-11-08,Female,73,70-74,9
13,0,0,0,0,2020-11-05,Female,52,45-54,8
13,1,15,0,16,2020-11-05,Male,68,65-69,12
13,3,2,3,8,2020-11-07,Female,59,55-64,2
13,2,0,0,2,2020-11-05,Male,70,70-74,12
13,0,2,0,2,2020-11-08,Male,59,55-64,8
13,1,0,0,1,2020-11-07,Male,58,55-64,9
13,2,0,0,2,2020-11-05,Male,66,65-69,8
13,0,2,0,2,2020-11-05,Female,53,45-54,9
13,0,1,0,1,2020-11-09,Male,29,25-34,4
13,0,1,0,1,2020-11-10,Male,50,45-54,10
13,2,0,0,2,2020-11-07,Male,19,15-19,8
13,3,0,0,3,2020-11-05,Male,2,1-4,10
13,0,0,0,0,2020-11-05,Female,31,25-34,9
13,0,1,0,1,2020-11-06,Male,61,55-64,10
13,1,2,0,3,2020-11-06,Female,69,65-69,10
13,1,1,0,2,2020-11-06,Male,67,65-69,13
13,2,41,3,46,2020-11-06,Male,47,45-54,2
13,0,2,0,2,2020-11-05,Male,77,75-79,6
13,3,1,0,4,2020-11-06,Female,66,65-69,7
13,1,0,0,1,2020-11-08,Male,35,35-44,9
13,2,1,0,3,2020-11-09,Male,75,75-79,6
13,2,0,0,2,2020-11-09,Female,23,20-24,7
13,0,0,0,0,2020-11-08,Male,27,25-34,7
13,0,1,0,1,2020-11-06,Female,69,65-69,5
13,0,0,0,0,2020-11-06,Female,48,45-54,7
13,0,3,0,3,2020-11-06,Male,59,55-64,10
13,0,1,0,1,2020-11-05,Male,37,35-44,12
13,0,1,0,1,2020-11-09,Female,42,35-44,9
13,0,0,0,0,2020-11-05,Male,51,45-54,10
13,4,0,0,4,2020-11-07,Female,31,25-34,9
13,2,0,0,2,2020-11-06,Male,8,5-9,7
13,1,1,0,2,2020-11-07,Female,46,45-54,11
13,0,0,0,0,2020-11-05,Male,42,35-44,6
13,0,0,0,0,2020-11-06,Male,62,55-64,7
13,1,0,0,1,2020-11-07,Male,55,55-64,11
13,1,2,0,3,2020-11-06,Female,41,35-44,9
13,1,0,0,1,2020-11-05,Female,52,45-54,7
13,2,3,0,5,2020-11-05,Female,70,70-74,10
13,0,0,0,0,2020-11-09,Female,65,65-69,8
13,3,0,0,3,2020-11-07,Male,18,15-19,11
13,0,1,0,1,2020-11-05,Male,55,55-64,10
13,3,0,0,3,2020-11-06,Female,59,55-64,9
13,1,0,0,1,2020-11-05,Female,36,35-44,7
13,0,2,0,2,2020-11-07,Male,59,55-64,6
13,2,0,0,2,2020-11-09,Female,51,45-54,6
13,0,1,0,1,2020-11-10,Male,31,25-34,8
13,1,0,0,1,2020-11-05,Female,21,20-24,10
13,3,0,0,3,2020-11-07,Female,66,65-69,12
13,2,0,0,2,2020-11-05,Male,51,45-54,11
13,0,1,0,1,2020-11-06,Male,65,65-69,10
13,3,6,0,9,2020-11-05,Female,50,45-54,6
13,1,0,0,1,2020-11-05,Male,48,45-54,7
13,0,0,5,5,2020-11-09,Male,59,55-64,9
13,1,2,0,3,2020-11-06,Male,69,65-69,8
13,0,11,2,13,2020-11-05,Male,30,25-34,10
13,0,0,0,0,2020-11-05,Male,36,35-44,9
13,3,2,0,5,2020-11-05,Male,9,5-9,6
13,1,0,0,1,2020-11-05,Female,30,25-34,4
13,0,1,0,1,2020-11-05,Female,69,65-69,10
13,0,1,0,1,2020-11-05,Female,26,25-34,10
13,1,0,0,1,2020-11-07,Female,60,55-64,10
13,0,3,0,3,2020-11-05,Male,65,65-69,13
13,1,1,0,2,2020-11-05,Male,52,45-54,7
13,0,5,0,5,2020-11-10,Female,39,35-44,6
13,0,0,0,0,2020-11-05,Female,65,65-69,13
13,1,1,0,2,2020-11-06,Male,69,65-69,11
13,1,0,0,1,2020-11-05,Female,71,70-74,6
13,2,2,0,4,2020-11-06,Male,62,55-64,8
13,0,0,0,0,2020-11-06,Female,65,65-69,9
13,0,1,0,1,2020-11-10,Female,56,55-64,2
13,1,2,0,3,2020-11-05,Male,79,75-79,9
13,1,2,0,3,2020-11-05,Male,72,70-74,6
13,0,1,0,1,2020-11-06,Male,67,65-69,9
13,1,0,0,1,2020-11-06,Female,67,65-69,8
13,2,0,0,2,2020-11-06,Male,58,55-64,13
13,2,0,0,2,2020-11-06,Male,69,65-69,12
13,1,4,8,13,2020-11-05,Male,51,45-54,12
13,3,3,0,6,2020-11-09,Male,9,5-9,5
13,1,0,0,1,2020-11-08,Male,72,70-74,10
13,2,1,0,3,2020-11-05,Male,71,70-74,11
13,0,1,0,1,2020-11-08,Female,52,45-54,6
13,1,0,0,1,2020-11-05,Female,63,55-64,8
13,2,0,0,2,2020-11-05,Female,17,15-19,12
13,2,0,0,2,2020-11-08,Male,0,<1,5
13,1,1,0,2,2020-11-06,Female,39,35-44,12
13,1,0,0,1,2020-11-06,Female,58,55-64,12
13,0,0,2,2,2020-11-10,Male,77,75-79,6
13,3,0,0,3,2020-11-05,Male,17,15-19,13
13,0,1,0,1,2020-11-05,Male,40,35-44,10
13,0,1,0,1,2020-11-09,Male,67,65-69,9
13,1,1,0,2,2020-11-06,Female,66,65-69,8
13,0,0,0,0,2020-11-05,Female,68,65-69,12
13,3,0,0,3,2020-11-09,Female,15,15-19,8
13,2,1,0,3,2020-11-06,Male,67,65-69,4
13,0,0,0,0,2020-11-05,Female,28,25-34,11
13,4,0,0,4,2020-11-06,Female,32,25-34,11
13,1,0,0,1,2020-11-06,Female,63,55-64,9
13,4,1,0,5,2020-11-06,Female,21,20-24,3
13,0,0,0,0,2020-11-05,Female,33,25-34,9
13,0,0,0,0,2020-11-07,Male,15,15-19,5
13,2,0,0,2,2020-11-06,Female,49,45-54,6
13,1,1,0,2,2020-11-06,Male,32,25-34,8
13,1,0,0,1,2020-11-06,Male,65,65-69,7
13,0,1,0,1,2020-11-07,Female,68,65-69,12
13,3,0,0,3,2020-11-05,Female,15,15-19,9
13,2,2,0,4,2020-11-05,Female,49,45-54,7
13,0,0,0,0,2020-11-05,Male,23,20-24,10
13,0,0,0,0,2020-11-05,Male,59,55-64,9
13,0,0,0,0,2020-11-08,Male,43,35-44,6
13,1,0,0,1,2020-11-05,Male,12,10-14,3
13,1,0,0,1,2020-11-09,Male,59,55-64,10
13,2,0,0,2,2020-11-05,Male,26,25-34,10
13,1,5,0,6,2020-11-06,Female,67,65-69,10
13,2,2,0,4,2020-11-05,Male,70,70-74,8
13,0,0,0,0,2020-11-05,Male,69,65-69,11
13,1,3,0,4,2020-11-06,Male,59,55-64,10
13,1,0,0,1,2020-11-06,Male,44,35-44,12
13,0,0,0,0,2020-11-08,Male,52,45-54,6
13,3,0,0,3,2020-11-05,Female,0,<1,10
13,0,2,0,2,2020-11-08,Female,63,55-64,7
13,0,0,0,0,2020-11-06,Male,42,35-44,10
13,1,9,0,10,2020-11-06,Male,8,5-9,7
13,0,0,0,0,2020-11-06,Male,36,35-44,11
13,3,0,0,3,2020-11-07,Male,14,10-14,9
13,2,0,0,2,2020-11-06,Female,50,45-54,7
13,2,1,0,3,2020-11-06,Female,67,65-69,11
13,1,0,0,1,2020-11-06,Male,50,45-54,10
13,1,0,0,1,2020-11-09,Male,32,25-34,6
13,1,0,0,1,2020-11-05,Female,22,20-24,3
13,0,10,0,10,2020-11-05,Male,51,45-54,12
13,0,0,0,0,2020-11-07,Female,55,55-64,8
13,0,0,0,0,2020-11-05,Male,70,70-74,10
13,1,0,0,1,2020-11-05,Male,67,65-69,9
13,0,0,0,0,2020-11-05,Female,60,55-64,11
13,1,0,0,1,2020-11-06,Male,40,35-44,9
13,0,0,0,0,2020-11-05,Male,53,45-54,8
13,1,0,0,1,2020-11-05,Female,30,25-34,12
13,5,0,0,5,2020-11-06,Female,4,1-4,4
13,0,0,0,0,2020-11-05,Male,33,25-34,12
13,0,3,0,3,2020-11-08,Male,46,45-54,7
13,1,0,0,1,2020-11-06,Female,54,45-54,9
13,0,1,0,1,2020-11-05,Female,66,65-69,11
13,1,0,0,1,2020-11-06,Female,68,65-69,8
13,0,0,0,0,2020-11-06,Female,67,65-69,8
13,1,0,0,1,2020-11-06,Male,22,20-24,3
13,0,1,0,1,2020-11-05,Female,69,65-69,9
13,2,0,0,2,2020-11-05,Male,45,45-54,13
13,0,0,0,0,2020-11-05,Female,65,65-69,12
13,3,2,0,5,2020-11-05,Male,4,1-4,4
13,1,0,0,1,2020-11-08,Female,29,25-34,7
13,0,0,0,0,2020-11-05,Male,29,25-34,9
13,1,3,0,4,2020-11-10,Male,59,55-64,5
13,0,1,0,1,2020-11-05,Male,39,35-44,6
13,1,6,0,7,2020-11-05,Male,68,65-69,10
13,0,0,0,0,2020-11-06,Male,14,10-14,6
13,0,0,0,0,2020-11-05,Male,28,25-34,7
13,3,0,0,3,2020-11-10,Female,55,55-64,4
13,0,0,0,0,2020-11-08,Male,23,20-24,6
13,1,0,0,1,2020-11-06,Male,78,75-79,7
13,1,2,0,3,2020-11-06,Male,62,55-64,7
13,2,0,0,2,2020-11-05,Male,11,10-14,10
13,1,2,0,3,2020-11-05,Male,73,70-74,8
13,5,2,0,7,2020-11-06,Female,8,5-9,3
13,1,0,0,1,2020-11-09,Female,26,25-34,6
13,2,0,0,2,2020-11-08,Female,58,55-64,10
13,0,1,0,1,2020-11-05,Male,35,35-44,9
13,5,0,0,5,2020-11-06,Male,16,15-19,9
13,2,1,0,3,2020-11-06,Male,76,75-79,7
13,1,6,0,7,2020-11-09,Male,32,25-34,10
13,3,1,0,4,2020-11-06,Male,10,10-14,4
13,1,0,0,1,2020-11-06,Female,67,65-69,6
13,1,1,0,2,2020-11-06,Male,58,55-64,10
13,0,3,0,3,2020-11-05,Male,42,35-44,9
13,3,3,0,6,2020-11-06,Male,11,10-14,10
13,3,1,0,4,2020-11-06,Male,14,10-14,9
13,0,0,0,0,2020-11-10,Male,65,65-69,9
13,1,0,0,1,2020-11-09,Female,66,65-69,10
13,1,0,0,1,2020-11-07,Female,68,65-69,11
13,2,1,0,3,2020-11-05,Male,81,80-84,8
13,2,0,0,2,2020-11-05,Male,50,45-54,8
13,1,1,0,2,2020-11-05,Female,53,45-54,8
13,2,2,2,6,2020-11-07,Female,67,65-69,8
13,0,18,0,18,2020-11-06,Female,47,45-54,9
13,1,0,0,1,2020-11-05,Male,71,70-74,9
13,0,0,0,0,2020-11-05,Female,30,25-34,7
13,0,0,0,0,2020-11-05,Female,23,20-24,10
13,1,0,0,1,2020-11-06,Male,65,65-69,11
13,1,0,0,1,2020-11-05,Female,62,55-64,11
13,1,1,0,2,2020-11-05,Female,52,45-54,7
13,0,0,0,0,2020-11-05,Male,65,65-69,12
13,0,0,0,0,2020-11-06,Male,76,75-79,7
13,0,0,0,0,2020-11-05,Male,66,65-69,11
13,1,1,0,2,2020-11-06,Male,63,55-64,12
13,0,2,0,2,2020-11-06,Female,69,65-69,8
13,2,0,0,2,2020-11-09,Female,68,65-69,8
13,0,0,0,0,2020-11-08,Female,27,25-34,8
13,1,0,0,1,2020-11-05,Male,72,70-74,11
13,0,0,0,0,2020-11-05,Female,63,55-64,10
13,0,0,0,0,2020-11-05,Female,36,35-44,12
13,6,2,0,8,2020-11-05,Male,6,5-9,10
13,2,0,0,2,2020-11-05,Male,70,70-74,8
13,0,0,0,0,2020-11-06,Male,40,35-44,4
13,5,0,0,5,2020-11-05,Female,12,10-14,10
13,3,3,0,6,2020-11-06,Female,65,65-69,13
13,0,0,0,0,2020-11-06,Female,61,55-64,11
13,0,0,0,0,2020-11-05,Female,31,25-34,10
13,0,0,0,0,2020-11-06,Male,26,25-34,8
13,2,2,0,4,2020-11-06,Male,55,55-64,11
13,2,2,0,4,2020-11-09,Male,54,45-54,7
13,0,0,0,0,2020-11-06,Female,42,35-44,8
13,0,3,0,3,2020-11-07,Female,66,65-69,8
13,0,0,0,0,2020-11-05,Male,44,35-44,6
13,2,0,0,2,2020-11-06,Female,59,55-64,11
13,0,0,0,0,2020-11-05,Female,22,20-24,9
13,0,0,0,0,2020-11-05,Female,31,25-34,10
13,0,3,0,3,2020-11-05,Male,53,45-54,10
13,9,1,9,19,2020-11-07,Female,28,25-34,8
13,2,5,0,7,2020-11-06,Male,57,55-64,8
13,0,3,0,3,2020-11-06,Male,39,35-44,9
13,3,2,0,5,2020-11-06,Female,13,10-14,11
13,1,8,0,9,2020-11-05,Male,43,35-44,10
13,1,1,0,2,2020-11-05,Male,41,35-44,9
13,3,0,0,3,2020-11-05,Male,19,15-19,7
13,3,2,0,5,2020-11-06,Male,65,65-69,6
13,0,1,0,1,2020-11-06,Female,64,55-64,12
13,0,0,0,0,2020-11-05,Male,19,15-19,13
13,1,0,0,1,2020-11-05,Female,66,65-69,10
13,2,3,28,33,2020-11-10,Female,61,55-64,10
13,0,0,0,0,2020-11-05,Female,61,55-64,12
13,1,0,0,1,2020-11-05,Male,50,45-54,9
13,0,0,0,0,2020-11-06,Male,44,35-44,12
13,2,1,0,3,2020-11-05,Male,15,15-19,9
13,1,1,0,2,2020-11-05,Male,71,70-74,8
13,0,1,0,1,2020-11-08,Female,67,65-69,7
13,0,0,0,0,2020-11-09,Female,68,65-69,9
13,2,0,0,2,2020-11-06,Male,70,70-74,9
13,2,1,0,3,2020-11-06,Male,8,5-9,8
13,0,1,0,1,2020-11-05,Female,70,70-74,11
13,0,0,0,0,2020-11-05,Male,5,5-9,9
13,2,0,0,2,2020-11-06,Male,67,65-69,9
13,1,0,0,1,2020-11-05,Male,66,65-69,10
13,0,0,0,0,2020-11-10,Female,22,20-24,3
13,0,0,0,0,2020-11-06,Male,70,70-74,9
13,0,0,0,0,2020-11-07,Female,33,25-34,6
13,0,0,0,0,2020-11-05,Male,74,70-74,11
13,0,0,0,0,2020-11-05,Female,33,25-34,12
13,0,0,0,0,2020-11-05,Male,52,45-54,12
13,1,0,0,1,2020-11-05,Male,68,65-69,13
13,0,4,0,4,2020-11-05,Female,52,45-54,7
13,2,1,0,3,2020-11-05,Male,78,75-79,7
13,5,0,0,5,2020-11-09,Female,14,10-14,7
13,2,0,0,2,2020-11-06,Female,17,15-19,7
13,0,0,0,0,2020-11-05,Male,24,20-24,10
13,0,0,0,0,2020-11-05,Male,17,15-19,10
13,3,0,0,3,2020-11-08,Female,6,5-9,7
13,0,0,0,0,2020-11-07,Male,42,35-44,5
13,4,0,0,4,2020-11-06,Female,5,5-9,3
13,4,7,0,11,2020-11-06,Male,13,10-14,9
13,2,0,0,2,2020-11-08,Female,35,35-44,6
13,0,0,0,0,2020-11-05,Female,22,20-24,9
13,2,7,0,9,2020-11-05,Male,79,75-79,8
13,2,0,0,2,2020-11-09,Male,52,45-54,10
13,0,1,0,1,2020-11-05,Female,33,25-34,6
13,1,0,0,1,2020-11-06,Male,52,45-54,9
13,0,1,0,1,2020-11-05,Male,51,45-54,8
13,3,0,0,3,2020-11-05,Female,43,35-44,12
13,2,0,0,2,2020-11-05,Female,70,70-74,10
13,1,10,0,11,2020-11-05,Female,24,20-24,11
13,0,0,0,0,2020-11-05,Male,31,25-34,9
13,0,0,0,0,2020-11-05,Female,68,65-69,13
13,0,0,0,0,2020-11-06,Male,59,55-64,8
13,3,0,0,3,2020-11-05,Female,36,35-44,7
13,2,0,0,2,2020-11-06,Male,11,10-14,10
13,1,0,0,1,2020-11-09,Male,24,20-24,3
13,2,1,0,3,2020-11-06,Male,69,65-69,6
13,2,0,0,2,2020-11-06,Female,51,45-54,11
13,0,0,0,0,2020-11-08,Female,69,65-69,7
13,2,0,0,2,2020-11-05,Male,33,25-34,10
13,4,1,0,5,2020-11-06,Female,11,10-14,10
13,3,0,0,3,2020-11-09,Female,3,1-4,10
13,2,0,0,2,2020-11-09,Female,0,<1,3
13,1,12,0,13,2020-11-06,Male,59,55-64,5
13,1,0,0,1,2020-11-05,Male,38,35-44,5
13,0,0,0,0,2020-11-06,Male,45,45-54,8
13,0,0,0,0,2020-11-06,Female,68,65-69,11
13,1,0,0,1,2020-11-06,Female,58,55-64,11
13,0,1,0,1,2020-11-09,Female,67,65-69,6
13,0,0,0,0,2020-11-05,Female,54,45-54,11
13,0,2,0,2,2020-11-08,Male,69,65-69,9
13,1,0,0,1,2020-11-09,Female,23,20-24,4
13,0,0,0,0,2020-11-06,Female,41,35-44,12
13,0,0,0,0,2020-11-06,Female,64,55-64,12
13,3,2,0,5,2020-11-05,Female,14,10-14,7
13,1,0,0,1,2020-11-05,Female,52,45-54,13
13,0,0,0,0,2020-11-06,Male,40,35-44,9
13,2,0,65,67,2020-11-05,Male,18,15-19,9
13,0,0,0,0,2020-11-05,Male,77,75-79,12
13,0,0,0,0,2020-11-09,Male,44,35-44,7
13,1,0,0,1,2020-11-06,Male,66,65-69,13
13,0,1,0,1,2020-11-05,Female,29,25-34,6
13,1,0,0,1,2020-11-05,Male,34,25-34,7
13,0,0,0,0,2020-11-05,Female,66,65-69,12
13,0,0,0,0,2020-11-06,Female,65,65-69,7
13,0,0,0,0,2020-11-10,Male,4,1-4,6
13,2,1,0,3,2020-11-10,Male,6,5-9,7
13,0,0,0,0,2020-11-09,Male,48,45-54,12
13,2,1,0,3,2020-11-08,Male,17,15-19,8
13,1,0,0,1,2020-11-06,Male,65,65-69,8
13,0,0,0,0,2020-11-06,Male,39,35-44,11
13,1,5,0,6,2020-11-06,Female,66,65-69,13
13,0,0,0,0,2020-11-05,Male,38,35-44,11
13,0,1,0,1,2020-11-10,Male,74,70-74,10
13,0,0,0,0,2020-11-05,Male,30,25-34,10
13,2,0,0,2,2020-11-06,Female,63,55-64,10
13,0,0,0,0,2020-11-05,Male,19,15-19,8
13,1,0,0,1,2020-11-07,Male,72,70-74,4
13,0,0,0,0,2020-11-05,Female,54,45-54,9
13,0,1,0,1,2020-11-06,Male,67,65-69,5
13,1,0,0,1,2020-11-05,Female,67,65-69,11
13,3,1,2,6,2020-11-05,Female,5,5-9,8
13,1,1,0,2,2020-11-05,Male,48,45-54,6
13,2,0,0,2,2020-11-07,Male,12,10-14,5
13,0,0,0,0,2020-11-06,Male,75,75-79,13
13,0,2,0,2,2020-11-05,Female,19,15-19,3
13,0,0,0,0,2020-11-09,Female,37,35-44,4
13,0,0,0,0,2020-11-06,Male,64,55-64,10
13,2,0,0,2,2020-11-06,Male,60,55-64,9
13,0,0,0,0,2020-11-05,Male,41,35-44,11
13,4,1,0,5,2020-11-05,Male,1,1-4,5
13,0,0,0,0,2020-11-06,Male,34,25-34,7
13,3,2,0,5,2020-11-06,Male,69,65-69,7
13,2,0,0,2,2020-11-06,Female,14,10-14,13
13,1,1,0,2,2020-11-06,Male,67,65-69,4
13,0,0,0,0,2020-11-06,Female,58,55-64,11
13,2,1,0,3,2020-11-10,Female,52,45-54,9
13,1,0,0,1,2020-11-05,Female,34,25-34,8
13,0,0,0,0,2020-11-06,Female,59,55-64,11
13,0,0,0,0,2020-11-05,Male,11,10-14,10
13,1,0,4,5,2020-11-06,Male,19,15-19,9
13,1,3,0,4,2020-11-08,Female,62,55-64,4
13,1,0,0,1,2020-11-05,Male,65,65-69,10
13,0,0,0,0,2020-11-05,Female,17,15-19,11
13,1,0,0,1,2020-11-05,Female,49,45-54,11
13,0,0,0,0,2020-11-06,Female,54,45-54,8
13,0,0,0,0,2020-11-07,Female,23,20-24,8
13,1,3,0,4,2020-11-05,Male,23,20-24,3
13,0,0,0,0,2020-11-05,Female,21,20-24,8
13,2,1,1,4,2020-11-07,Female,10,10-14,9
13,0,2,0,2,2020-11-09,Male,43,35-44,8
13,3,31,0,34,2020-11-06,Female,17,15-19,8
13,1,0,0,1,2020-11-08,Female,69,65-69,7
13,1,2,0,3,2020-11-05,Female,24,20-24,8
13,0,2,0,2,2020-11-07,Female,67,65-69,8
13,0,1,0,1,2020-11-10,Female,53,45-54,12
13,1,1,0,2,2020-11-05,Male,74,70-74,7
13,0,0,0,0,2020-11-05,Male,39,35-44,10
13,0,0,0,0,2020-11-09,Male,35,35-44,7
13,3,10,0,13,2020-11-07,Male,15,15-19,6
13,0,0,0,0,2020-11-05,Male,35,35-44,7
13,2,1,0,3,2020-11-06,Male,67,65-69,7
13,1,1,0,2,2020-11-07,Male,66,65-69,10
13,4,2,0,6,2020-11-05,Female,4,1-4,4
13,0,0,0,0,2020-11-07,Female,65,65-69,10
13,2,2,0,4,2020-11-05,Female,14,10-14,5
13,0,0,0,0,2020-11-05,Female,65,65-69,8
13,2,0,0,2,2020-11-06,Male,8,5-9,4
13,1,0,0,1,2020-11-08,Female,54,45-54,5
13,1,0,0,1,2020-11-07,Female,68,65-69,9
13,0,4,0,4,2020-11-05,Male,52,45-54,13
13,1,0,0,1,2020-11-05,Female,41,35-44,8
13,0,0,0,0,2020-11-05,Female,31,25-34,9
13,1,1,0,2,2020-11-06,Male,57,55-64,10
13,1,1,0,2,2020-11-06,Male,65,65-69,8
13,2,8,0,10,2020-11-09,Male,67,65-69,11
13,1,0,0,1,2020-11-09,Female,76,75-79,8
13,2,1,0,3,2020-11-08,Female,8,5-9,9
13,1,1,0,2,2020-11-05,Male,39,35-44,4
13,1,0,0,1,2020-11-05,Female,62,55-64,13
13,1,4,0,5,2020-11-07,Female,28,25-34,7
13,2,0,0,2,2020-11-06,Male,11,10-14,8
13,0,0,0,0,2020-11-05,Female,10,10-14,10
13,0,0,0,0,2020-11-08,Female,28,25-34,7
13,0,3,0,3,2020-11-06,Female,69,65-69,10
13,0,6,0,6,2020-11-05,Male,27,25-34,10
13,0,0,0,0,2020-11-06,Female,56,55-64,5
13,0,0,0,0,2020-11-05,Male,73,70-74,9
13,2,1,0,3,2020-11-05,Female,21,20-24,3
13,0,1,0,1,2020-11-06,Male,62,55-64,8
13,3,2,0,5,2020-11-05,Male,23,20-24,8
13,0,0,0,0,2020-11-05,Male,23,20-24,10
13,5,3,0,8,2020-11-07,Female,28,25-34,6
13,0,0,0,0,2020-11-06,Male,68,65-69,11
13,0,14,0,14,2020-11-05,Male,44,35-44,9
13,0,3,0,3,2020-11-08,Female,29,25-34,8
13,1,0,0,1,2020-11-07,Male,55,55-64,9
13,0,0,0,0,2020-11-09,Male,19,15-19,12
13,0,0,0,0,2020-11-08,Male,30,25-34,6
13,2,1,0,3,2020-11-06,Female,69,65-69,8
13,0,0,0,0,2020-11-09,Female,73,70-74,5
13,1,1,0,2,2020-11-05,Female,68,65-69,11
13,1,1,0,2,2020-11-05,Male,55,55-64,13
13,1,0,0,1,2020-11-06,Female,61,55-64,12
13,2,0,0,2,2020-11-06,Female,61,55-64,12
13,1,2,0,3,2020-11-05,Male,52,45-54,12
13,0,0,0,0,2020-11-09,Female,71,70-74,5
13,0,0,0,0,2020-11-06,Female,66,65-69,13
13,3,0,0,3,2020-11-05,Female,45,45-54,7
13,0,0,0,0,2020-11-06,Male,65,65-69,10
13,1,4,0,5,2020-11-05,Female,59,55-64,10
13,0,0,0,0,2020-11-09,Female,68,65-69,10
13,1,0,0,1,2020-11-07,Female,11,10-14,9
13,2,0,0,2,2020-11-08,Male,13,10-14,7
13,1,1,0,2,2020-11-09,Female,62,55-64,12
13,2,0,0,2,2020-11-05,Male,32,25-34,7
13,0,1,0,1,2020-11-05,Female,52,45-54,11
13,0,0,0,0,2020-11-09,Female,14,10-14,7
13,0,1,0,1,2020-11-05,Female,65,65-69,9
13,2,0,0,2,2020-11-06,Female,53,45-54,10
13,2,1,0,3,2020-11-05,Female,48,45-54,10
13,1,0,0,1,2020-11-07,Male,66,65-69,10
13,0,2,0,2,2020-11-06,Female,67,65-69,4
13,0,1,0,1,2020-11-06,Male,29,25-34,9
13,1,2,0,3,2020-11-05,Male,58,55-64,6
13,1,0,0,1,2020-11-09,Male,70,70-74,13
13,0,0,0,0,2020-11-05,Female,44,35-44,13
13,1,1,0,2,2020-11-05,Male,71,70-74,8
13,0,1,0,1,2020-11-05,Female,64,55-64,8
13,2,0,0,2,2020-11-09,Male,72,70-74,8
13,1,0,0,1,2020-11-06,Female,35,35-44,8
13,2,3,3,8,2020-11-06,Male,24,20-24,10
13,1,3,0,4,2020-11-05,Female,66,65-69,8
13,1,2,0,3,2020-11-05,Male,58,55-64,12
13,1,1,0,2,2020-11-09,Male,66,65-69,8
13,3,0,76,79,2020-11-05,Male,10,10-14,10
13,3,0,0,3,2020-11-06,Male,4,1-4,9
13,0,1,0,1,2020-11-08,Male,35,35-44,8
13,1,0,0,1,2020-11-10,Female,58,55-64,7
13,2,0,0,2,2020-11-05,Male,18,15-19,10
13,0,1,0,1,2020-11-05,Male,49,45-54,9
13,0,0,0,0,2020-11-05,Male,57,55-64,7
13,2,0,44,46,2020-11-06,Female,25,25-34,13
13,3,0,0,3,2020-11-05,Male,29,25-34,11
13,0,0,0,0,2020-11-05,Male,34,25-34,9
13,0,0,0,0,2020-11-05,Male,71,70-74,6
13,2,2,0,4,2020-11-05,Female,12,10-14,10
13,1,1,0,2,2020-11-05,Female,69,65-69,10
13,1,2,0,3,2020-11-06,Male,66,65-69,6
13,0,3,0,3,2020-11-06,Male,66,65-69,9
13,0,0,0,0,2020-11-07,Female,49,45-54,7
13,2,0,0,2,2020-11-07,Female,68,65-69,6
13,0,0,0,0,2020-11-05,Male,35,35-44,9
13,2,0,0,2,2020-11-05,Female,7,5-9,11
13,0,0,0,0,2020-11-10,Female,66,65-69,13
13,0,0,0,0,2020-11-05,Female,50,45-54,7
13,0,0,0,0,2020-11-06,Male,42,35-44,10
13,1,0,0,1,2020-11-05,Female,4,1-4,10
13,0,0,0,0,2020-11-08,Male,40,35-44,8
13,1,3,0,4,2020-11-06,Female,61,55-64,7
13,1,0,0,1,2020-11-06,Male,67,65-69,11
13,4,2,0,6,2020-11-05,Male,6,5-9,13
13,4,0,0,4,2020-11-09,Female,4,1-4,4
13,2,2,0,4,2020-11-09,Female,29,25-34,8
13,2,0,0,2,2020-11-06,Male,28,25-34,8
13,2,2,0,4,2020-11-05,Male,51,45-54,8
13,2,0,0,2,2020-11-06,Male,61,55-64,10
13,2,0,0,2,2020-11-07,Male,65,65-69,9
13,1,0,0,1,2020-11-05,Female,61,55-64,10
13,0,1,0,1,2020-11-06,Male,51,45-54,10
13,1,0,0,1,2020-11-05,Male,65,65-69,12
13,1,0,0,1,2020-11-09,Female,39,35-44,8
13,2,1,0,3,2020-11-06,Male,52,45-54,12
13,0,0,0,0,2020-11-05,Male,51,45-54,7
13,0,0,0,0,2020-11-05,Female,5,5-9,8
13,1,10,0,11,2020-11-05,Male,53,45-54,8
13,1,0,0,1,2020-11-07,Female,60,55-64,8
13,1,2,0,3,2020-11-07,Female,18,15-19,6
13,1,3,0,4,2020-11-06,Female,55,55-64,12
13,2,1,0,3,2020-11-07,Male,32,25-34,9
13,0,0,0,0,2020-11-05,Female,49,45-54,9
13,4,1,0,5,2020-11-07,Female,41,35-44,7
13,0,0,0,0,2020-11-06,Male,66,65-69,9
13,1,0,0,1,2020-11-06,Male,67,65-69,11
13,0,1,0,1,2020-11-06,Male,54,45-54,7
13,0,0,0,0,2020-11-06,Male,40,35-44,12
13,0,0,0,0,2020-11-07,Male,59,55-64,9
13,0,2,0,2,2020-11-09,Male,41,35-44,13
13,0,1,0,1,2020-11-06,Male,67,65-69,13
13,0,0,0,0,2020-11-06,Male,33,25-34,6
13,0,0,0,0,2020-11-05,Female,34,25-34,10
13,1,0,0,1,2020-11-06,Male,63,55-64,8
13,0,0,0,0,2020-11-06,Female,69,65-69,9
13,2,0,0,2,2020-11-05,Male,51,45-54,5
13,4,0,11,15,2020-11-05,Male,2,1-4,11
13,0,0,0,0,2020-11-05,Male,58,55-64,11
13,1,1,0,2,2020-11-05,Male,47,45-54,9
13,0,1,0,1,2020-11-09,Female,34,25-34,9
13,0,0,100,100,2020-11-05,Male,52,45-54,12
13,2,0,0,2,2020-11-05,Male,61,55-64,3
13,2,2,0,4,2020-11-09,Female,39,35-44,3
13,1,0,0,1,2020-11-05,Male,61,55-64,13
13,0,1,0,1,2020-11-09,Female,23,20-24,3
13,0,5,0,5,2020-11-05,Female,67,65-69,13
13,3,4,0,7,2020-11-06,Male,58,55-64,6
13,3,4,0,7,2020-11-06,Male,12,10-14,13
13,3,0,0,3,2020-11-09,Female,38,35-44,9
13,2,1,0,3,2020-11-06,Male,77,75-79,10
13,0,0,0,0,2020-11-05,Female,43,35-44,9
13,1,0,0,1,2020-11-09,Female,22,20-24,5
13,0,0,0,0,2020-11-06,Female,17,15-19,10
13,0,1,0,1,2020-11-06,Male,47,45-54,11
13,0,0,0,0,2020-11-08,Female,57,55-64,8
13,0,0,0,0,2020-11-06,Male,66,65-69,9
13,0,0,0,0,2020-11-06,Female,19,15-19,6
13,1,0,0,1,2020-11-10,Female,20,20-24,7
13,0,0,0,0,2020-11-05,Female,18,15-19,3
13,2,4,0,6,2020-11-06,Female,65,65-69,7
13,4,2,0,6,2020-11-09,Female,16,15-19,6
13,0,0,0,0,2020-11-05,Male,27,25-34,9
13,0,1,0,1,2020-11-06,Male,47,45-54,10
13,0,0,0,0,2020-11-07,Male,32,25-34,8
13,2,0,0,2,2020-11-05,Male,49,45-54,7
13,0,0,0,0,2020-11-05,Male,52,45-54,10
13,4,1,0,5,2020-11-05,Female,4,1-4,4
13,2,0,0,2,2020-11-05,Female,11,10-14,7
13,2,2,0,4,2020-11-06,Male,62,55-64,8
13,2,0,0,2,2020-11-05,Male,11,10-14,12
13,2,2,0,4,2020-11-05,Female,62,55-64,9
13,1,0,0,1,2020-11-05,Male,45,45-54,6
13,0,0,0,0,2020-11-06,Male,43,35-44,12
13,2,1,0,3,2020-11-05,Female,64,55-64,13
13,1,0,0,1,2020-11-05,Female,73,70-74,12
13,0,1,0,1,2020-11-05,Male,53,45-54,6
13,0,1,0,1,2020-11-05,Male,77,75-79,7
13,0,0,0,0,2020-11-05,Female,33,25-34,9
13,2,1,0,3,2020-11-06,Female,11,10-14,9
13,1,0,0,1,2020-11-05,Female,50,45-54,9
13,0,0,0,0,2020-11-05,Female,22,20-24,6
13,2,0,0,2,2020-11-05,Male,56,55-64,10
13,0,2,0,2,2020-11-06,Female,62,55-64,8
13,0,2,0,2,2020-11-08,Female,42,35-44,3
13,0,1,0,1,2020-11-05,Female,59,55-64,8
13,2,0,0,2,2020-11-08,Male,65,65-69,13
13,0,0,0,0,2020-11-05,Female,33,25-34,3
13,4,0,0,4,2020-11-09,Female,33,25-34,6
13,1,0,0,1,2020-11-09,Male,70,70-74,6
13,1,1,0,2,2020-11-06,Male,61,55-64,12
13,1,0,0,1,2020-11-05,Male,66,65-69,12
13,0,0,0,0,2020-11-05,Female,56,55-64,4
13,0,0,0,0,2020-11-05,Male,33,25-34,12
13,1,0,0,1,2020-11-06,Female,59,55-64,11
13,2,1,0,3,2020-11-05,Male,73,70-74,9
13,2,0,0,2,2020-11-05,Male,34,25-34,8
13,0,0,0,0,2020-11-05,Female,36,35-44,9
13,0,2,0,2,2020-11-09,Male,46,45-54,3
13,1,0,0,1,2020-11-10,Male,62,55-64,8
13,4,0,0,4,2020-11-07,Female,22,20-24,7
13,0,1,0,1,2020-11-06,Male,62,55-64,9
13,0,0,0,0,2020-11-09,Female,68,65-69,10
13,2,0,0,2,2020-11-05,Female,65,65-69,9
13,1,1,0,2,2020-11-06,Female,34,25-34,10
13,0,0,0,0,2020-11-05,Male,53,45-54,12
13,0,2,0,2,2020-11-05,Female,35,35-44,7
13,0,1,0,1,2020-11-06,Male,56,55-64,10
13,1,1,0,2,2020-11-05,Female,56,55-64,11
13,0,3,0,3,2020-11-06,Female,67,65-69,12
13,2,0,0,2,2020-11-07,Male,41,35-44,5
13,2,1,0,3,2020-11-05,Male,72,70-74,9
13,1,3,0,4,2020-11-07,Male,66,65-69,9
13,1,0,0,1,2020-11-08,Female,72,70-74,7
13,0,0,0,0,2020-11-05,Male,31,25-34,9
13,0,0,0,0,2020-11-07,Female,58,55-64,8
13,2,0,0,2,2020-11-05,Male,71,70-74,8
13,0,1,0,1,2020-11-08,Female,48,45-54,8
13,1,1,0,2,2020-11-06,Female,55,55-64,6
13,2,0,0,2,2020-11-07,Female,70,70-74,10
13,0,0,0,0,2020-11-06,Female,71,70-74,9
13,0,0,0,0,2020-11-05,Male,66,65-69,13
13,1,0,0,1,2020-11-08,Male,67,65-69,7
13,0,0,0,0,2020-11-05,Female,26,25-34,9
13,0,0,0,0,2020-11-05,Female,55,55-64,6
13,0,1,0,1,2020-11-06,Female,74,70-74,6
13,2,0,0,2,2020-11-05,Male,80,80-84,8
13,0,0,0,0,2020-11-06,Male,65,65-69,8
13,1,2,0,3,2020-11-09,Female,53,45-54,12
13,0,0,0,0,2020-11-05,Male,28,25-34,5
13,1,0,0,1,2020-11-05,Male,63,55-64,11
13,0,0,0,0,2020-11-05,Male,37,35-44,12
13,0,0,0,0,2020-11-09,Female,67,65-69,7
13,1,5,0,6,2020-11-05,Female,28,25-34,11
13,0,0,0,0,2020-11-05,Female,13,10-14,10
13,2,2,0,4,2020-11-07,Male,14,10-14,13
13,2,0,0,2,2020-11-06,Male,18,15-19,7
13,1,0,0,1,2020-11-05,Male,34,25-34,12
13,0,3,0,3,2020-11-05,Female,72,70-74,11
13,0,0,0,0,2020-11-05,Female,26,25-34,5
13,0,0,0,0,2020-11-05,Male,13,10-14,7
13,3,1,0,4,2020-11-05,Male,41,35-44,10
13,1,0,0,1,2020-11-05,Female,24,20-24,13
13,0,1,0,1,2020-11-09,Female,10,10-14,7
13,1,0,0,1,2020-11-05,Male,32,25-34,9
13,0,0,0,0,2020-11-05,Female,42,35-44,10
13,2,2,0,4,2020-11-05,Female,71,70-74,10
13,1,2,0,3,2020-11-07,Male,58,55-64,9
13,2,0,0,2,2020-11-06,Male,66,65-69,9
13,3,4,0,7,2020-11-07,Male,3,1-4,10
13,3,1,0,4,2020-11-05,Female,36,35-44,12
13,1,0,0,1,2020-11-05,Female,59,55-64,11
13,1,0,0,1,2020-11-09,Male,69,65-69,10
13,1,0,0,1,2020-11-05,Male,66,65-69,12
13,3,0,0,3,2020-11-07,Male,48,45-54,5
13,0,0,0,0,2020-11-08,Female,57,55-64,11
13,0,4,0,4,2020-11-05,Male,76,75-79,7
13,0,0,0,0,2020-11-05,Male,52,45-54,12
13,1,1,0,2,2020-11-05,Female,75,75-79,6
13,0,0,0,0,2020-11-09,Male,66,65-69,5
13,2,0,0,2,2020-11-06,Male,65,65-69,9
13,0,0,50,50,2020-11-07,Male,47,45-54,3
13,0,3,0,3,2020-11-05,Male,75,75-79,10
13,0,0,0,0,2020-11-06,Female,66,65-69,12
13,2,0,0,2,2020-11-08,Female,17,15-19,6
13,0,2,0,2,2020-11-07,Female,54,45-54,9
13,1,0,0,1,2020-11-06,Female,46,45-54,10
13,1,0,0,1,2020-11-05,Male,70,70-74,8
13,1,0,0,1,2020-11-05,Male,53,45-54,9
13,0,0,0,0,2020-11-05,Female,62,55-64,10
13,0,0,0,0,2020-11-05,Female,23,20-24,4
13,2,0,0,2,2020-11-06,Male,74,70-74,10
13,1,1,0,2,2020-11-05,Female,70,70-74,13
13,1,0,0,1,2020-11-05,Male,35,35-44,7
13,2,0,0,2,2020-11-08,Female,62,55-64,7
13,2,2,0,4,2020-11-06,Male,73,70-74,6
13,0,1,0,1,2020-11-08,Male,32,25-34,7
13,0,0,0,0,2020-11-05,Male,27,25-34,12
13,2,1,0,3,2020-11-05,Female,77,75-79,3
13,1,0,0,1,2020-11-05,Male,28,25-34,13
13,0,0,0,0,2020-11-05,Male,31,25-34,7
13,0,1,0,1,2020-11-09,Female,31,25-34,8
13,4,1,0,5,2020-11-09,Female,3,1-4,2
13,0,0,0,0,2020-11-06,Female,65,65-69,10
13,2,0,0,2,2020-11-05,Male,42,35-44,10
13,1,0,0,1,2020-11-09,Male,40,35-44,5
13,0,1,0,1,2020-11-06,Female,68,65-69,13
13,0,1,0,1,2020-11-05,Female,72,70-74,10
13,1,1,0,2,2020-11-06,Male,72,70-74,4
13,0,0,0,0,2020-11-09,Male,60,55-64,10
13,2,0,0,2,2020-11-05,Male,27,25-34,8
13,0,0,0,0,2020-11-10,Male,5,5-9,9
13,1,0,0,1,2020-11-05,Female,48,45-54,9
13,1,0,0,1,2020-11-06,Male,69,65-69,12
13,2,0,0,2,2020-11-06,Female,66,65-69,10
13,1,2,0,3,2020-11-05,Male,68,65-69,11
13,1,0,0,1,2020-11-07,Male,61,55-64,9
13,3,2,7,12,2020-11-10,Male,17,15-19,5
13,0,0,0,0,2020-11-05,Male,34,25-34,9
13,1,0,0,1,2020-11-05,Female,78,75-79,10
13,0,0,0,0,2020-11-06,Female,56,55-64,12
13,3,0,0,3,2020-11-07,Female,53,45-54,10
13,3,0,0,3,2020-11-06,Female,3,1-4,9
13,1,1,0,2,2020-11-05,Male,66,65-69,9
13,1,0,0,1,2020-11-07,Male,55,55-64,8
13,3,0,0,3,2020-11-06,Male,8,5-9,7
13,1,0,0,1,2020-11-05,Male,42,35-44,6
13,0,0,0,0,2020-11-09,Female,53,45-54,7
13,0,0,0,0,2020-11-06,Female,55,55-64,8
13,0,0,0,0,2020-11-05,Female,61,55-64,13
13,3,0,0,3,2020-11-09,Female,2,1-4,9
13,2,1,0,3,2020-11-09,Female,59,55-64,10
13,3,1,0,4,2020-11-08,Male,7,5-9,6
13,4,0,0,4,2020-11-06,Female,54,45-54,8
13,2,0,0,2,2020-11-05,Female,56,55-64,9
13,1,2,0,3,2020-11-05,Female,60,55-64,12
13,2,0,0,2,2020-11-06,Male,60,55-64,10
13,0,1,0,1,2020-11-05,Male,70,70-74,13
13,3,1,0,4,2020-11-07,Male,47,45-54,4
13,0,2,0,2,2020-11-06,Female,54,45-54,8
13,1,0,0,1,2020-11-06,Male,61,55-64,6
13,1,0,0,1,2020-11-05,Female,51,45-54,12
13,1,0,0,1,2020-11-06,Male,69,65-69,7
13,3,3,0,6,2020-11-05,Male,71,70-74,8
13,2,1,0,3,2020-11-05,Male,77,75-79,8
13,2,3,0,5,2020-11-09,Female,67,65-69,7
13,2,1,0,3,2020-11-05,Male,52,45-54,6
13,1,1,0,2,2020-11-06,Male,69,65-69,10
13,2,1,0,3,2020-11-09,Female,19,15-19,9
13,0,0,0,0,2020-11-05,Male,52,45-54,13
13,1,0,0,1,2020-11-06,Female,65,65-69,12
13,1,0,0,1,2020-11-05,Female,47,45-54,7
13,0,4,0,4,2020-11-06,Female,37,35-44,11
13,3,0,0,3,2020-11-07,Female,13,10-14,4
13,4,1,0,5,2020-11-05,Male,11,10-14,5
13,2,0,0,2,2020-11-05,Male,11,10-14,4
13,1,1,0,2,2020-11-06,Male,59,55-64,7
13,1,0,0,1,2020-11-05,Male,21,20-24,10
13,0,1,0,1,2020-11-05,Male,64,55-64,10
13,0,0,0,0,2020-11-10,Male,37,35-44,10
13,3,0,0,3,2020-11-06,Female,2,1-4,7
13,2,2,0,4,2020-11-05,Female,53,45-54,9
13,2,0,0,2,2020-11-06,Male,64,55-64,8
13,2,0,0,2,2020-11-09,Male,51,45-54,7
13,2,0,0,2,2020-11-05,Male,74,70-74,7
13,2,5,0,7,2020-11-07,Female,51,45-54,7
13,2,2,0,4,2020-11-05,Female,73,70-74,5
13,1,5,0,6,2020-11-05,Female,19,15-19,10
13,0,3,0,3,2020-11-06,Male,61,55-64,10
13,1,0,0,1,2020-11-08,Male,53,45-54,5
13,1,0,0,1,2020-11-05,Male,54,45-54,9
13,3,1,0,4,2020-11-10,Male,28,25-34,8
13,2,1,0,3,2020-11-05,Female,65,65-69,11
13,1,0,0,1,2020-11-05,Male,61,55-64,10
13,3,0,0,3,2020-11-06,Male,18,15-19,12
13,4,0,0,4,2020-11-05,Male,18,15-19,3
13,0,1,0,1,2020-11-05,Male,52,45-54,8
13,1,1,0,2,2020-11-05,Female,50,45-54,9
13,0,1,0,1,2020-11-07,Female,61,55-64,10
13,0,0,0,0,2020-11-05,Male,12,10-14,12
13,0,0,0,0,2020-11-06,Male,40,35-44,9
13,3,4,0,7,2020-11-07,Female,59,55-64,4
13,2,1,0,3,2020-11-09,Female,68,65-69,7
13,0,0,0,0,2020-11-10,Female,43,35-44,5
13,2,0,10,12,2020-11-05,Male,32,25-34,5
13,0,0,0,0,2020-11-05,Female,66,65-69,12
13,0,1,0,1,2020-11-05,Male,64,55-64,4
13,2,1,0,3,2020-11-07,Male,67,65-69,10
13,0,0,0,0,2020-11-05,Male,37,35-44,11
13,0,1,1,2,2020-11-07,Female,24,20-24,7
13,1,5,0,6,2020-11-09,Female,64,55-64,8
13,0,0,0,0,2020-11-06,Female,65,65-69,4
13,0,0,0,0,2020-11-06,Female,67,65-69,12
13,0,0,0,0,2020-11-05,Female,43,35-44,7
13,1,0,0,1,2020-11-10,Female,40,35-44,9
13,0,0,0,0,2020-11-05,Female,67,65-69,10
13,1,1,0,2,2020-11-07,Male,37,35-44,5
13,1,0,0,1,2020-11-05,Female,37,35-44,8
13,0,2,0,2,2020-11-10,Female,46,45-54,3
13,1,0,0,1,2020-11-08,Female,33,25-34,11
13,0,0,0,0,2020-11-06,Male,66,65-69,11
13,1,0,0,1,2020-11-07,Female,51,45-54,12
13,0,0,0,0,2020-11-05,Female,23,20-24,11
13,4,2,0,6,2020-11-07,Female,54,45-54,4
13,1,0,0,1,2020-11-05,Female,15,15-19,9
13,0,0,0,0,2020-11-05,Female,43,35-44,8
13,1,0,0,1,2020-11-05,Male,66,65-69,6
13,2,0,0,2,2020-11-07,Female,62,55-64,10
13,0,4,0,4,2020-11-06,Female,51,45-54,8
13,0,0,0,0,2020-11-06,Female,67,65-69,10
13,1,0,0,1,2020-11-05,Female,72,70-74,10
13,1,0,0,1,2020-11-05,Male,36,35-44,4
13,0,0,0,0,2020-11-06,Male,58,55-64,12
13,2,1,0,3,2020-11-06,Female,14,10-14,8
13,1,0,0,1,2020-11-05,Male,79,75-79,9
13,2,2,0,4,2020-11-06,Female,6,5-9,9
13,2,2,0,4,2020-11-05,Female,62,55-64,8
13,0,0,0,0,2020-11-05,Female,52,45-54,8
13,2,0,0,2,2020-11-06,Male,68,65-69,10
13,2,1,0,3,2020-11-10,Female,61,55-64,6
13,1,0,0,1,2020-11-06,Female,61,55-64,8
13,1,3,0,4,2020-11-05,Male,68,65-69,8
13,1,2,30,33,2020-11-05,Male,64,55-64,13
13,2,0,0,2,2020-11-05,Male,73,70-74,10
13,1,0,0,1,2020-11-07,Female,64,55-64,10
13,2,1,0,3,2020-11-06,Male,54,45-54,9
13,0,6,0,6,2020-11-06,Female,66,65-69,10
13,0,0,0,0,2020-11-07,Male,18,15-19,3
13,0,3,0,3,2020-11-06,Female,71,70-74,11
13,2,4,0,6,2020-11-07,Female,72,70-74,10
13,1,1,0,2,2020-11-06,Female,49,45-54,12
13,3,0,0,3,2020-11-06,Female,59,55-64,11
13,0,0,0,0,2020-11-06,Female,33,25-34,9
13,2,1,0,3,2020-11-06,Female,1,1-4,6
13,2,0,0,2,2020-11-05,Female,51,45-54,8
13,0,0,0,0,2020-11-06,Female,40,35-44,12
13,4,0,0,4,2020-11-05,Male,22,20-24,13
13,0,0,0,0,2020-11-05,Male,55,55-64,12
13,0,0,0,0,2020-11-05,Male,23,20-24,8
13,0,4,0,4,2020-11-06,Female,36,35-44,12
13,3,5,0,8,2020-11-05,Female,6,5-9,9
13,1,1,0,2,2020-11-06,Male,55,55-64,10
13,2,2,0,4,2020-11-06,Male,62,55-64,11
13,2,1,0,3,2020-11-05,Female,20,20-24,3
13,3,1,0,4,2020-11-08,Male,16,15-19,10
13,2,2,0,4,2020-11-09,Female,56,55-64,8
13,0,1,0,1,2020-11-05,Female,10,10-14,9
13,0,0,0,0,2020-11-06,Female,85,85+,4
13,0,0,0,0,2020-11-06,Female,70,70-74,11
13,1,5,0,6,2020-11-10,Male,74,70-74,13
13,1,0,0,1,2020-11-06,Female,66,65-69,10
13,3,1,0,4,2020-11-06,Male,13,10-14,11
13,1,3,0,4,2020-11-05,Male,73,70-74,10
13,0,0,0,0,2020-11-05,Female,37,35-44,10
13,3,0,0,3,2020-11-06,Female,5,5-9,6
13,1,0,0,1,2020-11-06,Female,60,55-64,11
13,1,0,0,1,2020-11-06,Female,66,65-69,8
13,1,0,0,1,2020-11-09,Male,67,65-69,11
13,3,0,0,3,2020-11-06,Female,11,10-14,10
13,1,7,0,8,2020-11-09,Male,71,70-74,4
13,1,0,0,1,2020-11-05,Female,51,45-54,8
13,3,3,0,6,2020-11-09,Female,11,10-14,6
13,2,0,4,6,2020-11-06,Female,50,45-54,4
13,0,0,0,0,2020-11-07,Male,21,20-24,9
13,1,0,0,1,2020-11-05,Male,65,65-69,12
13,1,2,0,3,2020-11-05,Female,29,25-34,9
13,0,1,0,1,2020-11-05,Male,31,25-34,8
13,4,0,0,4,2020-11-05,Female,13,10-14,8
13,3,1,0,4,2020-11-05,Female,65,65-69,12
13,2,1,0,3,2020-11-06,Female,66,65-69,11
13,0,2,0,2,2020-11-09,Female,75,75-79,11
13,0,0,0,0,2020-11-07,Female,37,35-44,8
13,2,0,0,2,2020-11-06,Female,44,35-44,6
13,0,0,0,0,2020-11-05,Male,32,25-34,11
13,3,0,0,3,2020-11-06,Male,17,15-19,11
13,2,2,0,4,2020-11-05,Female,23,20-24,10
13,0,0,0,0,2020-11-05,Male,18,15-19,10
13,1,3,0,4,2020-11-05,Male,65,65-69,11
13,3,0,0,3,2020-11-06,Female,13,10-14,13
13,0,8,0,8,2020-11-05,Female,65,65-69,7
13,1,0,0,1,2020-11-05,Male,76,75-79,9
13,1,0,0,1,2020-11-05,Male,21,20-24,3
13,1,0,0,1,2020-11-07,Male,58,55-64,7
13,1,0,0,1,2020-11-07,Male,62,55-64,13
13,2,0,0,2,2020-11-06,Male,66,65-69,11
13,0,0,0,0,2020-11-09,Female,37,35-44,3
13,0,0,0,0,2020-11-05,Male,27,25-34,8
13,1,1,0,2,2020-11-07,Female,43,35-44,12
13,0,0,0,0,2020-11-08,Male,67,65-69,6
13,1,5,0,6,2020-11-09,Female,62,55-64,8
13,1,0,0,1,2020-11-09,Female,30,25-34,7
13,1,0,0,1,2020-11-05,Female,53,45-54,11
13,0,0,0,0,2020-11-05,Female,24,20-24,4
13,0,0,0,0,2020-11-09,Male,54,45-54,7
13,0,1,0,1,2020-11-05,Male,75,75-79,3
13,1,0,0,1,2020-11-05,Female,48,45-54,11
13,0,0,0,0,2020-11-09,Male,19,15-19,5
13,0,0,0,0,2020-11-05,Female,73,70-74,5
13,0,0,0,0,2020-11-07,Female,13,10-14,6
13,1,0,0,1,2020-11-09,Male,66,65-69,9
13,1,0,0,1,2020-11-05,Male,30,25-34,6
13,0,0,0,0,2020-11-05,Female,24,20-24,12
13,0,0,0,0,2020-11-09,Female,21,20-24,10
13,1,0,0,1,2020-11-05,Male,40,35-44,10
13,0,0,0,0,2020-11-06,Male,34,25-34,11
13,1,0,0,1,2020-11-06,Male,62,55-64,10
13,0,0,0,0,2020-11-06,Female,68,65-69,8
13,1,0,0,1,2020-11-05,Male,67,65-69,11
13,2,0,0,2,2020-11-05,Male,6,5-9,13
13,1,12,0,13,2020-11-05,Female,24,20-24,7
13,1,1,0,2,2020-11-05,Female,10,10-14,7
13,0,0,0,0,2020-11-07,Male,55,55-64,10
13,1,2,0,3,2020-11-05,Male,70,70-74,8
13,1,1,0,2,2020-11-05,Female,47,45-54,12
13,2,0,0,2,2020-11-06,Female,60,55-64,10
13,5,0,0,5,2020-11-05,Female,33,25-34,7
13,2,0,0,2,2020-11-05,Male,64,55-64,10
13,3,0,0,3,2020-11-06,Female,19,15-19,9
13,1,0,0,1,2020-11-05,Male,1,1-4,3
13,2,0,0,2,2020-11-06,Female,63,55-64,11
13,2,2,0,4,2020-11-06,Female,67,65-69,5
13,0,1,0,1,2020-11-09,Female,70,70-74,7
13,1,0,0,1,2020-11-07,Male,45,45-54,8
13,0,1,0,1,2020-11-09,Female,34,25-34,9
13,2,1,0,3,2020-11-09,Female,33,25-34,11
13,0,0,0,0,2020-11-05,Male,58,55-64,13
13,2,0,0,2,2020-11-05,Male,64,55-64,13
13,0,1,0,1,2020-11-05,Female,62,55-64,11
13,1,0,0,1,2020-11-05,Female,63,55-64,11
13,0,0,0,0,2020-11-06,Female,43,35-44,10
13,2,1,0,3,2020-11-06,Female,68,65-69,13
13,1,0,0,1,2020-11-05,Male,52,45-54,9
13,2,10,0,12,2020-11-05,Male,50,45-54,11
13,0,0,0,0,2020-11-06,Female,63,55-64,8
13,1,4,0,5,2020-11-06,Female,67,65-69,11
13,0,0,0,0,2020-11-09,Male,19,15-19,13
13,1,0,0,1,2020-11-06,Male,60,55-64,12
13,2,0,0,2,2020-11-07,Female,38,35-44,10
13,3,0,0,3,2020-11-06,Male,11,10-14,6
13,0,0,0,0,2020-11-05,Male,33,25-34,10
13,3,16,0,19,2020-11-07,Male,9,5-9,5
13,0,0,0,0,2020-11-06,Male,42,35-44,11
13,1,2,0,3,2020-11-05,Male,68,65-69,13
13,0,0,0,0,2020-11-05,Male,11,10-14,10
13,2,0,0,2,2020-11-06,Male,76,75-79,8
13,1,0,0,1,2020-11-07,Female,58,55-64,13
13,0,0,0,0,2020-11-05,Female,25,25-34,8
13,2,0,0,2,2020-11-07,Female,32,25-34,9
13,0,0,0,0,2020-11-05,Female,14,10-14,12
13,1,0,0,1,2020-11-10,Female,26,25-34,7
13,1,1,0,2,2020-11-06,Female,66,65-69,5
13,0,0,0,0,2020-11-05,Female,68,65-69,7
13,1,0,0,1,2020-11-06,Female,34,25-34,9
13,0,1,0,1,2020-11-09,Female,19,15-19,7
13,2,0,0,2,2020-11-05,Male,24,20-24,5
13,0,0,0,0,2020-11-07,Male,32,25-34,8
13,0,2,0,2,2020-11-10,Female,39,35-44,8
13,2,1,0,3,2020-11-09,Male,17,15-19,7
13,1,0,0,1,2020-11-05,Male,51,45-54,10
13,1,0,0,1,2020-11-09,Male,46,45-54,5
13,0,3,0,3,2020-11-05,Male,49,45-54,9
13,0,2,15,17,2020-11-05,Female,21,20-24,4
13,0,0,0,0,2020-11-06,Female,34,25-34,11
13,0,12,0,12,2020-11-08,Male,30,25-34,3
13,0,1,0,1,2020-11-06,Female,67,65-69,5
13,1,1,0,2,2020-11-05,Male,45,45-54,9
13,0,4,0,4,2020-11-06,Female,65,65-69,9
13,1,2,0,3,2020-11-05,Female,70,70-74,2
13,0,0,0,0,2020-11-05,Female,19,15-19,5
13,0,0,0,0,2020-11-05,Female,52,45-54,9
13,3,0,0,3,2020-11-08,Male,26,25-34,7
13,3,0,0,3,2020-11-09,Female,13,10-14,8
13,0,1,0,1,2020-11-06,Female,27,25-34,10
13,0,0,0,0,2020-11-06,Female,67,65-69,11
13,2,0,0,2,2020-11-06,Female,67,65-69,5
13,0,1,0,1,2020-11-07,Female,69,65-69,11
13,4,7,0,11,2020-11-05,Female,28,25-34,6
13,4,2,0,6,2020-11-05,Male,5,5-9,7
13,5,0,0,5,2020-11-06,Male,13,10-14,11
13,2,3,0,5,2020-11-05,Female,55,55-64,9
13,2,0,0,2,2020-11-05,Male,48,45-54,12
13,0,0,0,0,2020-11-09,Female,52,45-54,12
13,4,0,0,4,2020-11-09,Female,20,20-24,3
13,0,1,0,1,2020-11-06,Male,48,45-54,9
13,1,0,0,1,2020-11-05,Male,63,55-64,9
13,1,0,0,1,2020-11-05,Male,35,35-44,9
13,1,0,0,1,2020-11-05,Male,49,45-54,10
13,2,1,0,3,2020-11-09,Female,51,45-54,5
13,0,0,1,1,2020-11-06,Female,53,45-54,8
13,2,0,0,2,2020-11-05,Male,68,65-69,11
13,2,0,0,2,2020-11-05,Female,48,45-54,11
13,3,2,0,5,2020-11-10,Male,85,85+,8
13,1,0,0,1,2020-11-06,Female,51,45-54,7
13,1,2,0,3,2020-11-09,Female,54,45-54,10
13,2,1,0,3,2020-11-06,Male,14,10-14,6
13,2,3,0,5,2020-11-05,Female,71,70-74,5
13,0,1,0,1,2020-11-06,Male,47,45-54,8
13,2,0,0,2,2020-11-06,Female,66,65-69,8
13,0,0,0,0,2020-11-05,Male,50,45-54,13
13,3,0,0,3,2020-11-05,Male,0,<1,3
13,1,4,0,5,2020-11-08,Male,21,20-24,3
13,0,0,0,0,2020-11-06,Male,23,20-24,8
13,0,1,0,1,2020-11-05,Female,70,70-74,3
13,0,0,4,4,2020-11-05,Male,28,25-34,10
13,0,1,0,1,2020-11-09,Female,28,25-34,6
13,2,0,0,2,2020-11-05,Male,74,70-74,12
13,2,2,2,6,2020-11-08,Female,14,10-14,6
13,0,1,0,1,2020-11-09,Male,30,25-34,10
13,2,0,0,2,2020-11-07,Male,66,65-69,10
13,0,0,0,0,2020-11-09,Male,43,35-44,11
13,0,0,0,0,2020-11-10,Female,20,20-24,3
13,2,0,0,2,2020-11-08,Female,79,75-79,10
13,0,2,0,2,2020-11-06,Female,20,20-24,3
13,1,0,0,1,2020-11-06,Female,70,70-74,11
13,0,5,0,5,2020-11-05,Female,69,65-69,13
13,1,1,0,2,2020-11-06,Male,71,70-74,11
13,0,0,0,0,2020-11-09,Female,36,35-44,8
13,0,0,0,0,2020-11-05,Male,10,10-14,6
13,0,0,0,0,2020-11-05,Male,61,55-64,12
13,4,2,0,6,2020-11-10,Female,13,10-14,9
13,0,2,0,2,2020-11-07,Male,66,65-69,5
13,1,7,0,8,2020-11-05,Female,30,25-34,11
13,1,0,0,1,2020-11-05,Female,9,5-9,10
13,3,0,0,3,2020-11-05,Male,14,10-14,9
13,0,0,0,0,2020-11-05,Male,34,25-34,12
13,0,0,0,0,2020-11-05,Male,18,15-19,6
13,3,1,0,4,2020-11-07,Male,1,1-4,3
13,2,0,0,2,2020-11-05,Male,19,15-19,9
14,0,0,0,0,2020-11-29,Male,60,55-64,10
14,1,1,0,2,2020-11-26,Male,68,65-69,9
14,1,1,0,2,2020-11-27,Female,58,55-64,9
14,2,0,0,2,2020-11-27,Female,69,65-69,9
14,2,0,0,2,2020-11-26,Female,66,65-69,14
14,0,1,2,3,2020-11-27,Female,71,70-74,10
14,2,2,0,4,2020-11-30,Female,4,1-4,1
14,0,0,0,0,2020-11-26,Female,50,45-54,10
14,1,0,0,1,2020-11-26,Female,72,70-74,14
14,0,0,0,0,2020-11-27,Male,30,25-34,11
14,0,2,0,2,2020-11-27,Male,34,25-34,14
14,0,0,0,0,2020-11-30,Female,34,25-34,1
14,1,0,0,1,2020-11-27,Female,59,55-64,10
14,1,2,0,3,2020-11-28,Female,61,55-64,8
14,0,0,0,0,2020-11-29,Male,51,45-54,11
14,1,0,0,1,2020-11-27,Male,50,45-54,9
14,0,2,0,2,2020-11-25,Female,35,35-44,11
14,2,0,0,2,2020-11-27,Male,1,1-4,3
14,0,0,0,0,2020-11-26,Male,42,35-44,8
14,0,0,0,0,2020-11-27,Male,32,25-34,12
14,1,2,0,3,2020-11-26,Male,66,65-69,8
14,0,0,0,0,2020-11-29,Male,66,65-69,9
14,0,3,0,3,2020-11-27,Male,62,55-64,14
14,1,0,0,1,2020-11-25,Male,9,5-9,9
14,1,1,0,2,2020-11-27,Male,15,15-19,12
14,0,2,0,2,2020-11-26,Male,48,45-54,11
14,2,0,0,2,2020-11-25,Male,58,55-64,9
14,2,0,0,2,2020-11-30,Male,51,45-54,1
14,1,0,0,1,2020-11-26,Male,35,35-44,9
14,0,0,0,0,2020-11-27,Male,53,45-54,9
14,1,0,0,1,2020-11-26,Female,70,70-74,13
14,0,0,0,0,2020-11-26,Male,68,65-69,13
14,0,0,0,0,2020-11-28,Male,20,20-24,9
14,2,0,18,20,2020-11-30,Female,14,10-14,1
14,3,1,0,4,2020-11-29,Female,52,45-54,10
14,1,2,0,3,2020-11-26,Female,69,65-69,11
14,0,0,0,0,2020-11-25,Male,41,35-44,14
14,1,2,0,3,2020-11-27,Female,56,55-64,14
14,2,0,0,2,2020-11-26,Female,21,20-24,12
14,2,0,0,2,2020-11-26,Male,52,45-54,12
14,0,0,0,0,2020-11-27,Male,85,85+,12
14,0,0,0,0,2020-11-29,Female,61,55-64,11
14,2,0,0,2,2020-11-26,Female,5,5-9,5
14,0,0,0,0,2020-11-25,Male,17,15-19,8
14,1,0,0,1,2020-11-27,Male,58,55-64,12
14,0,0,0,0,2020-11-26,Male,67,65-69,14
14,0,0,0,0,2020-11-25,Male,51,45-54,9
14,1,0,0,1,2020-11-27,Male,72,70-74,7
14,0,2,0,2,2020-11-27,Male,76,75-79,10
14,0,0,0,0,2020-11-30,Male,26,25-34,1
14,1,2,0,3,2020-11-26,Male,71,70-74,12
14,0,0,1,1,2020-11-29,Male,52,45-54,13
14,0,0,0,0,2020-11-27,Male,53,45-54,8
14,1,0,0,1,2020-11-27,Male,43,35-44,8
14,3,3,0,6,2020-11-27,Male,43,35-44,8
14,0,0,0,0,2020-11-28,Female,60,55-64,10
14,0,0,0,0,2020-11-25,Male,3,1-4,8
14,1,0,0,1,2020-11-25,Male,41,35-44,11
14,2,0,0,2,2020-11-27,Male,69,65-69,11
14,0,1,0,1,2020-11-28,Female,77,75-79,11
14,4,1,0,5,2020-11-25,Male,3,1-4,7
14,1,0,0,1,2020-11-30,Female,27,25-34,1
14,1,0,0,1,2020-11-26,Female,67,65-69,11
14,0,4,0,4,2020-11-27,Female,52,45-54,8
14,1,1,0,2,2020-11-25,Male,63,55-64,11
14,0,0,0,0,2020-11-27,Male,72,70-74,7
14,2,0,0,2,2020-11-30,Female,19,15-19,1
14,0,2,0,2,2020-11-27,Male,85,85+,9
14,2,3,0,5,2020-11-25,Male,54,45-54,13
14,1,0,0,1,2020-11-25,Male,70,70-74,11
14,1,0,0,1,2020-11-28,Female,71,70-74,10
14,2,0,0,2,2020-11-26,Male,66,65-69,8
14,1,4,0,5,2020-11-26,Female,65,65-69,13
14,2,1,0,3,2020-11-30,Female,22,20-24,1
14,1,0,0,1,2020-11-26,Male,67,65-69,13
14,4,0,0,4,2020-11-26,Female,14,10-14,7
14,1,2,0,3,2020-11-26,Male,67,65-69,11
14,2,0,0,2,2020-11-26,Male,70,70-74,5
14,7,0,0,7,2020-11-26,Female,16,15-19,8
14,0,0,0,0,2020-11-26,Male,43,35-44,10
14,3,0,0,3,2020-11-27,Female,5,5-9,10
14,1,1,0,2,2020-11-27,Female,43,35-44,7
14,0,5,0,5,2020-11-30,Female,24,20-24,1
14,4,0,0,4,2020-11-27,Male,19,15-19,4
14,1,2,0,3,2020-11-26,Male,69,65-69,14
14,2,0,0,2,2020-11-26,Female,60,55-64,12
14,1,0,0,1,2020-11-28,Male,31,25-34,9
14,0,3,0,3,2020-11-27,Female,52,45-54,12
14,2,2,0,4,2020-11-26,Male,22,20-24,4
14,0,2,0,2,2020-11-26,Male,69,65-69,9
14,1,0,0,1,2020-11-26,Female,66,65-69,7
14,0,0,0,0,2020-11-27,Female,63,55-64,12
14,0,0,1,1,2020-11-29,Female,28,25-34,10
14,1,0,0,1,2020-11-25,Female,29,25-34,5
14,1,0,0,1,2020-11-27,Female,31,25-34,13
14,0,0,0,0,2020-11-26,Female,62,55-64,12
14,0,0,0,0,2020-11-27,Female,47,45-54,10
14,0,0,0,0,2020-11-26,Male,68,65-69,9
14,0,0,0,0,2020-11-27,Male,54,45-54,11
14,2,0,0,2,2020-11-27,Male,29,25-34,8
14,1,1,0,2,2020-11-27,Male,57,55-64,10
14,1,0,0,1,2020-11-28,Female,73,70-74,11
14,0,1,0,1,2020-11-26,Male,32,25-34,14
14,0,0,0,0,2020-11-27,Male,65,65-69,9
14,2,0,0,2,2020-11-29,Male,27,25-34,4
14,0,0,0,0,2020-11-26,Female,30,25-34,8
14,0,0,0,0,2020-11-25,Male,35,35-44,4
14,0,0,0,0,2020-11-30,Female,22,20-24,1
14,0,3,0,3,2020-11-29,Female,33,25-34,11
14,1,2,0,3,2020-11-27,Female,62,55-64,11
14,1,1,0,2,2020-11-30,Female,22,20-24,1
14,1,1,0,2,2020-11-26,Male,65,65-69,9
14,0,0,0,0,2020-11-26,Male,63,55-64,12
14,3,1,1,5,2020-11-28,Male,8,5-9,5
14,0,1,0,1,2020-11-26,Female,26,25-34,9
14,0,2,0,2,2020-11-26,Male,69,65-69,9
14,2,0,0,2,2020-11-27,Male,42,35-44,9
14,2,0,0,2,2020-11-26,Male,58,55-64,13
14,2,0,0,2,2020-11-27,Female,41,35-44,5
14,0,0,0,0,2020-11-26,Female,62,55-64,10
14,3,3,0,6,2020-11-27,Female,69,65-69,9
14,0,0,0,0,2020-11-26,Male,69,65-69,10
14,3,0,0,3,2020-11-25,Male,24,20-24,6
14,2,0,0,2,2020-11-26,Male,18,15-19,9
14,3,0,0,3,2020-11-25,Female,10,10-14,11
14,1,0,0,1,2020-11-27,Male,65,65-69,12
14,0,0,0,0,2020-11-26,Male,56,55-64,11
14,1,0,0,1,2020-11-27,Female,28,25-34,11
14,2,2,0,4,2020-11-25,Female,66,65-69,10
14,2,24,0,26,2020-11-26,Female,56,55-64,9
14,1,1,0,2,2020-11-26,Male,27,25-34,6
14,1,2,0,3,2020-11-27,Male,70,70-74,11
14,2,4,0,6,2020-11-26,Male,31,25-34,14
14,0,0,0,0,2020-11-26,Female,52,45-54,13
14,0,0,0,0,2020-11-25,Male,28,25-34,10
14,3,0,0,3,2020-11-28,Male,5,5-9,9
14,0,0,0,0,2020-11-30,Female,32,25-34,1
14,3,0,0,3,2020-11-26,Male,65,65-69,10
14,1,3,0,4,2020-11-30,Female,24,20-24,1
14,1,1,0,2,2020-11-27,Female,58,55-64,11
14,0,0,0,0,2020-11-26,Female,66,65-69,13
14,1,0,0,1,2020-11-28,Female,42,35-44,5
14,1,0,0,1,2020-11-27,Female,60,55-64,10
14,0,1,2,3,2020-11-27,Male,70,70-74,14
14,2,0,0,2,2020-11-26,Male,21,20-24,10
14,0,0,0,0,2020-11-28,Female,71,70-74,9
14,1,5,0,6,2020-11-27,Male,74,70-74,12
14,0,1,0,1,2020-11-27,Female,65,65-69,9
14,0,0,0,0,2020-11-26,Male,50,45-54,8
14,2,0,0,2,2020-11-26,Female,31,25-34,10
14,0,0,0,0,2020-11-27,Male,54,45-54,10
14,1,0,0,1,2020-11-25,Male,51,45-54,11
14,1,0,0,1,2020-11-26,Female,49,45-54,10
14,0,0,0,0,2020-11-25,Male,14,10-14,9
14,2,2,0,4,2020-11-27,Male,15,15-19,10
14,0,1,0,1,2020-11-26,Male,65,65-69,8
14,1,1,0,2,2020-11-26,Male,68,65-69,11
14,1,0,0,1,2020-11-28,Female,58,55-64,12
14,0,0,0,0,2020-11-30,Male,2,1-4,1
14,0,0,0,0,2020-11-26,Male,50,45-54,12
14,0,0,0,0,2020-11-27,Male,12,10-14,11
14,0,0,0,0,2020-11-27,Male,40,35-44,8
14,2,0,0,2,2020-11-25,Female,69,65-69,14
14,0,0,0,0,2020-11-28,Male,38,35-44,8
14,1,0,0,1,2020-11-26,Female,34,25-34,4
14,0,0,0,0,2020-11-26,Male,20,20-24,8
14,0,0,0,0,2020-11-26,Female,7,5-9,9
14,0,0,0,0,2020-11-28,Male,21,20-24,4
14,2,0,0,2,2020-11-28,Female,73,70-74,7
14,0,4,0,4,2020-11-25,Male,51,45-54,8
14,1,0,0,1,2020-11-27,Female,57,55-64,11
14,1,0,0,1,2020-11-27,Female,59,55-64,14
14,0,0,0,0,2020-11-26,Male,43,35-44,13
14,2,0,0,2,2020-11-27,Female,63,55-64,10
14,0,3,10,13,2020-11-30,Male,14,10-14,1
14,1,0,0,1,2020-11-26,Female,23,20-24,7
14,2,0,0,2,2020-11-27,Male,73,70-74,11
14,0,0,0,0,2020-11-30,Female,31,25-34,1
14,2,5,0,7,2020-11-25,Female,52,45-54,13
14,2,3,0,5,2020-11-26,Male,69,65-69,10
14,1,0,0,1,2020-11-27,Male,34,25-34,13
14,0,0,0,0,2020-11-27,Male,48,45-54,9
14,3,1,0,4,2020-11-26,Male,69,65-69,9
14,0,0,0,0,2020-11-28,Male,65,65-69,13
14,3,0,0,3,2020-11-25,Male,7,5-9,10
14,1,4,0,5,2020-11-26,Male,68,65-69,13
14,0,5,0,5,2020-11-27,Male,61,55-64,10
14,0,0,0,0,2020-11-30,Female,28,25-34,1
14,1,0,0,1,2020-11-27,Male,70,70-74,9
14,0,0,0,0,2020-11-28,Male,43,35-44,7
14,0,0,0,0,2020-11-25,Female,56,55-64,12
14,0,1,0,1,2020-11-25,Female,58,55-64,10
14,3,11,0,14,2020-11-26,Male,23,20-24,4
14,0,0,0,0,2020-11-26,Female,66,65-69,13
14,0,0,0,0,2020-11-30,Female,40,35-44,13
14,0,0,0,0,2020-11-25,Male,44,35-44,7
14,0,5,0,5,2020-11-27,Female,25,25-34,6
14,0,0,0,0,2020-11-27,Female,63,55-64,9
14,1,1,0,2,2020-11-25,Female,61,55-64,14
14,1,2,0,3,2020-11-29,Male,61,55-64,8
14,0,0,0,0,2020-11-27,Male,49,45-54,9
14,1,2,0,3,2020-11-25,Female,54,45-54,14
14,0,0,0,0,2020-11-25,Male,34,25-34,10
14,0,1,0,1,2020-11-27,Male,56,55-64,10
14,0,0,0,0,2020-11-27,Female,65,65-69,14
14,1,0,0,1,2020-11-27,Male,73,70-74,12
14,3,1,0,4,2020-11-27,Female,6,5-9,8
14,2,0,0,2,2020-11-30,Male,10,10-14,1
14,1,0,0,1,2020-11-27,Male,79,75-79,9
14,0,1,0,1,2020-11-26,Female,67,65-69,9
14,0,0,0,0,2020-11-26,Male,38,35-44,10
14,2,0,0,2,2020-11-27,Female,70,70-74,4
14,1,2,0,3,2020-11-27,Male,48,45-54,8
14,1,0,0,1,2020-11-26,Male,69,65-69,12
14,2,1,0,3,2020-11-26,Male,19,15-19,9
14,1,3,0,4,2020-11-30,Female,32,25-34,5
14,0,2,0,2,2020-11-25,Male,36,35-44,14
14,2,2,0,4,2020-11-28,Female,49,45-54,7
14,2,0,0,2,2020-11-26,Male,65,65-69,5
14,1,5,0,6,2020-11-27,Male,40,35-44,14
14,2,0,0,2,2020-11-30,Female,61,55-64,11
14,0,0,0,0,2020-11-28,Male,32,25-34,11
14,2,0,0,2,2020-11-27,Male,62,55-64,13
14,0,2,0,2,2020-11-26,Female,68,65-69,9
14,4,1,0,5,2020-11-26,Female,23,20-24,8
14,1,2,0,3,2020-11-26,Male,68,65-69,7
14,0,0,0,0,2020-11-26,Male,6,5-9,10
14,1,0,0,1,2020-11-27,Female,33,25-34,10
14,0,0,0,0,2020-11-26,Male,68,65-69,13
14,0,1,0,1,2020-11-25,Male,28,25-34,12
14,2,0,0,2,2020-11-30,Female,22,20-24,1
14,2,16,0,18,2020-11-28,Male,9,5-9,10
14,0,3,0,3,2020-11-30,Male,31,25-34,1
14,0,0,0,0,2020-11-28,Male,47,45-54,8
14,3,2,0,5,2020-11-30,Female,2,1-4,1
14,1,2,0,3,2020-11-26,Male,52,45-54,11
14,1,3,0,4,2020-11-26,Female,69,65-69,6
14,1,10,0,11,2020-11-27,Male,32,25-34,9
14,3,0,0,3,2020-11-26,Male,69,65-69,9
14,2,0,0,2,2020-11-26,Female,69,65-69,12
14,0,0,0,0,2020-11-26,Male,19,15-19,11
14,2,0,0,2,2020-11-26,Male,65,65-69,10
14,0,1,0,1,2020-11-27,Male,49,45-54,11
14,3,1,0,4,2020-11-27,Female,66,65-69,8
14,0,0,0,0,2020-11-29,Male,50,45-54,6
14,0,0,0,0,2020-11-28,Female,60,55-64,8
14,1,0,0,1,2020-11-29,Female,65,65-69,9
14,1,0,0,1,2020-11-26,Male,66,65-69,13
14,0,0,0,0,2020-11-26,Male,65,65-69,13
14,2,1,0,3,2020-11-25,Female,67,65-69,13
14,1,0,0,1,2020-11-26,Male,68,65-69,12
14,0,0,5,5,2020-11-26,Male,40,35-44,7
14,0,2,0,2,2020-11-25,Male,65,65-69,8
14,3,0,0,3,2020-11-26,Female,19,15-19,2
14,0,2,0,2,2020-11-30,Female,26,25-34,1
14,2,0,0,2,2020-11-27,Male,70,70-74,7
14,3,0,0,3,2020-11-25,Female,18,15-19,10
14,0,4,0,4,2020-11-29,Female,47,45-54,6
14,1,0,0,1,2020-11-26,Female,61,55-64,6
14,0,0,0,0,2020-11-27,Male,14,10-14,11
14,0,0,0,0,2020-11-26,Male,52,45-54,10
14,0,0,0,0,2020-11-25,Female,51,45-54,12
14,5,0,0,5,2020-11-27,Male,11,10-14,11
14,0,0,0,0,2020-11-28,Female,60,55-64,10
14,0,0,0,0,2020-11-26,Male,30,25-34,13
14,3,3,18,24,2020-11-28,Female,4,1-4,7
14,5,3,0,8,2020-11-26,Female,5,5-9,4
14,0,0,0,0,2020-11-29,Female,58,55-64,8
14,0,0,0,0,2020-11-29,Female,12,10-14,9
14,2,1,0,3,2020-11-30,Male,26,25-34,1
14,0,0,0,0,2020-11-30,Female,50,45-54,1
14,0,0,0,0,2020-11-27,Male,49,45-54,10
14,1,0,0,1,2020-11-27,Female,52,45-54,10
14,0,1,0,1,2020-11-27,Male,24,20-24,11
14,2,0,0,2,2020-11-27,Male,71,70-74,12
14,0,0,0,0,2020-11-26,Male,35,35-44,13
14,0,0,0,0,2020-11-29,Female,21,20-24,9
14,0,0,0,0,2020-11-26,Female,34,25-34,8
14,0,0,0,0,2020-11-28,Female,23,20-24,13
14,0,0,0,0,2020-11-26,Female,66,65-69,10
14,3,0,0,3,2020-11-25,Male,23,20-24,11
14,0,0,0,0,2020-11-26,Female,9,5-9,10
14,1,0,0,1,2020-11-26,Female,67,65-69,8
14,0,0,0,0,2020-11-26,Male,67,65-69,12
14,0,0,0,0,2020-11-26,Male,22,20-24,6
14,2,0,0,2,2020-11-25,Male,41,35-44,14
14,0,0,0,0,2020-11-26,Male,65,65-69,12
14,1,0,0,1,2020-11-26,Female,29,25-34,5
14,4,11,0,15,2020-11-28,Male,49,45-54,8
14,0,0,0,0,2020-11-27,Male,71,70-74,8
14,2,0,0,2,2020-11-25,Male,58,55-64,10
14,3,0,0,3,2020-11-26,Female,67,65-69,4
14,3,0,0,3,2020-11-30,Male,13,10-14,1
14,2,0,0,2,2020-11-27,Male,75,75-79,10
14,1,0,0,1,2020-11-26,Male,79,75-79,12
14,2,0,0,2,2020-11-30,Male,54,45-54,12
14,0,0,0,0,2020-11-26,Male,63,55-64,9
14,0,1,0,1,2020-11-30,Male,20,20-24,1
14,2,1,0,3,2020-11-27,Female,24,20-24,4
14,0,2,0,2,2020-11-27,Female,26,25-34,9
14,0,1,0,1,2020-11-26,Female,68,65-69,12
14,0,2,0,2,2020-11-30,Female,28,25-34,1
14,0,1,0,1,2020-11-27,Male,28,25-34,4
14,2,1,0,3,2020-11-27,Female,78,75-79,12
14,2,0,0,2,2020-11-26,Female,66,65-69,8
14,0,1,0,1,2020-11-27,Female,64,55-64,9
14,1,0,0,1,2020-11-26,Male,69,65-69,13
14,0,0,0,0,2020-11-30,Female,33,25-34,9
14,1,2,0,3,2020-11-28,Male,37,35-44,8
14,0,10,0,10,2020-11-26,Male,29,25-34,13
14,0,1,0,1,2020-11-26,Female,71,70-74,8
14,0,0,0,0,2020-11-28,Female,40,35-44,12
14,3,2,0,5,2020-11-25,Female,52,45-54,9
14,2,0,0,2,2020-11-25,Female,52,45-54,11
14,2,0,4,6,2020-11-25,Female,16,15-19,4
14,2,0,0,2,2020-11-27,Female,66,65-69,12
14,2,0,0,2,2020-11-26,Female,78,75-79,10
14,0,0,0,0,2020-11-26,Male,66,65-69,14
14,0,0,0,0,2020-11-27,Male,42,35-44,10
14,1,0,0,1,2020-11-26,Female,69,65-69,10
14,0,0,0,0,2020-11-25,Female,76,75-79,12
14,2,1,0,3,2020-11-28,Male,37,35-44,9
14,0,0,0,0,2020-11-30,Male,26,25-34,1
14,0,0,0,0,2020-11-29,Female,48,45-54,12
14,1,1,0,2,2020-11-27,Male,61,55-64,8
14,1,0,0,1,2020-11-28,Female,51,45-54,8
14,0,0,0,0,2020-11-26,Male,10,10-14,4
14,0,0,0,0,2020-11-26,Female,18,15-19,4
14,1,0,0,1,2020-11-26,Male,68,65-69,13
14,1,2,5,8,2020-11-27,Female,54,45-54,10
14,0,0,0,0,2020-11-27,Male,62,55-64,10
14,2,3,0,5,2020-11-30,Female,1,1-4,1
14,0,0,0,0,2020-11-27,Female,65,65-69,9
14,0,1,0,1,2020-11-30,Female,32,25-34,1
14,0,0,0,0,2020-11-29,Female,33,25-34,5
14,0,0,0,0,2020-11-25,Female,60,55-64,5
14,1,0,0,1,2020-11-28,Female,61,55-64,10
14,0,2,0,2,2020-11-27,Male,51,45-54,10
14,0,0,0,0,2020-11-28,Female,49,45-54,11
14,0,0,0,0,2020-11-27,Male,74,70-74,13
14,3,6,0,9,2020-11-26,Female,16,15-19,13
14,2,0,0,2,2020-11-29,Male,66,65-69,6
14,3,0,0,3,2020-11-29,Female,11,10-14,12
14,1,1,0,2,2020-11-25,Male,31,25-34,12
14,1,3,0,4,2020-11-27,Female,70,70-74,11
14,4,0,0,4,2020-11-30,Male,6,5-9,1
14,1,1,0,2,2020-11-27,Female,13,10-14,10
14,0,0,0,0,2020-11-27,Female,65,65-69,10
14,1,1,0,2,2020-11-28,Female,26,25-34,11
14,1,1,0,2,2020-11-27,Male,73,70-74,11
14,0,0,0,0,2020-11-26,Male,30,25-34,9
14,2,0,0,2,2020-11-30,Male,0,<1,1
14,0,0,0,0,2020-11-26,Female,24,20-24,12
14,0,0,0,0,2020-11-30,Female,43,35-44,1
14,4,10,0,14,2020-11-27,Male,63,55-64,12
14,0,1,0,1,2020-11-30,Female,55,55-64,8
14,0,0,0,0,2020-11-27,Male,63,55-64,11
14,3,1,0,4,2020-11-27,Male,19,15-19,10
14,2,0,0,2,2020-11-28,Male,54,45-54,13
14,1,0,0,1,2020-11-30,Female,28,25-34,1
14,0,0,0,0,2020-11-26,Male,60,55-64,6
14,0,0,0,0,2020-11-25,Female,9,5-9,12
14,2,0,0,2,2020-11-27,Male,72,70-74,8
14,1,0,0,1,2020-11-27,Female,52,45-54,12
14,0,0,0,0,2020-11-28,Male,33,25-34,6
14,1,0,0,1,2020-11-26,Male,11,10-14,9
14,0,0,0,0,2020-11-28,Male,30,25-34,12
14,2,2,0,4,2020-11-27,Female,16,15-19,7
14,5,0,0,5,2020-11-25,Male,3,1-4,3
14,0,0,0,0,2020-11-25,Female,57,55-64,13
14,0,0,0,0,2020-11-26,Male,67,65-69,10
14,0,0,0,0,2020-11-28,Female,85,85+,10
14,0,0,0,0,2020-11-27,Male,51,45-54,11
14,0,0,0,0,2020-11-26,Male,54,45-54,11
14,0,0,0,0,2020-11-30,Female,6,5-9,11
14,2,0,0,2,2020-11-25,Male,66,65-69,13
14,1,0,0,1,2020-11-26,Male,50,45-54,10
14,0,0,0,0,2020-11-27,Female,29,25-34,10
14,0,0,0,0,2020-11-25,Male,45,45-54,11
14,0,5,0,5,2020-11-27,Male,37,35-44,7
14,2,0,0,2,2020-11-26,Female,69,65-69,9
14,1,0,0,1,2020-11-30,Male,54,45-54,7
14,0,0,0,0,2020-11-26,Female,25,25-34,7
14,1,2,0,3,2020-11-27,Female,47,45-54,7
14,0,1,0,1,2020-11-30,Female,42,35-44,1
14,0,0,0,0,2020-11-30,Female,9,5-9,1
14,1,0,0,1,2020-11-27,Male,63,55-64,12
14,1,7,0,8,2020-11-26,Male,66,65-69,11
14,2,0,0,2,2020-11-26,Male,6,5-9,13
14,0,0,0,0,2020-11-26,Female,15,15-19,6
14,3,10,0,13,2020-11-25,Male,60,55-64,11
14,0,0,0,0,2020-11-28,Male,66,65-69,8
14,0,1,0,1,2020-11-26,Male,58,55-64,13
14,2,7,0,9,2020-11-26,Female,65,65-69,14
14,1,0,0,1,2020-11-27,Male,51,45-54,6
14,2,2,0,4,2020-11-25,Female,12,10-14,9
14,0,0,0,0,2020-11-26,Female,72,70-74,5
14,4,4,0,8,2020-11-27,Male,10,10-14,14
14,1,2,0,3,2020-11-26,Male,50,45-54,12
14,0,1,0,1,2020-11-27,Male,74,70-74,14
14,0,0,0,0,2020-11-25,Male,19,15-19,4
14,0,1,0,1,2020-11-25,Female,66,65-69,9
14,0,0,0,0,2020-11-27,Male,70,70-74,9
14,1,1,0,2,2020-11-27,Male,54,45-54,12
14,0,1,0,1,2020-11-25,Female,68,65-69,13
14,0,1,0,1,2020-11-27,Male,77,75-79,10
14,0,0,0,0,2020-11-26,Male,85,85+,10
14,1,5,0,6,2020-11-28,Female,55,55-64,9
14,0,0,0,0,2020-11-25,Female,5,5-9,7
14,1,1,0,2,2020-11-29,Female,64,55-64,6
14,2,0,0,2,2020-11-25,Male,66,65-69,11
14,1,0,0,1,2020-11-26,Male,59,55-64,13
14,1,0,0,1,2020-11-26,Male,54,45-54,10
14,1,1,0,2,2020-11-28,Female,68,65-69,13
14,0,0,0,0,2020-11-27,Female,24,20-24,13
14,1,0,0,1,2020-11-25,Male,43,35-44,10
14,1,0,0,1,2020-11-29,Male,51,45-54,14
14,0,1,0,1,2020-11-26,Female,66,65-69,7
14,0,0,0,0,2020-11-25,Male,30,25-34,13
14,3,0,0,3,2020-11-26,Female,2,1-4,10
14,0,0,0,0,2020-11-26,Female,23,20-24,11
14,1,0,0,1,2020-11-25,Male,34,25-34,10
14,0,0,0,0,2020-11-25,Female,49,45-54,14
14,0,6,0,6,2020-11-25,Male,40,35-44,8
14,0,1,0,1,2020-11-26,Male,70,70-74,11
14,2,1,0,3,2020-11-26,Female,63,55-64,13
14,1,1,0,2,2020-11-27,Male,63,55-64,11
14,0,3,0,3,2020-11-30,Female,20,20-24,1
14,2,0,0,2,2020-11-26,Female,37,35-44,12
14,3,0,0,3,2020-11-26,Female,22,20-24,4
14,2,4,0,6,2020-11-27,Female,61,55-64,12
14,3,2,5,10,2020-11-30,Female,9,5-9,1
14,1,1,0,2,2020-11-27,Female,57,55-64,8
14,0,0,0,0,2020-11-27,Male,32,25-34,2
14,1,0,0,1,2020-11-26,Male,53,45-54,11
14,0,0,0,0,2020-11-27,Male,51,45-54,8
14,0,2,0,2,2020-11-26,Female,66,65-69,14
14,0,2,0,2,2020-11-27,Female,69,65-69,8
14,2,0,0,2,2020-11-30,Male,24,20-24,1
14,3,0,0,3,2020-11-26,Female,6,5-9,9
14,0,0,0,0,2020-11-26,Male,54,45-54,10
14,0,1,0,1,2020-11-27,Male,54,45-54,11
14,5,1,0,6,2020-11-26,Male,1,1-4,4
14,2,0,0,2,2020-11-26,Male,65,65-69,11
14,2,1,0,3,2020-11-26,Male,57,55-64,9
14,1,0,0,1,2020-11-26,Female,55,55-64,12
14,2,0,0,2,2020-11-27,Male,40,35-44,13
14,0,1,0,1,2020-11-25,Male,38,35-44,11
14,5,0,0,5,2020-11-29,Female,15,15-19,5
14,0,1,0,1,2020-11-28,Male,39,35-44,10
14,1,0,0,1,2020-11-30,Female,44,35-44,5
14,3,0,0,3,2020-11-26,Female,21,20-24,11
14,1,0,0,1,2020-11-30,Female,62,55-64,8
14,1,1,0,2,2020-11-30,Female,31,25-34,1
14,1,0,0,1,2020-11-27,Female,19,15-19,5
14,2,0,0,2,2020-11-29,Female,6,5-9,13
14,1,1,0,2,2020-11-26,Male,66,65-69,13
14,0,0,0,0,2020-11-30,Male,61,55-64,10
14,2,0,0,2,2020-11-25,Male,63,55-64,11
14,1,3,0,4,2020-11-27,Female,1,1-4,5
14,0,2,0,2,2020-11-25,Male,73,70-74,11
14,0,0,0,0,2020-11-27,Female,57,55-64,11
14,2,0,0,2,2020-11-26,Male,70,70-74,12
14,0,0,0,0,2020-11-28,Female,15,15-19,13
14,1,0,0,1,2020-11-26,Male,62,55-64,14
14,1,0,0,1,2020-11-26,Male,67,65-69,14
14,3,3,0,6,2020-11-30,Male,19,15-19,1
14,2,0,0,2,2020-11-27,Male,77,75-79,5
14,0,0,0,0,2020-11-29,Male,57,55-64,12
14,1,1,0,2,2020-11-27,Female,71,70-74,10
14,0,0,0,0,2020-11-25,Male,51,45-54,5
14,0,5,22,27,2020-11-28,Female,60,55-64,6
14,1,0,0,1,2020-11-30,Female,61,55-64,1
14,2,0,0,2,2020-11-27,Male,6,5-9,14
14,2,3,0,5,2020-11-26,Female,55,55-64,13
14,0,0,0,0,2020-11-27,Male,53,45-54,9
14,0,0,0,0,2020-11-25,Female,22,20-24,10
14,2,6,24,32,2020-11-25,Male,55,55-64,9
14,1,1,0,2,2020-11-27,Male,62,55-64,10
14,1,0,0,1,2020-11-30,Male,3,1-4,1
14,0,0,0,0,2020-11-27,Male,65,65-69,8
14,1,0,0,1,2020-11-26,Female,8,5-9,7
14,0,1,0,1,2020-11-26,Male,53,45-54,8
14,2,3,0,5,2020-11-28,Male,30,25-34,5
14,3,9,0,12,2020-11-30,Female,21,20-24,1
14,2,0,0,2,2020-11-30,Male,1,1-4,1
14,0,0,0,0,2020-11-25,Male,35,35-44,12
14,2,0,0,2,2020-11-28,Male,78,75-79,8
14,1,0,0,1,2020-11-26,Female,65,65-69,10
14,5,0,0,5,2020-11-29,Female,13,10-14,9
14,1,0,0,1,2020-11-25,Male,64,55-64,14
14,2,0,0,2,2020-11-27,Female,15,15-19,14
14,0,0,0,0,2020-11-27,Female,56,55-64,8
14,0,3,0,3,2020-11-28,Female,59,55-64,4
14,2,2,0,4,2020-11-27,Male,55,55-64,14
14,1,0,0,1,2020-11-26,Female,54,45-54,10
14,0,0,0,0,2020-11-26,Male,59,55-64,13
14,0,3,0,3,2020-11-26,Female,59,55-64,12
14,0,3,0,3,2020-11-27,Female,20,20-24,6
14,0,0,0,0,2020-11-27,Female,67,65-69,6
14,2,0,0,2,2020-11-27,Female,23,20-24,2
14,0,0,0,0,2020-11-26,Female,23,20-24,12
14,1,0,0,1,2020-11-29,Male,32,25-34,11
14,0,0,0,0,2020-11-26,Male,28,25-34,13
14,0,1,0,1,2020-11-26,Male,47,45-54,10
14,0,0,0,0,2020-11-26,Male,0,<1,4
14,0,0,0,0,2020-11-25,Female,8,5-9,13
14,0,0,0,0,2020-11-26,Female,41,35-44,14
14,1,2,0,3,2020-11-26,Male,68,65-69,11
14,2,1,0,3,2020-11-27,Female,73,70-74,7
14,0,0,0,0,2020-11-27,Male,11,10-14,10
14,0,0,0,0,2020-11-26,Male,66,65-69,11
14,3,0,0,3,2020-11-26,Male,14,10-14,4
14,0,1,0,1,2020-11-30,Female,48,45-54,1
14,1,0,0,1,2020-11-25,Male,33,25-34,10
14,1,1,0,2,2020-11-29,Female,61,55-64,9
14,3,0,0,3,2020-11-26,Female,65,65-69,8
14,0,1,0,1,2020-11-26,Male,69,65-69,11
14,0,0,0,0,2020-11-27,Female,31,25-34,13
14,1,2,0,3,2020-11-29,Male,62,55-64,8
14,2,0,0,2,2020-11-26,Female,20,20-24,5
14,0,1,0,1,2020-11-27,Female,73,70-74,10
14,0,0,0,0,2020-11-28,Male,59,55-64,9
14,1,0,0,1,2020-11-25,Male,68,65-69,13
14,1,0,0,1,2020-11-27,Male,79,75-79,6
14,0,1,0,1,2020-11-26,Male,59,55-64,9
14,1,0,0,1,2020-11-29,Male,58,55-64,10
14,2,0,0,2,2020-11-26,Male,66,65-69,9
14,0,0,0,0,2020-11-27,Female,53,45-54,10
14,2,0,0,2,2020-11-28,Male,19,15-19,9
14,3,0,0,3,2020-11-27,Male,2,1-4,11
14,0,0,0,0,2020-11-27,Female,31,25-34,10
14,0,1,0,1,2020-11-27,Male,61,55-64,11
14,1,1,0,2,2020-11-26,Male,67,65-69,14
14,0,0,0,0,2020-11-30,Female,24,20-24,1
14,3,1,0,4,2020-11-29,Female,66,65-69,8
14,2,0,0,2,2020-11-26,Male,75,75-79,7
14,1,0,0,1,2020-11-30,Female,28,25-34,1
14,2,1,0,3,2020-11-27,Female,23,20-24,8
14,0,0,0,0,2020-11-29,Male,27,25-34,8
14,1,0,0,1,2020-11-30,Female,63,55-64,1
14,0,0,0,0,2020-11-26,Female,69,65-69,6
14,1,0,0,1,2020-11-26,Female,48,45-54,8
14,0,2,0,2,2020-11-27,Male,59,55-64,11
14,0,0,0,0,2020-11-26,Male,37,35-44,13
14,1,0,0,1,2020-11-25,Female,54,45-54,5
14,0,3,0,3,2020-11-27,Female,42,35-44,10
14,0,2,0,2,2020-11-30,Female,23,20-24,1
14,1,0,0,1,2020-11-27,Male,9,5-9,7
14,0,0,0,0,2020-11-25,Male,51,45-54,11
14,2,0,0,2,2020-11-26,Male,9,5-9,8
14,1,0,0,1,2020-11-27,Female,46,45-54,12
14,3,0,0,3,2020-11-26,Male,68,65-69,7
14,0,0,5,5,2020-11-27,Male,42,35-44,7
14,0,1,0,1,2020-11-26,Male,62,55-64,8
14,1,0,0,1,2020-11-27,Male,55,55-64,12
14,1,1,0,2,2020-11-30,Male,33,25-34,1
14,0,0,0,0,2020-11-26,Female,41,35-44,10
14,1,1,0,2,2020-11-25,Female,52,45-54,8
14,0,0,0,0,2020-11-26,Female,65,65-69,9
14,3,0,0,3,2020-11-26,Male,17,15-19,12
14,0,2,0,2,2020-11-27,Male,55,55-64,11
14,3,0,0,3,2020-11-28,Female,59,55-64,10
14,1,0,0,1,2020-11-26,Female,36,35-44,8
14,0,2,0,2,2020-11-25,Male,59,55-64,7
14,1,0,0,1,2020-11-25,Male,22,20-24,9
14,0,0,0,0,2020-11-25,Male,31,25-34,9
14,1,0,0,1,2020-11-26,Female,21,20-24,11
14,3,0,0,3,2020-11-28,Female,66,65-69,13
14,2,0,0,2,2020-11-29,Male,51,45-54,12
14,0,2,0,2,2020-11-27,Male,65,65-69,11
14,3,1,0,4,2020-11-27,Female,50,45-54,7
14,1,0,0,1,2020-11-25,Male,48,45-54,8
14,0,0,0,0,2020-11-25,Male,59,55-64,10
14,1,0,0,1,2020-11-26,Male,69,65-69,9
14,0,10,2,12,2020-11-26,Male,30,25-34,11
14,0,0,0,0,2020-11-29,Male,36,35-44,10
14,2,5,0,7,2020-11-27,Male,5,5-9,7
14,1,2,0,3,2020-11-29,Female,30,25-34,5
14,1,0,0,1,2020-11-26,Female,69,65-69,11
14,0,1,0,1,2020-11-25,Female,26,25-34,11
14,3,0,0,3,2020-11-29,Female,27,25-34,6
14,0,1,0,1,2020-11-30,Female,24,20-24,1
14,1,0,0,1,2020-11-27,Female,60,55-64,11
14,0,0,0,0,2020-11-26,Male,40,35-44,8
14,0,1,0,1,2020-11-26,Male,65,65-69,14
14,1,4,0,5,2020-11-27,Male,52,45-54,8
14,0,1,0,1,2020-11-26,Male,70,70-74,7
14,2,0,0,2,2020-11-26,Male,56,55-64,8
14,1,10,0,11,2020-11-26,Female,65,65-69,14
14,1,1,0,2,2020-11-26,Male,69,65-69,12
14,1,0,0,1,2020-11-27,Male,33,25-34,6
14,2,2,0,4,2020-11-28,Male,62,55-64,9
14,1,0,0,1,2020-11-26,Female,60,55-64,3
14,0,0,0,0,2020-11-26,Male,46,45-54,8
14,0,0,0,0,2020-11-25,Female,65,65-69,10
14,1,1,0,2,2020-11-27,Male,79,75-79,10
14,2,1,2,5,2020-11-27,Male,72,70-74,7
14,0,0,0,0,2020-11-30,Female,8,5-9,1
14,0,0,0,0,2020-11-26,Male,45,45-54,10
14,2,0,0,2,2020-11-30,Female,25,25-34,1
14,1,0,0,1,2020-11-26,Female,67,65-69,9
14,1,0,0,1,2020-11-26,Male,58,55-64,14
14,3,0,0,3,2020-11-30,Female,20,20-24,1
14,2,1,0,3,2020-11-26,Male,69,65-69,13
14,1,0,35,36,2020-11-30,Male,38,35-44,1
14,1,3,0,4,2020-11-26,Male,51,45-54,13
14,1,0,0,1,2020-11-30,Female,26,25-34,1
14,3,0,0,3,2020-11-29,Male,5,5-9,6
14,1,0,0,1,2020-11-28,Male,72,70-74,11
14,2,1,0,3,2020-11-27,Male,71,70-74,12
14,0,1,0,1,2020-11-30,Female,52,45-54,7
14,1,0,0,1,2020-11-27,Female,63,55-64,9
14,2,0,0,2,2020-11-28,Female,17,15-19,13
14,2,3,0,5,2020-11-30,Female,23,20-24,1
14,2,0,2,4,2020-11-27,Male,0,<1,6
14,1,1,0,2,2020-11-26,Female,39,35-44,13
14,0,0,0,0,2020-11-27,Male,77,75-79,7
14,0,0,0,0,2020-11-25,Male,16,15-19,14
14,0,2,0,2,2020-11-26,Male,40,35-44,11
14,0,1,0,1,2020-11-26,Male,67,65-69,10
14,0,0,0,0,2020-11-30,Male,31,25-34,1
14,1,0,0,1,2020-11-26,Female,66,65-69,9
14,1,1,0,2,2020-11-26,Female,68,65-69,13
14,3,0,0,3,2020-11-25,Female,19,15-19,9
14,2,0,0,2,2020-11-26,Male,67,65-69,5
14,0,0,0,0,2020-11-26,Female,28,25-34,12
14,1,0,0,1,2020-11-27,Female,63,55-64,10
14,4,1,0,5,2020-11-27,Female,21,20-24,4
14,0,0,0,0,2020-11-26,Female,33,25-34,10
14,2,0,0,2,2020-11-28,Female,49,45-54,7
14,0,0,0,0,2020-11-27,Female,46,45-54,10
14,1,0,0,1,2020-11-25,Male,32,25-34,9
14,1,0,0,1,2020-11-27,Male,65,65-69,8
14,0,0,0,0,2020-11-28,Female,68,65-69,13
14,0,0,0,0,2020-11-25,Female,19,15-19,10
14,2,1,0,3,2020-11-27,Female,49,45-54,8
14,2,0,0,2,2020-11-28,Female,15,15-19,12
14,0,0,0,0,2020-11-26,Male,23,20-24,11
14,0,0,0,0,2020-11-26,Male,59,55-64,10
14,0,0,0,0,2020-11-28,Male,43,35-44,7
14,1,0,0,1,2020-11-26,Male,3,1-4,4
14,2,0,0,2,2020-11-27,Male,59,55-64,11
14,1,3,0,4,2020-11-27,Female,60,55-64,2
14,2,0,0,2,2020-11-28,Male,26,25-34,11
14,1,3,0,4,2020-11-28,Female,67,65-69,11
14,2,0,0,2,2020-11-27,Male,56,55-64,9
14,1,1,0,2,2020-11-26,Male,70,70-74,9
14,0,0,0,0,2020-11-26,Male,69,65-69,12
14,1,3,0,4,2020-11-27,Male,59,55-64,11
14,1,3,0,4,2020-11-27,Male,44,35-44,13
14,0,0,0,0,2020-11-27,Male,52,45-54,7
14,2,10,5,17,2020-11-27,Male,30,25-34,11
14,2,0,0,2,2020-11-28,Male,21,20-24,6
14,3,0,0,3,2020-11-26,Female,0,<1,11
14,1,0,0,1,2020-11-27,Female,63,55-64,8
14,0,0,0,0,2020-11-27,Male,42,35-44,11
14,2,0,0,2,2020-11-26,Female,67,65-69,2
14,1,0,0,1,2020-11-26,Male,29,25-34,3
14,1,0,0,1,2020-11-26,Male,35,35-44,12
14,0,0,0,0,2020-11-29,Female,24,20-24,7
14,3,0,0,3,2020-11-29,Male,15,15-19,10
14,0,0,0,0,2020-11-26,Male,25,25-34,5
14,2,2,0,4,2020-11-28,Female,50,45-54,8
14,2,0,0,2,2020-11-26,Female,67,65-69,12
14,1,0,0,1,2020-11-26,Male,50,45-54,11
14,0,0,0,0,2020-11-29,Female,24,20-24,8
14,1,1,0,2,2020-11-29,Female,22,20-24,4
14,2,0,0,2,2020-11-27,Male,51,45-54,13
14,1,2,0,3,2020-11-30,Male,43,35-44,1
14,0,1,0,1,2020-11-27,Female,55,55-64,9
14,2,0,0,2,2020-11-25,Male,70,70-74,11
14,2,0,0,2,2020-11-26,Male,67,65-69,10
14,0,0,0,0,2020-11-25,Female,60,55-64,12
14,1,0,0,1,2020-11-25,Male,40,35-44,10
14,0,1,0,1,2020-11-30,Female,45,45-54,1
14,0,0,0,0,2020-11-27,Male,53,45-54,9
14,0,0,0,0,2020-11-26,Female,30,25-34,13
14,4,4,0,8,2020-11-25,Female,4,1-4,5
14,0,0,0,0,2020-11-27,Male,33,25-34,13
14,0,6,0,6,2020-11-30,Female,20,20-24,1
14,0,11,0,11,2020-11-28,Male,46,45-54,8
14,1,0,0,1,2020-11-30,Female,54,45-54,10
14,0,2,0,2,2020-11-25,Female,66,65-69,12
14,1,1,0,2,2020-11-26,Female,68,65-69,9
14,2,1,0,3,2020-11-26,Female,14,10-14,8
14,0,0,0,0,2020-11-27,Female,67,65-69,9
14,0,0,0,0,2020-11-30,Female,22,20-24,1
14,0,1,0,1,2020-11-27,Female,68,65-69,10
14,2,0,0,2,2020-11-25,Male,45,45-54,14
14,2,1,0,3,2020-11-27,Female,60,55-64,3
14,0,0,0,0,2020-11-30,Female,55,55-64,13
14,3,2,0,5,2020-11-25,Male,2,1-4,5
14,1,0,0,1,2020-11-26,Female,29,25-34,8
14,0,1,0,1,2020-11-26,Male,29,25-34,10
14,1,4,0,5,2020-11-27,Male,59,55-64,6
14,0,0,0,0,2020-11-26,Male,38,35-44,7
14,1,8,0,9,2020-11-26,Male,68,65-69,11
14,0,0,0,0,2020-11-26,Male,12,10-14,7
14,0,0,0,0,2020-11-29,Male,23,20-24,7
14,3,0,34,37,2020-11-28,Female,17,15-19,7
14,2,0,0,2,2020-11-27,Male,78,75-79,8
14,2,0,0,2,2020-11-26,Male,68,65-69,6
14,2,0,0,2,2020-11-27,Female,58,55-64,11
14,5,10,0,15,2020-11-27,Male,16,15-19,10
14,1,1,0,2,2020-11-26,Male,32,25-34,11
14,1,1,0,2,2020-11-27,Male,12,10-14,5
14,1,0,0,1,2020-11-26,Female,67,65-69,7
14,1,0,0,1,2020-11-26,Male,58,55-64,11
14,2,0,0,2,2020-11-27,Female,29,25-34,4
14,0,3,0,3,2020-11-26,Male,42,35-44,10
14,3,2,0,5,2020-11-26,Male,14,10-14,11
14,3,0,3,6,2020-11-26,Male,11,10-14,10
14,0,0,0,0,2020-11-25,Male,65,65-69,10
14,1,2,0,3,2020-11-26,Female,66,65-69,11
14,1,0,0,1,2020-11-28,Female,68,65-69,12
14,2,1,0,3,2020-11-27,Male,81,80-84,9
14,2,0,0,2,2020-11-27,Male,50,45-54,9
14,0,0,0,0,2020-11-25,Female,20,20-24,6
14,0,1,1,2,2020-11-26,Female,47,45-54,10
14,1,0,0,1,2020-11-28,Male,71,70-74,10
14,0,0,0,0,2020-11-28,Female,30,25-34,8
14,0,0,0,0,2020-11-26,Female,20,20-24,11
14,0,0,0,0,2020-11-27,Male,27,25-34,10
14,1,0,0,1,2020-11-26,Male,65,65-69,12
14,2,21,0,23,2020-11-28,Female,11,10-14,5
14,2,0,0,2,2020-11-26,Female,69,65-69,3
14,1,0,0,1,2020-11-25,Female,62,55-64,12
14,1,0,0,1,2020-11-27,Female,52,45-54,8
14,0,0,0,0,2020-11-26,Male,65,65-69,13
14,0,0,0,0,2020-11-28,Male,57,55-64,8
14,0,0,0,0,2020-11-26,Male,66,65-69,12
14,1,0,0,1,2020-11-27,Male,63,55-64,13
14,0,5,0,5,2020-11-27,Female,69,65-69,9
14,1,2,0,3,2020-11-26,Male,31,25-34,6
14,0,0,0,0,2020-11-30,Female,30,25-34,9
14,1,0,0,1,2020-11-27,Male,72,70-74,12
14,0,2,0,2,2020-11-29,Female,63,55-64,11
14,6,2,0,8,2020-11-27,Male,9,5-9,11
14,2,0,0,2,2020-11-27,Male,70,70-74,9
14,4,0,0,4,2020-11-30,Female,23,20-24,1
14,0,0,0,0,2020-11-29,Male,43,35-44,5
14,5,0,0,5,2020-11-27,Female,19,15-19,11
14,3,3,0,6,2020-11-26,Female,65,65-69,14
14,0,1,0,1,2020-11-27,Female,61,55-64,12
14,0,0,0,0,2020-11-26,Female,31,25-34,11
14,0,0,0,0,2020-11-27,Male,26,25-34,9
14,2,0,0,2,2020-11-26,Male,55,55-64,12
14,0,0,0,0,2020-11-26,Female,66,65-69,9
14,0,0,0,0,2020-11-26,Male,18,15-19,7
14,2,0,0,2,2020-11-27,Female,59,55-64,12
14,1,0,0,1,2020-11-26,Female,22,20-24,10
14,2,0,0,2,2020-11-30,Female,18,15-19,1
14,1,2,0,3,2020-11-27,Male,55,55-64,8
14,0,0,0,0,2020-11-27,Female,31,25-34,11
14,0,0,0,0,2020-11-30,Female,25,25-34,1
14,0,0,0,0,2020-11-27,Male,53,45-54,11
14,0,0,0,0,2020-11-27,Male,39,35-44,10
14,3,2,0,5,2020-11-25,Female,12,10-14,12
14,1,11,0,12,2020-11-27,Male,43,35-44,11
14,0,0,0,0,2020-11-28,Female,50,45-54,6
14,3,0,0,3,2020-11-28,Male,17,15-19,8
14,2,0,0,2,2020-11-26,Male,65,65-69,7
14,0,1,0,1,2020-11-26,Female,64,55-64,13
14,3,0,0,3,2020-11-30,Female,18,15-19,1
14,1,0,0,1,2020-11-25,Female,66,65-69,11
14,2,4,0,6,2020-11-30,Female,61,55-64,11
14,0,0,0,0,2020-11-27,Male,60,55-64,6
14,0,2,0,2,2020-11-25,Female,61,55-64,13
14,0,0,0,0,2020-11-26,Male,49,45-54,10
14,0,0,0,0,2020-11-27,Male,44,35-44,13
14,1,0,0,1,2020-11-27,Male,60,55-64,8
14,1,1,0,2,2020-11-27,Male,71,70-74,9
14,0,0,0,0,2020-11-26,Female,68,65-69,10
14,2,0,0,2,2020-11-26,Male,70,70-74,10
14,0,0,0,0,2020-11-27,Male,19,15-19,3
14,2,2,0,4,2020-11-27,Male,7,5-9,9
14,0,0,0,0,2020-11-27,Female,70,70-74,12
14,6,2,0,8,2020-11-30,Female,26,25-34,1
14,0,0,0,0,2020-11-26,Female,8,5-9,10
14,2,1,0,3,2020-11-26,Male,67,65-69,10
14,1,0,0,1,2020-11-26,Male,66,65-69,11
14,0,0,0,0,2020-11-30,Female,22,20-24,4
14,0,1,0,1,2020-11-26,Female,57,55-64,9
14,0,1,0,1,2020-11-26,Male,70,70-74,10
14,0,0,0,0,2020-11-29,Female,33,25-34,7
14,0,0,0,0,2020-11-27,Female,33,25-34,13
14,0,0,2,2,2020-11-27,Male,52,45-54,13
14,1,0,0,1,2020-11-26,Male,68,65-69,14
14,0,0,0,0,2020-11-28,Male,34,25-34,10
14,0,0,0,0,2020-11-26,Female,52,45-54,8
14,0,0,0,0,2020-11-26,Male,36,35-44,6
14,2,0,0,2,2020-11-27,Male,78,75-79,8
14,3,1,0,4,2020-11-27,Female,12,10-14,8
14,2,0,0,2,2020-11-30,Female,24,20-24,1
14,2,0,0,2,2020-11-27,Male,17,15-19,8
14,0,0,0,0,2020-11-26,Male,8,5-9,6
14,0,0,0,0,2020-11-26,Male,17,15-19,11
14,1,3,0,4,2020-11-30,Female,29,25-34,1
14,1,0,0,1,2020-11-30,Female,57,55-64,1
14,0,2,0,2,2020-11-30,Male,42,35-44,6
14,4,2,20,26,2020-11-25,Female,7,5-9,4
14,4,7,0,11,2020-11-27,Male,14,10-14,10
14,0,0,0,0,2020-11-26,Female,22,20-24,10
14,2,5,0,7,2020-11-27,Male,79,75-79,9
14,2,0,0,2,2020-11-27,Male,52,45-54,11
14,1,0,0,1,2020-11-27,Female,33,25-34,7
14,1,1,0,2,2020-11-26,Male,66,65-69,7
14,1,0,0,1,2020-11-27,Male,52,45-54,10
14,0,0,0,0,2020-11-27,Female,53,45-54,7
14,1,0,0,1,2020-11-28,Male,24,20-24,2
14,3,3,0,6,2020-11-27,Female,43,35-44,13
14,0,0,0,0,2020-11-30,Female,33,25-34,1
14,2,1,0,3,2020-11-27,Female,70,70-74,11
14,1,0,0,1,2020-11-26,Female,24,20-24,12
14,0,0,0,0,2020-11-27,Female,71,70-74,8
14,0,0,0,0,2020-11-26,Female,68,65-69,14
14,0,0,0,0,2020-11-27,Male,59,55-64,9
14,2,0,0,2,2020-11-27,Male,24,20-24,4
14,2,0,0,2,2020-11-26,Male,69,65-69,7
14,2,0,0,2,2020-11-29,Female,51,45-54,12
14,0,4,0,4,2020-11-26,Female,69,65-69,8
14,0,0,0,0,2020-11-26,Male,33,25-34,11
14,4,2,0,6,2020-11-27,Female,12,10-14,11
14,3,0,0,3,2020-11-29,Female,2,1-4,11
14,1,15,0,16,2020-11-27,Male,59,55-64,6
14,0,0,0,0,2020-11-27,Male,45,45-54,9
14,2,0,0,2,2020-11-30,Male,5,5-9,1
14,0,0,0,0,2020-11-26,Female,68,65-69,12
14,1,0,0,1,2020-11-27,Female,58,55-64,12
14,0,2,0,2,2020-11-27,Female,54,45-54,12
14,3,0,0,3,2020-11-26,Male,69,65-69,10
14,0,0,0,0,2020-11-27,Female,41,35-44,13
14,0,0,0,0,2020-11-26,Female,64,55-64,13
14,0,0,0,0,2020-11-25,Male,40,35-44,8
14,2,3,0,5,2020-11-26,Male,59,55-64,6
14,0,0,0,0,2020-11-25,Female,10,10-14,8
14,0,0,0,0,2020-11-25,Male,22,20-24,6
14,1,0,0,1,2020-11-26,Female,52,45-54,14
14,0,1,0,1,2020-11-26,Male,40,35-44,10
14,3,0,0,3,2020-11-30,Male,11,10-14,1
14,2,0,0,2,2020-11-27,Male,19,15-19,10
14,0,5,0,5,2020-11-27,Male,77,75-79,13
14,0,0,0,0,2020-11-26,Male,44,35-44,8
14,1,1,0,2,2020-11-30,Female,21,20-24,1
14,1,0,0,1,2020-11-25,Male,66,65-69,14
14,0,1,0,1,2020-11-26,Female,29,25-34,7
14,1,0,0,1,2020-11-25,Male,34,25-34,8
14,2,0,0,2,2020-11-25,Female,66,65-69,13
14,0,0,0,0,2020-11-26,Female,65,65-69,8
14,3,0,0,3,2020-11-26,Male,2,1-4,7
14,0,0,0,0,2020-11-27,Male,48,45-54,13
14,1,2,0,3,2020-11-26,Male,65,65-69,9
14,0,1,0,1,2020-11-26,Male,39,35-44,12
14,1,4,0,5,2020-11-26,Female,66,65-69,14
14,0,40,0,40,2020-11-25,Male,38,35-44,12
14,0,0,0,0,2020-11-25,Female,39,35-44,6
14,2,1,0,3,2020-11-27,Male,74,70-74,11
14,0,0,0,0,2020-11-27,Male,30,25-34,11
14,2,0,0,2,2020-11-26,Female,62,55-64,11
14,0,0,0,0,2020-11-26,Male,16,15-19,9
14,1,2,0,3,2020-11-27,Male,72,70-74,5
14,0,0,0,0,2020-11-27,Female,54,45-54,10
14,0,0,0,0,2020-11-26,Male,57,55-64,6
14,1,3,0,4,2020-11-26,Female,67,65-69,12
14,1,1,0,2,2020-11-27,Male,48,45-54,7
14,2,0,40,42,2020-11-26,Female,44,35-44,6
14,0,0,0,0,2020-11-27,Female,37,35-44,5
14,1,0,0,1,2020-11-27,Male,64,55-64,11
14,1,0,0,1,2020-11-27,Male,60,55-64,10
14,0,0,0,0,2020-11-27,Male,41,35-44,12
14,3,0,0,3,2020-11-25,Female,12,10-14,6
14,0,0,0,0,2020-11-27,Male,34,25-34,8
14,2,0,0,2,2020-11-26,Female,14,10-14,14
14,0,0,0,0,2020-11-27,Female,58,55-64,12
14,2,0,0,2,2020-11-27,Female,52,45-54,10
14,1,0,0,1,2020-11-25,Female,34,25-34,9
14,2,1,0,3,2020-11-30,Male,56,55-64,1
14,1,0,0,1,2020-11-25,Female,59,55-64,12
14,0,0,0,0,2020-11-27,Male,14,10-14,11
14,1,0,4,5,2020-11-27,Male,49,45-54,10
14,1,13,0,14,2020-11-27,Female,62,55-64,5
14,1,0,0,1,2020-11-27,Male,65,65-69,11
14,1,0,0,1,2020-11-27,Female,15,15-19,12
14,1,0,0,1,2020-11-25,Male,55,55-64,6
14,2,0,0,2,2020-11-29,Female,49,45-54,12
14,5,1,0,6,2020-11-26,Male,23,20-24,4
14,0,0,0,0,2020-11-25,Female,21,20-24,9
14,0,1,0,1,2020-11-27,Male,43,35-44,9
14,3,11,0,14,2020-11-27,Female,18,15-19,9
14,6,1,0,7,2020-11-30,Female,26,25-34,1
14,0,0,0,0,2020-11-30,Female,37,35-44,1
14,0,4,0,4,2020-11-26,Female,67,65-69,9
14,0,0,0,0,2020-11-27,Female,53,45-54,13
14,0,0,0,0,2020-11-25,Male,39,35-44,11
14,3,1,0,4,2020-11-26,Male,19,15-19,7
14,0,0,0,0,2020-11-26,Male,35,35-44,8
14,2,0,0,2,2020-11-26,Male,67,65-69,8
14,0,0,0,0,2020-11-29,Female,15,15-19,9
14,1,3,0,4,2020-11-29,Male,66,65-69,11
14,3,0,0,3,2020-11-27,Female,0,<1,5
14,1,1,0,2,2020-11-30,Female,25,25-34,1
14,0,0,0,0,2020-11-27,Female,65,65-69,11
14,3,3,0,6,2020-11-27,Female,13,10-14,6
14,0,0,0,0,2020-11-26,Female,65,65-69,9
14,2,0,0,2,2020-11-26,Male,43,35-44,4
14,1,0,0,1,2020-11-29,Female,54,45-54,6
14,1,0,0,1,2020-11-26,Male,52,45-54,5
14,0,4,0,4,2020-11-26,Male,52,45-54,14
14,1,0,0,1,2020-11-27,Female,41,35-44,9
14,0,0,0,0,2020-11-26,Female,31,25-34,10
14,1,1,0,2,2020-11-26,Male,57,55-64,11
14,1,9,0,10,2020-11-26,Male,65,65-69,9
14,2,10,0,12,2020-11-26,Male,67,65-69,12
14,0,1,0,1,2020-11-30,Female,58,55-64,1
14,2,1,0,3,2020-11-26,Female,7,5-9,10
14,1,1,0,2,2020-11-25,Male,39,35-44,5
14,0,0,0,0,2020-11-30,Male,17,15-19,1
14,1,0,0,1,2020-11-27,Female,62,55-64,14
14,0,0,0,0,2020-11-27,Male,10,10-14,9
14,0,0,0,0,2020-11-25,Female,10,10-14,11
14,0,0,0,0,2020-11-27,Female,28,25-34,8
14,0,1,0,1,2020-11-26,Female,69,65-69,11
14,0,5,0,5,2020-11-27,Male,27,25-34,11
14,0,0,0,0,2020-11-25,Male,73,70-74,10
14,1,0,0,1,2020-11-28,Male,62,55-64,7
14,4,2,0,6,2020-11-27,Female,9,5-9,8
14,2,0,17,19,2020-11-30,Male,6,5-9,1
14,0,1,0,1,2020-11-27,Male,62,55-64,9
14,3,1,0,4,2020-11-26,Male,20,20-24,9
14,2,0,0,2,2020-11-26,Male,68,65-69,12
14,0,0,0,0,2020-11-27,Male,44,35-44,10
14,1,0,0,1,2020-11-27,Male,55,55-64,10
14,2,0,0,2,2020-11-26,Male,17,15-19,13
14,0,0,0,0,2020-11-29,Male,30,25-34,7
14,1,1,0,2,2020-11-29,Female,69,65-69,9
14,1,0,0,1,2020-11-26,Female,68,65-69,12
14,1,2,0,3,2020-11-30,Female,22,20-24,1
14,1,0,0,1,2020-11-26,Male,55,55-64,14
14,1,0,0,1,2020-11-27,Female,61,55-64,13
14,0,1,0,1,2020-11-26,Male,66,65-69,11
14,0,0,0,0,2020-11-25,Female,2,1-4,4
14,0,0,0,0,2020-11-29,Male,54,45-54,6
14,2,0,0,2,2020-11-26,Female,61,55-64,13
14,2,0,0,2,2020-11-30,Male,2,1-4,1
14,1,2,0,3,2020-11-27,Male,52,45-54,13
14,0,0,0,0,2020-11-27,Female,51,45-54,6
14,0,3,0,3,2020-11-28,Female,66,65-69,14
14,0,0,0,0,2020-11-26,Male,65,65-69,11
14,1,2,0,3,2020-11-27,Female,59,55-64,11
14,1,0,0,1,2020-11-30,Male,24,20-24,1
14,0,0,0,0,2020-11-25,Female,13,10-14,10
14,2,1,0,3,2020-11-29,Male,13,10-14,8
14,1,2,0,3,2020-11-26,Female,62,55-64,13
14,0,1,0,1,2020-11-26,Female,52,45-54,12
14,0,0,0,0,2020-11-26,Female,9,5-9,8
14,0,1,0,1,2020-11-25,Female,65,65-69,10
14,2,0,0,2,2020-11-28,Female,53,45-54,11
14,2,1,0,3,2020-11-27,Female,48,45-54,11
14,1,0,0,1,2020-11-26,Male,66,65-69,11
14,0,0,0,0,2020-11-30,Female,30,25-34,1
14,1,1,0,2,2020-11-26,Male,58,55-64,7
14,1,3,0,4,2020-11-27,Male,70,70-74,14
14,4,0,0,4,2020-11-25,Female,44,35-44,14
14,0,1,0,1,2020-11-27,Male,21,20-24,6
14,1,0,0,1,2020-11-27,Male,71,70-74,9
14,1,2,0,3,2020-11-26,Male,70,70-74,9
14,2,3,12,17,2020-11-27,Male,22,20-24,11
14,1,0,0,1,2020-11-26,Female,66,65-69,9
14,1,2,0,3,2020-11-27,Male,58,55-64,13
14,1,0,0,1,2020-11-26,Male,66,65-69,9
14,0,0,1,1,2020-11-26,Male,13,10-14,11
14,3,0,0,3,2020-11-26,Male,1,1-4,10
14,0,2,0,2,2020-11-26,Male,35,35-44,9
14,3,0,0,3,2020-11-26,Male,19,15-19,11
14,0,0,0,0,2020-11-25,Male,49,45-54,10
14,0,0,0,0,2020-11-26,Male,67,65-69,3
14,0,0,0,0,2020-11-27,Male,57,55-64,8
14,0,0,0,0,2020-11-30,Female,21,20-24,1
14,2,0,57,59,2020-11-26,Female,25,25-34,14
14,3,1,0,4,2020-11-27,Male,29,25-34,12
14,2,0,0,2,2020-11-28,Male,71,70-74,7
14,2,2,0,4,2020-11-25,Female,13,10-14,11
14,1,0,0,1,2020-11-26,Female,69,65-69,11
14,1,1,0,2,2020-11-26,Male,66,65-69,7
14,0,0,0,0,2020-11-26,Male,66,65-69,10
14,0,0,0,0,2020-11-29,Female,49,45-54,8
14,2,0,0,2,2020-11-26,Female,68,65-69,7
14,0,0,0,0,2020-11-25,Male,35,35-44,10
14,2,0,0,2,2020-11-27,Female,7,5-9,12
14,0,0,0,0,2020-11-26,Female,66,65-69,14
14,0,0,0,0,2020-11-25,Male,42,35-44,11
14,0,3,1,4,2020-11-27,Female,76,75-79,4
14,3,0,0,3,2020-11-25,Female,2,1-4,11
14,0,0,0,0,2020-11-26,Male,40,35-44,9
14,1,2,0,3,2020-11-27,Female,61,55-64,8
14,2,0,0,2,2020-11-30,Male,11,10-14,1
14,2,0,0,2,2020-11-27,Male,55,55-64,6
14,1,0,0,1,2020-11-26,Male,67,65-69,12
14,4,2,0,6,2020-11-25,Male,9,5-9,14
14,2,2,0,4,2020-11-25,Female,2,1-4,9
14,3,0,0,3,2020-11-26,Female,31,25-34,9
14,2,0,0,2,2020-11-27,Male,51,45-54,9
14,1,0,0,1,2020-11-26,Female,68,65-69,8
14,2,0,0,2,2020-11-27,Male,61,55-64,11
14,2,0,0,2,2020-11-26,Male,65,65-69,10
14,1,2,0,3,2020-11-27,Female,61,55-64,11
14,1,2,0,3,2020-11-27,Male,65,65-69,13
14,1,0,0,1,2020-11-26,Female,39,35-44,9
14,0,0,0,0,2020-11-30,Female,23,20-24,1
14,2,4,1,7,2020-11-27,Male,52,45-54,13
14,0,0,0,0,2020-11-27,Male,51,45-54,8
14,4,0,0,4,2020-11-30,Male,4,1-4,1
14,1,10,0,11,2020-11-27,Male,53,45-54,9
14,0,0,0,0,2020-11-29,Female,60,55-64,9
14,1,2,0,3,2020-11-28,Female,18,15-19,7
14,1,1,0,2,2020-11-27,Female,55,55-64,13
14,1,0,0,1,2020-11-27,Male,32,25-34,10
14,0,0,0,0,2020-11-26,Female,49,45-54,10
14,1,0,0,1,2020-11-26,Male,67,65-69,12
14,0,0,0,0,2020-11-26,Male,59,55-64,10
14,0,7,0,7,2020-11-25,Male,41,35-44,14
14,0,0,0,0,2020-11-26,Male,67,65-69,14
14,0,0,0,0,2020-11-29,Female,34,25-34,11
14,1,0,0,1,2020-11-27,Male,63,55-64,9
14,0,0,0,0,2020-11-26,Female,69,65-69,10
14,2,0,0,2,2020-11-27,Male,51,45-54,6
14,3,0,0,3,2020-11-27,Male,17,15-19,12
14,0,0,0,0,2020-11-26,Male,55,55-64,10
14,0,0,0,0,2020-11-27,Male,58,55-64,12
14,1,1,0,2,2020-11-27,Male,47,45-54,10
14,3,0,0,3,2020-11-30,Male,9,5-9,1
14,0,1,0,1,2020-11-26,Female,34,25-34,10
14,2,0,0,2,2020-11-27,Male,61,55-64,4
14,2,3,0,5,2020-11-28,Female,39,35-44,4
14,1,1,0,2,2020-11-26,Male,61,55-64,14
14,0,0,0,0,2020-11-26,Female,23,20-24,4
14,0,4,0,4,2020-11-26,Female,67,65-69,14
14,0,0,0,0,2020-11-28,Male,58,55-64,7
14,3,4,0,7,2020-11-26,Male,14,10-14,14
14,3,0,0,3,2020-11-26,Female,38,35-44,10
14,0,0,0,0,2020-11-25,Female,38,35-44,10
14,0,0,0,0,2020-11-27,Female,19,15-19,11
14,0,1,0,1,2020-11-25,Male,47,45-54,12
14,0,0,0,0,2020-11-28,Female,57,55-64,9
14,1,0,0,1,2020-11-26,Male,66,65-69,10
14,4,0,0,4,2020-11-27,Female,23,20-24,8
14,0,0,0,0,2020-11-25,Female,15,15-19,4
14,2,1,0,3,2020-11-26,Female,65,65-69,8
14,0,0,0,0,2020-11-25,Male,27,25-34,10
14,0,1,0,1,2020-11-25,Male,47,45-54,11
14,1,0,0,1,2020-11-28,Male,32,25-34,9
14,2,0,0,2,2020-11-27,Male,49,45-54,8
14,0,0,0,0,2020-11-27,Male,52,45-54,11
14,3,2,0,5,2020-11-27,Male,19,15-19,10
14,0,1,0,1,2020-11-30,Male,28,25-34,1
14,5,1,0,6,2020-11-27,Female,4,1-4,5
14,2,3,0,5,2020-11-27,Female,13,10-14,8
14,0,0,0,0,2020-11-27,Male,62,55-64,9
14,0,0,0,0,2020-11-30,Female,30,25-34,1
14,2,0,0,2,2020-11-26,Male,13,10-14,13
14,2,1,0,3,2020-11-26,Female,62,55-64,10
14,0,0,100,100,2020-11-27,Male,43,35-44,13
14,2,2,0,4,2020-11-27,Female,64,55-64,14
14,1,0,0,1,2020-11-27,Female,48,45-54,13
14,0,1,0,1,2020-11-29,Male,53,45-54,7
14,0,0,0,0,2020-11-26,Female,45,45-54,11
14,2,0,0,2,2020-11-26,Male,5,5-9,8
14,2,1,0,3,2020-11-27,Female,12,10-14,10
14,1,0,0,1,2020-11-25,Female,50,45-54,10
14,0,0,0,0,2020-11-25,Female,23,20-24,7
14,2,0,0,2,2020-11-26,Male,56,55-64,11
14,0,1,0,1,2020-11-30,Female,42,35-44,1
14,0,0,0,0,2020-11-27,Female,59,55-64,9
14,1,0,0,1,2020-11-29,Male,57,55-64,9
14,2,1,0,3,2020-11-28,Male,65,65-69,14
14,2,0,0,2,2020-11-27,Female,33,25-34,4
14,3,2,0,5,2020-11-29,Female,33,25-34,7
14,0,0,4,4,2020-11-30,Female,35,35-44,1
14,1,0,0,1,2020-11-25,Male,61,55-64,13
14,0,0,0,0,2020-11-29,Male,66,65-69,13
14,2,0,0,2,2020-11-29,Female,56,55-64,5
14,1,0,0,1,2020-11-27,Female,59,55-64,12
14,2,0,2,4,2020-11-25,Male,73,70-74,10
14,2,0,0,2,2020-11-27,Male,66,65-69,8
14,1,1,0,2,2020-11-26,Male,34,25-34,9
14,0,0,0,0,2020-11-26,Female,36,35-44,10
14,0,0,0,0,2020-11-27,Male,62,55-64,10
14,0,1,0,1,2020-11-25,Male,25,25-34,7
14,2,0,0,2,2020-11-28,Female,65,65-69,10
14,1,3,0,4,2020-11-28,Female,34,25-34,11
14,0,0,0,0,2020-11-27,Male,53,45-54,13
14,0,0,0,0,2020-11-28,Male,56,55-64,11
14,1,2,0,3,2020-11-26,Female,56,55-64,12
14,0,0,0,0,2020-11-26,Female,67,65-69,13
14,0,0,0,0,2020-11-25,Male,41,35-44,6
14,2,1,0,3,2020-11-27,Male,72,70-74,10
14,2,0,0,2,2020-11-27,Female,53,45-54,9
14,1,2,0,3,2020-11-26,Male,66,65-69,10
14,1,0,0,1,2020-11-30,Female,24,20-24,1
14,1,1,0,2,2020-11-27,Female,72,70-74,8
14,0,0,0,0,2020-11-26,Male,31,25-34,10
14,0,0,0,0,2020-11-27,Male,71,70-74,9
14,0,0,0,0,2020-11-27,Female,48,45-54,9
14,1,5,0,6,2020-11-30,Female,55,55-64,7
14,2,0,0,2,2020-11-27,Female,70,70-74,11
14,0,0,0,0,2020-11-26,Male,66,65-69,14
14,1,0,0,1,2020-11-27,Male,51,45-54,8
14,0,0,0,0,2020-11-27,Female,26,25-34,10
14,0,1,0,1,2020-11-27,Female,74,70-74,7
14,2,0,0,2,2020-11-27,Male,80,80-84,9
14,0,0,0,0,2020-11-28,Female,50,45-54,9
14,1,0,0,1,2020-11-27,Female,53,45-54,13
14,0,1,0,1,2020-11-25,Male,28,25-34,6
14,1,0,0,1,2020-11-27,Male,63,55-64,12
14,0,0,0,0,2020-11-25,Male,37,35-44,13
14,0,1,0,1,2020-11-25,Female,67,65-69,8
14,1,3,0,4,2020-11-27,Female,28,25-34,12
14,0,0,0,0,2020-11-26,Female,47,45-54,5
14,1,0,0,1,2020-11-26,Female,13,10-14,11
14,0,0,0,0,2020-11-27,Male,54,45-54,12
14,5,0,0,5,2020-11-26,Female,4,1-4,14
14,1,0,0,1,2020-11-25,Male,34,25-34,13
14,0,1,0,1,2020-11-26,Female,72,70-74,12
14,0,0,0,0,2020-11-27,Female,26,25-34,6
14,3,0,2,5,2020-11-26,Male,40,35-44,8
14,3,2,0,5,2020-11-27,Male,41,35-44,11
14,0,0,0,0,2020-11-30,Female,63,55-64,1
14,1,0,0,1,2020-11-26,Female,24,20-24,14
14,1,2,0,3,2020-11-27,Male,10,10-14,8
14,1,0,0,1,2020-11-29,Male,32,25-34,10
14,0,4,0,4,2020-11-27,Female,42,35-44,11
14,2,0,0,2,2020-11-27,Female,71,70-74,11
14,2,0,13,15,2020-11-29,Male,41,35-44,4
14,1,1,0,2,2020-11-27,Male,58,55-64,10
14,1,0,0,1,2020-11-30,Male,32,25-34,5
14,1,1,0,2,2020-11-27,Male,55,55-64,10
14,3,2,0,5,2020-11-25,Male,2,1-4,11
14,3,1,0,4,2020-11-25,Female,36,35-44,13
14,1,0,0,1,2020-11-25,Female,59,55-64,12
14,1,0,0,1,2020-11-25,Male,66,65-69,13
14,1,0,0,1,2020-11-30,Male,28,25-34,1
14,4,0,0,4,2020-11-27,Male,48,45-54,6
14,0,0,0,0,2020-11-27,Female,57,55-64,12
14,0,1,0,1,2020-11-27,Male,76,75-79,8
14,0,1,0,1,2020-11-30,Female,49,45-54,1
14,0,0,0,0,2020-11-27,Male,52,45-54,13
14,1,0,0,1,2020-11-27,Female,75,75-79,7
14,1,0,0,1,2020-11-26,Male,25,25-34,7
14,0,0,0,0,2020-11-26,Male,66,65-69,6
14,2,0,0,2,2020-11-27,Male,65,65-69,10
14,3,10,0,13,2020-11-27,Male,19,15-19,6
14,0,0,0,0,2020-11-27,Female,23,20-24,3
14,0,0,100,100,2020-11-25,Male,47,45-54,4
14,3,0,0,3,2020-11-27,Female,19,15-19,10
14,0,1,0,1,2020-11-27,Male,75,75-79,11
14,0,0,0,0,2020-11-26,Female,45,45-54,6
14,0,0,0,0,2020-11-30,Male,28,25-34,1
14,0,1,0,1,2020-11-30,Male,35,35-44,1
14,0,1,0,1,2020-11-26,Female,66,65-69,13
14,0,0,0,0,2020-11-30,Male,19,15-19,1
14,0,1,0,1,2020-11-27,Female,54,45-54,10
14,1,1,0,2,2020-11-27,Female,46,45-54,11
14,1,2,0,3,2020-11-27,Male,70,70-74,9
14,0,0,0,0,2020-11-27,Female,62,55-64,11
14,0,0,0,0,2020-11-26,Female,23,20-24,5
14,0,1,0,1,2020-11-30,Male,37,35-44,1
14,1,5,0,6,2020-11-27,Female,70,70-74,14
14,1,1,0,2,2020-11-30,Female,53,45-54,1
14,1,0,0,1,2020-11-26,Male,35,35-44,8
14,0,0,0,0,2020-11-29,Female,62,55-64,8
14,2,0,6,8,2020-11-27,Male,73,70-74,7
14,0,0,0,0,2020-11-27,Male,27,25-34,13
14,2,0,0,2,2020-11-27,Female,77,75-79,4
14,1,0,0,1,2020-11-27,Male,28,25-34,14
14,4,2,22,28,2020-11-26,Female,3,1-4,3
14,1,0,1,2,2020-11-27,Male,42,35-44,11
14,0,1,0,1,2020-11-27,Male,71,70-74,12
14,0,10,0,10,2020-11-26,Female,68,65-69,14
14,0,1,0,1,2020-11-27,Female,62,55-64,11
14,1,3,0,4,2020-11-27,Male,72,70-74,5
14,0,0,0,0,2020-11-26,Male,60,55-64,11
14,0,0,0,0,2020-11-26,Male,33,25-34,10
14,0,0,0,0,2020-11-27,Female,34,25-34,10
14,1,1,0,2,2020-11-26,Male,69,65-69,13
14,2,0,0,2,2020-11-26,Female,66,65-69,11
14,0,0,0,0,2020-11-30,Female,40,35-44,1
14,1,2,0,3,2020-11-25,Male,68,65-69,12
14,0,0,0,0,2020-11-25,Male,34,25-34,10
14,3,0,0,3,2020-11-27,Male,19,15-19,7
14,0,0,0,0,2020-11-26,Female,62,55-64,11
14,0,2,0,2,2020-11-27,Female,56,55-64,13
14,3,0,0,3,2020-11-28,Female,53,45-54,11
14,1,1,0,2,2020-11-27,Male,66,65-69,10
14,1,0,0,1,2020-11-27,Male,55,55-64,9
14,3,0,0,3,2020-11-26,Male,9,5-9,8
14,1,0,0,1,2020-11-26,Male,42,35-44,7
14,0,1,0,1,2020-11-28,Female,53,45-54,8
14,0,1,0,1,2020-11-26,Female,33,25-34,11
14,0,0,0,0,2020-11-30,Female,55,55-64,9
14,0,0,0,0,2020-11-26,Female,59,55-64,14
14,3,0,0,3,2020-11-26,Female,1,1-4,10
14,2,0,0,2,2020-11-27,Male,57,55-64,3
14,3,5,18,26,2020-11-26,Male,7,5-9,7
14,4,2,0,6,2020-11-27,Female,54,45-54,9
14,2,0,0,2,2020-11-27,Female,56,55-64,10
14,1,1,0,2,2020-11-26,Female,60,55-64,13
14,0,0,0,0,2020-11-27,Male,70,70-74,14
14,3,0,0,3,2020-11-26,Male,47,45-54,5
14,0,1,0,1,2020-11-28,Female,54,45-54,9
14,1,0,0,1,2020-11-27,Female,56,55-64,7
14,1,1,0,2,2020-11-27,Female,51,45-54,13
14,2,0,0,2,2020-11-26,Male,69,65-69,8
14,3,2,0,5,2020-11-27,Male,71,70-74,9
14,2,0,0,2,2020-11-27,Male,77,75-79,9
14,3,0,0,3,2020-11-26,Male,14,10-14,4
14,2,3,0,5,2020-11-27,Female,67,65-69,8
14,2,0,0,2,2020-11-28,Male,52,45-54,7
14,1,1,0,2,2020-11-26,Male,69,65-69,11
14,0,0,0,0,2020-11-27,Male,52,45-54,14
14,3,0,0,3,2020-11-27,Female,17,15-19,10
14,0,0,0,0,2020-11-30,Female,41,35-44,1
14,1,0,0,1,2020-11-26,Female,65,65-69,13
14,0,0,0,0,2020-11-26,Female,15,15-19,8
14,0,0,0,0,2020-11-25,Female,37,35-44,12
14,0,3,0,3,2020-11-29,Male,57,55-64,8
14,0,3,0,3,2020-11-27,Female,59,55-64,3
14,0,0,0,0,2020-11-28,Male,59,55-64,8
14,0,0,0,0,2020-11-27,Male,21,20-24,11
14,0,1,0,1,2020-11-26,Male,55,55-64,11
14,0,0,0,0,2020-11-25,Male,36,35-44,8
14,0,0,0,0,2020-11-26,Male,37,35-44,11
14,2,0,0,2,2020-11-26,Female,2,1-4,8
14,2,1,0,3,2020-11-30,Female,18,15-19,1
14,1,0,0,1,2020-11-30,Male,18,15-19,1
14,2,0,0,2,2020-11-26,Male,64,55-64,9
14,2,1,0,3,2020-11-25,Male,51,45-54,8
14,2,3,0,5,2020-11-28,Female,51,45-54,8
14,2,1,0,3,2020-11-26,Female,73,70-74,6
14,2,0,0,2,2020-11-28,Male,10,10-14,7
14,1,8,0,9,2020-11-27,Female,16,15-19,11
14,0,5,0,5,2020-11-25,Male,61,55-64,11
14,2,0,2,4,2020-11-27,Female,55,55-64,7
14,1,0,0,1,2020-11-30,Male,18,15-19,1
14,1,1,0,2,2020-11-30,Male,50,45-54,1
14,0,0,0,0,2020-11-29,Male,53,45-54,6
14,1,0,0,1,2020-11-30,Male,52,45-54,1
14,1,0,0,1,2020-11-27,Male,54,45-54,10
14,2,0,0,2,2020-11-25,Female,65,65-69,12
14,0,0,0,0,2020-11-27,Male,79,75-79,6
14,1,0,0,1,2020-11-27,Male,61,55-64,11
14,3,0,0,3,2020-11-26,Male,18,15-19,13
14,3,1,0,4,2020-11-25,Male,17,15-19,4
14,0,0,0,0,2020-11-27,Male,52,45-54,9
14,1,0,0,1,2020-11-29,Female,50,45-54,10
14,0,0,0,0,2020-11-27,Female,60,55-64,11
14,3,0,0,3,2020-11-25,Male,14,10-14,13
14,1,0,0,1,2020-11-30,Female,26,25-34,1
14,0,0,0,0,2020-11-27,Female,66,65-69,13
14,0,0,0,0,2020-11-26,Male,64,55-64,5
14,0,1,8,9,2020-11-27,Male,61,55-64,7
14,1,0,0,1,2020-11-27,Female,64,55-64,9
14,0,0,0,0,2020-11-25,Female,65,65-69,5
14,0,0,0,0,2020-11-26,Female,67,65-69,13
14,2,0,0,2,2020-11-25,Female,40,35-44,10
14,0,0,0,0,2020-11-26,Female,67,65-69,11
14,1,0,0,1,2020-11-26,Male,37,35-44,6
14,0,0,0,0,2020-11-25,Female,46,45-54,4
14,0,0,10,10,2020-11-26,Male,66,65-69,12
14,1,0,0,1,2020-11-25,Female,51,45-54,13
14,4,0,0,4,2020-11-29,Female,54,45-54,5
14,0,1,0,1,2020-11-27,Female,17,15-19,10
14,0,0,0,0,2020-11-27,Female,43,35-44,9
14,3,1,0,4,2020-11-30,Female,21,20-24,1
14,1,0,0,1,2020-11-28,Male,66,65-69,7
14,2,0,0,2,2020-11-26,Female,62,55-64,11
14,0,0,0,0,2020-11-30,Male,42,35-44,1
14,0,0,0,0,2020-11-26,Female,67,65-69,11
14,1,0,0,1,2020-11-25,Male,36,35-44,5
14,0,0,0,0,2020-11-27,Male,58,55-64,13
14,2,2,0,4,2020-11-27,Female,11,10-14,9
14,2,0,39,41,2020-11-30,Female,8,5-9,1
14,0,0,0,0,2020-11-30,Female,23,20-24,8
14,0,1,0,1,2020-11-27,Male,67,65-69,10
14,2,24,0,26,2020-11-27,Female,6,5-9,10
14,1,0,0,1,2020-11-27,Male,43,35-44,8
14,2,1,0,3,2020-11-27,Female,62,55-64,9
14,0,0,0,0,2020-11-26,Female,52,45-54,9
14,2,1,0,3,2020-11-26,Male,68,65-69,11
14,1,0,0,1,2020-11-27,Female,55,55-64,11
14,2,0,0,2,2020-11-27,Female,61,55-64,7
14,0,0,5,5,2020-11-30,Male,20,20-24,1
14,1,1,0,2,2020-11-27,Female,61,55-64,9
14,1,0,0,1,2020-11-25,Male,68,65-69,9
14,1,1,80,82,2020-11-26,Male,64,55-64,14
14,2,0,0,2,2020-11-27,Male,73,70-74,11
14,3,0,0,3,2020-11-26,Female,22,20-24,5
14,1,0,0,1,2020-11-27,Female,64,55-64,11
14,2,0,0,2,2020-11-27,Male,54,45-54,10
14,0,1,0,1,2020-11-26,Female,66,65-69,11
14,0,0,0,0,2020-11-29,Female,31,25-34,5
14,0,1,0,1,2020-11-30,Male,13,10-14,1
14,0,1,0,1,2020-11-29,Female,71,70-74,12
14,2,3,0,5,2020-11-26,Female,72,70-74,11
14,0,0,0,0,2020-11-26,Female,66,65-69,7
14,1,3,0,4,2020-11-27,Female,49,45-54,13
14,4,0,0,4,2020-11-26,Female,59,55-64,12
14,2,1,0,3,2020-11-27,Female,1,1-4,7
14,0,0,0,0,2020-11-25,Female,40,35-44,13
14,4,0,0,4,2020-11-27,Male,22,20-24,14
14,0,0,0,0,2020-11-26,Male,55,55-64,13
14,1,0,0,1,2020-11-28,Male,23,20-24,9
14,3,6,0,9,2020-11-27,Female,5,5-9,10
14,0,0,0,0,2020-11-27,Male,55,55-64,11
14,2,5,0,7,2020-11-27,Male,62,55-64,12
14,0,0,0,0,2020-11-27,Female,20,20-24,4
14,3,0,0,3,2020-11-27,Male,16,15-19,11
14,1,4,0,5,2020-11-27,Female,56,55-64,9
14,1,0,0,1,2020-11-26,Female,67,65-69,10
14,4,0,0,4,2020-11-26,Female,24,20-24,10
14,0,3,0,3,2020-11-26,Female,70,70-74,12
14,2,2,0,4,2020-11-27,Male,74,70-74,14
14,1,1,0,2,2020-11-28,Female,66,65-69,11
14,3,0,0,3,2020-11-25,Male,14,10-14,12
14,1,4,0,5,2020-11-26,Male,73,70-74,11
14,1,0,0,1,2020-11-30,Female,39,35-44,1
14,0,0,0,0,2020-11-29,Male,36,35-44,7
14,0,0,0,0,2020-11-27,Female,37,35-44,11
14,0,0,0,0,2020-11-25,Female,8,5-9,7
14,1,0,0,1,2020-11-26,Male,66,65-69,10
14,1,0,0,1,2020-11-27,Female,60,55-64,12
14,3,0,0,3,2020-11-26,Female,10,10-14,11
14,2,0,0,2,2020-11-29,Female,51,45-54,9
14,2,0,3,5,2020-11-26,Female,50,45-54,5
14,0,5,0,5,2020-11-28,Male,21,20-24,10
14,0,0,0,0,2020-11-29,Female,3,1-4,9
14,1,1,0,2,2020-11-26,Male,65,65-69,13
14,1,0,0,1,2020-11-29,Female,29,25-34,10
14,0,1,0,1,2020-11-25,Male,31,25-34,9
14,2,0,0,2,2020-11-27,Female,13,10-14,9
14,1,1,0,2,2020-11-29,Female,24,20-24,6
14,3,1,0,4,2020-11-26,Female,65,65-69,13
14,2,0,0,2,2020-11-26,Female,66,65-69,12
14,0,0,0,0,2020-11-25,Female,75,75-79,12
14,2,0,0,2,2020-11-27,Female,44,35-44,7
14,2,0,0,2,2020-11-28,Male,32,25-34,12
14,3,0,0,3,2020-11-26,Male,16,15-19,12
14,2,0,0,2,2020-11-29,Female,23,20-24,11
14,0,0,0,0,2020-11-26,Male,35,35-44,7
14,0,0,0,0,2020-11-27,Male,18,15-19,11
14,1,0,0,1,2020-11-28,Female,63,55-64,9
14,1,1,1,3,2020-11-27,Male,65,65-69,12
14,3,0,0,3,2020-11-26,Female,11,10-14,14
14,0,2,0,2,2020-11-27,Female,65,65-69,8
14,3,2,0,5,2020-11-30,Male,12,10-14,3
14,1,0,0,1,2020-11-27,Male,54,45-54,10
14,0,0,0,0,2020-11-25,Male,21,20-24,4
14,1,0,0,1,2020-11-28,Male,58,55-64,8
14,1,0,0,1,2020-11-25,Male,62,55-64,14
14,2,0,0,2,2020-11-26,Male,66,65-69,12
14,0,12,0,12,2020-11-28,Male,38,35-44,9
14,1,0,0,1,2020-11-29,Female,66,65-69,8
14,0,1,0,1,2020-11-30,Female,29,25-34,1
14,1,11,9,21,2020-11-26,Male,67,65-69,7
14,1,0,10,11,2020-11-28,Female,62,55-64,9
14,1,7,0,8,2020-11-27,Female,30,25-34,8
14,1,1,0,2,2020-11-27,Female,53,45-54,12
14,1,0,0,1,2020-11-27,Female,48,45-54,12
14,0,0,0,0,2020-11-29,Female,73,70-74,6
14,1,0,0,1,2020-11-27,Male,65,65-69,10
14,0,0,0,0,2020-11-27,Female,25,25-34,13
14,0,0,0,0,2020-11-26,Female,21,20-24,11
14,1,1,0,2,2020-11-26,Male,40,35-44,11
14,1,1,0,2,2020-11-27,Male,62,55-64,11
14,0,1,0,1,2020-11-26,Female,68,65-69,9
14,2,0,0,2,2020-11-30,Male,9,5-9,1
14,1,0,0,1,2020-11-26,Male,67,65-69,12
14,2,0,0,2,2020-11-25,Male,7,5-9,14
14,1,2,0,3,2020-11-29,Female,24,20-24,8
14,5,0,0,5,2020-11-27,Female,12,10-14,8
14,0,0,0,0,2020-11-29,Male,55,55-64,11
14,1,1,0,2,2020-11-25,Male,70,70-74,9
14,2,0,0,2,2020-11-27,Female,29,25-34,5
14,2,0,0,2,2020-11-26,Female,60,55-64,11
14,0,0,0,0,2020-11-28,Male,45,45-54,7
14,3,0,0,3,2020-11-26,Female,19,15-19,10
14,1,0,0,1,2020-11-26,Male,4,1-4,4
14,2,2,0,4,2020-11-28,Female,47,45-54,12
14,2,0,0,2,2020-11-26,Female,67,65-69,6
14,6,0,0,6,2020-11-25,Male,36,35-44,10
14,1,0,0,1,2020-11-27,Male,45,45-54,9
14,0,2,0,2,2020-11-28,Female,34,25-34,10
14,2,1,0,3,2020-11-27,Female,33,25-34,12
14,0,0,0,0,2020-11-26,Male,58,55-64,14
14,2,0,0,2,2020-11-26,Male,64,55-64,14
14,1,0,0,1,2020-11-26,Female,62,55-64,12
14,1,1,0,2,2020-11-27,Female,63,55-64,12
14,2,2,0,4,2020-11-26,Female,68,65-69,14
14,1,40,0,41,2020-11-25,Male,52,45-54,10
14,2,0,0,2,2020-11-25,Male,50,45-54,12
14,1,0,0,1,2020-11-25,Female,67,65-69,12
14,1,0,0,1,2020-11-28,Male,7,5-9,5
14,0,0,0,0,2020-11-26,Male,16,15-19,14
14,0,0,0,0,2020-11-26,Female,65,65-69,7
14,3,4,0,7,2020-11-25,Male,10,10-14,7
14,0,0,0,0,2020-11-27,Male,33,25-34,11
14,1,0,0,1,2020-11-26,Female,65,65-69,9
14,1,2,0,3,2020-11-25,Male,68,65-69,14
14,1,0,0,1,2020-11-26,Male,10,10-14,11
14,2,0,0,2,2020-11-25,Male,76,75-79,9
14,1,0,0,1,2020-11-25,Female,58,55-64,14
14,5,1,0,6,2020-11-25,Female,15,15-19,13
14,1,0,0,1,2020-11-26,Male,67,65-69,4
14,0,0,0,0,2020-11-27,Female,68,65-69,8
14,1,0,0,1,2020-11-25,Female,38,35-44,10
14,3,2,0,5,2020-11-27,Male,14,10-14,10
14,0,0,2,2,2020-11-25,Female,19,15-19,8
14,2,0,0,2,2020-11-28,Male,24,20-24,6
14,0,0,0,0,2020-11-26,Male,39,35-44,9
14,0,0,0,0,2020-11-27,Male,52,45-54,8
14,1,0,0,1,2020-11-26,Male,51,45-54,11
14,0,3,0,3,2020-11-27,Male,39,35-44,10
14,0,0,0,0,2020-11-26,Female,34,25-34,12
14,1,8,0,9,2020-11-28,Male,29,25-34,4
14,0,1,0,1,2020-11-26,Female,67,65-69,6
14,6,0,0,6,2020-11-30,Female,19,15-19,1
14,1,0,0,1,2020-11-26,Male,45,45-54,10
14,0,1,0,1,2020-11-26,Female,65,65-69,10
14,0,0,0,0,2020-11-25,Female,19,15-19,6
14,0,0,0,0,2020-11-26,Female,52,45-54,10
14,0,0,0,0,2020-11-30,Female,28,25-34,1
14,2,0,0,2,2020-11-25,Male,26,25-34,8
14,3,2,0,5,2020-11-26,Female,11,10-14,9
14,0,2,0,2,2020-11-29,Female,27,25-34,11
14,0,0,0,0,2020-11-30,Male,43,35-44,1
14,1,0,0,1,2020-11-29,Female,73,70-74,9
14,0,2,0,2,2020-11-25,Female,67,65-69,12
14,2,0,0,2,2020-11-27,Female,67,65-69,6
14,0,1,0,1,2020-11-26,Female,69,65-69,12
14,4,0,0,4,2020-11-29,Male,5,5-9,8
14,5,10,22,37,2020-11-28,Male,10,10-14,12
14,2,4,0,6,2020-11-27,Female,55,55-64,10
14,2,0,0,2,2020-11-25,Male,48,45-54,13
14,0,0,0,0,2020-11-26,Female,52,45-54,13
14,0,2,0,2,2020-11-25,Female,38,35-44,9
14,0,0,0,0,2020-11-26,Female,20,20-24,4
14,1,0,0,1,2020-11-26,Male,54,45-54,8
14,2,0,0,2,2020-11-26,Male,67,65-69,7
14,1,0,0,1,2020-11-30,Female,39,35-44,1
14,0,1,0,1,2020-11-27,Male,48,45-54,10
14,1,0,0,1,2020-11-27,Male,63,55-64,10
14,0,0,0,0,2020-11-27,Male,27,25-34,8
14,1,0,0,1,2020-11-25,Male,35,35-44,10
14,1,0,0,1,2020-11-27,Male,49,45-54,11
14,2,0,3,5,2020-11-28,Female,51,45-54,6
14,2,0,0,2,2020-11-27,Female,53,45-54,9
14,2,0,0,2,2020-11-26,Male,68,65-69,12
14,2,4,23,29,2020-11-25,Female,48,45-54,12
14,5,10,0,15,2020-11-27,Female,15,15-19,11
14,2,1,0,3,2020-11-27,Male,85,85+,9
14,1,1,0,2,2020-11-29,Female,51,45-54,8
14,1,2,0,3,2020-11-25,Female,54,45-54,11
14,2,0,0,2,2020-11-27,Male,11,10-14,7
14,0,0,0,0,2020-11-29,Male,47,45-54,9
14,2,2,0,4,2020-11-26,Female,66,65-69,9
14,0,0,0,0,2020-11-26,Male,50,45-54,14
14,3,0,0,3,2020-11-26,Male,0,<1,4
14,0,0,0,0,2020-11-26,Male,23,20-24,9
14,0,0,0,0,2020-11-27,Male,28,25-34,11
14,0,0,0,0,2020-11-26,Male,66,65-69,8
14,2,0,0,2,2020-11-27,Male,54,45-54,13
14,0,1,0,1,2020-11-29,Male,30,25-34,11
14,2,0,0,2,2020-11-26,Male,66,65-69,11
14,0,0,0,0,2020-11-25,Male,43,35-44,12
14,2,0,0,2,2020-11-26,Female,79,75-79,11
14,1,0,0,1,2020-11-26,Female,70,70-74,12
14,0,0,0,0,2020-11-26,Female,69,65-69,14
14,1,0,0,1,2020-11-27,Male,71,70-74,12
14,0,0,0,0,2020-11-28,Female,33,25-34,9
14,0,0,0,0,2020-11-25,Male,11,10-14,7
14,0,0,0,0,2020-11-27,Male,61,55-64,13
14,3,1,0,4,2020-11-27,Female,13,10-14,10
14,1,5,0,6,2020-11-27,Female,30,25-34,12
14,3,0,0,3,2020-11-30,Female,5,5-9,11
14,0,0,0,0,2020-11-27,Male,10,10-14,10
14,0,0,0,0,2020-11-26,Male,34,25-34,13
14,2,0,0,2,2020-11-26,Male,18,15-19,7
14,3,0,0,3,2020-11-27,Male,1,1-4,4
14,2,0,0,2,2020-11-26,Male,19,15-19,10
15,0,0,0,0,2020-12-11,Male,60,55-64,11
15,1,2,0,3,2020-12-12,Male,68,65-69,10
15,1,0,0,1,2020-12-11,Female,69,65-69,10
15,2,0,0,2,2020-12-12,Female,66,65-69,15
15,0,0,0,0,2020-12-09,Female,18,15-19,5
15,0,0,0,0,2020-12-11,Female,71,70-74,11
15,0,0,0,0,2020-12-10,Female,50,45-54,11
15,1,0,0,1,2020-12-10,Female,72,70-74,15
15,0,0,0,0,2020-12-11,Male,30,25-34,12
15,0,0,0,0,2020-12-09,Female,53,45-54,7
15,0,0,0,0,2020-12-09,Female,53,45-54,10
15,0,0,0,0,2020-12-11,Female,67,65-69,9
15,0,5,0,5,2020-12-12,Male,34,25-34,15
15,0,10,0,10,2020-12-09,Female,34,25-34,2
15,0,0,0,0,2020-12-11,Female,59,55-64,11
15,0,0,0,0,2020-12-10,Male,51,45-54,12
15,1,0,0,1,2020-12-12,Male,50,45-54,10
15,1,0,0,1,2020-12-09,Female,35,35-44,12
15,2,0,0,2,2020-12-09,Male,1,1-4,4
15,3,0,0,3,2020-12-09,Female,57,55-64,12
15,3,0,0,3,2020-12-09,Female,14,10-14,11
15,0,0,0,0,2020-12-10,Male,42,35-44,9
15,0,0,0,0,2020-12-10,Male,32,25-34,13
15,1,4,0,5,2020-12-11,Male,66,65-69,9
15,1,0,0,1,2020-12-11,Male,66,65-69,10
15,0,2,0,2,2020-12-11,Male,62,55-64,15
15,0,1,0,1,2020-12-09,Male,8,5-9,10
15,1,1,0,2,2020-12-09,Male,16,15-19,13
15,0,0,0,0,2020-12-10,Male,49,45-54,12
15,1,0,0,1,2020-12-09,Male,58,55-64,10
15,2,0,0,2,2020-12-10,Male,51,45-54,2
15,1,0,0,1,2020-12-10,Male,35,35-44,10
15,0,0,0,0,2020-12-09,Male,53,45-54,10
15,0,0,0,0,2020-12-10,Female,70,70-74,14
15,2,0,0,2,2020-12-09,Female,13,10-14,2
15,1,0,0,1,2020-12-09,Female,52,45-54,11
15,0,0,0,0,2020-12-09,Male,41,35-44,15
15,4,16,0,20,2020-12-15,Male,18,15-19,1
15,1,3,0,4,2020-12-11,Female,56,55-64,15
15,2,0,0,2,2020-12-09,Female,22,20-24,13
15,2,0,0,2,2020-12-09,Male,52,45-54,13
15,0,0,0,0,2020-12-15,Male,23,20-24,1
15,2,0,0,2,2020-12-12,Male,85,85+,13
15,0,0,0,0,2020-12-14,Female,66,65-69,6
15,1,0,0,1,2020-12-09,Male,58,55-64,13
15,0,0,0,0,2020-12-11,Male,51,45-54,10
15,0,5,0,5,2020-12-11,Female,22,20-24,3
15,1,0,0,1,2020-12-09,Male,72,70-74,8
15,0,12,0,12,2020-12-12,Male,76,75-79,11
15,0,0,0,0,2020-12-11,Male,26,25-34,2
15,1,1,0,2,2020-12-12,Male,71,70-74,13
15,0,0,0,0,2020-12-09,Male,52,45-54,14
15,0,0,1,1,2020-12-13,Male,37,35-44,6
15,0,0,0,0,2020-12-15,Male,53,45-54,9
15,3,4,0,7,2020-12-09,Male,43,35-44,9
15,0,0,0,0,2020-12-11,Male,1,1-4,3
15,2,0,0,2,2020-12-11,Male,35,35-44,9
15,1,0,0,1,2020-12-10,Male,39,35-44,12
15,3,21,12,36,2020-12-15,Male,5,5-9,1
15,0,1,0,1,2020-12-10,Female,77,75-79,12
15,3,1,0,4,2020-12-09,Male,4,1-4,8
15,1,0,0,1,2020-12-09,Female,67,65-69,12
15,1,1,0,2,2020-12-09,Male,38,35-44,13
15,1,0,0,1,2020-12-09,Male,63,55-64,12
15,1,3,0,4,2020-12-12,Female,14,10-14,10
15,0,1,0,1,2020-12-12,Male,72,70-74,8
15,2,0,0,2,2020-12-09,Female,19,15-19,2
15,0,0,0,0,2020-12-09,Male,85,85+,10
15,2,2,0,4,2020-12-11,Female,71,70-74,10
15,3,0,0,3,2020-12-15,Female,22,20-24,1
15,2,3,0,5,2020-12-09,Male,54,45-54,14
15,0,0,0,0,2020-12-14,Male,31,25-34,7
15,1,1,0,2,2020-12-10,Male,70,70-74,12
15,2,0,0,2,2020-12-12,Female,69,65-69,11
15,1,2,0,3,2020-12-09,Female,65,65-69,14
15,3,3,0,6,2020-12-12,Male,12,10-14,7
15,2,0,0,2,2020-12-11,Male,67,65-69,14
15,4,17,0,21,2020-12-10,Female,14,10-14,8
15,1,0,0,1,2020-12-12,Male,40,35-44,6
15,1,1,0,2,2020-12-12,Male,67,65-69,12
15,2,2,0,4,2020-12-12,Male,70,70-74,6
15,0,0,0,0,2020-12-15,Female,13,10-14,1
15,6,0,0,6,2020-12-11,Female,23,20-24,9
15,0,0,0,0,2020-12-09,Male,43,35-44,11
15,3,0,0,3,2020-12-11,Female,5,5-9,11
15,0,4,0,4,2020-12-09,Female,24,20-24,2
15,4,10,5,19,2020-12-11,Male,16,15-19,5
15,2,0,0,2,2020-12-11,Male,33,25-34,10
15,1,1,0,2,2020-12-10,Male,69,65-69,15
15,2,0,0,2,2020-12-09,Female,60,55-64,13
15,4,0,0,4,2020-12-10,Male,16,15-19,12
15,1,0,0,1,2020-12-10,Male,31,25-34,10
15,0,2,0,2,2020-12-10,Female,52,45-54,13
15,0,0,0,0,2020-12-10,Male,49,45-54,13
15,2,0,0,2,2020-12-10,Male,22,20-24,5
15,0,2,0,2,2020-12-12,Male,69,65-69,10
15,1,3,0,4,2020-12-14,Female,66,65-69,8
15,0,3,0,3,2020-12-09,Female,63,55-64,13
15,0,0,0,0,2020-12-12,Female,25,25-34,11
15,1,0,0,1,2020-12-09,Female,29,25-34,6
15,0,0,0,0,2020-12-09,Female,31,25-34,14
15,0,0,0,0,2020-12-11,Female,67,65-69,10
15,1,2,0,3,2020-12-09,Male,18,15-19,7
15,1,0,0,1,2020-12-09,Female,62,55-64,13
15,0,0,0,0,2020-12-12,Female,47,45-54,11
15,0,0,0,0,2020-12-09,Male,54,45-54,12
15,0,0,0,0,2020-12-10,Male,33,25-34,9
15,1,0,0,1,2020-12-12,Female,73,70-74,12
15,0,1,0,1,2020-12-09,Male,32,25-34,15
15,0,1,0,1,2020-12-12,Male,65,65-69,10
15,0,0,0,0,2020-12-09,Female,30,25-34,9
15,3,1,0,4,2020-12-13,Female,22,20-24,2
15,0,0,0,0,2020-12-09,Male,37,35-44,11
15,1,1,0,2,2020-12-12,Female,22,20-24,2
15,1,3,0,4,2020-12-09,Female,59,55-64,10
15,0,0,0,0,2020-12-10,Male,63,55-64,13
15,1,0,0,1,2020-12-09,Male,8,5-9,6
15,0,0,0,0,2020-12-11,Male,29,25-34,8
15,0,1,0,1,2020-12-10,Female,26,25-34,10
15,0,1,0,1,2020-12-11,Male,69,65-69,10
15,2,1,0,3,2020-12-09,Male,42,35-44,10
15,2,0,0,2,2020-12-09,Male,58,55-64,14
15,0,0,0,0,2020-12-10,Female,62,55-64,11
15,4,0,0,4,2020-12-12,Male,12,10-14,4
15,0,0,0,0,2020-12-11,Male,69,65-69,11
15,3,0,0,3,2020-12-13,Male,32,25-34,10
15,2,0,0,2,2020-12-12,Male,34,25-34,13
15,3,0,0,3,2020-12-09,Male,24,20-24,7
15,3,0,0,3,2020-12-09,Female,13,10-14,12
15,1,0,0,1,2020-12-10,Male,65,65-69,13
15,1,1,0,2,2020-12-10,Female,79,75-79,11
15,0,0,0,0,2020-12-11,Male,56,55-64,12
15,1,0,0,1,2020-12-10,Female,28,25-34,12
15,0,0,0,0,2020-12-11,Male,23,20-24,5
15,0,0,0,0,2020-12-10,Female,56,55-64,10
15,1,3,0,4,2020-12-15,Female,33,25-34,1
15,1,0,0,1,2020-12-14,Male,52,45-54,11
15,0,0,0,0,2020-12-11,Male,52,45-54,7
15,1,2,0,3,2020-12-13,Male,27,25-34,7
15,1,1,1,3,2020-12-11,Male,70,70-74,12
15,1,2,0,3,2020-12-13,Female,68,65-69,15
15,1,3,0,4,2020-12-09,Female,52,45-54,14
15,0,0,0,0,2020-12-11,Male,28,25-34,11
15,3,0,0,3,2020-12-09,Male,5,5-9,10
15,3,1,0,4,2020-12-09,Male,65,65-69,11
15,1,0,0,1,2020-12-14,Female,58,55-64,12
15,0,0,0,0,2020-12-13,Female,66,65-69,14
15,1,0,0,1,2020-12-10,Female,42,35-44,6
15,1,0,0,1,2020-12-10,Female,60,55-64,11
15,0,0,0,0,2020-12-13,Female,66,65-69,6
15,0,1,2,3,2020-12-11,Male,70,70-74,15
15,2,1,0,3,2020-12-09,Male,34,25-34,11
15,0,0,0,0,2020-12-11,Female,71,70-74,10
15,1,3,0,4,2020-12-12,Male,74,70-74,13
15,0,0,0,0,2020-12-12,Male,50,45-54,9
15,1,0,0,1,2020-12-09,Female,31,25-34,11
15,0,0,0,0,2020-12-13,Female,21,20-24,7
15,0,0,0,0,2020-12-13,Male,54,45-54,11
15,1,0,0,1,2020-12-14,Male,51,45-54,12
15,1,0,0,1,2020-12-10,Female,49,45-54,11
15,0,0,0,0,2020-12-09,Male,40,35-44,10
15,2,80,100,182,2020-12-09,Male,17,15-19,11
15,2,0,0,2,2020-12-12,Female,68,65-69,7
15,0,0,0,0,2020-12-12,Male,65,65-69,9
15,1,1,0,2,2020-12-12,Male,68,65-69,12
15,1,0,0,1,2020-12-12,Female,58,55-64,13
15,0,0,0,0,2020-12-09,Male,50,45-54,13
15,0,0,0,0,2020-12-10,Male,10,10-14,12
15,0,0,0,0,2020-12-12,Male,71,70-74,13
15,0,2,0,2,2020-12-10,Male,40,35-44,9
15,2,0,0,2,2020-12-09,Female,69,65-69,15
15,0,0,0,0,2020-12-10,Male,40,35-44,9
15,2,0,0,2,2020-12-10,Female,73,70-74,8
15,0,2,0,2,2020-12-11,Male,51,45-54,9
15,1,0,0,1,2020-12-09,Female,57,55-64,12
15,1,0,0,1,2020-12-10,Female,60,55-64,15
15,0,0,0,0,2020-12-11,Male,43,35-44,14
15,2,0,0,2,2020-12-14,Male,63,55-64,6
15,2,1,0,3,2020-12-09,Female,63,55-64,11
15,1,1,17,19,2020-12-11,Male,12,10-14,2
15,2,0,0,2,2020-12-14,Male,31,25-34,10
15,2,0,0,2,2020-12-12,Male,73,70-74,12
15,1,2,0,3,2020-12-12,Female,31,25-34,2
15,1,0,0,1,2020-12-14,Male,66,65-69,5
15,2,5,3,10,2020-12-09,Female,53,45-54,14
15,1,0,0,1,2020-12-10,Male,34,25-34,14
15,1,0,0,1,2020-12-10,Female,23,20-24,3
15,0,0,0,0,2020-12-13,Male,48,45-54,10
15,3,1,0,4,2020-12-09,Male,69,65-69,10
15,0,0,0,0,2020-12-12,Male,65,65-69,14
15,3,0,0,3,2020-12-13,Male,9,5-9,11
15,2,2,0,4,2020-12-12,Male,68,65-69,14
15,0,3,0,3,2020-12-13,Male,61,55-64,11
15,0,2,0,2,2020-12-11,Male,70,70-74,10
15,2,0,0,2,2020-12-15,Male,20,20-24,1
15,0,0,0,0,2020-12-10,Male,43,35-44,8
15,0,10,0,10,2020-12-09,Female,56,55-64,13
15,0,0,0,0,2020-12-09,Female,58,55-64,11
15,3,0,0,3,2020-12-10,Male,23,20-24,5
15,0,0,0,0,2020-12-09,Male,44,35-44,8
15,1,1,1,3,2020-12-12,Female,25,25-34,7
15,0,5,0,5,2020-12-10,Female,63,55-64,10
15,2,0,0,2,2020-12-14,Female,13,10-14,7
15,1,1,0,2,2020-12-10,Female,61,55-64,15
15,0,0,0,0,2020-12-11,Male,60,55-64,5
15,0,0,0,0,2020-12-09,Male,49,45-54,10
15,1,2,0,3,2020-12-09,Female,54,45-54,15
15,0,0,0,0,2020-12-10,Male,34,25-34,11
15,0,1,0,1,2020-12-15,Male,56,55-64,11
15,0,3,0,3,2020-12-10,Female,65,65-69,15
15,2,0,0,2,2020-12-10,Male,10,10-14,11
15,1,0,0,1,2020-12-12,Male,73,70-74,13
15,3,15,0,18,2020-12-11,Male,10,10-14,9
15,3,16,0,19,2020-12-09,Male,7,5-9,8
15,2,0,0,2,2020-12-09,Male,11,10-14,2
15,1,0,0,1,2020-12-14,Male,79,75-79,10
15,0,1,0,1,2020-12-12,Female,67,65-69,10
15,0,0,0,0,2020-12-10,Male,39,35-44,11
15,0,0,0,0,2020-12-09,Female,16,15-19,8
15,2,0,0,2,2020-12-09,Female,65,65-69,12
15,0,0,0,0,2020-12-10,Male,53,45-54,9
15,1,0,0,1,2020-12-09,Male,48,45-54,9
15,1,0,0,1,2020-12-10,Male,69,65-69,13
15,2,0,16,18,2020-12-09,Male,16,15-19,10
15,0,1,0,1,2020-12-10,Male,36,35-44,15
15,2,0,0,2,2020-12-12,Male,65,65-69,6
15,1,5,0,6,2020-12-09,Male,40,35-44,15
15,0,0,0,0,2020-12-12,Male,32,25-34,12
15,2,0,0,2,2020-12-10,Male,62,55-64,14
15,3,0,0,3,2020-12-09,Female,4,1-4,4
15,3,1,0,4,2020-12-12,Female,23,20-24,9
15,1,1,0,2,2020-12-12,Male,68,65-69,8
15,0,0,0,0,2020-12-10,Male,6,5-9,11
15,2,2,0,4,2020-12-12,Female,71,70-74,8
15,0,0,0,0,2020-12-12,Male,68,65-69,14
15,0,0,0,0,2020-12-12,Male,37,35-44,7
15,0,0,0,0,2020-12-09,Female,53,45-54,11
15,2,0,0,2,2020-12-09,Female,22,20-24,2
15,3,15,0,18,2020-12-10,Male,6,5-9,11
15,0,1,0,1,2020-12-09,Male,31,25-34,2
15,0,0,0,0,2020-12-11,Male,76,75-79,7
15,0,1,0,1,2020-12-12,Male,47,45-54,9
15,1,3,0,4,2020-12-09,Male,52,45-54,12
15,0,0,0,0,2020-12-12,Female,70,70-74,9
15,1,10,0,11,2020-12-10,Male,32,25-34,10
15,3,0,0,3,2020-12-11,Male,69,65-69,10
15,0,0,0,0,2020-12-09,Male,18,15-19,12
15,2,0,0,2,2020-12-09,Male,65,65-69,11
15,0,1,0,1,2020-12-12,Male,49,45-54,12
15,1,0,0,1,2020-12-14,Male,66,65-69,8
15,1,0,0,1,2020-12-13,Male,75,75-79,8
15,0,0,0,0,2020-12-11,Male,50,45-54,7
15,0,0,0,0,2020-12-11,Female,60,55-64,9
15,0,0,0,0,2020-12-13,Male,17,15-19,7
15,0,0,0,0,2020-12-10,Male,66,65-69,14
15,0,0,0,0,2020-12-12,Male,65,65-69,14
15,2,1,0,3,2020-12-09,Female,67,65-69,14
15,1,0,0,1,2020-12-09,Male,68,65-69,13
15,0,0,0,0,2020-12-10,Male,40,35-44,8
15,0,4,0,4,2020-12-09,Female,26,25-34,2
15,1,0,0,1,2020-12-10,Female,44,35-44,7
15,2,0,0,2,2020-12-13,Male,70,70-74,8
15,3,0,34,37,2020-12-10,Female,19,15-19,11
15,0,0,0,0,2020-12-13,Female,47,45-54,7
15,3,0,0,3,2020-12-12,Male,14,10-14,12
15,0,0,0,0,2020-12-13,Male,52,45-54,11
15,0,0,0,0,2020-12-12,Female,52,45-54,13
15,5,0,0,5,2020-12-11,Male,14,10-14,12
15,0,0,0,0,2020-12-14,Female,60,55-64,11
15,0,0,0,0,2020-12-10,Male,28,25-34,14
15,2,3,15,20,2020-12-09,Female,4,1-4,8
15,0,0,0,0,2020-12-13,Male,47,45-54,7
15,1,1,0,2,2020-12-12,Male,81,80-84,13
15,3,2,0,5,2020-12-09,Female,7,5-9,5
15,0,0,0,0,2020-12-10,Female,58,55-64,9
15,0,0,0,0,2020-12-09,Female,9,5-9,10
15,2,1,43,46,2020-12-12,Male,59,55-64,8
15,0,3,0,3,2020-12-10,Female,50,45-54,2
15,0,0,0,0,2020-12-10,Male,49,45-54,11
15,1,1,0,2,2020-12-09,Female,53,45-54,11
15,0,0,0,0,2020-12-14,Female,28,25-34,4
15,0,0,0,0,2020-12-10,Male,24,20-24,12
15,2,0,0,2,2020-12-12,Male,71,70-74,13
15,0,0,0,0,2020-12-11,Male,35,35-44,14
15,1,0,0,1,2020-12-09,Female,11,10-14,3
15,0,0,0,0,2020-12-09,Female,23,20-24,14
15,1,0,0,1,2020-12-11,Female,6,5-9,11
15,1,2,0,3,2020-12-11,Female,67,65-69,9
15,0,0,0,0,2020-12-12,Male,68,65-69,13
15,1,0,0,1,2020-12-09,Male,22,20-24,7
15,2,0,0,2,2020-12-09,Male,41,35-44,15
15,1,0,0,1,2020-12-12,Male,65,65-69,13
15,3,3,0,6,2020-12-12,Male,50,45-54,9
15,0,0,0,0,2020-12-11,Male,71,70-74,9
15,2,0,0,2,2020-12-09,Male,58,55-64,11
15,0,0,0,0,2020-12-09,Male,11,10-14,2
15,2,0,0,2,2020-12-11,Male,75,75-79,11
15,1,0,0,1,2020-12-09,Male,79,75-79,13
15,2,0,0,2,2020-12-12,Male,54,45-54,13
15,2,0,0,2,2020-12-14,Male,64,55-64,8
15,1,0,1,2,2020-12-09,Male,63,55-64,10
15,0,3,0,3,2020-12-10,Female,67,65-69,12
15,0,0,0,0,2020-12-10,Male,20,20-24,2
15,0,1,0,1,2020-12-11,Female,68,65-69,13
15,0,3,0,3,2020-12-15,Female,33,25-34,1
15,0,4,0,4,2020-12-10,Female,28,25-34,2
15,0,2,0,2,2020-12-14,Male,28,25-34,5
15,2,0,0,2,2020-12-11,Female,78,75-79,13
15,0,0,0,0,2020-12-10,Female,66,65-69,9
15,0,1,0,1,2020-12-12,Female,64,55-64,10
15,1,0,0,1,2020-12-13,Male,69,65-69,14
15,0,0,0,0,2020-12-14,Female,33,25-34,10
15,1,2,0,3,2020-12-10,Male,37,35-44,9
15,0,1,0,1,2020-12-10,Male,30,25-34,14
15,3,0,0,3,2020-12-09,Female,52,45-54,10
15,2,0,0,2,2020-12-11,Male,61,55-64,12
15,0,0,0,0,2020-12-13,Male,17,15-19,5
15,2,0,0,2,2020-12-13,Female,66,65-69,13
15,2,0,0,2,2020-12-13,Female,78,75-79,11
15,0,0,0,0,2020-12-12,Male,66,65-69,15
15,1,2,0,3,2020-12-12,Female,69,65-69,11
15,0,0,0,0,2020-12-12,Female,76,75-79,13
15,3,0,0,3,2020-12-12,Male,37,35-44,10
15,0,0,0,0,2020-12-09,Male,26,25-34,2
15,1,0,0,1,2020-12-09,Female,48,45-54,13
15,1,0,0,1,2020-12-11,Male,61,55-64,9
15,1,0,0,1,2020-12-10,Female,51,45-54,9
15,3,0,0,3,2020-12-12,Female,18,15-19,5
15,1,0,0,1,2020-12-13,Male,68,65-69,14
15,2,0,0,2,2020-12-13,Female,54,45-54,11
15,0,0,0,0,2020-12-09,Male,62,55-64,11
15,2,8,0,10,2020-12-09,Male,26,25-34,2
15,0,0,0,0,2020-12-12,Female,65,65-69,10
15,0,1,0,1,2020-12-11,Female,32,25-34,2
15,0,0,0,0,2020-12-10,Female,60,55-64,6
15,0,0,0,0,2020-12-13,Male,40,35-44,8
15,1,2,0,3,2020-12-13,Female,61,55-64,11
15,0,0,0,0,2020-12-11,Male,51,45-54,11
15,0,0,0,0,2020-12-12,Female,49,45-54,12
15,0,0,0,0,2020-12-11,Male,74,70-74,14
15,3,4,0,7,2020-12-10,Female,19,15-19,14
15,3,3,0,6,2020-12-09,Female,12,10-14,13
15,1,1,0,2,2020-12-09,Male,13,10-14,13
15,1,3,0,4,2020-12-10,Female,70,70-74,12
15,0,0,0,0,2020-12-13,Female,80,80-84,4
15,0,0,0,0,2020-12-10,Male,19,15-19,5
15,4,13,0,17,2020-12-10,Male,8,5-9,2
15,1,0,0,1,2020-12-09,Female,10,10-14,11
15,0,2,0,2,2020-12-12,Female,65,65-69,11
15,1,0,0,1,2020-12-10,Female,26,25-34,12
15,2,0,0,2,2020-12-14,Male,76,75-79,13
15,2,0,0,2,2020-12-12,Male,52,45-54,8
15,0,0,0,0,2020-12-09,Male,30,25-34,10
15,0,0,0,0,2020-12-09,Female,24,20-24,13
15,0,0,4,4,2020-12-09,Female,43,35-44,2
15,3,1,0,4,2020-12-10,Male,63,55-64,13
15,2,0,0,2,2020-12-14,Female,55,55-64,9
15,0,0,0,0,2020-12-10,Male,64,55-64,12
15,3,0,0,3,2020-12-11,Male,17,15-19,11
15,2,0,0,2,2020-12-12,Male,54,45-54,14
15,0,0,0,0,2020-12-10,Male,60,55-64,7
15,0,0,0,0,2020-12-10,Female,7,5-9,13
15,0,0,0,0,2020-12-11,Male,72,70-74,9
15,2,0,0,2,2020-12-12,Male,72,70-74,9
15,1,0,0,1,2020-12-09,Female,52,45-54,13
15,0,0,0,0,2020-12-12,Male,33,25-34,7
15,0,1,0,1,2020-12-13,Male,85,85+,6
15,0,3,0,3,2020-12-09,Female,71,70-74,12
15,0,0,0,0,2020-12-12,Male,11,10-14,10
15,0,0,0,0,2020-12-14,Male,30,25-34,13
15,2,1,0,3,2020-12-12,Female,19,15-19,8
15,0,0,0,0,2020-12-10,Female,57,55-64,14
15,0,0,0,0,2020-12-10,Male,67,65-69,11
15,0,0,0,0,2020-12-14,Female,85,85+,11
15,0,0,0,0,2020-12-10,Male,52,45-54,12
15,0,5,0,5,2020-12-10,Male,54,45-54,12
15,0,0,0,0,2020-12-13,Male,5,5-9,12
15,2,0,0,2,2020-12-10,Male,66,65-69,14
15,0,2,0,2,2020-12-12,Female,69,65-69,8
15,0,0,0,0,2020-12-14,Male,51,45-54,11
15,0,0,0,0,2020-12-09,Male,46,45-54,12
15,2,0,0,2,2020-12-12,Female,69,65-69,10
15,1,0,0,1,2020-12-10,Male,55,55-64,8
15,1,0,0,1,2020-12-09,Female,25,25-34,8
15,1,0,2,3,2020-12-12,Female,47,45-54,8
15,0,1,0,1,2020-12-09,Female,42,35-44,2
15,2,0,0,2,2020-12-11,Female,6,5-9,2
15,1,0,0,1,2020-12-09,Male,63,55-64,13
15,1,10,0,11,2020-12-12,Male,66,65-69,12
15,2,0,0,2,2020-12-10,Male,7,5-9,14
15,0,0,0,0,2020-12-09,Female,15,15-19,7
15,3,10,0,13,2020-12-12,Male,60,55-64,12
15,0,0,0,0,2020-12-10,Male,58,55-64,14
15,1,7,0,8,2020-12-10,Female,65,65-69,15
15,2,22,0,24,2020-12-12,Male,3,1-4,8
15,1,0,0,1,2020-12-13,Male,52,45-54,7
15,2,27,0,29,2020-12-09,Female,12,10-14,10
15,2,0,1,3,2020-12-14,Female,72,70-74,6
15,2,0,0,2,2020-12-11,Female,24,20-24,11
15,4,1,0,5,2020-12-13,Male,12,10-14,15
15,2,7,0,9,2020-12-10,Male,50,45-54,13
15,0,3,0,3,2020-12-12,Female,52,45-54,7
15,0,0,0,0,2020-12-13,Male,74,70-74,15
15,0,0,0,0,2020-12-09,Male,19,15-19,5
15,0,0,0,0,2020-12-12,Female,66,65-69,10
15,0,0,0,0,2020-12-10,Male,70,70-74,10
15,1,0,0,1,2020-12-09,Male,54,45-54,13
15,0,1,0,1,2020-12-09,Female,69,65-69,14
15,0,4,0,4,2020-12-12,Male,78,75-79,11
15,0,1,0,1,2020-12-15,Female,32,25-34,1
15,1,5,0,6,2020-12-12,Female,56,55-64,10
15,0,0,0,0,2020-12-11,Female,5,5-9,8
15,1,0,0,1,2020-12-12,Female,64,55-64,7
15,2,0,0,2,2020-12-09,Male,66,65-69,12
15,1,0,0,1,2020-12-10,Male,59,55-64,14
15,1,0,0,1,2020-12-09,Male,54,45-54,11
15,0,0,0,0,2020-12-10,Female,25,25-34,14
15,1,0,0,1,2020-12-09,Male,35,35-44,11
15,1,0,0,1,2020-12-13,Male,52,45-54,15
15,0,0,0,0,2020-12-11,Male,30,25-34,14
15,3,0,0,3,2020-12-10,Female,2,1-4,11
15,0,0,0,0,2020-12-12,Female,24,20-24,12
15,1,0,0,1,2020-12-10,Male,34,25-34,11
15,0,0,0,0,2020-12-11,Female,49,45-54,15
15,0,10,0,10,2020-12-09,Male,40,35-44,9
15,0,0,0,0,2020-12-09,Male,70,70-74,12
15,2,2,0,4,2020-12-10,Female,64,55-64,14
15,1,0,0,1,2020-12-11,Male,63,55-64,12
15,0,0,0,0,2020-12-09,Female,20,20-24,2
15,2,2,0,4,2020-12-11,Female,37,35-44,13
15,0,0,0,0,2020-12-10,Female,22,20-24,5
15,2,4,0,6,2020-12-10,Female,61,55-64,13
15,1,0,0,1,2020-12-11,Male,70,70-74,11
15,1,0,0,1,2020-12-14,Female,57,55-64,9
15,0,0,0,0,2020-12-09,Male,32,25-34,3
15,1,0,0,1,2020-12-09,Male,53,45-54,12
15,0,0,0,0,2020-12-10,Male,51,45-54,9
15,0,2,0,2,2020-12-12,Female,66,65-69,15
15,0,2,0,2,2020-12-13,Female,66,65-69,12
15,0,1,0,1,2020-12-12,Female,70,70-74,9
15,3,0,0,3,2020-12-09,Female,6,5-9,10
15,0,1,0,1,2020-12-09,Male,54,45-54,11
15,0,0,0,0,2020-12-09,Male,54,45-54,12
15,5,0,0,5,2020-12-10,Male,2,1-4,5
15,2,0,0,2,2020-12-10,Male,65,65-69,12
15,2,10,0,12,2020-12-10,Male,57,55-64,10
15,2,0,0,2,2020-12-10,Male,40,35-44,14
15,0,1,0,1,2020-12-10,Male,38,35-44,12
15,0,0,0,0,2020-12-13,Male,39,35-44,11
15,3,0,0,3,2020-12-10,Female,21,20-24,12
15,1,0,0,1,2020-12-12,Female,62,55-64,9
15,1,0,0,1,2020-12-12,Female,15,15-19,6
15,1,0,0,1,2020-12-10,Female,6,5-9,14
15,0,0,0,0,2020-12-11,Male,66,65-69,14
15,0,0,0,0,2020-12-12,Male,61,55-64,11
15,2,0,0,2,2020-12-11,Male,63,55-64,12
15,2,0,0,2,2020-12-15,Female,22,20-24,1
15,2,7,0,9,2020-12-15,Male,19,15-19,1
15,0,2,0,2,2020-12-09,Male,73,70-74,12
15,1,0,0,1,2020-12-15,Female,32,25-34,5
15,0,0,0,0,2020-12-15,Female,57,55-64,12
15,2,1,0,3,2020-12-09,Male,70,70-74,13
15,0,0,0,0,2020-12-11,Female,18,15-19,14
15,1,0,0,1,2020-12-09,Male,67,65-69,15
15,0,0,0,0,2020-12-09,Male,57,55-64,13
15,1,0,0,1,2020-12-10,Female,71,70-74,11
15,0,7,0,7,2020-12-12,Female,60,55-64,7
15,2,0,0,2,2020-12-10,Male,6,5-9,15
15,2,0,0,2,2020-12-09,Female,55,55-64,14
15,0,1,0,1,2020-12-10,Female,27,25-34,8
15,3,1,0,4,2020-12-10,Female,5,5-9,9
15,0,0,0,0,2020-12-09,Male,53,45-54,10
15,2,0,0,2,2020-12-10,Female,22,20-24,11
15,0,0,0,0,2020-12-11,Female,35,35-44,11
15,2,2,0,4,2020-12-14,Male,55,55-64,10
15,1,1,0,2,2020-12-10,Male,62,55-64,11
15,0,0,0,0,2020-12-09,Male,53,45-54,9
15,2,1,0,3,2020-12-12,Female,73,70-74,6
15,3,0,0,3,2020-12-09,Female,21,20-24,2
15,2,0,0,2,2020-12-09,Male,4,1-4,2
15,0,0,0,0,2020-12-09,Male,12,10-14,13
15,2,0,0,2,2020-12-10,Male,79,75-79,9
15,1,0,0,1,2020-12-10,Female,65,65-69,11
15,5,0,30,35,2020-12-09,Female,10,10-14,10
15,1,0,0,1,2020-12-09,Male,64,55-64,15
15,1,0,0,1,2020-12-12,Female,51,45-54,11
15,2,0,0,2,2020-12-09,Female,16,15-19,15
15,0,1,0,1,2020-12-12,Female,73,70-74,8
15,0,4,0,4,2020-12-10,Female,56,55-64,9
15,1,0,27,28,2020-12-09,Male,53,45-54,10
15,2,6,0,8,2020-12-10,Male,56,55-64,15
15,0,0,0,0,2020-12-12,Female,22,20-24,3
15,1,0,0,1,2020-12-09,Female,54,45-54,11
15,0,0,0,0,2020-12-13,Male,59,55-64,14
15,0,1,0,1,2020-12-10,Female,59,55-64,13
15,0,3,0,3,2020-12-13,Female,20,20-24,7
15,0,1,0,1,2020-12-13,Female,67,65-69,7
15,0,0,0,0,2020-12-10,Female,23,20-24,13
15,0,0,0,0,2020-12-15,Male,20,20-24,1
15,1,0,0,1,2020-12-15,Female,26,25-34,1
15,1,0,0,1,2020-12-09,Male,32,25-34,12
15,0,0,0,0,2020-12-10,Male,28,25-34,14
15,0,1,0,1,2020-12-11,Male,47,45-54,11
15,0,0,0,0,2020-12-09,Male,0,<1,5
15,0,0,0,0,2020-12-10,Female,6,5-9,14
15,0,2,0,2,2020-12-09,Female,41,35-44,15
15,1,4,0,5,2020-12-09,Male,68,65-69,12
15,2,2,0,4,2020-12-10,Female,73,70-74,8
15,0,0,0,0,2020-12-12,Male,10,10-14,11
15,2,0,0,2,2020-12-11,Male,66,65-69,12
15,3,0,0,3,2020-12-10,Male,14,10-14,5
15,0,4,0,4,2020-12-15,Female,48,45-54,2
15,1,0,0,1,2020-12-09,Male,33,25-34,11
15,1,0,0,1,2020-12-09,Female,61,55-64,10
15,2,1,0,3,2020-12-12,Female,65,65-69,9
15,0,0,0,0,2020-12-10,Male,69,65-69,12
15,3,0,0,3,2020-12-12,Male,53,45-54,10
15,0,0,0,0,2020-12-11,Female,19,15-19,6
15,0,0,0,0,2020-12-11,Female,73,70-74,11
15,0,0,0,0,2020-12-13,Male,59,55-64,10
15,2,0,0,2,2020-12-09,Male,68,65-69,14
15,0,0,0,0,2020-12-10,Male,59,55-64,10
15,1,0,0,1,2020-12-10,Male,58,55-64,11
15,2,0,0,2,2020-12-10,Male,66,65-69,10
15,0,0,0,0,2020-12-10,Female,53,45-54,11
15,0,1,0,1,2020-12-11,Male,50,45-54,11
15,2,0,0,2,2020-12-11,Male,15,15-19,10
15,3,0,0,3,2020-12-09,Male,1,1-4,12
15,0,0,0,0,2020-12-13,Female,31,25-34,11
15,0,1,0,1,2020-12-13,Male,61,55-64,12
15,1,2,0,3,2020-12-13,Female,69,65-69,11
15,0,1,0,1,2020-12-11,Male,67,65-69,15
15,2,34,5,41,2020-12-09,Male,47,45-54,3
15,2,2,0,4,2020-12-12,Male,77,75-79,7
15,0,1,0,1,2020-12-09,Female,24,20-24,2
15,3,0,0,3,2020-12-12,Female,66,65-69,9
15,1,0,0,1,2020-12-11,Female,28,25-34,2
15,1,0,0,1,2020-12-12,Female,23,20-24,9
15,0,0,0,0,2020-12-09,Male,27,25-34,9
15,1,0,0,1,2020-12-10,Female,63,55-64,2
15,1,0,3,4,2020-12-10,Female,48,45-54,9
15,0,2,0,2,2020-12-12,Male,59,55-64,12
15,0,6,0,6,2020-12-11,Female,42,35-44,11
15,0,1,0,1,2020-12-10,Female,23,20-24,2
15,0,0,0,0,2020-12-09,Male,52,45-54,12
15,4,0,0,4,2020-12-13,Female,31,25-34,10
15,0,0,0,0,2020-12-12,Female,46,45-54,13
15,3,4,0,7,2020-12-10,Male,68,65-69,8
15,0,0,3,3,2020-12-10,Male,42,35-44,8
15,0,0,0,0,2020-12-10,Male,52,45-54,4
15,0,0,0,0,2020-12-11,Male,62,55-64,9
15,1,0,0,1,2020-12-14,Male,33,25-34,2
15,0,1,0,1,2020-12-09,Female,42,35-44,11
15,1,0,0,1,2020-12-09,Female,52,45-54,9
15,2,1,0,3,2020-12-12,Female,70,70-74,11
15,3,0,0,3,2020-12-12,Male,18,15-19,13
15,0,2,0,2,2020-12-09,Male,55,55-64,12
15,3,0,0,3,2020-12-13,Female,60,55-64,11
15,1,0,0,1,2020-12-13,Female,36,35-44,9
15,0,0,0,0,2020-12-11,Male,59,55-64,8
15,0,0,0,0,2020-12-09,Male,22,20-24,10
15,0,0,0,0,2020-12-09,Male,31,25-34,10
15,1,0,0,1,2020-12-10,Female,21,20-24,12
15,3,0,0,3,2020-12-13,Female,66,65-69,14
15,2,0,0,2,2020-12-11,Male,51,45-54,13
15,1,0,0,1,2020-12-09,Male,48,45-54,9
15,0,0,0,0,2020-12-09,Male,60,55-64,11
15,1,1,0,2,2020-12-11,Male,69,65-69,10
15,0,2,7,9,2020-12-09,Male,30,25-34,12
15,0,0,0,0,2020-12-11,Male,36,35-44,11
15,0,0,0,0,2020-12-09,Male,6,5-9,8
15,1,0,0,1,2020-12-09,Female,30,25-34,6
15,2,0,0,2,2020-12-10,Female,69,65-69,12
15,1,5,0,6,2020-12-10,Female,56,55-64,5
15,0,1,0,1,2020-12-09,Female,26,25-34,12
15,4,4,0,8,2020-12-11,Female,27,25-34,7
15,1,0,0,1,2020-12-09,Female,60,55-64,12
15,0,0,0,0,2020-12-11,Male,40,35-44,9
15,0,2,0,2,2020-12-10,Male,65,65-69,15
15,1,3,0,4,2020-12-09,Male,52,45-54,9
15,0,1,0,1,2020-12-14,Male,70,70-74,8
15,2,0,0,2,2020-12-09,Female,65,65-69,15
15,1,2,0,3,2020-12-14,Male,62,55-64,10
15,0,0,0,0,2020-12-14,Male,46,45-54,9
15,0,0,0,0,2020-12-09,Female,65,65-69,11
15,0,0,0,0,2020-12-12,Female,56,55-64,3
15,1,2,0,3,2020-12-11,Male,79,75-79,11
15,2,6,46,54,2020-12-12,Male,72,70-74,8
15,0,0,0,0,2020-12-09,Female,6,5-9,2
15,0,0,0,0,2020-12-12,Male,67,65-69,11
15,3,0,0,3,2020-12-14,Male,20,20-24,4
15,2,0,0,2,2020-12-09,Female,26,25-34,2
15,1,0,0,1,2020-12-14,Female,67,65-69,10
15,0,0,0,0,2020-12-10,Female,64,55-64,13
15,1,0,0,1,2020-12-10,Male,59,55-64,15
15,2,0,0,2,2020-12-13,Male,70,70-74,14
15,1,0,0,1,2020-12-09,Male,38,35-44,2
15,1,2,0,3,2020-12-09,Male,51,45-54,14
15,1,0,0,1,2020-12-09,Female,26,25-34,2
15,1,0,0,1,2020-12-10,Male,72,70-74,12
15,2,3,0,5,2020-12-10,Female,77,75-79,9
15,2,1,0,3,2020-12-12,Male,71,70-74,13
15,1,0,0,1,2020-12-10,Female,64,55-64,10
15,6,1,0,7,2020-12-14,Male,21,20-24,4
15,2,0,0,2,2020-12-15,Female,23,20-24,2
15,2,0,0,2,2020-12-09,Male,0,<1,7
15,1,1,0,2,2020-12-09,Female,39,35-44,14
15,1,0,0,1,2020-12-10,Male,62,55-64,13
15,2,0,0,2,2020-12-13,Male,77,75-79,8
15,0,0,0,0,2020-12-09,Male,15,15-19,15
15,0,2,0,2,2020-12-09,Male,40,35-44,12
15,1,1,0,2,2020-12-14,Male,77,75-79,5
15,0,0,0,0,2020-12-10,Male,60,55-64,11
15,1,1,0,2,2020-12-12,Female,67,65-69,10
15,1,1,0,2,2020-12-11,Female,68,65-69,14
15,3,0,0,3,2020-12-14,Female,15,15-19,10
15,0,0,0,0,2020-12-10,Female,28,25-34,13
15,4,0,0,4,2020-12-10,Female,32,25-34,12
15,4,0,0,4,2020-12-13,Female,21,20-24,5
15,0,0,0,0,2020-12-09,Female,33,25-34,11
15,0,0,0,0,2020-12-13,Male,19,15-19,6
15,0,0,0,0,2020-12-09,Female,46,45-54,11
15,1,0,0,1,2020-12-10,Male,32,25-34,10
15,1,0,0,1,2020-12-11,Male,65,65-69,9
15,0,0,0,0,2020-12-12,Female,68,65-69,14
15,1,1,0,2,2020-12-09,Female,17,15-19,11
15,1,0,0,1,2020-12-10,Male,52,45-54,6
15,3,1,0,4,2020-12-14,Female,16,15-19,13
15,0,0,0,0,2020-12-15,Female,24,20-24,1
15,0,0,0,0,2020-12-10,Male,23,20-24,12
15,0,0,0,0,2020-12-10,Male,59,55-64,11
15,0,0,0,0,2020-12-09,Male,43,35-44,8
15,0,0,0,0,2020-12-10,Male,1,1-4,5
15,1,0,0,1,2020-12-10,Male,59,55-64,12
15,2,0,0,2,2020-12-14,Male,26,25-34,12
15,1,0,0,1,2020-12-13,Female,67,65-69,12
15,0,0,0,0,2020-12-11,Female,23,20-24,2
15,2,0,0,2,2020-12-09,Male,57,55-64,10
15,2,1,0,3,2020-12-10,Male,70,70-74,10
15,0,0,0,0,2020-12-10,Male,69,65-69,13
15,1,1,0,2,2020-12-13,Male,59,55-64,12
15,1,0,0,1,2020-12-10,Male,44,35-44,14
15,0,0,0,0,2020-12-09,Male,52,45-54,8
15,0,0,0,0,2020-12-13,Male,21,20-24,7
15,3,0,0,3,2020-12-09,Female,0,<1,12
15,1,1,0,2,2020-12-12,Female,63,55-64,9
15,0,0,0,0,2020-12-11,Male,42,35-44,12
15,1,6,22,29,2020-12-15,Male,8,5-9,8
15,1,0,0,1,2020-12-10,Male,29,25-34,4
15,0,0,0,0,2020-12-10,Male,36,35-44,13
15,0,0,0,0,2020-12-13,Female,23,20-24,8
15,3,0,0,3,2020-12-12,Male,11,10-14,11
15,0,0,0,0,2020-12-10,Male,25,25-34,6
15,0,0,0,0,2020-12-13,Female,68,65-69,5
15,2,0,0,2,2020-12-13,Female,50,45-54,9
15,2,1,0,3,2020-12-12,Female,67,65-69,13
15,1,0,0,1,2020-12-12,Male,50,45-54,12
15,1,0,0,1,2020-12-13,Female,31,25-34,7
15,1,2,0,3,2020-12-12,Female,22,20-24,5
15,1,0,0,1,2020-12-09,Male,51,45-54,14
15,1,1,0,2,2020-12-10,Male,43,35-44,2
15,0,0,0,0,2020-12-13,Female,56,55-64,10
15,0,0,0,0,2020-12-14,Female,25,25-34,8
15,2,1,0,3,2020-12-10,Male,70,70-74,12
15,0,0,0,0,2020-12-09,Female,60,55-64,13
15,0,0,0,0,2020-12-11,Male,40,35-44,11
15,0,3,3,6,2020-12-13,Female,46,45-54,2
15,0,0,0,0,2020-12-11,Male,53,45-54,10
15,0,0,0,0,2020-12-09,Female,31,25-34,14
15,0,0,0,0,2020-12-09,Male,33,25-34,14
15,0,0,0,0,2020-12-09,Male,46,45-54,9
15,1,2,0,3,2020-12-12,Female,55,55-64,11
15,0,0,0,0,2020-12-09,Female,66,65-69,13
15,1,2,0,3,2020-12-11,Female,68,65-69,10
15,2,1,0,3,2020-12-10,Female,10,10-14,9
15,0,0,0,0,2020-12-09,Female,68,65-69,10
15,0,0,0,0,2020-12-11,Female,22,20-24,2
15,0,1,0,1,2020-12-12,Female,69,65-69,11
15,2,0,0,2,2020-12-10,Male,46,45-54,15
15,1,1,0,2,2020-12-11,Female,60,55-64,4
15,0,0,0,0,2020-12-10,Female,55,55-64,14
15,3,2,0,5,2020-12-09,Male,4,1-4,6
15,1,0,0,1,2020-12-09,Female,29,25-34,9
15,0,1,0,1,2020-12-10,Male,29,25-34,11
15,2,3,0,5,2020-12-10,Male,23,20-24,2
15,0,2,0,2,2020-12-09,Male,38,35-44,8
15,1,8,0,9,2020-12-09,Male,68,65-69,12
15,0,0,0,0,2020-12-10,Male,10,10-14,8
15,0,0,0,0,2020-12-15,Male,28,25-34,8
15,3,2,0,5,2020-12-11,Female,55,55-64,5
15,3,0,0,3,2020-12-14,Female,18,15-19,8
15,1,0,0,1,2020-12-12,Male,78,75-79,9
15,2,0,0,2,2020-12-13,Male,68,65-69,7
15,0,0,0,0,2020-12-13,Male,47,45-54,6
15,2,10,0,12,2020-12-12,Female,58,55-64,12
15,5,2,0,7,2020-12-10,Male,19,15-19,11
15,2,0,0,2,2020-12-14,Male,76,75-79,8
15,1,3,0,4,2020-12-12,Male,32,25-34,12
15,2,0,0,2,2020-12-15,Male,18,15-19,1
15,2,0,0,2,2020-12-14,Male,10,10-14,6
15,1,0,0,1,2020-12-09,Female,67,65-69,8
15,1,3,0,4,2020-12-09,Male,58,55-64,12
15,2,0,0,2,2020-12-10,Female,29,25-34,5
15,0,3,0,3,2020-12-11,Male,42,35-44,11
15,3,0,0,3,2020-12-10,Male,11,10-14,12
15,3,2,0,5,2020-12-12,Male,14,10-14,11
15,0,0,0,0,2020-12-11,Male,65,65-69,11
15,1,1,0,2,2020-12-12,Female,66,65-69,12
15,1,0,0,1,2020-12-13,Female,68,65-69,13
15,2,2,0,4,2020-12-12,Male,81,80-84,10
15,0,0,0,0,2020-12-11,Male,51,45-54,10
15,0,0,0,0,2020-12-13,Female,21,20-24,7
15,1,2,0,3,2020-12-10,Female,53,45-54,9
15,0,3,0,3,2020-12-09,Female,47,45-54,11
15,1,0,0,1,2020-12-14,Male,71,70-74,11
15,0,0,0,0,2020-12-12,Female,30,25-34,9
15,0,0,0,0,2020-12-10,Female,24,20-24,12
15,0,0,0,0,2020-12-10,Male,27,25-34,11
15,0,0,0,0,2020-12-10,Male,65,65-69,13
15,1,0,0,1,2020-12-14,Female,62,55-64,13
15,1,0,0,1,2020-12-14,Female,52,45-54,9
15,0,0,0,0,2020-12-10,Male,65,65-69,14
15,0,0,0,0,2020-12-12,Male,57,55-64,9
15,0,0,0,0,2020-12-11,Male,66,65-69,13
15,1,0,0,1,2020-12-10,Male,63,55-64,14
15,0,1,0,1,2020-12-14,Female,69,65-69,10
15,1,2,0,3,2020-12-15,Male,31,25-34,7
15,0,1,0,1,2020-12-12,Female,30,25-34,10
15,1,0,0,1,2020-12-11,Male,72,70-74,13
15,0,2,0,2,2020-12-09,Female,63,55-64,12
15,0,0,0,0,2020-12-10,Female,36,35-44,13
15,2,0,0,2,2020-12-10,Male,71,70-74,10
15,4,0,0,4,2020-12-12,Female,23,20-24,2
15,5,0,0,5,2020-12-09,Female,13,10-14,12
15,0,0,0,0,2020-12-12,Female,61,55-64,13
15,2,0,0,2,2020-12-09,Male,55,55-64,13
15,2,0,0,2,2020-12-10,Male,55,55-64,8
15,0,0,0,0,2020-12-11,Female,42,35-44,9
15,0,0,0,0,2020-12-12,Female,66,65-69,10
15,2,0,0,2,2020-12-13,Female,59,55-64,13
15,1,0,0,1,2020-12-10,Female,22,20-24,11
15,2,1,0,3,2020-12-14,Female,19,15-19,2
15,1,0,0,1,2020-12-13,Male,55,55-64,9
15,0,0,0,0,2020-12-15,Female,31,25-34,12
15,0,0,0,0,2020-12-10,Female,25,25-34,2
15,0,0,0,0,2020-12-10,Male,53,45-54,12
15,0,3,0,3,2020-12-12,Male,40,35-44,11
15,3,2,0,5,2020-12-13,Female,10,10-14,13
15,1,12,0,13,2020-12-11,Male,43,35-44,12
15,3,0,0,3,2020-12-15,Female,19,15-19,1
15,0,0,0,0,2020-12-10,Female,64,55-64,14
15,0,0,0,0,2020-12-14,Male,19,15-19,14
15,1,0,0,1,2020-12-13,Female,66,65-69,12
15,2,19,42,63,2020-12-12,Female,61,55-64,12
15,0,0,0,0,2020-12-15,Male,19,15-19,1
15,0,0,0,0,2020-12-09,Male,60,55-64,7
15,0,1,0,1,2020-12-09,Female,61,55-64,14
15,0,0,0,0,2020-12-09,Male,50,45-54,11
15,0,0,0,0,2020-12-09,Male,44,35-44,14
15,1,0,0,1,2020-12-13,Male,60,55-64,9
15,2,1,0,3,2020-12-10,Male,15,15-19,10
15,1,1,0,2,2020-12-11,Male,71,70-74,10
15,0,4,0,4,2020-12-10,Female,67,65-69,8
15,0,0,0,0,2020-12-14,Female,68,65-69,11
15,1,0,0,1,2020-12-10,Male,70,70-74,11
15,0,0,14,14,2020-12-10,Male,19,15-19,4
15,2,2,0,4,2020-12-11,Male,5,5-9,10
15,0,0,0,0,2020-12-09,Female,70,70-74,13
15,1,11,0,12,2020-12-09,Female,26,25-34,2
15,0,0,0,0,2020-12-09,Male,8,5-9,11
15,2,0,0,2,2020-12-11,Male,67,65-69,11
15,1,0,0,1,2020-12-10,Male,66,65-69,12
15,2,0,0,2,2020-12-15,Male,4,1-4,1
15,0,0,0,0,2020-12-14,Female,23,20-24,5
15,0,0,0,0,2020-12-09,Female,57,55-64,10
15,0,0,0,0,2020-12-12,Male,70,70-74,11
15,0,0,0,0,2020-12-12,Female,33,25-34,8
15,0,0,0,0,2020-12-10,Male,74,70-74,12
15,0,0,0,0,2020-12-10,Female,33,25-34,14
15,0,0,0,0,2020-12-10,Male,52,45-54,14
15,1,0,0,1,2020-12-09,Male,68,65-69,15
15,0,0,0,0,2020-12-12,Male,34,25-34,11
15,0,0,0,0,2020-12-10,Female,52,45-54,9
15,1,3,0,4,2020-12-10,Male,78,75-79,9
15,0,0,0,0,2020-12-10,Female,24,20-24,2
15,0,0,0,0,2020-12-09,Male,19,15-19,12
15,3,1,0,4,2020-12-10,Female,6,5-9,8
15,1,1,0,2,2020-12-09,Female,57,55-64,2
15,0,1,0,1,2020-12-12,Male,42,35-44,7
15,4,5,0,9,2020-12-10,Male,12,10-14,11
15,2,1,0,3,2020-12-10,Female,61,55-64,9
15,0,0,0,0,2020-12-13,Female,35,35-44,7
15,0,0,0,0,2020-12-11,Female,22,20-24,11
15,2,4,0,6,2020-12-12,Male,79,75-79,10
15,2,0,0,2,2020-12-09,Male,53,45-54,12
15,0,0,0,0,2020-12-14,Female,33,25-34,8
15,2,0,0,2,2020-12-14,Female,48,45-54,3
15,3,0,0,3,2020-12-11,Male,9,5-9,4
15,1,1,0,2,2020-12-11,Male,66,65-69,8
15,1,0,0,1,2020-12-13,Male,52,45-54,11
15,1,0,0,1,2020-12-09,Female,53,45-54,8
15,0,0,0,0,2020-12-09,Male,51,45-54,9
15,1,0,0,1,2020-12-11,Male,24,20-24,3
15,3,0,0,3,2020-12-12,Female,43,35-44,14
15,0,0,0,0,2020-12-12,Female,33,25-34,2
15,3,0,0,3,2020-12-12,Female,70,70-74,12
15,1,1,0,2,2020-12-09,Female,24,20-24,13
15,0,0,0,0,2020-12-12,Female,71,70-74,9
15,0,0,0,0,2020-12-15,Male,31,25-34,10
15,0,0,0,0,2020-12-09,Female,69,65-69,15
15,0,0,0,0,2020-12-14,Male,59,55-64,10
15,3,0,0,3,2020-12-13,Female,36,35-44,8
15,2,0,0,2,2020-12-10,Male,14,10-14,11
15,2,0,0,2,2020-12-09,Male,24,20-24,5
15,2,0,0,2,2020-12-09,Male,70,70-74,8
15,2,0,0,2,2020-12-12,Female,51,45-54,13
15,0,3,0,3,2020-12-12,Female,69,65-69,9
15,1,0,0,1,2020-12-09,Male,25,25-34,7
15,0,0,0,0,2020-12-10,Male,33,25-34,12
15,4,0,0,4,2020-12-13,Female,12,10-14,12
15,1,0,0,1,2020-12-11,Female,32,25-34,4
15,3,1,0,4,2020-12-09,Female,2,1-4,12
15,1,6,6,13,2020-12-13,Male,59,55-64,7
15,1,0,0,1,2020-12-09,Male,38,35-44,6
15,0,0,0,0,2020-12-11,Male,45,45-54,10
15,0,0,0,0,2020-12-09,Male,5,5-9,2
15,0,0,0,0,2020-12-14,Female,68,65-69,13
15,1,0,0,1,2020-12-09,Female,59,55-64,13
15,0,3,0,3,2020-12-09,Female,54,45-54,13
15,0,0,0,0,2020-12-10,Female,41,35-44,14
15,2,0,4,6,2020-12-15,Female,14,10-14,1
15,0,0,0,0,2020-12-09,Female,64,55-64,14
15,2,2,0,4,2020-12-11,Male,59,55-64,7
15,3,3,0,6,2020-12-09,Female,10,10-14,9
15,0,1,0,1,2020-12-09,Male,22,20-24,7
15,1,0,0,1,2020-12-09,Female,52,45-54,15
15,0,1,0,1,2020-12-10,Male,40,35-44,11
15,1,2,0,3,2020-12-12,Male,78,75-79,6
15,3,0,20,23,2020-12-10,Male,19,15-19,11
15,0,0,0,0,2020-12-11,Male,78,75-79,14
15,0,0,0,0,2020-12-09,Male,44,35-44,9
15,1,0,0,1,2020-12-09,Female,21,20-24,2
15,1,0,0,1,2020-12-11,Male,67,65-69,15
15,1,0,0,1,2020-12-09,Male,34,25-34,9
15,0,0,0,0,2020-12-10,Female,66,65-69,14
15,0,0,0,0,2020-12-14,Female,65,65-69,9
15,0,0,0,0,2020-12-13,Male,2,1-4,8
15,2,0,0,2,2020-12-12,Male,6,5-9,8
15,0,0,0,0,2020-12-09,Male,48,45-54,14
15,1,0,0,1,2020-12-13,Female,67,65-69,5
15,0,0,0,0,2020-12-10,Male,40,35-44,13
15,1,5,0,6,2020-12-11,Female,66,65-69,15
15,0,0,0,0,2020-12-10,Male,38,35-44,13
15,0,0,0,0,2020-12-12,Male,30,25-34,12
15,2,2,0,4,2020-12-10,Female,62,55-64,12
15,0,0,0,0,2020-12-10,Male,17,15-19,10
15,1,0,0,1,2020-12-12,Male,72,70-74,6
15,0,0,0,0,2020-12-09,Female,54,45-54,11
15,2,0,0,2,2020-12-12,Male,57,55-64,7
15,1,0,0,1,2020-12-09,Female,67,65-69,13
15,1,0,0,1,2020-12-09,Male,48,45-54,8
15,2,0,0,2,2020-12-09,Female,44,35-44,7
15,0,0,0,0,2020-12-10,Male,35,35-44,14
15,0,5,0,5,2020-12-15,Female,19,15-19,4
15,0,0,0,0,2020-12-09,Female,37,35-44,6
15,1,0,0,1,2020-12-11,Male,64,55-64,12
15,0,0,0,0,2020-12-10,Male,41,35-44,13
15,3,1,0,4,2020-12-09,Female,10,10-14,7
15,0,0,0,0,2020-12-09,Male,34,25-34,9
15,2,1,0,3,2020-12-12,Male,69,65-69,8
15,2,0,0,2,2020-12-10,Female,12,10-14,15
15,0,0,0,0,2020-12-09,Female,58,55-64,13
15,2,0,0,2,2020-12-13,Female,52,45-54,11
15,1,0,0,1,2020-12-09,Female,35,35-44,10
15,1,3,0,4,2020-12-10,Male,56,55-64,2
15,1,0,0,1,2020-12-11,Female,59,55-64,13
15,0,0,0,0,2020-12-09,Male,11,10-14,12
15,1,0,0,1,2020-12-12,Male,15,15-19,11
15,1,3,0,4,2020-12-14,Female,62,55-64,6
15,1,0,0,1,2020-12-10,Male,65,65-69,12
15,0,0,0,0,2020-12-09,Female,17,15-19,13
15,2,0,0,2,2020-12-11,Female,49,45-54,13
15,0,0,0,0,2020-12-09,Female,23,20-24,9
15,0,0,0,0,2020-12-14,Female,23,20-24,9
15,0,0,0,0,2020-12-09,Female,21,20-24,10
15,2,0,0,2,2020-12-10,Female,11,10-14,10
15,0,2,0,2,2020-12-11,Male,43,35-44,10
15,3,1,0,4,2020-12-14,Female,15,15-19,10
15,0,0,0,0,2020-12-09,Female,24,20-24,9
15,6,1,0,7,2020-12-11,Female,26,25-34,2
15,0,0,0,0,2020-12-10,Female,37,35-44,2
15,0,0,0,0,2020-12-09,Female,53,45-54,14
15,1,1,0,2,2020-12-14,Male,74,70-74,8
15,0,0,0,0,2020-12-09,Male,39,35-44,12
15,0,0,0,0,2020-12-10,Male,35,35-44,8
15,2,0,0,2,2020-12-12,Male,17,15-19,8
15,0,0,0,0,2020-12-11,Male,35,35-44,9
15,2,0,0,2,2020-12-11,Male,67,65-69,9
15,0,0,0,0,2020-12-12,Female,19,15-19,10
15,1,3,0,4,2020-12-13,Male,66,65-69,12
15,2,0,0,2,2020-12-10,Female,0,<1,6
15,1,1,0,2,2020-12-10,Female,46,45-54,2
15,0,0,0,0,2020-12-12,Female,66,65-69,12
15,1,0,0,1,2020-12-14,Female,12,10-14,7
15,0,0,0,0,2020-12-10,Female,65,65-69,10
15,1,1,0,2,2020-12-10,Female,54,45-54,7
15,1,0,0,1,2020-12-12,Male,52,45-54,6
15,1,0,0,1,2020-12-10,Female,68,65-69,10
15,0,5,0,5,2020-12-10,Male,52,45-54,15
15,1,0,0,1,2020-12-10,Female,41,35-44,10
15,0,0,0,0,2020-12-09,Female,31,25-34,11
15,1,1,0,2,2020-12-11,Male,65,65-69,10
15,2,10,0,12,2020-12-11,Male,67,65-69,13
15,0,1,0,1,2020-12-10,Female,58,55-64,2
15,2,1,0,3,2020-12-09,Female,7,5-9,11
15,1,1,0,2,2020-12-10,Male,40,35-44,6
15,0,0,0,0,2020-12-14,Male,18,15-19,2
15,1,0,0,1,2020-12-11,Female,62,55-64,15
15,1,0,0,1,2020-12-11,Female,29,25-34,8
15,2,0,0,2,2020-12-10,Male,13,10-14,10
15,0,0,0,0,2020-12-15,Female,13,10-14,12
15,0,0,0,0,2020-12-10,Female,28,25-34,9
15,0,0,0,0,2020-12-09,Female,69,65-69,12
15,2,31,0,33,2020-12-09,Male,54,45-54,7
15,0,6,0,6,2020-12-11,Male,27,25-34,12
15,0,0,0,0,2020-12-11,Male,73,70-74,11
15,1,0,0,1,2020-12-13,Male,62,55-64,8
15,1,0,0,1,2020-12-11,Female,21,20-24,4
15,1,0,0,1,2020-12-10,Male,8,5-9,2
15,0,1,0,1,2020-12-12,Male,62,55-64,10
15,3,2,0,5,2020-12-11,Male,23,20-24,10
15,0,0,0,0,2020-12-09,Female,23,20-24,11
15,0,0,0,0,2020-12-11,Male,68,65-69,13
15,0,0,0,0,2020-12-10,Male,44,35-44,11
15,0,2,0,2,2020-12-10,Female,29,25-34,9
15,2,1,0,3,2020-12-10,Male,15,15-19,14
15,0,0,0,0,2020-12-13,Male,30,25-34,8
15,1,4,0,5,2020-12-11,Female,69,65-69,10
15,2,1,0,3,2020-12-14,Female,62,55-64,9
15,1,1,0,2,2020-12-11,Female,22,20-24,2
15,1,0,0,1,2020-12-09,Male,55,55-64,15
15,1,0,0,1,2020-12-09,Female,61,55-64,14
15,0,0,0,0,2020-12-10,Male,67,65-69,12
15,0,0,0,0,2020-12-09,Female,4,1-4,5
15,2,0,0,2,2020-12-09,Male,54,45-54,7
15,2,0,0,2,2020-12-09,Female,61,55-64,14
15,2,0,0,2,2020-12-13,Male,3,1-4,2
15,1,3,0,4,2020-12-11,Male,52,45-54,14
15,0,0,0,0,2020-12-13,Female,51,45-54,7
15,0,4,0,4,2020-12-11,Female,66,65-69,15
15,0,0,0,0,2020-12-09,Male,65,65-69,12
15,1,2,2,5,2020-12-09,Female,59,55-64,12
15,1,1,0,2,2020-12-09,Male,65,65-69,12
15,1,1,0,2,2020-12-09,Male,24,20-24,2
15,0,0,0,0,2020-12-12,Female,68,65-69,11
15,0,0,0,0,2020-12-09,Female,41,35-44,11
15,2,16,0,18,2020-12-12,Male,10,10-14,9
15,1,2,0,3,2020-12-09,Female,63,55-64,14
15,0,1,0,1,2020-12-09,Female,52,45-54,13
15,0,0,0,0,2020-12-11,Female,8,5-9,9
15,0,0,0,0,2020-12-09,Female,65,65-69,11
15,2,0,0,2,2020-12-14,Female,53,45-54,12
15,2,0,0,2,2020-12-09,Female,48,45-54,12
15,1,0,0,1,2020-12-12,Male,66,65-69,12
15,0,0,0,0,2020-12-09,Female,30,25-34,2
15,0,0,0,0,2020-12-09,Male,29,25-34,10
15,1,1,0,2,2020-12-09,Male,58,55-64,8
15,1,2,0,3,2020-12-13,Male,59,55-64,15
15,0,2,0,2,2020-12-15,Male,21,20-24,7
15,1,0,0,1,2020-12-11,Male,66,65-69,10
15,2,0,0,2,2020-12-12,Female,68,65-69,11
15,2,2,0,4,2020-12-11,Male,21,20-24,12
15,1,3,0,4,2020-12-09,Male,58,55-64,14
15,1,1,0,2,2020-12-12,Male,66,65-69,10
15,2,0,0,2,2020-12-10,Male,12,10-14,12
15,0,0,0,0,2020-12-10,Male,41,35-44,11
15,0,3,0,3,2020-12-10,Male,35,35-44,10
15,0,0,0,0,2020-12-10,Male,17,15-19,12
15,0,0,0,0,2020-12-15,Male,50,45-54,11
15,0,1,0,1,2020-12-11,Male,69,65-69,5
15,0,0,1,1,2020-12-12,Male,67,65-69,4
15,0,0,0,0,2020-12-09,Female,21,20-24,2
15,2,0,47,49,2020-12-11,Female,25,25-34,15
15,2,0,0,2,2020-12-11,Male,29,25-34,13
15,0,0,0,0,2020-12-09,Male,34,25-34,10
15,2,0,0,2,2020-12-11,Male,33,25-34,8
15,1,0,0,1,2020-12-12,Female,69,65-69,12
15,1,4,0,5,2020-12-09,Male,66,65-69,8
15,0,1,0,1,2020-12-10,Male,66,65-69,11
15,2,0,0,2,2020-12-12,Female,68,65-69,8
15,0,0,0,0,2020-12-10,Male,35,35-44,11
15,2,0,0,2,2020-12-09,Female,9,5-9,13
15,0,0,0,0,2020-12-10,Female,66,65-69,15
15,0,0,0,0,2020-12-12,Female,50,45-54,8
15,0,0,0,0,2020-12-09,Male,42,35-44,12
15,0,2,0,2,2020-12-12,Female,76,75-79,5
15,1,0,0,1,2020-12-13,Female,61,55-64,9
15,2,0,0,2,2020-12-14,Male,55,55-64,7
15,1,0,0,1,2020-12-09,Male,68,65-69,13
15,4,2,0,6,2020-12-10,Male,9,5-9,15
15,3,1,0,4,2020-12-15,Male,22,20-24,4
15,2,2,0,4,2020-12-13,Female,1,1-4,10
15,3,0,0,3,2020-12-09,Female,32,25-34,10
15,2,0,0,2,2020-12-09,Male,51,45-54,10
15,2,4,0,6,2020-12-15,Male,61,55-64,12
15,1,1,0,2,2020-12-10,Female,61,55-64,12
15,1,1,0,2,2020-12-12,Male,65,65-69,14
15,0,0,0,0,2020-12-13,Female,23,20-24,2
15,2,2,0,4,2020-12-12,Male,52,45-54,14
15,1,0,0,1,2020-12-14,Male,51,45-54,9
15,1,10,0,11,2020-12-10,Male,53,45-54,10
15,1,2,0,3,2020-12-11,Female,60,55-64,10
15,1,2,0,3,2020-12-12,Female,16,15-19,8
15,1,5,0,6,2020-12-10,Female,55,55-64,14
15,1,1,0,2,2020-12-10,Male,32,25-34,11
15,1,0,0,1,2020-12-09,Female,49,45-54,11
15,0,0,0,0,2020-12-11,Male,66,65-69,10
15,1,0,0,1,2020-12-10,Male,67,65-69,13
15,0,0,0,0,2020-12-11,Male,40,35-44,13
15,2,0,0,2,2020-12-11,Male,49,45-54,11
15,0,6,0,6,2020-12-09,Male,41,35-44,15
15,0,1,0,1,2020-12-11,Male,67,65-69,15
15,0,0,0,0,2020-12-13,Female,34,25-34,12
15,1,1,0,2,2020-12-11,Male,63,55-64,10
15,0,0,0,0,2020-12-10,Female,69,65-69,11
15,2,0,0,2,2020-12-10,Male,51,45-54,7
15,0,0,0,0,2020-12-13,Male,55,55-64,11
15,0,0,0,0,2020-12-09,Male,58,55-64,13
15,1,1,0,2,2020-12-09,Male,47,45-54,11
15,3,0,0,3,2020-12-09,Male,7,5-9,2
15,0,0,0,0,2020-12-14,Female,34,25-34,11
15,0,0,0,0,2020-12-12,Male,52,45-54,13
15,1,1,0,2,2020-12-11,Female,39,35-44,5
15,1,0,0,1,2020-12-11,Male,62,55-64,15
15,0,1,0,1,2020-12-09,Female,23,20-24,5
15,0,3,0,3,2020-12-10,Female,67,65-69,15
15,3,0,0,3,2020-12-12,Male,13,10-14,15
15,3,0,0,3,2020-12-12,Female,38,35-44,11
15,0,0,0,0,2020-12-10,Female,38,35-44,11
15,0,0,0,0,2020-12-11,Female,19,15-19,12
15,0,1,0,1,2020-12-09,Male,47,45-54,13
15,0,0,0,0,2020-12-12,Female,58,55-64,10
15,1,0,0,1,2020-12-11,Male,66,65-69,11
15,4,0,0,4,2020-12-11,Female,16,15-19,7
15,1,0,0,1,2020-12-09,Female,23,20-24,9
15,0,0,0,0,2020-12-09,Female,18,15-19,5
15,2,3,0,5,2020-12-10,Female,65,65-69,9
15,0,0,0,0,2020-12-09,Male,27,25-34,11
15,0,1,0,1,2020-12-09,Male,47,45-54,12
15,1,0,0,1,2020-12-12,Male,32,25-34,10
15,0,0,0,0,2020-12-10,Male,52,45-54,12
15,3,0,0,3,2020-12-10,Male,19,15-19,11
15,4,1,0,5,2020-12-12,Female,1,1-4,6
15,2,2,0,4,2020-12-10,Female,14,10-14,9
15,0,0,0,0,2020-12-10,Male,62,55-64,10
15,0,5,0,5,2020-12-10,Female,30,25-34,2
15,2,0,0,2,2020-12-09,Male,14,10-14,14
15,2,2,0,4,2020-12-10,Female,63,55-64,11
15,1,0,2,3,2020-12-11,Male,45,45-54,7
15,0,0,100,100,2020-12-10,Male,43,35-44,14
15,2,2,0,4,2020-12-11,Female,64,55-64,15
15,1,0,0,1,2020-12-11,Female,48,45-54,14
15,2,1,0,3,2020-12-12,Female,11,10-14,11
15,1,0,0,1,2020-12-09,Female,50,45-54,11
15,2,0,0,2,2020-12-10,Male,56,55-64,12
15,0,0,0,0,2020-12-09,Female,42,35-44,2
15,0,4,0,4,2020-12-11,Female,62,55-64,9
15,0,4,0,4,2020-12-14,Female,42,35-44,4
15,0,0,0,0,2020-12-10,Female,59,55-64,10
15,1,0,0,1,2020-12-09,Male,57,55-64,10
15,0,0,0,0,2020-12-13,Male,65,65-69,15
15,1,0,0,1,2020-12-14,Female,54,45-54,5
15,1,0,0,1,2020-12-09,Female,34,25-34,5
15,3,6,0,9,2020-12-11,Female,33,25-34,8
15,1,1,0,2,2020-12-09,Male,61,55-64,14
15,0,0,0,0,2020-12-09,Male,66,65-69,14
15,0,0,0,0,2020-12-09,Female,56,55-64,6
15,1,0,0,1,2020-12-09,Female,59,55-64,13
15,2,1,0,3,2020-12-13,Male,73,70-74,11
15,0,0,0,0,2020-12-09,Male,34,25-34,10
15,1,0,0,1,2020-12-14,Male,62,55-64,9
15,1,0,0,1,2020-12-14,Female,47,45-54,7
15,0,0,0,0,2020-12-10,Male,63,55-64,11
15,0,0,0,0,2020-12-11,Male,25,25-34,8
15,0,0,0,0,2020-12-12,Male,38,35-44,6
15,0,0,0,0,2020-12-11,Female,69,65-69,11
15,2,0,0,2,2020-12-11,Female,65,65-69,11
15,2,2,0,4,2020-12-09,Female,34,25-34,12
15,2,1,0,3,2020-12-10,Male,53,45-54,14
15,0,2,0,2,2020-12-13,Female,35,35-44,8
15,0,0,0,0,2020-12-09,Male,56,55-64,12
15,1,3,0,4,2020-12-09,Female,56,55-64,13
15,0,2,0,2,2020-12-09,Female,67,65-69,14
15,2,0,0,2,2020-12-09,Male,42,35-44,7
15,2,1,0,3,2020-12-13,Male,72,70-74,11
15,1,0,0,1,2020-12-14,Male,66,65-69,11
15,1,0,0,1,2020-12-12,Female,24,20-24,2
15,1,0,0,1,2020-12-12,Female,72,70-74,9
15,1,0,1,2,2020-12-10,Male,31,25-34,11
15,0,0,0,0,2020-12-11,Male,71,70-74,10
15,0,0,0,0,2020-12-10,Female,48,45-54,10
15,2,0,0,2,2020-12-12,Female,70,70-74,12
15,0,0,0,0,2020-12-12,Female,71,70-74,10
15,0,4,0,4,2020-12-09,Male,66,65-69,15
15,0,0,0,0,2020-12-09,Female,26,25-34,11
15,1,0,0,1,2020-12-12,Female,55,55-64,7
15,0,1,0,1,2020-12-12,Female,74,70-74,8
15,2,0,0,2,2020-12-12,Male,80,80-84,10
15,0,0,0,0,2020-12-11,Male,65,65-69,10
15,1,0,0,1,2020-12-09,Female,53,45-54,14
15,0,0,0,0,2020-12-11,Female,67,65-69,4
15,1,0,0,1,2020-12-10,Male,63,55-64,13
15,0,0,0,0,2020-12-09,Male,37,35-44,14
15,0,0,0,0,2020-12-11,Female,67,65-69,9
15,1,0,3,4,2020-12-11,Female,28,25-34,13
15,0,0,0,0,2020-12-12,Female,11,10-14,12
15,0,0,0,0,2020-12-09,Male,54,45-54,13
15,2,0,0,2,2020-12-10,Female,11,10-14,15
15,1,0,0,1,2020-12-09,Male,34,25-34,14
15,0,0,0,0,2020-12-11,Female,72,70-74,13
15,0,0,0,0,2020-12-09,Female,26,25-34,7
15,3,0,0,3,2020-12-09,Male,54,45-54,9
15,3,0,0,3,2020-12-09,Male,41,35-44,12
15,0,2,0,2,2020-12-09,Female,63,55-64,2
15,1,0,0,1,2020-12-15,Female,24,20-24,15
15,1,0,0,1,2020-12-11,Male,32,25-34,11
15,0,3,0,3,2020-12-09,Female,43,35-44,12
15,0,0,0,0,2020-12-13,Male,58,55-64,11
15,1,0,0,1,2020-12-12,Male,55,55-64,11
15,3,4,0,7,2020-12-09,Male,1,1-4,12
15,3,0,0,3,2020-12-10,Female,36,35-44,14
15,1,0,0,1,2020-12-10,Female,59,55-64,13
15,1,0,0,1,2020-12-09,Male,66,65-69,14
15,3,0,0,3,2020-12-10,Male,48,45-54,7
15,0,1,0,1,2020-12-11,Male,76,75-79,9
15,0,2,0,2,2020-12-10,Female,49,45-54,2
15,0,0,0,0,2020-12-09,Male,52,45-54,14
15,1,3,0,4,2020-12-12,Female,75,75-79,8
15,0,0,0,0,2020-12-12,Female,63,55-64,9
15,2,0,0,2,2020-12-11,Male,65,65-69,11
15,0,0,0,0,2020-12-15,Male,31,25-34,1
15,0,0,0,0,2020-12-09,Male,35,35-44,2
15,0,0,0,0,2020-12-11,Male,35,35-44,2
15,0,1,0,1,2020-12-10,Female,66,65-69,14
15,0,0,0,0,2020-12-10,Male,19,15-19,2
15,0,2,0,2,2020-12-11,Female,54,45-54,11
15,1,0,0,1,2020-12-10,Female,46,45-54,12
15,0,0,0,0,2020-12-09,Male,53,45-54,10
15,0,0,0,0,2020-12-12,Female,62,55-64,12
15,0,0,0,0,2020-12-10,Female,23,20-24,6
15,1,1,0,2,2020-12-15,Female,26,25-34,1
15,0,6,0,6,2020-12-11,Male,37,35-44,2
15,2,1,0,3,2020-12-12,Male,74,70-74,11
15,1,2,0,3,2020-12-11,Female,70,70-74,15
15,1,1,0,2,2020-12-09,Female,53,45-54,2
15,2,1,3,6,2020-12-12,Male,73,70-74,8
15,0,5,0,5,2020-12-10,Male,27,25-34,14
15,2,0,0,2,2020-12-14,Female,78,75-79,5
15,1,0,0,1,2020-12-10,Male,28,25-34,15
15,1,0,0,1,2020-12-11,Female,31,25-34,9
15,0,0,0,0,2020-12-12,Female,65,65-69,11
15,1,0,0,1,2020-12-11,Male,42,35-44,12
15,0,0,0,0,2020-12-11,Male,71,70-74,13
15,0,4,0,4,2020-12-13,Male,66,65-69,11
15,0,0,0,0,2020-12-10,Female,68,65-69,15
15,0,1,0,1,2020-12-12,Female,62,55-64,12
15,2,0,0,2,2020-12-12,Male,73,70-74,4
15,0,0,0,0,2020-12-13,Male,60,55-64,12
15,0,0,0,0,2020-12-09,Male,27,25-34,9
15,0,0,0,0,2020-12-10,Male,8,5-9,11
15,0,1,0,1,2020-12-10,Female,34,25-34,11
15,1,2,0,3,2020-12-10,Male,69,65-69,14
15,2,0,0,2,2020-12-11,Female,66,65-69,12
15,0,0,0,0,2020-12-09,Female,40,35-44,2
15,1,1,0,2,2020-12-09,Male,68,65-69,13
15,1,1,0,2,2020-12-11,Male,61,55-64,10
15,3,0,0,3,2020-12-10,Male,19,15-19,2
15,0,0,0,0,2020-12-10,Male,34,25-34,11
15,3,0,0,3,2020-12-11,Male,18,15-19,8
15,1,0,0,1,2020-12-09,Female,62,55-64,12
15,0,0,0,0,2020-12-09,Female,56,55-64,14
15,1,3,0,4,2020-12-11,Male,66,65-69,11
15,1,0,0,1,2020-12-10,Male,55,55-64,10
15,3,0,0,3,2020-12-10,Male,9,5-9,9
15,1,0,0,1,2020-12-09,Male,42,35-44,8
15,0,0,0,0,2020-12-13,Female,53,45-54,9
15,2,2,0,4,2020-12-10,Female,34,25-34,12
15,0,0,0,0,2020-12-09,Female,59,55-64,15
15,0,0,0,0,2020-12-12,Female,67,65-69,2
15,3,0,0,3,2020-12-09,Female,3,1-4,11
15,2,0,0,2,2020-12-14,Male,57,55-64,4
15,1,0,0,1,2020-12-15,Female,23,20-24,1
15,1,0,0,1,2020-12-11,Male,59,55-64,11
15,3,0,0,3,2020-12-10,Male,8,5-9,8
15,4,0,0,4,2020-12-10,Female,54,45-54,10
15,0,0,0,0,2020-12-12,Male,66,65-69,2
15,2,0,0,2,2020-12-09,Female,56,55-64,11
15,1,2,0,3,2020-12-10,Female,60,55-64,14
15,2,0,0,2,2020-12-11,Male,60,55-64,11
15,0,0,0,0,2020-12-10,Male,70,70-74,15
15,2,0,0,2,2020-12-09,Male,47,45-54,6
15,0,2,0,2,2020-12-09,Female,54,45-54,10
15,1,0,0,1,2020-12-11,Male,61,55-64,8
15,2,6,0,8,2020-12-12,Male,66,65-69,5
15,2,2,0,4,2020-12-09,Female,51,45-54,14
15,3,0,0,3,2020-12-12,Male,69,65-69,9
15,3,5,0,8,2020-12-12,Male,71,70-74,10
15,2,5,0,7,2020-12-11,Male,77,75-79,10
15,2,0,0,2,2020-12-10,Male,10,10-14,5
15,2,0,0,2,2020-12-09,Male,52,45-54,8
15,1,1,0,2,2020-12-12,Male,70,70-74,12
15,3,1,0,4,2020-12-15,Male,19,15-19,1
15,3,0,0,3,2020-12-15,Female,18,15-19,11
15,1,0,0,1,2020-12-09,Female,65,65-69,14
15,4,1,0,5,2020-12-14,Male,12,10-14,6
15,0,0,0,0,2020-12-13,Male,57,55-64,9
15,1,0,0,1,2020-12-15,Female,28,25-34,1
15,0,2,0,2,2020-12-09,Female,48,45-54,7
15,0,0,0,0,2020-12-12,Male,60,55-64,9
15,0,0,0,0,2020-12-09,Female,55,55-64,12
15,0,0,0,0,2020-12-10,Male,60,55-64,12
15,0,0,0,0,2020-12-11,Male,36,35-44,9
15,0,0,0,0,2020-12-13,Male,37,35-44,12
15,2,0,0,2,2020-12-11,Female,2,1-4,9
15,1,0,0,1,2020-12-09,Male,18,15-19,2
15,2,0,0,2,2020-12-10,Male,64,55-64,10
15,2,2,0,4,2020-12-11,Male,51,45-54,9
15,0,0,0,0,2020-12-13,Male,74,70-74,8
15,2,3,0,5,2020-12-12,Female,51,45-54,9
15,2,2,0,4,2020-12-10,Female,73,70-74,7
15,2,0,0,2,2020-12-09,Male,10,10-14,8
15,1,5,0,6,2020-12-09,Female,15,15-19,12
15,0,4,0,4,2020-12-10,Male,61,55-64,12
15,1,0,0,1,2020-12-10,Female,55,55-64,8
15,2,4,7,13,2020-12-12,Male,15,15-19,2
15,1,0,0,1,2020-12-09,Male,50,45-54,2
15,1,0,0,1,2020-12-12,Male,53,45-54,7
15,1,10,0,11,2020-12-11,Male,52,45-54,2
15,1,0,0,1,2020-12-10,Male,54,45-54,11
15,2,3,0,5,2020-12-09,Female,65,65-69,13
15,0,0,0,0,2020-12-14,Male,79,75-79,7
15,1,1,0,2,2020-12-13,Male,61,55-64,12
15,3,0,0,3,2020-12-09,Male,18,15-19,14
15,0,1,0,1,2020-12-09,Male,15,15-19,5
15,0,3,0,3,2020-12-12,Male,52,45-54,10
15,0,0,0,0,2020-12-13,Female,61,55-64,12
15,3,0,0,3,2020-12-09,Male,13,10-14,14
15,1,0,0,1,2020-12-10,Female,27,25-34,2
15,0,0,0,0,2020-12-13,Male,40,35-44,10
15,3,21,0,24,2020-12-13,Female,59,55-64,5
15,0,0,0,0,2020-12-15,Female,0,<1,1
15,0,0,0,0,2020-12-12,Female,66,65-69,14
15,0,1,0,1,2020-12-11,Male,64,55-64,6
15,0,0,0,0,2020-12-13,Male,37,35-44,12
15,1,0,0,1,2020-12-11,Female,64,55-64,10
15,0,0,0,0,2020-12-11,Female,67,65-69,14
15,0,0,0,0,2020-12-09,Female,43,35-44,8
15,2,2,0,4,2020-12-11,Female,40,35-44,11
15,0,0,0,0,2020-12-10,Female,67,65-69,12
15,0,0,0,0,2020-12-10,Female,46,45-54,5
15,1,1,0,2,2020-12-11,Female,33,25-34,12
15,1,0,0,1,2020-12-12,Female,51,45-54,14
15,0,0,0,0,2020-12-09,Female,24,20-24,12
15,4,0,0,4,2020-12-11,Female,54,45-54,6
15,0,0,38,38,2020-12-09,Female,19,15-19,11
15,0,0,0,0,2020-12-10,Female,44,35-44,10
15,0,0,0,0,2020-12-09,Female,21,20-24,2
15,1,0,0,1,2020-12-11,Male,66,65-69,8
15,0,0,0,0,2020-12-10,Female,63,55-64,12
15,0,0,0,0,2020-12-10,Female,51,45-54,9
15,0,0,0,0,2020-12-09,Female,67,65-69,12
15,1,0,0,1,2020-12-13,Female,72,70-74,11
15,1,0,0,1,2020-12-09,Male,36,35-44,6
15,0,0,0,0,2020-12-09,Male,58,55-64,14
15,2,17,0,19,2020-12-10,Female,5,5-9,2
15,0,0,0,0,2020-12-11,Female,23,20-24,9
15,1,0,0,1,2020-12-11,Male,79,75-79,11
15,2,2,0,4,2020-12-09,Female,9,5-9,11
15,1,2,0,3,2020-12-11,Male,43,35-44,9
15,2,0,0,2,2020-12-10,Female,63,55-64,10
15,0,0,0,0,2020-12-10,Female,52,45-54,10
15,2,1,0,3,2020-12-11,Male,68,65-69,12
15,1,60,0,61,2020-12-10,Female,55,55-64,12
15,2,0,0,2,2020-12-14,Female,61,55-64,8
15,0,0,0,0,2020-12-13,Male,43,35-44,6
15,1,1,0,2,2020-12-10,Female,61,55-64,10
15,1,0,0,1,2020-12-09,Male,68,65-69,10
15,1,2,0,3,2020-12-10,Male,64,55-64,15
15,2,0,0,2,2020-12-10,Male,73,70-74,12
15,3,0,0,3,2020-12-09,Female,22,20-24,6
15,1,0,0,1,2020-12-12,Female,64,55-64,12
15,1,0,0,1,2020-12-09,Male,54,45-54,11
15,0,0,0,0,2020-12-12,Female,66,65-69,12
15,0,0,0,0,2020-12-12,Female,31,25-34,6
15,0,3,0,3,2020-12-12,Female,72,70-74,13
15,2,0,0,2,2020-12-10,Female,72,70-74,12
15,0,0,0,0,2020-12-12,Female,66,65-69,8
15,1,1,0,2,2020-12-10,Female,49,45-54,14
15,4,0,0,4,2020-12-14,Female,59,55-64,13
15,0,0,0,0,2020-12-09,Female,34,25-34,10
15,0,3,0,3,2020-12-15,Female,34,25-34,1
15,1,0,0,1,2020-12-12,Male,60,55-64,7
15,0,0,0,0,2020-12-09,Female,40,35-44,14
15,0,0,0,0,2020-12-10,Male,55,55-64,15
15,0,0,0,0,2020-12-09,Male,55,55-64,14
15,0,4,0,4,2020-12-11,Female,36,35-44,13
15,3,6,0,9,2020-12-09,Female,5,5-9,11
15,2,1,0,3,2020-12-12,Male,62,55-64,13
15,3,0,0,3,2020-12-09,Male,16,15-19,12
15,1,2,0,3,2020-12-10,Female,57,55-64,10
15,1,0,0,1,2020-12-10,Female,67,65-69,11
15,0,1,0,1,2020-12-12,Female,85,85+,5
15,0,3,0,3,2020-12-11,Female,70,70-74,13
15,1,0,0,1,2020-12-12,Male,74,70-74,15
15,1,0,0,1,2020-12-12,Female,66,65-69,12
15,2,1,0,3,2020-12-11,Male,11,10-14,13
15,1,1,0,2,2020-12-12,Male,73,70-74,12
15,0,0,0,0,2020-12-11,Female,36,35-44,8
15,0,0,0,0,2020-12-13,Female,37,35-44,12
15,3,0,0,3,2020-12-11,Female,7,5-9,8
15,1,0,0,1,2020-12-11,Male,66,65-69,11
15,1,2,0,3,2020-12-10,Female,66,65-69,9
15,1,0,0,1,2020-12-13,Male,67,65-69,12
15,3,0,0,3,2020-12-11,Female,12,10-14,12
15,1,4,0,5,2020-12-11,Male,71,70-74,5
15,0,0,0,0,2020-12-10,Female,51,45-54,10
15,2,0,0,2,2020-12-15,Female,50,45-54,6
15,0,0,0,0,2020-12-10,Male,22,20-24,11
15,3,0,0,3,2020-12-12,Female,4,1-4,10
15,2,0,0,2,2020-12-10,Male,25,25-34,3
15,1,0,0,1,2020-12-09,Male,65,65-69,14
15,1,0,0,1,2020-12-09,Female,29,25-34,11
15,0,0,0,0,2020-12-09,Male,31,25-34,10
15,2,0,0,2,2020-12-13,Female,10,10-14,10
15,0,1,0,1,2020-12-09,Female,24,20-24,7
15,3,2,0,5,2020-12-11,Female,65,65-69,14
15,0,1,0,1,2020-12-11,Female,75,75-79,13
15,0,0,0,0,2020-12-11,Female,37,35-44,9
15,2,0,0,2,2020-12-12,Female,44,35-44,8
15,3,0,0,3,2020-12-13,Male,18,15-19,13
15,3,0,0,3,2020-12-10,Male,34,25-34,9
15,2,0,0,2,2020-12-12,Female,23,20-24,12
15,0,0,0,0,2020-12-12,Male,35,35-44,8
15,0,0,0,0,2020-12-09,Male,19,15-19,12
15,1,0,0,1,2020-12-13,Female,63,55-64,10
15,1,1,0,2,2020-12-10,Male,65,65-69,13
15,0,0,0,0,2020-12-10,Male,56,55-64,4
15,3,0,0,3,2020-12-10,Female,11,10-14,15
15,0,7,0,7,2020-12-10,Female,65,65-69,9
15,1,2,0,3,2020-12-12,Male,54,45-54,11
15,0,0,0,0,2020-12-09,Male,21,20-24,5
15,1,0,0,1,2020-12-10,Male,58,55-64,9
15,1,0,0,1,2020-12-10,Male,62,55-64,15
15,2,0,0,2,2020-12-09,Male,66,65-69,13
15,0,0,0,0,2020-12-13,Female,37,35-44,4
15,2,0,0,2,2020-12-15,Female,18,15-19,1
15,0,0,7,7,2020-12-12,Male,38,35-44,10
15,1,0,0,1,2020-12-14,Female,66,65-69,9
15,0,0,0,0,2020-12-09,Male,28,25-34,9
15,1,1,0,2,2020-12-12,Female,44,35-44,13
15,0,0,0,0,2020-12-11,Female,29,25-34,2
15,1,0,8,9,2020-12-11,Female,62,55-64,10
15,1,3,0,4,2020-12-09,Female,30,25-34,9
15,1,0,0,1,2020-12-10,Female,53,45-54,13
15,0,1,0,1,2020-12-14,Female,25,25-34,5
15,0,0,0,0,2020-12-09,Male,75,75-79,4
15,1,0,0,1,2020-12-10,Female,49,45-54,13
15,0,0,0,0,2020-12-12,Female,73,70-74,7
15,1,0,0,1,2020-12-15,Male,11,10-14,1
15,1,0,0,1,2020-12-12,Male,66,65-69,11
15,0,0,0,0,2020-12-10,Female,25,25-34,14
15,0,6,0,6,2020-12-09,Female,21,20-24,12
15,1,0,0,1,2020-12-10,Male,40,35-44,12
15,1,0,0,1,2020-12-12,Male,62,55-64,12
15,0,0,0,0,2020-12-09,Female,68,65-69,10
15,0,0,0,0,2020-12-13,Male,9,5-9,2
15,1,0,0,1,2020-12-13,Male,67,65-69,13
15,2,0,0,2,2020-12-10,Female,0,<1,6
15,2,0,0,2,2020-12-09,Male,9,5-9,15
15,1,1,0,2,2020-12-14,Female,24,20-24,9
15,4,0,0,4,2020-12-14,Female,10,10-14,9
15,0,0,0,0,2020-12-10,Male,55,55-64,12
15,1,2,0,3,2020-12-11,Male,71,70-74,10
15,2,0,0,2,2020-12-14,Female,60,55-64,12
15,5,0,0,5,2020-12-12,Female,33,25-34,8
15,0,0,0,0,2020-12-10,Male,45,45-54,8
15,1,0,0,1,2020-12-09,Male,1,1-4,5
15,2,0,0,2,2020-12-12,Female,57,55-64,13
15,0,0,0,0,2020-12-14,Female,70,70-74,8
15,3,1,0,4,2020-12-15,Female,23,20-24,1
15,0,0,0,0,2020-12-10,Male,45,45-54,10
15,0,0,0,0,2020-12-09,Female,34,25-34,11
15,3,1,0,4,2020-12-13,Female,33,25-34,13
15,1,0,62,63,2020-12-10,Female,62,55-64,13
15,1,0,0,1,2020-12-14,Female,64,55-64,13
15,3,0,0,3,2020-12-09,Female,43,35-44,11
15,2,2,0,4,2020-12-12,Female,68,65-69,15
15,1,0,0,1,2020-12-10,Male,43,35-44,11
15,1,1,0,2,2020-12-09,Male,50,45-54,13
15,1,0,0,1,2020-12-14,Female,63,55-64,9
15,1,2,0,3,2020-12-10,Female,67,65-69,13
15,0,0,0,0,2020-12-10,Male,17,15-19,15
15,2,0,0,2,2020-12-12,Male,59,55-64,13
15,2,0,0,2,2020-12-11,Female,38,35-44,11
15,3,3,0,6,2020-12-09,Male,12,10-14,8
15,0,0,0,0,2020-12-10,Male,33,25-34,12
15,1,0,0,1,2020-12-11,Female,65,65-69,10
15,1,3,0,4,2020-12-09,Male,68,65-69,15
15,1,0,0,1,2020-12-10,Male,12,10-14,12
15,2,0,0,2,2020-12-09,Male,76,75-79,10
15,1,0,0,1,2020-12-09,Female,58,55-64,15
15,0,0,0,0,2020-12-11,Female,25,25-34,9
15,0,0,2,2,2020-12-13,Male,35,35-44,3
15,6,0,0,6,2020-12-09,Female,19,15-19,14
15,1,0,0,1,2020-12-10,Female,26,25-34,8
15,1,0,0,1,2020-12-14,Male,67,65-69,5
15,1,0,0,1,2020-12-12,Female,66,65-69,6
15,0,0,0,0,2020-12-09,Female,68,65-69,9
15,1,0,0,1,2020-12-09,Female,38,35-44,11
15,2,17,0,19,2020-12-09,Male,10,10-14,11
15,2,0,0,2,2020-12-09,Male,24,20-24,7
15,0,0,0,0,2020-12-09,Male,13,10-14,10
15,2,0,0,2,2020-12-10,Male,15,15-19,9
15,2,2,0,4,2020-12-10,Male,51,45-54,12
15,0,3,0,3,2020-12-09,Male,39,35-44,11
15,0,0,0,0,2020-12-11,Female,34,25-34,13
15,0,10,0,10,2020-12-15,Male,30,25-34,5
15,0,0,0,0,2020-12-14,Female,67,65-69,7
15,6,0,0,6,2020-12-10,Female,19,15-19,2
15,0,1,0,1,2020-12-09,Male,45,45-54,11
15,0,2,0,2,2020-12-09,Female,65,65-69,11
15,0,0,0,0,2020-12-12,Female,76,75-79,6
15,9,0,0,9,2020-12-09,Female,18,15-19,7
15,0,0,0,0,2020-12-09,Female,52,45-54,11
15,0,1,0,1,2020-12-10,Female,28,25-34,2
15,2,0,0,2,2020-12-11,Male,26,25-34,9
15,3,0,0,3,2020-12-14,Female,14,10-14,10
15,0,1,0,1,2020-12-10,Female,28,25-34,12
15,0,14,0,14,2020-12-10,Male,43,35-44,2
15,0,1,0,1,2020-12-14,Female,74,70-74,10
15,2,0,0,2,2020-12-13,Female,67,65-69,7
15,0,0,0,0,2020-12-11,Female,69,65-69,13
15,0,0,0,0,2020-12-15,Male,25,25-34,1
15,0,0,0,0,2020-12-15,Female,20,20-24,1
15,5,2,0,7,2020-12-10,Male,14,10-14,13
15,2,1,0,3,2020-12-09,Female,55,55-64,11
15,0,6,0,6,2020-12-12,Female,27,25-34,9
15,2,0,0,2,2020-12-10,Male,48,45-54,14
15,0,0,0,0,2020-12-09,Female,52,45-54,14
15,0,2,0,2,2020-12-09,Female,38,35-44,10
15,1,0,0,1,2020-12-14,Male,54,45-54,9
15,0,0,0,0,2020-12-10,Male,67,65-69,8
15,1,0,0,1,2020-12-09,Female,39,35-44,2
15,0,1,0,1,2020-12-09,Male,49,45-54,11
15,1,0,0,1,2020-12-09,Male,63,55-64,11
15,1,0,0,1,2020-12-09,Male,35,35-44,11
15,3,0,0,3,2020-12-15,Male,15,15-19,1
15,1,0,0,1,2020-12-14,Female,49,45-54,12
15,1,1,0,2,2020-12-10,Female,51,45-54,7
15,2,0,0,2,2020-12-10,Female,53,45-54,10
15,2,0,0,2,2020-12-11,Male,68,65-69,13
15,2,0,0,2,2020-12-14,Female,48,45-54,13
15,5,1,0,6,2020-12-10,Female,19,15-19,12
15,3,0,0,3,2020-12-12,Male,85,85+,10
15,1,0,0,1,2020-12-10,Female,54,45-54,12
15,2,0,0,2,2020-12-11,Male,12,10-14,8
15,2,0,0,2,2020-12-12,Female,20,20-24,5
15,0,0,0,0,2020-12-12,Male,47,45-54,10
15,2,0,0,2,2020-12-09,Female,66,65-69,10
15,0,0,0,0,2020-12-09,Male,50,45-54,15
15,0,0,0,0,2020-12-13,Male,0,<1,5
15,0,0,0,0,2020-12-10,Male,28,25-34,12
15,1,10,0,11,2020-12-11,Female,38,35-44,2
15,2,0,16,18,2020-12-15,Female,19,15-19,1
15,0,0,0,0,2020-12-13,Female,29,25-34,7
15,2,0,0,2,2020-12-10,Male,64,55-64,14
15,0,1,0,1,2020-12-09,Male,30,25-34,12
15,2,0,0,2,2020-12-14,Female,67,65-69,5
15,0,0,0,0,2020-12-09,Male,43,35-44,13
15,0,0,0,0,2020-12-11,Female,20,20-24,4
15,2,1,0,3,2020-12-09,Female,79,75-79,12
15,1,0,0,1,2020-12-10,Female,70,70-74,13
15,3,0,0,3,2020-12-10,Male,17,15-19,3
15,0,0,0,0,2020-12-10,Female,69,65-69,15
15,1,1,0,2,2020-12-12,Male,71,70-74,13
15,4,0,0,4,2020-12-10,Male,12,10-14,8
15,0,0,0,0,2020-12-09,Male,61,55-64,14
15,0,4,0,4,2020-12-11,Male,66,65-69,6
15,1,2,0,3,2020-12-14,Female,30,25-34,13
15,2,0,0,2,2020-12-10,Female,8,5-9,12
15,3,0,0,3,2020-12-09,Male,12,10-14,11
15,0,1,0,1,2020-12-10,Male,34,25-34,14
15,2,0,0,2,2020-12-10,Male,18,15-19,8
15,3,0,0,3,2020-12-13,Male,4,1-4,5
15,2,0,0,2,2020-12-09,Male,20,20-24,11
16,1,1,0,2,2020-12-23,Male,68,65-69,11
16,1,0,0,1,2020-12-23,Female,69,65-69,11
16,2,0,0,2,2020-12-25,Female,66,65-69,16
16,0,1,0,1,2020-12-24,Female,71,70-74,12
16,2,3,0,5,2020-12-28,Female,3,1-4,2
16,0,0,0,0,2020-12-23,Female,50,45-54,12
16,1,0,0,1,2020-12-23,Female,72,70-74,16
16,0,0,0,0,2020-12-24,Male,30,25-34,13
16,0,0,0,0,2020-12-25,Female,63,55-64,8
16,0,0,0,0,2020-12-27,Female,53,45-54,11
16,0,0,0,0,2020-12-23,Female,67,65-69,10
16,0,0,0,0,2020-12-23,Male,34,25-34,16
16,0,10,0,10,2020-12-25,Female,34,25-34,3
16,0,0,0,0,2020-12-26,Female,59,55-64,12
16,1,0,0,1,2020-12-26,Female,61,55-64,9
16,0,0,0,0,2020-12-26,Male,51,45-54,13
16,1,0,0,1,2020-12-24,Male,50,45-54,11
16,0,0,0,0,2020-12-23,Female,35,35-44,13
16,2,0,0,2,2020-12-23,Male,3,1-4,5
16,3,0,0,3,2020-12-23,Female,57,55-64,13
16,3,0,0,3,2020-12-23,Female,10,10-14,12
16,0,0,0,0,2020-12-23,Male,42,35-44,10
16,1,2,0,3,2020-12-23,Male,66,65-69,10
16,1,0,0,1,2020-12-24,Male,66,65-69,11
16,1,0,0,1,2020-12-23,Male,62,55-64,16
16,1,0,0,1,2020-12-28,Male,7,5-9,11
16,1,0,0,1,2020-12-23,Male,17,15-19,14
16,0,0,0,0,2020-12-23,Male,49,45-54,13
16,2,0,0,2,2020-12-24,Male,51,45-54,3
16,0,0,0,0,2020-12-24,Male,53,45-54,11
16,0,0,0,0,2020-12-23,Female,70,70-74,15
16,1,6,0,7,2020-12-25,Male,68,65-69,14
16,0,0,0,0,2020-12-26,Male,20,20-24,10
16,1,0,0,1,2020-12-24,Female,52,45-54,12
16,1,1,0,2,2020-12-25,Female,69,65-69,12
16,0,0,0,0,2020-12-23,Male,41,35-44,16
16,4,0,0,4,2020-12-23,Male,18,15-19,2
16,1,1,0,2,2020-12-24,Male,58,55-64,10
16,1,2,0,3,2020-12-24,Female,56,55-64,16
16,2,0,0,2,2020-12-25,Female,22,20-24,14
16,2,0,0,2,2020-12-23,Male,52,45-54,14
16,3,0,0,3,2020-12-23,Male,23,20-24,2
16,0,0,0,0,2020-12-23,Male,85,85+,14
16,0,1,0,1,2020-12-25,Female,68,65-69,12
16,3,0,0,3,2020-12-23,Male,4,1-4,6
16,0,0,0,0,2020-12-23,Male,18,15-19,9
16,1,0,0,1,2020-12-23,Male,58,55-64,14
16,0,0,0,0,2020-12-23,Male,67,65-69,15
16,0,0,0,0,2020-12-26,Male,51,45-54,11
16,1,0,0,1,2020-12-24,Male,72,70-74,9
16,0,12,0,12,2020-12-23,Male,76,75-79,12
16,0,0,0,0,2020-12-23,Male,26,25-34,3
16,1,0,0,1,2020-12-23,Male,71,70-74,14
16,0,0,0,0,2020-12-27,Male,37,35-44,7
16,0,4,0,4,2020-12-25,Male,53,45-54,10
16,1,0,0,1,2020-12-25,Male,43,35-44,9
16,3,0,0,3,2020-12-23,Male,43,35-44,10
16,0,0,0,0,2020-12-23,Male,26,25-34,9
16,2,0,0,2,2020-12-27,Male,35,35-44,10
16,1,0,0,1,2020-12-23,Male,41,35-44,13
16,2,0,0,2,2020-12-23,Male,69,65-69,12
16,0,2,0,2,2020-12-25,Female,77,75-79,13
16,4,0,0,4,2020-12-23,Male,2,1-4,9
16,1,0,0,1,2020-12-23,Female,67,65-69,13
16,1,1,0,2,2020-12-23,Male,38,35-44,14
16,1,0,0,1,2020-12-23,Male,63,55-64,13
16,0,4,0,4,2020-12-26,Male,72,70-74,9
16,1,0,0,1,2020-12-23,Female,19,15-19,3
16,0,0,0,0,2020-12-23,Male,85,85+,11
16,2,0,0,2,2020-12-23,Female,71,70-74,11
16,3,0,0,3,2020-12-23,Female,22,20-24,2
16,2,3,0,5,2020-12-23,Male,54,45-54,15
16,0,0,0,0,2020-12-23,Male,31,25-34,8
16,1,1,0,2,2020-12-23,Male,70,70-74,13
16,2,0,0,2,2020-12-23,Female,69,65-69,12
16,2,6,0,8,2020-12-26,Male,66,65-69,9
16,1,1,0,2,2020-12-23,Female,65,65-69,15
16,3,0,0,3,2020-12-23,Male,11,10-14,8
16,2,0,0,2,2020-12-23,Male,67,65-69,15
16,1,0,0,1,2020-12-24,Male,69,65-69,10
16,0,0,0,0,2020-12-24,Male,40,35-44,7
16,0,0,0,0,2020-12-23,Female,11,10-14,2
16,0,1,0,1,2020-12-23,Male,43,35-44,12
16,3,2,0,5,2020-12-26,Female,9,5-9,12
16,0,1,0,1,2020-12-23,Female,24,20-24,3
16,4,0,9,13,2020-12-25,Male,19,15-19,6
16,0,0,0,0,2020-12-26,Male,33,25-34,11
16,1,9,0,10,2020-12-23,Male,69,65-69,16
16,4,0,0,4,2020-12-28,Female,3,1-4,11
16,2,0,0,2,2020-12-23,Female,60,55-64,14
16,3,1,0,4,2020-12-23,Male,17,15-19,13
16,1,0,0,1,2020-12-23,Male,31,25-34,11
16,0,6,0,6,2020-12-24,Female,52,45-54,14
16,1,0,0,1,2020-12-23,Male,49,45-54,14
16,2,0,0,2,2020-12-28,Male,22,20-24,6
16,1,0,0,1,2020-12-23,Female,66,65-69,9
16,0,2,0,2,2020-12-23,Female,63,55-64,14
16,0,0,0,0,2020-12-26,Female,32,25-34,12
16,1,0,0,1,2020-12-23,Female,29,25-34,7
16,0,0,0,0,2020-12-23,Female,31,25-34,15
16,2,0,0,2,2020-12-24,Female,67,65-69,11
16,1,0,0,1,2020-12-23,Male,17,15-19,8
16,1,0,0,1,2020-12-26,Female,62,55-64,14
16,0,0,0,0,2020-12-23,Male,18,15-19,7
16,0,0,0,0,2020-12-26,Female,47,45-54,12
16,0,0,0,0,2020-12-26,Male,68,65-69,10
16,0,0,0,0,2020-12-24,Male,54,45-54,13
16,0,0,0,0,2020-12-23,Male,33,25-34,10
16,1,0,0,1,2020-12-23,Male,57,55-64,11
16,0,1,0,1,2020-12-23,Female,32,25-34,16
16,0,0,0,0,2020-12-23,Male,65,65-69,11
16,2,8,0,10,2020-12-27,Female,45,45-54,4
16,2,6,0,8,2020-12-28,Male,27,25-34,5
16,0,0,0,0,2020-12-23,Female,30,25-34,10
16,0,0,0,0,2020-12-25,Male,35,35-44,5
16,0,0,0,0,2020-12-27,Female,33,25-34,12
16,0,0,0,0,2020-12-24,Male,37,35-44,12
16,1,5,0,6,2020-12-23,Female,62,55-64,12
16,1,0,0,1,2020-12-23,Female,22,20-24,3
16,1,0,0,1,2020-12-23,Male,65,65-69,11
16,0,0,0,0,2020-12-25,Male,63,55-64,14
16,2,0,0,2,2020-12-23,Male,5,5-9,7
16,0,0,0,0,2020-12-26,Male,29,25-34,9
16,0,0,0,0,2020-12-23,Female,26,25-34,11
16,0,0,0,0,2020-12-23,Male,69,65-69,11
16,2,0,0,2,2020-12-24,Male,42,35-44,11
16,2,0,0,2,2020-12-23,Male,58,55-64,15
16,2,0,0,2,2020-12-24,Female,41,35-44,6
16,0,0,0,0,2020-12-24,Female,62,55-64,12
16,0,0,0,0,2020-12-23,Male,69,65-69,12
16,3,0,0,3,2020-12-29,Male,32,25-34,11
16,2,0,0,2,2020-12-26,Male,70,70-74,8
16,3,0,0,3,2020-12-23,Male,24,20-24,8
16,4,0,0,4,2020-12-24,Male,20,20-24,10
16,3,0,0,3,2020-12-24,Female,19,15-19,13
16,1,0,0,1,2020-12-24,Male,65,65-69,14
16,1,0,0,1,2020-12-25,Female,24,20-24,4
16,1,1,0,2,2020-12-24,Female,79,75-79,12
16,1,0,0,1,2020-12-27,Male,56,55-64,13
16,1,0,0,1,2020-12-27,Female,28,25-34,13
16,2,0,0,2,2020-12-23,Female,66,65-69,11
16,2,0,0,2,2020-12-23,Female,56,55-64,11
16,1,1,0,2,2020-12-29,Female,33,25-34,2
16,0,0,0,0,2020-12-24,Male,52,45-54,8
16,1,1,0,2,2020-12-23,Male,70,70-74,13
16,1,2,0,3,2020-12-25,Female,58,55-64,16
16,0,0,0,0,2020-12-27,Female,52,45-54,15
16,0,0,0,0,2020-12-24,Male,28,25-34,12
16,3,0,0,3,2020-12-23,Male,8,5-9,11
16,0,3,0,3,2020-12-23,Female,32,25-34,2
16,3,2,0,5,2020-12-23,Male,65,65-69,12
16,1,3,0,4,2020-12-26,Female,24,20-24,2
16,1,0,0,1,2020-12-23,Female,58,55-64,13
16,0,0,0,0,2020-12-26,Female,66,65-69,15
16,1,0,0,1,2020-12-24,Female,42,35-44,7
16,1,1,0,2,2020-12-23,Female,60,55-64,12
16,0,1,1,2,2020-12-23,Male,70,70-74,16
16,0,0,0,0,2020-12-26,Female,71,70-74,11
16,1,0,0,1,2020-12-24,Male,74,70-74,14
16,0,0,0,0,2020-12-23,Male,50,45-54,10
16,2,0,0,2,2020-12-25,Female,31,25-34,12
16,0,0,0,0,2020-12-26,Female,21,20-24,8
16,2,0,0,2,2020-12-29,Male,33,25-34,8
16,0,0,0,0,2020-12-24,Male,54,45-54,12
16,1,0,0,1,2020-12-27,Male,51,45-54,13
16,0,0,0,0,2020-12-23,Female,24,20-24,5
16,2,1,0,3,2020-12-23,Male,68,65-69,4
16,1,0,0,1,2020-12-23,Female,49,45-54,12
16,0,0,0,0,2020-12-23,Male,11,10-14,11
16,2,79,100,181,2020-12-23,Male,16,15-19,12
16,0,1,0,1,2020-12-24,Male,65,65-69,10
16,1,1,0,2,2020-12-23,Male,68,65-69,13
16,1,0,0,1,2020-12-27,Female,58,55-64,14
16,0,0,0,0,2020-12-23,Male,50,45-54,14
16,0,0,0,0,2020-12-24,Male,14,10-14,13
16,0,0,0,0,2020-12-26,Female,59,55-64,9
16,0,0,0,0,2020-12-23,Male,71,70-74,14
16,0,0,0,0,2020-12-26,Male,40,35-44,10
16,2,0,0,2,2020-12-23,Female,69,65-69,16
16,0,0,0,0,2020-12-23,Male,38,35-44,10
16,2,0,0,2,2020-12-27,Female,34,25-34,5
16,0,0,0,0,2020-12-26,Male,20,20-24,9
16,1,0,0,1,2020-12-25,Female,8,5-9,10
16,2,1,0,3,2020-12-23,Female,73,70-74,9
16,0,0,0,0,2020-12-23,Male,51,45-54,10
16,1,0,0,1,2020-12-23,Female,57,55-64,13
16,1,0,0,1,2020-12-23,Female,60,55-64,16
16,0,0,0,0,2020-12-23,Male,43,35-44,15
16,2,1,0,3,2020-12-23,Male,63,55-64,7
16,2,0,0,2,2020-12-26,Female,63,55-64,12
16,1,0,0,1,2020-12-23,Male,10,10-14,3
16,1,2,0,3,2020-12-23,Female,31,25-34,3
16,2,1,0,3,2020-12-23,Female,53,45-54,15
16,2,3,0,5,2020-12-23,Male,69,65-69,11
16,1,0,0,1,2020-12-25,Male,34,25-34,15
16,0,0,0,0,2020-12-26,Male,48,45-54,11
16,3,2,0,5,2020-12-23,Male,69,65-69,11
16,0,0,0,0,2020-12-26,Male,65,65-69,15
16,3,0,0,3,2020-12-26,Male,6,5-9,12
16,0,6,0,6,2020-12-23,Male,61,55-64,12
16,1,3,0,4,2020-12-23,Male,70,70-74,11
16,2,0,0,2,2020-12-26,Male,20,20-24,2
16,2,0,0,2,2020-12-23,Female,15,15-19,6
16,0,0,0,0,2020-12-28,Male,43,35-44,9
16,0,0,0,0,2020-12-23,Female,56,55-64,14
16,0,0,0,0,2020-12-23,Female,58,55-64,12
16,3,10,0,13,2020-12-24,Male,23,20-24,6
16,0,0,0,0,2020-12-24,Female,66,65-69,14
16,0,0,0,0,2020-12-28,Male,23,20-24,4
16,0,0,0,0,2020-12-27,Female,40,35-44,14
16,0,0,0,0,2020-12-23,Male,44,35-44,9
16,0,1,0,1,2020-12-24,Female,63,55-64,11
16,4,0,0,4,2020-12-25,Female,12,10-14,8
16,1,0,0,1,2020-12-23,Female,61,55-64,16
16,0,0,0,0,2020-12-23,Male,49,45-54,11
16,1,0,0,1,2020-12-23,Female,54,45-54,16
16,0,0,0,0,2020-12-26,Male,56,55-64,12
16,0,3,0,3,2020-12-23,Female,65,65-69,16
16,3,0,0,3,2020-12-23,Female,7,5-9,10
16,4,2,0,6,2020-12-25,Male,6,5-9,9
16,2,0,0,2,2020-12-23,Male,14,10-14,3
16,1,0,0,1,2020-12-23,Male,79,75-79,11
16,0,0,0,0,2020-12-23,Female,67,65-69,11
16,0,0,0,0,2020-12-24,Male,39,35-44,12
16,2,0,0,2,2020-12-23,Female,18,15-19,9
16,0,0,0,0,2020-12-23,Female,55,55-64,13
16,0,0,2,2,2020-12-23,Male,53,45-54,10
16,1,4,0,5,2020-12-23,Male,48,45-54,10
16,1,1,0,2,2020-12-23,Male,69,65-69,14
16,1,1,0,2,2020-12-23,Male,19,15-19,11
16,0,2,0,2,2020-12-25,Male,36,35-44,16
16,2,0,0,2,2020-12-26,Female,49,45-54,8
16,1,0,0,1,2020-12-25,Male,39,35-44,16
16,2,0,0,2,2020-12-23,Female,71,70-74,12
16,2,0,0,2,2020-12-26,Male,62,55-64,15
16,1,0,0,1,2020-12-23,Female,2,1-4,5
16,1,2,0,3,2020-12-23,Female,68,65-69,10
16,0,3,0,3,2020-12-23,Female,70,70-74,10
16,1,1,0,2,2020-12-23,Male,68,65-69,9
16,0,0,0,0,2020-12-23,Male,8,5-9,12
16,1,0,0,1,2020-12-23,Female,33,25-34,11
16,1,0,0,1,2020-12-23,Male,73,70-74,9
16,0,0,0,0,2020-12-23,Male,68,65-69,15
16,0,0,0,0,2020-12-23,Male,37,35-44,8
16,0,4,0,4,2020-12-27,Male,28,25-34,13
16,0,0,0,0,2020-12-24,Female,53,45-54,12
16,3,2,0,5,2020-12-24,Male,8,5-9,12
16,0,1,0,1,2020-12-23,Male,31,25-34,3
16,0,0,0,0,2020-12-25,Male,76,75-79,8
16,0,1,0,1,2020-12-24,Male,47,45-54,10
16,3,0,0,3,2020-12-27,Female,4,1-4,2
16,1,24,0,25,2020-12-23,Male,52,45-54,13
16,0,1,0,1,2020-12-25,Female,70,70-74,10
16,0,10,0,10,2020-12-23,Male,32,25-34,11
16,3,0,0,3,2020-12-25,Male,69,65-69,11
16,2,0,0,2,2020-12-24,Female,69,65-69,13
16,0,0,0,0,2020-12-23,Male,17,15-19,13
16,2,0,0,2,2020-12-24,Male,65,65-69,12
16,0,1,0,1,2020-12-26,Male,49,45-54,13
16,1,1,0,2,2020-12-25,Male,75,75-79,9
16,1,0,0,1,2020-12-23,Female,53,45-54,8
16,0,0,0,0,2020-12-24,Female,60,55-64,10
16,1,0,0,1,2020-12-26,Female,65,65-69,10
16,1,0,0,1,2020-12-23,Male,66,65-69,15
16,0,0,0,0,2020-12-23,Male,65,65-69,15
16,2,1,0,3,2020-12-25,Female,67,65-69,15
16,1,0,0,1,2020-12-23,Male,68,65-69,14
16,0,0,0,0,2020-12-23,Male,40,35-44,9
16,0,0,0,0,2020-12-23,Male,12,10-14,4
16,0,4,0,4,2020-12-23,Female,26,25-34,3
16,3,0,0,3,2020-12-23,Female,17,15-19,12
16,2,2,0,4,2020-12-26,Female,61,55-64,7
16,3,0,0,3,2020-12-23,Male,14,10-14,13
16,0,0,0,0,2020-12-26,Female,20,20-24,9
16,0,0,0,0,2020-12-27,Female,52,45-54,14
16,5,0,0,5,2020-12-24,Male,11,10-14,13
16,5,0,0,5,2020-12-26,Male,27,25-34,8
16,0,0,0,0,2020-12-27,Female,60,55-64,12
16,0,0,0,0,2020-12-24,Male,14,10-14,15
16,3,0,0,3,2020-12-27,Female,1,1-4,9
16,0,2,0,2,2020-12-26,Male,47,45-54,8
16,1,0,0,1,2020-12-23,Male,81,80-84,14
16,4,0,0,4,2020-12-26,Female,6,5-9,6
16,0,0,0,0,2020-12-23,Female,58,55-64,10
16,0,7,0,7,2020-12-27,Female,50,45-54,3
16,0,0,0,0,2020-12-23,Male,49,45-54,12
16,0,1,0,1,2020-12-23,Male,24,20-24,13
16,0,0,0,0,2020-12-27,Male,19,15-19,10
16,2,0,0,2,2020-12-23,Male,71,70-74,14
16,0,0,0,0,2020-12-23,Male,35,35-44,15
16,0,0,0,0,2020-12-23,Female,21,20-24,10
16,0,0,0,0,2020-12-23,Female,35,35-44,9
16,0,0,0,0,2020-12-25,Female,23,20-24,15
16,0,0,0,0,2020-12-26,Female,66,65-69,11
16,0,0,0,0,2020-12-23,Female,5,5-9,12
16,1,0,0,1,2020-12-23,Female,67,65-69,10
16,0,0,0,0,2020-12-24,Male,68,65-69,14
16,0,0,0,0,2020-12-23,Male,22,20-24,8
16,2,0,0,2,2020-12-23,Male,41,35-44,16
16,0,0,0,0,2020-12-27,Female,29,25-34,6
16,3,0,0,3,2020-12-27,Male,50,45-54,10
16,0,0,0,0,2020-12-23,Male,71,70-74,10
16,2,0,0,2,2020-12-23,Male,58,55-64,12
16,2,0,0,2,2020-12-23,Male,33,25-34,3
16,2,0,0,2,2020-12-24,Male,75,75-79,12
16,1,31,0,32,2020-12-23,Male,79,75-79,14
16,0,4,0,4,2020-12-24,Female,68,65-69,10
16,2,60,0,62,2020-12-23,Male,64,55-64,9
16,0,5,0,5,2020-12-23,Female,67,65-69,13
16,0,0,0,0,2020-12-23,Male,20,20-24,3
16,2,2,0,4,2020-12-24,Female,24,20-24,5
16,0,1,0,1,2020-12-23,Female,68,65-69,14
16,0,5,0,5,2020-12-23,Female,28,25-34,3
16,0,0,0,0,2020-12-23,Female,78,75-79,14
16,0,0,0,0,2020-12-23,Female,66,65-69,10
16,0,1,0,1,2020-12-23,Male,67,65-69,4
16,0,0,0,0,2020-12-27,Female,64,55-64,11
16,1,0,0,1,2020-12-24,Male,69,65-69,15
16,0,0,0,0,2020-12-26,Male,11,10-14,6
16,0,0,0,0,2020-12-29,Female,33,25-34,11
16,0,1,0,1,2020-12-23,Male,30,25-34,15
16,0,1,0,1,2020-12-25,Male,54,45-54,4
16,0,0,0,0,2020-12-23,Female,8,5-9,13
16,3,1,0,4,2020-12-23,Female,52,45-54,11
16,0,1,0,1,2020-12-26,Female,52,45-54,13
16,1,0,0,1,2020-12-25,Male,19,15-19,6
16,2,0,0,2,2020-12-24,Female,78,75-79,12
16,1,0,0,1,2020-12-30,Female,22,20-24,1
16,0,0,0,0,2020-12-23,Male,66,65-69,16
16,0,0,0,0,2020-12-24,Male,42,35-44,11
16,1,0,0,1,2020-12-23,Female,69,65-69,12
16,0,0,0,0,2020-12-23,Female,76,75-79,14
16,3,0,0,3,2020-12-25,Male,37,35-44,11
16,0,0,0,0,2020-12-23,Male,26,25-34,3
16,1,0,20,21,2020-12-23,Male,61,55-64,10
16,1,0,0,1,2020-12-24,Female,51,45-54,10
16,1,0,0,1,2020-12-26,Male,68,65-69,15
16,2,0,0,2,2020-12-25,Male,57,55-64,7
16,2,3,0,5,2020-12-25,Female,54,45-54,12
16,0,0,0,0,2020-12-23,Male,62,55-64,12
16,1,3,0,4,2020-12-23,Female,1,1-4,3
16,0,0,0,0,2020-12-23,Female,33,25-34,6
16,0,1,0,1,2020-12-23,Female,60,55-64,7
16,1,0,0,1,2020-12-25,Female,61,55-64,12
16,0,1,0,1,2020-12-27,Male,51,45-54,12
16,0,0,0,0,2020-12-23,Female,49,45-54,13
16,1,4,0,5,2020-12-25,Male,65,65-69,4
16,0,0,0,0,2020-12-23,Male,74,70-74,15
16,3,1,0,4,2020-12-23,Female,17,15-19,15
16,3,0,0,3,2020-12-23,Female,14,10-14,14
16,0,0,0,0,2020-12-23,Male,29,25-34,14
16,1,6,0,7,2020-12-25,Female,70,70-74,13
16,0,4,0,4,2020-12-24,Female,80,80-84,5
16,0,0,0,0,2020-12-23,Male,42,35-44,4
16,4,0,0,4,2020-12-23,Male,7,5-9,3
16,1,0,0,1,2020-12-24,Female,12,10-14,12
16,0,0,0,0,2020-12-23,Female,65,65-69,12
16,1,0,0,1,2020-12-26,Female,26,25-34,13
16,2,0,0,2,2020-12-25,Male,76,75-79,14
16,1,3,0,4,2020-12-25,Male,73,70-74,12
16,0,0,0,0,2020-12-23,Male,30,25-34,11
16,0,0,0,0,2020-12-23,Female,24,20-24,14
16,0,0,0,0,2020-12-24,Female,43,35-44,3
16,3,10,0,13,2020-12-24,Male,63,55-64,14
16,2,0,0,2,2020-12-24,Female,55,55-64,10
16,0,1,0,1,2020-12-24,Male,64,55-64,13
16,2,1,0,3,2020-12-23,Male,16,15-19,12
16,2,0,0,2,2020-12-23,Male,54,45-54,15
16,0,0,0,0,2020-12-26,Male,60,55-64,8
16,0,0,0,0,2020-12-23,Female,7,5-9,14
16,2,2,0,4,2020-12-23,Male,72,70-74,10
16,2,0,0,2,2020-12-23,Male,72,70-74,10
16,1,0,1,2,2020-12-23,Female,52,45-54,14
16,0,0,0,0,2020-12-23,Male,33,25-34,8
16,0,1,0,1,2020-12-26,Male,85,85+,7
16,0,0,0,0,2020-12-25,Male,30,25-34,14
16,2,0,0,2,2020-12-28,Female,19,15-19,9
16,0,1,0,1,2020-12-23,Female,57,55-64,15
16,0,0,0,0,2020-12-24,Male,67,65-69,12
16,0,0,0,0,2020-12-23,Male,52,45-54,13
16,0,2,0,2,2020-12-23,Male,54,45-54,13
16,0,0,0,0,2020-12-24,Male,8,5-9,13
16,2,0,0,2,2020-12-23,Male,66,65-69,15
16,1,0,0,1,2020-12-23,Male,50,45-54,12
16,0,0,0,0,2020-12-27,Female,29,25-34,11
16,0,1,0,1,2020-12-23,Male,46,45-54,13
16,2,0,0,2,2020-12-23,Female,69,65-69,11
16,1,0,0,1,2020-12-29,Female,22,20-24,1
16,1,0,0,1,2020-12-27,Male,55,55-64,9
16,1,1,0,2,2020-12-23,Female,25,25-34,9
16,1,2,0,3,2020-12-23,Female,47,45-54,9
16,0,1,0,1,2020-12-23,Female,42,35-44,3
16,2,0,0,2,2020-12-26,Female,9,5-9,3
16,1,2,0,3,2020-12-24,Male,63,55-64,14
16,1,0,0,1,2020-12-25,Male,66,65-69,13
16,2,0,0,2,2020-12-23,Male,8,5-9,15
16,5,0,0,5,2020-12-26,Female,19,15-19,8
16,3,10,0,13,2020-12-23,Male,60,55-64,13
16,0,0,0,0,2020-12-24,Male,66,65-69,9
16,0,0,4,4,2020-12-23,Male,58,55-64,15
16,1,1,0,2,2020-12-23,Female,65,65-69,16
16,1,0,0,1,2020-12-27,Male,52,45-54,8
16,3,0,0,3,2020-12-25,Female,7,5-9,7
16,2,0,0,2,2020-12-23,Female,12,10-14,11
16,2,5,0,7,2020-12-25,Female,24,20-24,12
16,4,0,0,4,2020-12-25,Male,11,10-14,16
16,2,2,0,4,2020-12-23,Male,50,45-54,14
16,0,0,0,0,2020-12-24,Male,74,70-74,16
16,0,0,0,0,2020-12-23,Male,19,15-19,6
16,0,0,0,0,2020-12-25,Female,67,65-69,11
16,0,0,0,0,2020-12-26,Male,70,70-74,11
16,1,0,0,1,2020-12-23,Male,54,45-54,14
16,0,0,0,0,2020-12-23,Female,69,65-69,15
16,0,0,0,0,2020-12-23,Male,78,75-79,12
16,0,1,0,1,2020-12-23,Female,32,25-34,2
16,0,1,0,1,2020-12-23,Male,85,85+,11
16,1,2,0,3,2020-12-25,Female,56,55-64,11
16,1,0,0,1,2020-12-26,Female,64,55-64,8
16,2,0,0,2,2020-12-26,Female,67,65-69,6
16,2,0,0,2,2020-12-23,Male,66,65-69,13
16,1,1,0,2,2020-12-24,Male,59,55-64,15
16,1,0,0,1,2020-12-23,Male,54,45-54,12
16,0,0,0,0,2020-12-23,Female,25,25-34,15
16,0,0,0,0,2020-12-23,Male,35,35-44,12
16,0,1,0,1,2020-12-23,Male,52,45-54,16
16,0,0,0,0,2020-12-23,Male,30,25-34,15
16,3,0,0,3,2020-12-23,Female,1,1-4,12
16,0,1,0,1,2020-12-23,Female,24,20-24,13
16,1,0,0,1,2020-12-25,Male,34,25-34,12
16,0,1,0,1,2020-12-24,Female,49,45-54,16
16,0,6,0,6,2020-12-27,Male,40,35-44,10
16,0,0,0,0,2020-12-24,Male,70,70-74,13
16,2,1,0,3,2020-12-23,Female,64,55-64,15
16,1,1,0,2,2020-12-24,Male,63,55-64,13
16,1,0,0,1,2020-12-25,Male,37,35-44,8
16,0,0,0,0,2020-12-23,Female,20,20-24,3
16,2,0,0,2,2020-12-26,Female,37,35-44,14
16,1,0,0,1,2020-12-24,Female,47,45-54,4
16,0,0,0,0,2020-12-23,Female,22,20-24,6
16,2,0,0,2,2020-12-24,Female,61,55-64,14
16,1,0,0,1,2020-12-23,Male,70,70-74,12
16,1,0,0,1,2020-12-23,Male,53,45-54,13
16,0,1,0,1,2020-12-23,Female,66,65-69,16
16,0,0,0,0,2020-12-26,Female,66,65-69,13
16,0,3,0,3,2020-12-25,Female,70,70-74,10
16,3,0,0,3,2020-12-23,Female,7,5-9,11
16,0,1,0,1,2020-12-26,Female,53,45-54,10
16,0,0,0,0,2020-12-23,Male,54,45-54,12
16,0,0,0,0,2020-12-23,Male,54,45-54,13
16,1,0,0,1,2020-12-23,Male,65,65-69,13
16,1,0,0,1,2020-12-23,Male,57,55-64,11
16,1,2,0,3,2020-12-25,Female,55,55-64,13
16,2,0,0,2,2020-12-24,Male,40,35-44,15
16,0,0,0,0,2020-12-24,Male,38,35-44,13
16,5,0,0,5,2020-12-24,Female,18,15-19,6
16,0,0,0,0,2020-12-23,Male,39,35-44,12
16,3,4,0,7,2020-12-26,Male,42,35-44,3
16,1,5,0,6,2020-12-26,Female,62,55-64,10
16,3,0,0,3,2020-12-26,Female,15,15-19,7
16,0,0,0,0,2020-12-24,Female,56,55-64,7
16,2,0,0,2,2020-12-24,Female,9,5-9,15
16,0,1,0,1,2020-12-23,Male,66,65-69,15
16,0,0,0,0,2020-12-23,Male,61,55-64,12
16,2,0,0,2,2020-12-23,Male,63,55-64,13
16,0,0,0,0,2020-12-23,Female,22,20-24,2
16,0,2,0,2,2020-12-23,Male,73,70-74,13
16,1,0,0,1,2020-12-23,Female,32,25-34,6
16,0,0,0,0,2020-12-24,Female,57,55-64,13
16,2,0,0,2,2020-12-23,Male,70,70-74,14
16,0,0,0,0,2020-12-23,Female,18,15-19,15
16,1,0,0,1,2020-12-23,Male,63,55-64,15
16,1,0,0,1,2020-12-23,Male,67,65-69,16
16,0,0,0,0,2020-12-25,Male,57,55-64,14
16,1,0,0,1,2020-12-24,Female,71,70-74,12
16,0,0,0,0,2020-12-23,Male,51,45-54,6
16,0,3,0,3,2020-12-24,Female,60,55-64,8
16,0,0,0,0,2020-12-24,Female,61,55-64,2
16,2,0,0,2,2020-12-24,Male,7,5-9,16
16,2,0,0,2,2020-12-23,Female,55,55-64,15
16,0,1,0,1,2020-12-26,Male,58,55-64,9
16,0,0,0,0,2020-12-24,Female,27,25-34,9
16,2,0,0,2,2020-12-28,Female,22,20-24,12
16,2,0,0,2,2020-12-24,Female,67,65-69,4
16,0,0,0,0,2020-12-23,Female,35,35-44,12
16,2,6,45,53,2020-12-23,Male,55,55-64,11
16,1,0,0,1,2020-12-24,Male,62,55-64,12
16,0,0,0,0,2020-12-23,Male,65,65-69,9
16,0,0,1,1,2020-12-25,Male,53,45-54,10
16,2,3,0,5,2020-12-23,Male,30,25-34,6
16,2,2,0,4,2020-12-23,Female,73,70-74,7
16,3,2,0,5,2020-12-23,Female,21,20-24,3
16,2,0,0,2,2020-12-25,Male,3,1-4,3
16,0,0,0,0,2020-12-23,Male,10,10-14,14
16,1,0,0,1,2020-12-23,Female,65,65-69,12
16,5,0,0,5,2020-12-29,Female,11,10-14,11
16,1,0,0,1,2020-12-23,Male,64,55-64,16
16,1,0,0,1,2020-12-25,Female,51,45-54,12
16,2,0,0,2,2020-12-24,Female,16,15-19,16
16,0,1,0,1,2020-12-23,Female,73,70-74,9
16,4,0,0,4,2020-12-24,Female,35,35-44,10
16,0,0,0,0,2020-12-23,Female,56,55-64,10
16,1,0,35,36,2020-12-27,Male,53,45-54,11
16,0,1,0,1,2020-12-25,Female,59,55-64,5
16,2,1,0,3,2020-12-23,Male,56,55-64,16
16,3,0,0,3,2020-12-23,Female,22,20-24,4
16,1,0,0,1,2020-12-23,Female,54,45-54,12
16,0,0,0,0,2020-12-24,Male,59,55-64,15
16,0,1,0,1,2020-12-23,Female,59,55-64,14
16,0,0,0,0,2020-12-23,Female,23,20-24,14
16,3,0,0,3,2020-12-23,Male,20,20-24,2
16,0,0,3,3,2020-12-23,Female,26,25-34,2
16,1,0,0,1,2020-12-23,Male,32,25-34,13
16,0,0,0,0,2020-12-23,Male,28,25-34,15
16,3,4,0,7,2020-12-26,Male,58,55-64,10
16,0,1,0,1,2020-12-28,Male,47,45-54,12
16,0,0,0,0,2020-12-23,Female,8,5-9,15
16,1,0,0,1,2020-12-23,Female,41,35-44,16
16,1,1,0,2,2020-12-23,Male,68,65-69,13
16,0,3,0,3,2020-12-23,Male,73,70-74,7
16,2,2,0,4,2020-12-25,Female,73,70-74,9
16,0,0,0,0,2020-12-23,Male,11,10-14,12
16,2,0,0,2,2020-12-23,Male,66,65-69,13
16,3,5,0,8,2020-12-23,Male,10,10-14,6
16,0,3,0,3,2020-12-25,Female,48,45-54,3
16,1,1,0,2,2020-12-24,Male,33,25-34,12
16,1,0,0,1,2020-12-24,Female,51,45-54,11
16,2,0,0,2,2020-12-24,Female,65,65-69,10
16,0,0,0,0,2020-12-23,Male,69,65-69,13
16,0,0,0,0,2020-12-23,Female,30,25-34,14
16,3,0,1,4,2020-12-24,Male,18,15-19,11
16,0,0,0,0,2020-12-27,Male,49,45-54,6
16,0,0,1,1,2020-12-26,Female,19,15-19,7
16,0,4,0,4,2020-12-25,Female,73,70-74,12
16,2,0,0,2,2020-12-23,Male,68,65-69,15
16,0,0,0,0,2020-12-25,Male,59,55-64,11
16,1,0,0,1,2020-12-23,Male,58,55-64,12
16,0,0,0,0,2020-12-24,Male,66,65-69,11
16,2,1,0,3,2020-12-23,Male,19,15-19,11
16,3,0,0,3,2020-12-25,Male,4,1-4,13
16,0,0,0,0,2020-12-23,Female,31,25-34,12
16,0,1,0,1,2020-12-24,Male,61,55-64,13
16,1,2,0,3,2020-12-25,Female,69,65-69,12
16,0,0,0,0,2020-12-23,Male,67,65-69,16
16,2,0,5,7,2020-12-24,Male,47,45-54,4
16,0,0,0,0,2020-12-28,Female,24,20-24,3
16,1,0,0,1,2020-12-25,Female,28,25-34,3
16,2,0,0,2,2020-12-23,Female,23,20-24,10
16,1,1,0,2,2020-12-24,Female,63,55-64,3
16,0,0,0,0,2020-12-23,Female,69,65-69,7
16,1,0,1,2,2020-12-23,Female,48,45-54,10
16,0,2,0,2,2020-12-23,Male,59,55-64,13
16,0,0,0,0,2020-12-24,Male,37,35-44,14
16,0,1,0,1,2020-12-23,Female,42,35-44,12
16,0,0,0,0,2020-12-23,Male,52,45-54,13
16,4,0,0,4,2020-12-24,Female,31,25-34,11
16,2,0,0,2,2020-12-28,Male,9,5-9,9
16,1,0,0,1,2020-12-23,Female,46,45-54,14
16,3,2,0,5,2020-12-26,Male,68,65-69,9
16,0,0,0,0,2020-12-23,Male,42,35-44,9
16,0,0,0,0,2020-12-24,Male,62,55-64,10
16,1,0,0,1,2020-12-24,Male,55,55-64,13
16,1,6,0,7,2020-12-23,Male,33,25-34,3
16,1,0,0,1,2020-12-24,Female,52,45-54,10
16,2,2,0,4,2020-12-26,Female,70,70-74,12
16,1,0,0,1,2020-12-25,Female,65,65-69,10
16,3,0,0,3,2020-12-23,Male,18,15-19,14
16,0,1,0,1,2020-12-24,Male,55,55-64,13
16,3,1,0,4,2020-12-26,Female,60,55-64,12
16,0,0,0,0,2020-12-25,Female,36,35-44,10
16,0,2,0,2,2020-12-23,Male,59,55-64,9
16,0,0,0,0,2020-12-23,Male,31,25-34,11
16,1,0,0,1,2020-12-23,Female,21,20-24,13
16,2,0,0,2,2020-12-24,Male,51,45-54,14
16,0,4,0,4,2020-12-24,Male,65,65-69,12
16,3,0,2,5,2020-12-26,Female,50,45-54,8
16,1,0,0,1,2020-12-23,Male,48,45-54,10
16,0,0,0,0,2020-12-23,Male,60,55-64,12
16,1,0,0,1,2020-12-23,Male,69,65-69,11
16,0,2,0,2,2020-12-23,Male,30,25-34,13
16,0,0,0,0,2020-12-24,Male,36,35-44,12
16,0,1,0,1,2020-12-23,Male,8,5-9,9
16,1,2,1,4,2020-12-29,Female,30,25-34,7
16,0,0,0,0,2020-12-26,Female,69,65-69,13
16,1,4,0,5,2020-12-26,Female,56,55-64,6
16,0,1,0,1,2020-12-23,Female,26,25-34,13
16,3,0,0,3,2020-12-26,Female,27,25-34,8
16,0,2,0,2,2020-12-24,Female,24,20-24,2
16,1,0,0,1,2020-12-23,Female,60,55-64,13
16,0,1,0,1,2020-12-23,Male,65,65-69,16
16,1,1,0,2,2020-12-23,Male,52,45-54,10
16,0,1,0,1,2020-12-23,Male,70,70-74,9
16,1,0,0,1,2020-12-23,Female,65,65-69,16
16,1,0,0,1,2020-12-23,Male,69,65-69,13
16,1,4,0,5,2020-12-26,Male,62,55-64,11
16,0,2,0,2,2020-12-23,Female,65,65-69,12
16,1,0,0,1,2020-12-23,Male,79,75-79,12
16,2,6,0,8,2020-12-24,Male,72,70-74,9
16,0,0,0,0,2020-12-23,Female,45,45-54,12
16,2,0,0,2,2020-12-23,Female,26,25-34,3
16,1,0,0,1,2020-12-26,Female,67,65-69,11
16,1,0,0,1,2020-12-24,Male,59,55-64,16
16,2,2,0,4,2020-12-25,Male,70,70-74,15
16,1,0,0,1,2020-12-23,Male,38,35-44,3
16,1,3,0,4,2020-12-23,Male,51,45-54,15
16,3,0,0,3,2020-12-23,Male,5,5-9,7
16,2,0,0,2,2020-12-26,Female,77,75-79,10
16,2,0,0,2,2020-12-23,Male,71,70-74,14
16,0,1,0,1,2020-12-23,Female,53,45-54,8
16,1,1,0,2,2020-12-27,Female,64,55-64,11
16,3,0,0,3,2020-12-25,Female,19,15-19,14
16,0,0,0,0,2020-12-29,Male,21,20-24,5
16,0,0,0,0,2020-12-23,Male,0,<1,8
16,1,1,0,2,2020-12-23,Female,39,35-44,15
16,1,0,0,1,2020-12-23,Female,58,55-64,14
16,0,0,0,0,2020-12-24,Male,77,75-79,9
16,3,0,0,3,2020-12-23,Male,17,15-19,16
16,0,0,0,0,2020-12-26,Male,40,35-44,13
16,1,0,0,1,2020-12-23,Male,77,75-79,6
16,0,0,0,0,2020-12-24,Male,67,65-69,12
16,0,0,0,0,2020-12-28,Male,31,25-34,2
16,1,1,0,2,2020-12-26,Female,67,65-69,11
16,1,0,0,1,2020-12-23,Female,68,65-69,15
16,3,2,0,5,2020-12-26,Female,19,15-19,11
16,0,0,0,0,2020-12-23,Female,28,25-34,14
16,4,0,0,4,2020-12-26,Female,32,25-34,13
16,0,0,0,0,2020-12-23,Female,33,25-34,12
16,1,0,0,1,2020-12-28,Female,49,45-54,8
16,1,0,0,1,2020-12-24,Female,46,45-54,12
16,1,0,0,1,2020-12-28,Male,32,25-34,11
16,1,0,0,1,2020-12-23,Male,65,65-69,10
16,0,0,0,0,2020-12-24,Female,68,65-69,15
16,0,0,0,0,2020-12-23,Female,17,15-19,12
16,2,3,0,5,2020-12-23,Female,50,45-54,9
16,1,0,0,1,2020-12-23,Male,62,55-64,7
16,0,0,0,0,2020-12-23,Male,23,20-24,13
16,0,0,0,0,2020-12-23,Male,59,55-64,12
16,0,0,0,0,2020-12-23,Male,43,35-44,9
16,0,0,0,0,2020-12-23,Male,16,15-19,6
16,1,0,0,1,2020-12-23,Male,59,55-64,13
16,2,0,0,2,2020-12-27,Male,26,25-34,13
16,1,0,0,1,2020-12-26,Female,67,65-69,13
16,2,0,0,2,2020-12-25,Female,23,20-24,3
16,2,0,0,2,2020-12-23,Male,57,55-64,11
16,2,2,0,4,2020-12-23,Male,70,70-74,11
16,2,0,0,2,2020-12-23,Male,69,65-69,14
16,1,0,0,1,2020-12-25,Male,59,55-64,13
16,1,5,0,6,2020-12-27,Male,45,45-54,15
16,0,1,0,1,2020-12-23,Male,52,45-54,9
16,2,10,2,14,2020-12-23,Male,30,25-34,12
16,4,0,0,4,2020-12-27,Female,3,1-4,4
16,2,0,0,2,2020-12-24,Male,21,20-24,8
16,3,0,0,3,2020-12-23,Female,0,<1,13
16,1,0,0,1,2020-12-24,Female,63,55-64,10
16,0,0,0,0,2020-12-24,Male,42,35-44,13
16,0,0,0,0,2020-12-28,Female,24,20-24,9
16,3,2,0,5,2020-12-26,Male,14,10-14,12
16,0,0,0,0,2020-12-29,Male,25,25-34,7
16,2,0,0,2,2020-12-27,Female,50,45-54,10
16,1,0,0,1,2020-12-25,Male,50,45-54,13
16,0,1,0,1,2020-12-26,Female,24,20-24,9
16,1,0,0,1,2020-12-25,Male,51,45-54,15
16,1,3,0,4,2020-12-24,Male,43,35-44,3
16,0,3,0,3,2020-12-23,Female,56,55-64,11
16,2,0,0,2,2020-12-24,Male,70,70-74,13
16,2,0,0,2,2020-12-23,Female,60,55-64,14
16,1,0,0,1,2020-12-23,Male,40,35-44,12
16,0,0,0,0,2020-12-23,Female,46,45-54,3
16,0,0,0,0,2020-12-26,Male,53,45-54,11
16,0,4,0,4,2020-12-23,Female,31,25-34,15
16,4,6,0,10,2020-12-23,Female,2,1-4,6
16,0,0,0,0,2020-12-23,Male,33,25-34,15
16,0,3,0,3,2020-12-23,Male,46,45-54,10
16,0,0,0,0,2020-12-23,Female,66,65-69,14
16,0,0,0,0,2020-12-23,Female,68,65-69,11
16,0,0,0,0,2020-12-23,Female,22,20-24,3
16,0,7,0,7,2020-12-28,Male,22,20-24,4
16,0,0,0,0,2020-12-25,Female,69,65-69,12
16,2,0,0,2,2020-12-23,Male,46,45-54,16
16,0,0,0,0,2020-12-27,Female,60,55-64,5
16,3,0,0,3,2020-12-23,Male,2,1-4,7
16,0,0,0,0,2020-12-29,Male,29,25-34,12
16,0,0,0,0,2020-12-23,Male,23,20-24,3
16,1,0,0,1,2020-12-26,Male,60,55-64,7
16,0,0,0,0,2020-12-23,Male,38,35-44,9
16,1,11,0,12,2020-12-24,Male,68,65-69,13
16,0,0,0,0,2020-12-23,Male,10,10-14,9
16,3,0,3,6,2020-12-29,Male,28,25-34,3
16,0,0,0,0,2020-12-25,Male,23,20-24,8
16,3,0,0,3,2020-12-24,Female,17,15-19,9
16,2,1,0,3,2020-12-26,Male,68,65-69,8
16,0,0,0,0,2020-12-24,Male,47,45-54,7
16,1,1,0,2,2020-12-26,Male,73,70-74,9
16,2,0,0,2,2020-12-23,Male,76,75-79,9
16,2,0,0,2,2020-12-28,Male,18,15-19,2
16,3,0,0,3,2020-12-24,Male,13,10-14,7
16,1,1,0,2,2020-12-23,Male,58,55-64,13
16,2,0,0,2,2020-12-23,Female,29,25-34,6
16,0,3,0,3,2020-12-23,Male,42,35-44,12
16,0,0,0,0,2020-12-26,Male,20,20-24,6
16,3,0,0,3,2020-12-23,Male,10,10-14,13
16,3,0,0,3,2020-12-23,Male,10,10-14,12
16,0,0,0,0,2020-12-23,Male,65,65-69,12
16,1,1,0,2,2020-12-23,Female,66,65-69,13
16,1,0,0,1,2020-12-24,Female,68,65-69,14
16,2,0,0,2,2020-12-23,Female,81,80-84,11
16,0,0,0,0,2020-12-27,Male,51,45-54,11
16,0,0,0,0,2020-12-25,Female,21,20-24,8
16,2,2,0,4,2020-12-25,Female,62,55-64,9
16,0,7,3,10,2020-12-24,Female,47,45-54,12
16,1,0,0,1,2020-12-23,Male,71,70-74,12
16,0,0,0,0,2020-12-29,Female,30,25-34,10
16,0,0,0,0,2020-12-23,Female,22,20-24,13
16,0,0,0,0,2020-12-24,Male,27,25-34,12
16,2,0,0,2,2020-12-24,Female,69,65-69,4
16,1,0,0,1,2020-12-23,Female,62,55-64,14
16,1,0,0,1,2020-12-24,Female,52,45-54,10
16,0,1,0,1,2020-12-23,Male,65,65-69,15
16,0,0,0,0,2020-12-23,Male,57,55-64,10
16,0,0,0,0,2020-12-23,Male,66,65-69,14
16,1,0,0,1,2020-12-23,Male,63,55-64,15
16,0,3,0,3,2020-12-26,Female,69,65-69,11
16,2,0,0,2,2020-12-23,Female,69,65-69,9
16,1,1,0,2,2020-12-23,Male,31,25-34,8
16,0,0,0,0,2020-12-27,Female,30,25-34,11
16,1,0,0,1,2020-12-23,Male,72,70-74,14
16,2,1,0,3,2020-12-25,Female,46,45-54,7
16,0,6,0,6,2020-12-23,Female,63,55-64,13
16,0,0,0,0,2020-12-23,Female,36,35-44,14
16,2,0,0,2,2020-12-23,Male,71,70-74,11
16,4,0,0,4,2020-12-23,Female,23,20-24,3
16,0,0,0,0,2020-12-26,Male,43,35-44,6
16,5,0,0,5,2020-12-23,Female,15,15-19,13
16,3,3,0,6,2020-12-23,Female,65,65-69,15
16,0,0,0,0,2020-12-23,Female,61,55-64,14
16,1,0,0,1,2020-12-27,Male,26,25-34,10
16,2,0,0,2,2020-12-23,Male,55,55-64,14
16,0,0,0,0,2020-12-23,Female,66,65-69,11
16,1,0,0,1,2020-12-23,Female,22,20-24,12
16,1,1,0,2,2020-12-23,Female,19,15-19,3
16,1,0,0,1,2020-12-24,Male,55,55-64,10
16,0,0,0,0,2020-12-23,Female,31,25-34,13
16,0,0,0,0,2020-12-23,Female,25,25-34,3
16,0,0,0,0,2020-12-23,Male,53,45-54,13
16,0,3,0,3,2020-12-24,Male,40,35-44,12
16,3,1,0,4,2020-12-23,Female,13,10-14,14
16,1,1,0,2,2020-12-23,Male,43,35-44,13
16,0,0,0,0,2020-12-23,Female,19,15-19,2
16,3,0,0,3,2020-12-23,Male,17,15-19,9
16,0,5,0,5,2020-12-26,Female,64,55-64,15
16,0,0,0,0,2020-12-24,Male,19,15-19,15
16,3,0,0,3,2020-12-27,Female,18,15-19,2
16,1,0,0,1,2020-12-26,Female,66,65-69,13
16,2,0,0,2,2020-12-24,Female,61,55-64,13
16,3,4,0,7,2020-12-24,Male,18,15-19,2
16,0,0,0,0,2020-12-23,Male,60,55-64,8
16,0,4,0,4,2020-12-23,Female,61,55-64,15
16,0,0,0,0,2020-12-23,Male,50,45-54,12
16,2,0,0,2,2020-12-23,Male,16,15-19,11
16,1,1,0,2,2020-12-24,Male,71,70-74,11
16,0,6,0,6,2020-12-26,Female,67,65-69,9
16,0,2,0,2,2020-12-24,Female,68,65-69,12
16,1,0,0,1,2020-12-24,Male,70,70-74,12
16,0,1,0,1,2020-12-28,Male,23,20-24,7
16,0,0,0,0,2020-12-27,Male,17,15-19,5
16,2,0,0,2,2020-12-23,Male,8,5-9,11
16,0,0,0,0,2020-12-26,Female,70,70-74,14
16,3,10,0,13,2020-12-23,Male,26,25-34,3
16,0,0,0,0,2020-12-23,Male,35,35-44,12
16,2,0,0,2,2020-12-26,Male,67,65-69,12
16,1,0,0,1,2020-12-24,Male,66,65-69,13
16,0,0,0,0,2020-12-23,Female,28,25-34,2
16,0,0,0,0,2020-12-23,Female,57,55-64,11
16,0,1,0,1,2020-12-23,Male,70,70-74,12
16,0,0,0,0,2020-12-23,Female,33,25-34,9
16,0,5,0,5,2020-12-23,Male,74,70-74,13
16,0,0,0,0,2020-12-26,Female,33,25-34,15
16,0,0,0,0,2020-12-25,Male,52,45-54,15
16,1,0,0,1,2020-12-23,Male,68,65-69,16
16,0,0,0,0,2020-12-25,Male,34,25-34,12
16,0,0,0,0,2020-12-27,Female,52,45-54,10
16,1,0,0,1,2020-12-23,Male,78,75-79,10
16,3,0,0,3,2020-12-26,Male,6,5-9,7
16,0,0,0,0,2020-12-24,Male,51,45-54,13
16,3,0,0,3,2020-12-23,Female,7,5-9,9
16,1,0,0,1,2020-12-23,Female,57,55-64,3
16,0,2,0,2,2020-12-26,Male,42,35-44,8
16,3,0,0,3,2020-12-23,Male,12,10-14,12
16,0,0,0,0,2020-12-26,Female,22,20-24,12
16,2,4,0,6,2020-12-24,Male,79,75-79,11
16,2,0,0,2,2020-12-23,Male,53,45-54,13
16,1,0,0,1,2020-12-23,Female,33,25-34,9
16,1,0,0,1,2020-12-25,Male,52,45-54,12
16,3,0,0,3,2020-12-24,Female,43,35-44,15
16,0,0,0,0,2020-12-23,Female,33,25-34,3
16,1,1,0,2,2020-12-23,Female,24,20-24,14
16,0,4,0,4,2020-12-26,Female,71,70-74,10
16,0,0,0,0,2020-12-25,Male,31,25-34,11
16,0,0,0,0,2020-12-24,Female,69,65-69,16
16,0,0,0,0,2020-12-26,Male,59,55-64,11
16,3,0,0,3,2020-12-27,Female,36,35-44,9
16,2,0,0,2,2020-12-27,Male,12,10-14,12
16,2,0,0,2,2020-12-26,Male,24,20-24,6
16,1,0,0,1,2020-12-23,Male,70,70-74,9
16,2,0,0,2,2020-12-25,Female,51,45-54,14
16,0,3,0,3,2020-12-24,Female,69,65-69,10
16,2,0,0,2,2020-12-23,Male,33,25-34,13
16,4,0,0,4,2020-12-26,Female,11,10-14,13
16,1,0,0,1,2020-12-26,Female,32,25-34,5
16,3,0,0,3,2020-12-24,Female,2,1-4,13
16,1,14,9,24,2020-12-24,Male,59,55-64,8
16,1,1,0,2,2020-12-24,Male,38,35-44,7
16,0,0,0,0,2020-12-23,Male,45,45-54,11
16,0,0,0,0,2020-12-23,Male,8,5-9,3
16,0,0,0,0,2020-12-25,Female,68,65-69,14
16,1,0,0,1,2020-12-25,Female,59,55-64,14
16,0,4,0,4,2020-12-23,Female,54,45-54,14
16,0,0,0,0,2020-12-23,Female,41,35-44,15
16,0,0,0,0,2020-12-23,Male,40,35-44,9
16,2,1,0,3,2020-12-26,Male,59,55-64,8
16,3,2,0,5,2020-12-23,Female,13,10-14,10
16,0,1,0,1,2020-12-24,Male,22,20-24,8
16,1,0,0,1,2020-12-24,Female,52,45-54,16
16,0,0,0,0,2020-12-24,Male,40,35-44,12
16,3,0,0,3,2020-12-23,Male,17,15-19,12
16,0,3,0,3,2020-12-23,Male,78,75-79,15
16,0,0,0,0,2020-12-23,Male,44,35-44,10
16,1,0,0,1,2020-12-23,Female,21,20-24,3
16,1,0,0,1,2020-12-23,Male,67,65-69,16
16,0,0,0,0,2020-12-29,Female,29,25-34,8
16,2,0,0,2,2020-12-23,Female,66,65-69,15
16,2,0,0,2,2020-12-26,Female,11,10-14,9
16,0,0,0,0,2020-12-24,Male,48,45-54,15
16,1,0,0,1,2020-12-23,Male,65,65-69,10
16,0,0,0,0,2020-12-23,Male,40,35-44,14
16,1,5,0,6,2020-12-24,Female,66,65-69,16
16,2,0,0,2,2020-12-23,Male,74,70-74,12
16,0,0,0,0,2020-12-23,Male,30,25-34,13
16,2,1,0,3,2020-12-24,Female,62,55-64,13
16,0,0,0,0,2020-12-23,Male,19,15-19,11
16,0,0,0,0,2020-12-23,Female,54,45-54,12
16,0,0,0,0,2020-12-25,Male,57,55-64,8
16,1,0,0,1,2020-12-26,Female,67,65-69,14
16,1,1,0,2,2020-12-23,Male,48,45-54,9
16,2,0,5,7,2020-12-23,Female,43,35-44,8
16,0,0,0,0,2020-12-24,Male,40,35-44,15
16,0,0,0,0,2020-12-26,Female,19,15-19,5
16,0,0,0,0,2020-12-23,Female,37,35-44,7
16,1,0,0,1,2020-12-23,Male,64,55-64,13
16,0,0,0,0,2020-12-24,Male,41,35-44,14
16,0,2,0,2,2020-12-23,Female,13,10-14,8
16,0,0,0,0,2020-12-26,Male,34,25-34,10
16,2,0,0,2,2020-12-23,Male,69,65-69,9
16,2,0,0,2,2020-12-27,Female,42,35-44,16
16,1,2,0,3,2020-12-23,Male,67,65-69,5
16,0,0,0,0,2020-12-23,Female,58,55-64,14
16,2,0,0,2,2020-12-26,Female,52,45-54,12
16,1,0,0,1,2020-12-23,Female,35,35-44,11
16,2,0,0,2,2020-12-27,Female,58,55-64,8
16,1,0,0,1,2020-12-23,Female,59,55-64,14
16,0,0,0,0,2020-12-23,Male,14,10-14,13
16,1,0,2,3,2020-12-25,Male,15,15-19,12
16,1,4,0,5,2020-12-24,Female,62,55-64,7
16,0,0,0,0,2020-12-23,Male,65,65-69,13
16,0,0,0,0,2020-12-23,Female,17,15-19,14
16,1,0,0,1,2020-12-23,Female,49,45-54,14
16,0,0,0,0,2020-12-25,Female,23,20-24,10
16,0,0,0,0,2020-12-29,Female,23,20-24,10
16,0,0,0,0,2020-12-23,Female,21,20-24,11
16,0,2,0,2,2020-12-25,Male,43,35-44,11
16,3,1,0,4,2020-12-28,Female,16,15-19,11
16,0,0,0,0,2020-12-23,Female,69,65-69,8
16,3,0,0,3,2020-12-23,Female,24,20-24,10
16,1,3,0,4,2020-12-27,Female,7,5-9,7
16,0,1,0,1,2020-12-23,Female,53,45-54,15
16,1,1,0,2,2020-12-23,Male,74,70-74,9
16,0,0,0,0,2020-12-23,Male,39,35-44,13
16,3,0,0,3,2020-12-26,Male,15,15-19,9
16,0,0,0,0,2020-12-27,Male,35,35-44,10
16,2,0,0,2,2020-12-24,Male,67,65-69,10
16,0,0,0,0,2020-12-27,Female,19,15-19,11
16,1,0,0,1,2020-12-26,Male,66,65-69,13
16,3,0,0,3,2020-12-24,Female,0,<1,7
16,1,1,0,2,2020-12-23,Female,25,25-34,3
16,0,1,0,1,2020-12-23,Female,66,65-69,13
16,0,0,0,0,2020-12-23,Female,65,65-69,11
16,2,0,0,2,2020-12-23,Male,43,35-44,5
16,1,4,0,5,2020-12-23,Female,54,45-54,8
16,1,0,0,1,2020-12-26,Male,52,45-54,7
16,0,6,0,6,2020-12-23,Male,52,45-54,16
16,0,2,0,2,2020-12-24,Female,31,25-34,12
16,1,4,0,5,2020-12-23,Male,65,65-69,11
16,2,11,0,13,2020-12-23,Male,67,65-69,14
16,0,1,0,1,2020-12-24,Female,58,55-64,3
16,1,0,0,1,2020-12-23,Female,76,75-79,9
16,2,2,0,4,2020-12-23,Female,9,5-9,12
16,0,0,0,0,2020-12-28,Male,16,15-19,3
16,1,0,0,1,2020-12-24,Female,62,55-64,16
16,3,0,0,3,2020-12-26,Male,8,5-9,2
16,1,0,0,1,2020-12-23,Female,29,25-34,9
16,2,0,0,2,2020-12-23,Male,13,10-14,11
16,0,0,0,0,2020-12-23,Female,12,10-14,13
16,0,0,0,0,2020-12-28,Female,28,25-34,10
16,0,0,0,0,2020-12-23,Female,69,65-69,13
16,0,0,0,0,2020-12-23,Male,27,25-34,13
16,0,0,0,0,2020-12-25,Female,56,55-64,6
16,0,0,0,0,2020-12-23,Male,73,70-74,12
16,1,2,0,3,2020-12-25,Male,62,55-64,9
16,0,0,0,0,2020-12-24,Female,30,25-34,5
16,2,0,20,22,2020-12-26,Male,8,5-9,3
16,0,0,0,0,2020-12-24,Male,62,55-64,11
16,3,2,0,5,2020-12-23,Male,22,20-24,11
16,0,0,0,0,2020-12-23,Male,68,65-69,14
16,0,2,0,2,2020-12-23,Male,44,35-44,12
16,0,0,0,0,2020-12-29,Female,29,25-34,10
16,1,0,0,1,2020-12-25,Male,55,55-64,11
16,2,0,0,2,2020-12-23,Male,52,45-54,15
16,0,0,0,0,2020-12-23,Male,30,25-34,9
16,1,3,0,4,2020-12-23,Female,69,65-69,11
16,2,0,0,2,2020-12-23,Female,73,70-74,6
16,1,0,0,1,2020-12-24,Female,68,65-69,13
16,1,2,0,3,2020-12-23,Male,55,55-64,16
16,1,0,0,1,2020-12-23,Female,61,55-64,15
16,0,0,0,0,2020-12-23,Male,67,65-69,13
16,0,0,0,0,2020-12-23,Female,1,1-4,6
16,2,0,0,2,2020-12-23,Female,61,55-64,15
16,2,0,0,2,2020-12-24,Male,1,1-4,3
16,1,0,0,1,2020-12-24,Male,52,45-54,15
16,0,0,0,0,2020-12-23,Female,51,45-54,8
16,0,3,0,3,2020-12-23,Female,66,65-69,16
16,4,0,0,4,2020-12-28,Female,45,45-54,8
16,0,0,0,0,2020-12-23,Male,65,65-69,13
16,1,1,0,2,2020-12-23,Female,59,55-64,13
16,1,0,0,1,2020-12-23,Male,25,25-34,3
16,0,0,0,0,2020-12-23,Female,38,35-44,12
16,2,1,0,3,2020-12-27,Male,11,10-14,10
16,1,3,0,4,2020-12-23,Female,63,55-64,15
16,0,1,0,1,2020-12-27,Female,52,45-54,14
16,0,0,0,0,2020-12-23,Female,65,65-69,12
16,2,0,0,2,2020-12-24,Female,53,45-54,13
16,2,0,0,2,2020-12-23,Female,48,45-54,13
16,1,0,0,1,2020-12-23,Male,66,65-69,13
16,0,0,0,0,2020-12-26,Female,30,25-34,3
16,0,0,0,0,2020-12-23,Male,29,25-34,11
16,0,1,0,1,2020-12-23,Male,58,55-64,9
16,1,1,0,2,2020-12-26,Male,58,55-64,16
16,0,0,0,0,2020-12-23,Female,44,35-44,15
16,0,2,0,2,2020-12-24,Male,21,20-24,8
16,1,0,0,1,2020-12-23,Male,72,70-74,11
16,2,0,0,2,2020-12-25,Female,68,65-69,12
16,1,1,0,2,2020-12-24,Male,70,70-74,10
16,1,4,0,5,2020-12-23,Female,35,35-44,9
16,2,1,0,3,2020-12-24,Male,21,20-24,13
16,1,2,0,3,2020-12-23,Male,58,55-64,15
16,1,0,0,1,2020-12-25,Male,66,65-69,11
16,3,0,0,3,2020-12-23,Male,11,10-14,13
16,3,0,0,3,2020-12-23,Male,3,1-4,12
16,0,0,0,0,2020-12-24,Male,50,45-54,12
16,1,1,0,2,2020-12-23,Male,69,65-69,6
16,0,0,0,0,2020-12-25,Male,57,55-64,9
16,0,0,0,0,2020-12-23,Female,21,20-24,3
16,2,0,0,2,2020-12-27,Female,25,25-34,16
16,3,0,0,3,2020-12-23,Male,29,25-34,14
16,0,0,0,0,2020-12-23,Male,34,25-34,11
16,2,0,0,2,2020-12-26,Male,33,25-34,9
16,2,2,0,4,2020-12-25,Female,14,10-14,12
16,1,0,0,1,2020-12-24,Female,69,65-69,13
16,1,0,0,1,2020-12-23,Male,66,65-69,9
16,0,0,0,0,2020-12-23,Male,66,65-69,12
16,0,0,0,0,2020-12-27,Female,49,45-54,9
16,2,0,0,2,2020-12-25,Female,68,65-69,9
16,0,0,0,0,2020-12-23,Male,35,35-44,12
16,2,0,0,2,2020-12-23,Female,8,5-9,14
16,0,0,0,0,2020-12-23,Female,66,65-69,16
16,0,0,0,0,2020-12-24,Female,50,45-54,9
16,2,0,0,2,2020-12-23,Male,42,35-44,13
16,0,3,0,3,2020-12-24,Female,76,75-79,6
16,3,0,0,3,2020-12-25,Female,1,1-4,12
16,0,0,0,0,2020-12-24,Male,40,35-44,10
16,1,1,0,2,2020-12-26,Female,61,55-64,10
16,1,0,0,1,2020-12-23,Male,68,65-69,14
16,3,0,0,3,2020-12-23,Male,9,5-9,16
16,2,2,0,4,2020-12-27,Male,43,35-44,4
16,2,2,0,4,2020-12-23,Female,3,1-4,11
16,3,0,0,3,2020-12-23,Female,28,25-34,11
16,2,0,0,2,2020-12-23,Male,51,45-54,11
16,1,0,0,1,2020-12-26,Female,68,65-69,9
16,2,12,0,14,2020-12-24,Male,61,55-64,13
16,0,0,0,0,2020-12-23,Male,51,45-54,11
16,1,2,0,3,2020-12-24,Male,65,65-69,15
16,1,0,0,1,2020-12-28,Female,39,35-44,10
16,2,0,0,2,2020-12-24,Male,52,45-54,15
16,0,0,0,0,2020-12-23,Male,51,45-54,10
16,4,2,0,6,2020-12-23,Male,4,1-4,2
16,0,1,0,1,2020-12-29,Female,26,25-34,4
16,0,0,0,0,2020-12-23,Female,7,5-9,9
16,1,0,0,1,2020-12-24,Male,53,45-54,11
16,0,0,0,0,2020-12-24,Female,60,55-64,11
16,1,0,0,1,2020-12-23,Female,17,15-19,9
16,1,7,0,8,2020-12-23,Female,55,55-64,15
16,1,2,0,3,2020-12-26,Male,32,25-34,12
16,0,0,0,0,2020-12-24,Female,49,45-54,12
16,1,0,0,1,2020-12-24,Male,67,65-69,14
16,1,0,0,1,2020-12-27,Male,54,45-54,8
16,0,0,0,0,2020-12-23,Male,40,35-44,14
16,0,0,24,24,2020-12-23,Male,59,55-64,12
16,0,5,0,5,2020-12-23,Male,41,35-44,16
16,0,0,0,0,2020-12-23,Male,67,65-69,16
16,0,0,0,0,2020-12-26,Male,33,25-34,7
16,0,0,0,0,2020-12-25,Female,34,25-34,13
16,1,0,0,1,2020-12-24,Male,63,55-64,11
16,0,0,0,0,2020-12-23,Female,69,65-69,12
16,2,1,0,3,2020-12-24,Male,51,45-54,8
16,4,0,0,4,2020-12-23,Male,3,1-4,13
16,0,0,0,0,2020-12-26,Male,55,55-64,12
16,0,0,0,0,2020-12-23,Male,58,55-64,14
16,1,1,0,2,2020-12-23,Male,47,45-54,12
16,3,2,0,5,2020-12-23,Male,6,5-9,3
16,0,1,0,1,2020-12-27,Female,34,25-34,12
16,0,0,0,0,2020-12-27,Male,52,45-54,14
16,1,1,0,2,2020-12-24,Male,61,55-64,5
16,1,0,0,1,2020-12-23,Male,62,55-64,16
16,1,1,0,2,2020-12-23,Female,23,20-24,6
16,0,2,0,2,2020-12-23,Female,67,65-69,16
16,3,0,0,3,2020-12-23,Male,11,10-14,16
16,3,0,0,3,2020-12-23,Female,38,35-44,12
16,2,0,0,2,2020-12-25,Male,77,75-79,11
16,0,0,0,0,2020-12-23,Female,38,35-44,12
16,0,0,0,0,2020-12-23,Female,16,15-19,13
16,0,1,0,1,2020-12-23,Male,47,45-54,14
16,0,0,26,26,2020-12-25,Female,58,55-64,11
16,1,0,0,1,2020-12-23,Male,66,65-69,12
16,0,0,0,0,2020-12-23,Female,17,15-19,6
16,2,5,10,17,2020-12-23,Female,65,65-69,10
16,0,0,0,0,2020-12-23,Male,27,25-34,12
16,0,1,0,1,2020-12-23,Male,47,45-54,13
16,0,0,0,0,2020-12-23,Male,32,25-34,11
16,2,2,0,4,2020-12-26,Male,49,45-54,9
16,0,0,0,0,2020-12-23,Male,52,45-54,13
16,0,0,5,5,2020-12-25,Male,72,70-74,5
16,0,2,0,2,2020-12-28,Male,28,25-34,2
16,4,0,0,4,2020-12-23,Female,3,1-4,7
16,0,0,0,0,2020-12-23,Male,62,55-64,11
16,0,0,0,0,2020-12-28,Female,30,25-34,3
16,2,0,0,2,2020-12-23,Male,12,10-14,15
16,2,1,0,3,2020-12-23,Female,63,55-64,12
16,1,0,0,1,2020-12-26,Male,45,45-54,8
16,0,9,100,109,2020-12-25,Male,43,35-44,15
16,2,1,0,3,2020-12-23,Female,64,55-64,16
16,1,0,0,1,2020-12-25,Female,48,45-54,15
16,0,1,0,1,2020-12-23,Male,54,45-54,8
16,0,0,0,0,2020-12-23,Male,77,75-79,8
16,1,0,0,1,2020-12-23,Female,33,25-34,10
16,2,0,0,2,2020-12-24,Male,5,5-9,9
16,2,0,0,2,2020-12-23,Female,11,10-14,12
16,1,0,0,1,2020-12-23,Female,50,45-54,12
16,0,0,0,0,2020-12-23,Female,23,20-24,8
16,2,0,0,2,2020-12-23,Male,56,55-64,13
16,0,2,0,2,2020-12-23,Female,42,35-44,3
16,0,1,0,1,2020-12-23,Female,62,55-64,10
16,0,0,0,0,2020-12-23,Female,59,55-64,11
16,1,0,0,1,2020-12-24,Male,57,55-64,11
16,2,0,0,2,2020-12-24,Male,65,65-69,16
16,1,0,0,1,2020-12-28,Female,54,45-54,6
16,1,0,0,1,2020-12-23,Female,34,25-34,6
16,4,0,0,4,2020-12-23,Female,9,5-9,7
16,3,0,0,3,2020-12-23,Female,33,25-34,9
16,0,0,0,0,2020-12-25,Female,35,35-44,2
16,2,0,0,2,2020-12-23,Male,70,70-74,7
16,0,3,0,3,2020-12-25,Male,61,55-64,15
16,1,0,0,1,2020-12-23,Male,66,65-69,15
16,1,0,0,1,2020-12-23,Female,56,55-64,7
16,0,0,0,0,2020-12-26,Male,33,25-34,13
16,1,0,0,1,2020-12-23,Female,59,55-64,14
16,2,1,0,3,2020-12-24,Male,73,70-74,12
16,2,0,0,2,2020-12-25,Male,73,70-74,9
16,2,2,0,4,2020-12-25,Male,34,25-34,11
16,0,0,0,0,2020-12-27,Female,37,35-44,11
16,0,1,0,1,2020-12-25,Male,46,45-54,4
16,1,0,0,1,2020-12-24,Female,47,45-54,8
16,4,0,0,4,2020-12-23,Female,22,20-24,8
16,0,0,0,0,2020-12-24,Male,63,55-64,12
16,0,2,0,2,2020-12-26,Male,25,25-34,9
16,0,0,0,0,2020-12-25,Female,69,65-69,12
16,4,0,0,4,2020-12-27,Female,34,25-34,13
16,0,0,0,0,2020-12-24,Male,53,45-54,15
16,0,3,0,3,2020-12-25,Female,35,35-44,9
16,0,1,0,1,2020-12-23,Male,56,55-64,13
16,1,2,0,3,2020-12-25,Female,56,55-64,14
16,0,2,0,2,2020-12-24,Female,67,65-69,15
16,2,0,0,2,2020-12-23,Male,42,35-44,8
16,1,1,0,2,2020-12-23,Male,72,70-74,12
16,2,0,0,2,2020-12-28,Female,53,45-54,10
16,1,0,0,1,2020-12-23,Female,24,20-24,3
16,1,0,0,1,2020-12-25,Female,72,70-74,10
16,0,0,0,0,2020-12-23,Male,71,70-74,11
16,2,0,0,2,2020-12-24,Female,70,70-74,13
16,0,0,0,0,2020-12-24,Female,71,70-74,11
16,0,1,0,1,2020-12-23,Male,66,65-69,16
16,0,0,0,0,2020-12-26,Female,26,25-34,12
16,1,0,0,1,2020-12-24,Female,55,55-64,8
16,0,0,0,0,2020-12-24,Female,74,70-74,9
16,2,0,0,2,2020-12-24,Male,80,80-84,11
16,0,0,0,0,2020-12-25,Male,60,55-64,11
16,1,31,0,32,2020-12-23,Female,53,45-54,15
16,1,1,0,2,2020-12-26,Male,63,55-64,14
16,0,0,0,0,2020-12-23,Male,37,35-44,15
16,0,0,0,0,2020-12-25,Female,67,65-69,10
16,1,0,0,1,2020-12-23,Female,28,25-34,14
16,0,0,0,0,2020-12-26,Male,54,45-54,14
16,2,0,0,2,2020-12-25,Female,9,5-9,16
16,2,0,0,2,2020-12-24,Male,16,15-19,8
16,1,0,0,1,2020-12-23,Male,34,25-34,15
16,0,1,0,1,2020-12-23,Female,72,70-74,14
16,0,0,0,0,2020-12-23,Female,26,25-34,8
16,3,0,0,3,2020-12-23,Male,52,45-54,10
16,3,0,0,3,2020-12-23,Male,41,35-44,13
16,0,3,0,3,2020-12-24,Female,63,55-64,3
16,1,0,0,1,2020-12-26,Female,24,20-24,16
16,0,1,0,1,2020-12-27,Male,13,10-14,9
16,1,0,0,1,2020-12-23,Male,32,25-34,12
16,0,2,0,2,2020-12-23,Female,43,35-44,13
16,2,0,0,2,2020-12-26,Female,71,70-74,12
16,0,0,0,0,2020-12-25,Male,58,55-64,12
16,1,0,0,1,2020-12-23,Male,55,55-64,12
16,3,5,0,8,2020-12-27,Male,8,5-9,13
16,3,0,0,3,2020-12-23,Female,36,35-44,15
16,1,0,0,1,2020-12-23,Female,59,55-64,14
16,1,21,2,24,2020-12-26,Male,69,65-69,11
16,1,0,0,1,2020-12-23,Male,66,65-69,15
16,1,0,0,1,2020-12-23,Male,28,25-34,2
16,0,0,0,0,2020-12-25,Female,57,55-64,13
16,0,0,0,0,2020-12-23,Male,76,75-79,10
16,0,1,0,1,2020-12-23,Female,49,45-54,3
16,1,1,0,2,2020-12-23,Female,75,75-79,9
16,2,0,0,2,2020-12-25,Male,65,65-69,12
16,2,0,0,2,2020-12-24,Male,17,15-19,7
16,1,0,0,1,2020-12-25,Male,31,25-34,2
16,3,0,0,3,2020-12-27,Female,17,15-19,11
16,0,3,3,6,2020-12-24,Male,75,75-79,12
16,0,1,0,1,2020-12-24,Female,45,45-54,7
16,0,0,0,0,2020-12-23,Male,35,35-44,3
16,0,0,0,0,2020-12-23,Male,35,35-44,3
16,0,1,0,1,2020-12-23,Female,66,65-69,15
16,2,0,0,2,2020-12-27,Female,18,15-19,7
16,0,0,0,0,2020-12-23,Male,19,15-19,3
16,0,0,0,0,2020-12-26,Female,54,45-54,12
16,2,5,0,7,2020-12-23,Female,29,25-34,2
16,1,2,0,3,2020-12-27,Female,46,45-54,13
16,1,1,0,2,2020-12-24,Male,70,70-74,10
16,0,0,0,0,2020-12-26,Male,53,45-54,11
16,5,1,0,6,2020-12-23,Male,19,15-19,7
16,0,0,0,0,2020-12-23,Female,62,55-64,13
16,0,0,0,0,2020-12-23,Female,23,20-24,7
16,1,0,0,1,2020-12-23,Female,26,25-34,2
16,2,0,0,2,2020-12-23,Male,74,70-74,12
16,1,0,0,1,2020-12-23,Female,70,70-74,16
16,1,0,0,1,2020-12-23,Female,53,45-54,3
16,0,0,0,0,2020-12-26,Female,63,55-64,9
16,0,0,0,0,2020-12-27,Male,27,25-34,15
16,1,2,0,3,2020-12-25,Male,28,25-34,16
16,1,0,0,1,2020-12-25,Female,31,25-34,10
16,0,0,0,0,2020-12-24,Female,65,65-69,12
16,1,0,0,1,2020-12-24,Male,42,35-44,13
16,0,0,0,0,2020-12-23,Male,71,70-74,14
16,1,2,0,3,2020-12-26,Male,40,35-44,6
16,0,2,0,2,2020-12-23,Female,68,65-69,16
16,0,1,0,1,2020-12-23,Female,62,55-64,13
16,1,0,0,1,2020-12-23,Male,72,70-74,6
16,0,0,0,0,2020-12-25,Male,60,55-64,13
16,0,0,0,0,2020-12-27,Male,27,25-34,10
16,0,0,0,0,2020-12-25,Male,26,25-34,12
16,0,0,0,0,2020-12-23,Female,34,25-34,12
16,1,0,0,1,2020-12-23,Male,69,65-69,15
16,0,0,0,0,2020-12-25,Male,67,65-69,8
16,2,0,0,2,2020-12-26,Female,66,65-69,13
16,0,0,0,0,2020-12-23,Female,40,35-44,3
16,1,2,0,3,2020-12-23,Male,68,65-69,14
16,1,0,0,1,2020-12-25,Male,61,55-64,11
16,0,0,0,0,2020-12-23,Male,19,15-19,3
16,0,0,0,0,2020-12-23,Male,34,25-34,12
16,3,0,0,3,2020-12-24,Male,16,15-19,9
16,0,0,0,0,2020-12-23,Female,62,55-64,13
16,0,0,0,0,2020-12-23,Female,56,55-64,15
16,3,2,0,5,2020-12-25,Female,53,45-54,12
16,1,0,0,1,2020-12-23,Male,55,55-64,11
16,3,0,0,3,2020-12-23,Male,9,5-9,10
16,1,0,0,1,2020-12-23,Male,42,35-44,9
16,0,0,0,0,2020-12-26,Female,53,45-54,10
16,2,0,0,2,2020-12-27,Female,34,25-34,13
16,0,0,0,0,2020-12-23,Female,59,55-64,16
16,3,0,0,3,2020-12-23,Female,1,1-4,12
16,2,0,0,2,2020-12-26,Male,57,55-64,5
16,1,0,0,1,2020-12-26,Female,59,55-64,12
16,1,0,0,1,2020-12-24,Female,30,25-34,9
16,4,1,0,5,2020-12-26,Female,54,45-54,11
16,2,0,0,2,2020-12-23,Female,56,55-64,12
16,1,1,0,2,2020-12-23,Female,60,55-64,15
16,2,1,0,3,2020-12-23,Male,60,55-64,12
16,3,0,0,3,2020-12-23,Male,47,45-54,7
16,0,0,0,0,2020-12-23,Female,54,45-54,11
16,1,10,0,11,2020-12-23,Female,56,55-64,9
16,2,5,0,7,2020-12-23,Female,51,45-54,15
16,3,0,0,3,2020-12-23,Male,69,65-69,10
16,3,3,0,6,2020-12-23,Male,71,70-74,11
16,2,0,0,2,2020-12-26,Male,59,55-64,2
16,2,4,0,6,2020-12-26,Male,77,75-79,11
16,3,0,0,3,2020-12-23,Male,13,10-14,6
16,2,0,0,2,2020-12-24,Male,52,45-54,9
16,1,1,0,2,2020-12-26,Male,70,70-74,13
16,0,0,0,0,2020-12-23,Male,19,15-19,2
16,0,0,0,0,2020-12-24,Male,52,45-54,15
16,3,0,0,3,2020-12-26,Female,16,15-19,12
16,0,7,0,7,2020-12-24,Female,41,35-44,2
16,1,0,0,1,2020-12-23,Female,65,65-69,15
16,5,0,0,5,2020-12-23,Female,17,15-19,9
16,0,0,0,0,2020-12-24,Female,37,35-44,13
16,3,0,0,3,2020-12-24,Female,14,10-14,5
16,0,4,0,4,2020-12-26,Male,57,55-64,10
16,1,0,0,1,2020-12-26,Female,28,25-34,2
16,0,3,8,11,2020-12-23,Female,48,45-54,8
16,2,0,0,2,2020-12-26,Male,10,10-14,5
16,0,0,0,0,2020-12-23,Male,60,55-64,10
16,0,0,0,0,2020-12-23,Female,55,55-64,13
16,0,0,0,0,2020-12-23,Female,60,55-64,13
16,0,0,0,0,2020-12-23,Male,36,35-44,10
16,3,0,0,3,2020-12-26,Female,3,1-4,10
16,1,0,0,1,2020-12-23,Male,19,15-19,3
16,2,0,0,2,2020-12-23,Male,64,55-64,11
16,2,4,0,6,2020-12-23,Male,51,45-54,10
16,0,0,0,0,2020-12-24,Male,74,70-74,9
16,2,2,0,4,2020-12-23,Female,51,45-54,10
16,1,0,0,1,2020-12-28,Female,32,25-34,7
16,2,1,0,3,2020-12-24,Female,73,70-74,8
16,2,0,0,2,2020-12-26,Male,12,10-14,9
16,1,0,0,1,2020-12-24,Female,15,15-19,13
16,0,5,0,5,2020-12-23,Male,61,55-64,13
16,1,0,0,1,2020-12-23,Female,55,55-64,9
16,2,0,0,2,2020-12-23,Male,19,15-19,3
16,1,0,0,1,2020-12-23,Male,50,45-54,3
16,1,1,0,2,2020-12-25,Male,53,45-54,8
16,1,0,0,1,2020-12-24,Male,54,45-54,12
16,2,0,0,2,2020-12-23,Female,65,65-69,14
16,1,0,0,1,2020-12-26,Male,61,55-64,13
16,4,0,0,4,2020-12-23,Male,17,15-19,6
16,0,3,0,3,2020-12-23,Male,52,45-54,11
16,1,0,0,1,2020-12-24,Female,50,45-54,11
16,0,0,0,0,2020-12-25,Female,61,55-64,13
16,3,1,0,4,2020-12-23,Male,14,10-14,15
16,1,0,0,1,2020-12-23,Female,27,25-34,3
16,1,0,0,1,2020-12-26,Male,40,35-44,11
16,2,1,0,3,2020-12-25,Female,68,65-69,8
16,3,0,0,3,2020-12-23,Female,0,<1,2
16,0,0,0,0,2020-12-25,Female,66,65-69,15
16,0,0,0,0,2020-12-26,Male,64,55-64,7
16,0,0,0,0,2020-12-24,Male,37,35-44,13
16,1,0,0,1,2020-12-23,Female,64,55-64,11
16,0,0,0,0,2020-12-24,Female,67,65-69,15
16,0,10,0,10,2020-12-24,Female,43,35-44,9
16,1,1,0,2,2020-12-25,Male,40,35-44,12
16,0,2,0,2,2020-12-23,Female,67,65-69,13
16,1,0,0,1,2020-12-23,Male,37,35-44,7
16,1,10,0,11,2020-12-25,Female,37,35-44,9
16,0,0,0,0,2020-12-25,Female,6,5-9,5
16,0,2,0,2,2020-12-24,Female,46,45-54,6
16,1,0,0,1,2020-12-26,Female,51,45-54,15
16,0,0,0,0,2020-12-23,Female,24,20-24,13
16,3,0,0,3,2020-12-24,Female,54,45-54,7
16,0,0,0,0,2020-12-23,Female,17,15-19,12
16,0,0,0,0,2020-12-24,Female,44,35-44,11
16,2,1,0,3,2020-12-24,Female,21,20-24,3
16,1,0,0,1,2020-12-23,Male,66,65-69,9
16,2,0,0,2,2020-12-23,Female,63,55-64,13
16,0,3,0,3,2020-12-25,Female,51,45-54,10
16,0,0,0,0,2020-12-26,Female,67,65-69,13
16,1,0,0,1,2020-12-26,Female,72,70-74,12
16,1,0,0,1,2020-12-26,Male,36,35-44,7
16,0,0,0,0,2020-12-26,Male,58,55-64,15
16,2,0,0,2,2020-12-27,Female,11,10-14,10
16,2,0,0,2,2020-12-25,Female,8,5-9,3
16,0,0,0,0,2020-12-29,Female,23,20-24,10
16,1,3,0,4,2020-12-23,Male,79,75-79,12
16,2,0,0,2,2020-12-25,Female,9,5-9,12
16,1,1,0,2,2020-12-23,Male,43,35-44,10
16,2,1,0,3,2020-12-25,Female,63,55-64,11
16,1,0,0,1,2020-12-26,Female,52,45-54,11
16,2,0,0,2,2020-12-23,Male,68,65-69,13
16,1,0,0,1,2020-12-27,Female,55,55-64,13
16,0,0,0,0,2020-12-29,Male,23,20-24,7
16,1,3,2,6,2020-12-23,Female,61,55-64,11
16,1,7,0,8,2020-12-25,Male,68,65-69,11
16,1,1,0,2,2020-12-23,Male,64,55-64,16
16,2,0,0,2,2020-12-23,Male,73,70-74,13
16,3,0,0,3,2020-12-23,Female,22,20-24,7
16,1,0,0,1,2020-12-23,Female,64,55-64,13
16,2,0,0,2,2020-12-26,Male,54,45-54,12
16,0,1,0,1,2020-12-23,Female,66,65-69,13
16,0,0,0,0,2020-12-29,Female,31,25-34,7
16,0,1,0,1,2020-12-24,Female,72,70-74,14
16,0,0,0,0,2020-12-23,Female,66,65-69,9
16,1,0,0,1,2020-12-28,Female,48,45-54,15
16,0,0,0,0,2020-12-23,Female,34,25-34,11
16,0,2,0,2,2020-12-25,Female,34,25-34,2
16,1,0,0,1,2020-12-23,Male,74,70-74,8
16,2,1,0,3,2020-12-23,Female,4,1-4,8
16,2,0,0,2,2020-12-25,Female,51,45-54,9
16,0,0,0,0,2020-12-23,Female,40,35-44,15
16,3,0,0,3,2020-12-26,Male,22,20-24,16
16,0,0,0,0,2020-12-23,Male,55,55-64,15
16,0,0,0,0,2020-12-29,Male,23,20-24,10
16,0,0,0,0,2020-12-24,Female,36,35-44,14
16,3,0,0,3,2020-12-23,Female,7,5-9,12
16,0,0,0,0,2020-12-23,Male,55,55-64,12
16,2,0,0,2,2020-12-23,Male,62,55-64,14
16,0,0,1,1,2020-12-23,Female,20,20-24,5
16,5,0,0,5,2020-12-23,Male,17,15-19,13
16,1,3,0,4,2020-12-23,Female,57,55-64,11
16,0,2,0,2,2020-12-23,Female,85,85+,6
16,0,0,0,0,2020-12-23,Female,70,70-74,14
16,1,2,0,3,2020-12-23,Male,74,70-74,16
16,1,1,0,2,2020-12-24,Male,66,65-69,13
16,3,0,0,3,2020-12-26,Male,10,10-14,14
16,0,2,0,2,2020-12-23,Male,73,70-74,13
16,0,0,0,0,2020-12-26,Female,36,35-44,9
16,0,0,0,0,2020-12-24,Female,37,35-44,13
16,0,0,0,0,2020-12-24,Female,43,35-44,9
16,1,0,0,1,2020-12-26,Male,66,65-69,12
16,1,0,0,1,2020-12-24,Female,60,55-64,13
16,1,1,0,2,2020-12-24,Female,66,65-69,10
16,1,0,0,1,2020-12-25,Male,67,65-69,13
16,3,0,0,3,2020-12-25,Female,13,10-14,13
16,1,3,11,15,2020-12-25,Male,71,70-74,6
16,0,0,0,0,2020-12-25,Female,51,45-54,11
16,0,3,0,3,2020-12-28,Male,22,20-24,12
16,0,0,0,0,2020-12-23,Female,3,1-4,11
16,2,0,0,2,2020-12-23,Male,25,25-34,4
16,1,0,0,1,2020-12-26,Male,65,65-69,15
16,1,0,0,1,2020-12-28,Female,29,25-34,12
16,0,0,0,0,2020-12-23,Male,31,25-34,11
16,2,0,0,2,2020-12-23,Female,14,10-14,11
16,3,6,0,9,2020-12-25,Female,24,20-24,8
16,3,1,0,4,2020-12-25,Female,65,65-69,15
16,2,1,0,3,2020-12-26,Female,66,65-69,13
16,0,4,0,4,2020-12-26,Female,75,75-79,14
16,0,0,0,0,2020-12-24,Female,37,35-44,10
16,2,0,0,2,2020-12-23,Female,44,35-44,9
16,0,0,0,0,2020-12-24,Male,32,25-34,13
16,3,0,0,3,2020-12-23,Male,16,15-19,14
16,3,0,0,3,2020-12-23,Male,34,25-34,10
16,2,0,0,2,2020-12-27,Female,23,20-24,13
16,0,0,0,0,2020-12-23,Male,35,35-44,9
16,0,0,0,0,2020-12-23,Male,18,15-19,13
16,0,0,0,0,2020-12-24,Female,63,55-64,11
16,1,0,0,1,2020-12-23,Male,65,65-69,14
16,1,0,0,1,2020-12-26,Male,56,55-64,5
16,3,0,0,3,2020-12-25,Female,10,10-14,16
16,0,0,0,0,2020-12-23,Female,65,65-69,10
16,1,3,0,4,2020-12-23,Male,54,45-54,12
16,1,0,0,1,2020-12-23,Male,21,20-24,6
16,1,1,0,2,2020-12-23,Male,58,55-64,10
16,1,0,0,1,2020-12-23,Male,62,55-64,16
16,2,0,0,2,2020-12-24,Male,66,65-69,14
16,0,0,0,0,2020-12-24,Female,37,35-44,5
16,0,0,0,0,2020-12-26,Male,38,35-44,11
16,1,1,0,2,2020-12-24,Female,66,65-69,10
16,0,0,0,0,2020-12-23,Male,30,25-34,5
16,0,0,0,0,2020-12-27,Male,28,25-34,10
16,1,2,0,3,2020-12-27,Female,44,35-44,14
16,0,0,0,0,2020-12-24,Male,68,65-69,8
16,1,0,10,11,2020-12-24,Female,62,55-64,11
16,1,0,0,1,2020-12-23,Female,30,25-34,10
16,1,0,0,1,2020-12-23,Female,53,45-54,14
16,0,0,0,0,2020-12-28,Female,25,25-34,6
16,1,0,0,1,2020-12-23,Male,75,75-79,5
16,1,0,0,1,2020-12-23,Female,49,45-54,14
16,0,0,0,0,2020-12-24,Female,73,70-74,8
16,1,0,0,1,2020-12-26,Male,66,65-69,12
16,0,0,0,0,2020-12-27,Female,25,25-34,15
16,0,0,0,0,2020-12-23,Female,21,20-24,13
16,1,0,0,1,2020-12-23,Male,40,35-44,13
16,1,0,0,1,2020-12-24,Female,59,55-64,13
16,0,0,0,0,2020-12-23,Female,68,65-69,11
16,1,1,0,2,2020-12-24,Male,67,65-69,14
16,2,0,0,2,2020-12-23,Female,9,5-9,16
16,1,2,0,3,2020-12-26,Female,24,20-24,10
16,5,0,0,5,2020-12-23,Female,10,10-14,10
16,0,0,0,0,2020-12-24,Male,56,55-64,13
16,1,2,0,3,2020-12-23,Male,71,70-74,11
16,0,0,0,0,2020-12-28,Male,30,25-34,3
16,2,0,0,2,2020-12-27,Female,29,25-34,6
16,2,0,0,2,2020-12-24,Female,60,55-64,13
16,5,0,0,5,2020-12-26,Female,33,25-34,9
16,0,4,0,4,2020-12-25,Male,45,45-54,9
16,1,0,0,1,2020-12-23,Male,64,55-64,11
16,0,0,0,0,2020-12-23,Female,19,15-19,11
16,1,0,0,1,2020-12-26,Male,1,1-4,6
16,2,1,0,3,2020-12-23,Female,63,55-64,14
16,3,0,0,3,2020-12-23,Female,23,20-24,2
16,1,0,0,1,2020-12-24,Male,45,45-54,11
16,0,0,0,0,2020-12-23,Female,34,25-34,12
16,3,1,0,4,2020-12-25,Female,33,25-34,14
16,1,0,0,1,2020-12-26,Male,58,55-64,15
16,2,0,0,2,2020-12-23,Male,64,55-64,15
16,1,0,0,1,2020-12-23,Female,62,55-64,14
16,1,0,0,1,2020-12-24,Female,64,55-64,14
16,0,0,0,0,2020-12-23,Female,43,35-44,12
16,2,1,0,3,2020-12-23,Female,68,65-69,16
16,1,0,0,1,2020-12-23,Male,52,45-54,12
16,2,0,0,2,2020-12-23,Male,50,45-54,14
16,1,0,0,1,2020-12-23,Female,67,65-69,14
16,5,0,0,5,2020-12-23,Male,8,5-9,6
16,0,0,0,0,2020-12-24,Male,16,15-19,16
16,0,0,0,0,2020-12-24,Female,65,65-69,8
16,2,0,0,2,2020-12-24,Male,59,55-64,14
16,2,0,0,2,2020-12-24,Female,38,35-44,12
16,0,0,0,0,2020-12-23,Male,33,25-34,13
16,1,0,0,1,2020-12-23,Female,65,65-69,11
16,3,0,0,3,2020-12-23,Male,66,65-69,3
16,1,2,0,3,2020-12-23,Male,68,65-69,16
16,0,0,0,0,2020-12-23,Male,11,10-14,13
16,2,0,0,2,2020-12-24,Male,76,75-79,11
16,1,0,0,1,2020-12-23,Female,58,55-64,16
16,2,0,0,2,2020-12-26,Female,32,25-34,10
16,6,0,0,6,2020-12-25,Female,17,15-19,15
16,0,0,0,0,2020-12-26,Female,68,65-69,10
16,1,0,0,1,2020-12-23,Female,38,35-44,12
16,2,0,0,2,2020-12-23,Male,13,10-14,12
16,2,0,0,2,2020-12-23,Male,24,20-24,8
16,0,0,0,0,2020-12-28,Female,1,1-4,11
16,0,22,0,22,2020-12-25,Female,39,35-44,9
16,2,0,0,2,2020-12-23,Male,18,15-19,10
16,1,0,0,1,2020-12-26,Male,47,45-54,6
16,0,2,0,2,2020-12-23,Male,39,35-44,12
16,0,0,0,0,2020-12-23,Female,34,25-34,14
16,6,0,0,6,2020-12-23,Female,19,15-19,3
16,0,1,0,1,2020-12-23,Male,45,45-54,12
16,0,3,0,3,2020-12-23,Female,65,65-69,12
16,0,0,0,0,2020-12-23,Female,76,75-79,7
16,1,0,0,1,2020-12-26,Male,71,70-74,2
16,0,0,0,0,2020-12-26,Female,19,15-19,8
16,0,1,0,1,2020-12-23,Female,52,45-54,12
16,0,1,0,1,2020-12-23,Female,28,25-34,3
16,2,0,0,2,2020-12-26,Male,26,25-34,10
16,0,0,0,0,2020-12-28,Female,28,25-34,13
16,0,5,0,5,2020-12-26,Male,43,35-44,3
16,0,0,0,0,2020-12-23,Male,17,15-19,7
16,2,0,0,2,2020-12-24,Female,67,65-69,8
16,0,1,0,1,2020-12-23,Female,69,65-69,14
16,0,0,5,5,2020-12-23,Male,30,25-34,2
16,5,0,0,5,2020-12-27,Male,12,10-14,14
16,2,2,0,4,2020-12-23,Female,55,55-64,12
16,0,3,0,3,2020-12-27,Female,27,25-34,10
16,2,0,0,2,2020-12-23,Male,48,45-54,15
16,0,0,0,0,2020-12-25,Female,52,45-54,15
16,5,0,0,5,2020-12-25,Female,20,20-24,6
16,0,1,0,1,2020-12-23,Female,38,35-44,11
16,1,0,0,1,2020-12-27,Male,54,45-54,10
16,1,0,0,1,2020-12-23,Female,39,35-44,3
16,0,1,0,1,2020-12-23,Male,49,45-54,12
16,1,0,0,1,2020-12-23,Male,63,55-64,12
16,1,0,0,1,2020-12-23,Male,35,35-44,12
16,5,0,0,5,2020-12-23,Male,19,15-19,2
16,1,0,0,1,2020-12-23,Male,49,45-54,13
16,0,0,0,0,2020-12-27,Female,53,45-54,11
16,2,0,0,2,2020-12-23,Male,68,65-69,14
16,3,0,0,3,2020-12-23,Male,20,20-24,13
16,3,0,0,3,2020-12-24,Male,85,85+,11
16,1,6,0,7,2020-12-26,Female,54,45-54,13
16,2,0,0,2,2020-12-23,Male,11,10-14,9
16,2,5,0,7,2020-12-27,Female,20,20-24,6
16,2,1,0,3,2020-12-23,Female,66,65-69,11
16,0,0,0,0,2020-12-23,Male,50,45-54,16
16,0,0,1,1,2020-12-26,Male,0,<1,6
16,0,1,0,1,2020-12-24,Male,23,20-24,10
16,1,3,0,4,2020-12-26,Female,71,70-74,4
16,0,0,0,0,2020-12-23,Female,19,15-19,2
16,0,14,0,14,2020-12-27,Female,29,25-34,8
16,2,0,0,2,2020-12-25,Male,74,70-74,15
16,0,0,0,0,2020-12-29,Male,30,25-34,13
16,2,0,0,2,2020-12-25,Male,66,65-69,12
16,0,0,0,0,2020-12-23,Male,43,35-44,14
16,3,0,1,4,2020-12-29,Female,20,20-24,5
16,2,0,0,2,2020-12-25,Female,79,75-79,13
16,1,0,0,1,2020-12-26,Female,70,70-74,14
16,0,0,0,0,2020-12-23,Female,69,65-69,16
16,1,5,0,6,2020-12-25,Male,71,70-74,14
16,0,0,0,0,2020-12-23,Male,10,10-14,9
16,0,0,0,0,2020-12-23,Male,61,55-64,15
16,4,0,0,4,2020-12-23,Female,11,10-14,11
16,0,2,0,2,2020-12-23,Male,66,65-69,7
16,1,4,0,5,2020-12-28,Female,30,25-34,14
16,2,0,0,2,2020-12-23,Female,5,5-9,13
16,0,0,0,0,2020-12-23,Male,14,10-14,12
16,0,1,0,1,2020-12-23,Male,34,25-34,15
16,3,0,0,3,2020-12-28,Male,9,5-9,6
16,2,0,0,2,2020-12-24,Male,20,20-24,12
17,0,0,0,0,2021-01-28,Male,60,55-64,12
17,1,10,0,11,2021-01-28,Male,68,65-69,12
17,1,0,0,1,2021-01-29,Female,70,70-74,12
17,2,0,0,2,2021-01-28,Female,66,65-69,17
17,0,0,0,0,2021-01-28,Female,18,15-19,6
17,0,0,0,0,2021-01-29,Female,72,70-74,13
17,1,0,0,1,2021-01-29,Female,72,70-74,17
17,0,0,0,0,2021-01-30,Male,30,25-34,14
17,0,0,0,0,2021-01-29,Female,53,45-54,12
17,0,0,0,0,2021-01-29,Female,34,25-34,4
17,0,0,0,0,2021-01-29,Female,59,55-64,13
17,1,1,0,2,2021-01-29,Male,51,45-54,12
17,1,1,0,2,2021-01-28,Female,35,35-44,14
17,2,0,0,2,2021-01-28,Male,1,1-4,6
17,3,1,0,4,2021-01-28,Female,57,55-64,14
17,1,1,0,2,2021-01-29,Female,22,20-24,2
17,0,0,0,0,2021-01-28,Female,10,10-14,13
17,1,0,0,1,2021-01-29,Male,66,65-69,12
17,1,1,0,2,2021-01-28,Male,62,55-64,17
17,0,0,0,0,2021-01-28,Male,18,15-19,15
17,0,2,0,2,2021-01-29,Male,49,45-54,14
17,3,0,0,3,2021-01-28,Male,58,55-64,11
17,2,0,0,2,2021-01-28,Male,51,45-54,4
17,0,0,0,0,2021-01-29,Female,70,70-74,16
17,0,0,0,0,2021-01-28,Male,20,20-24,11
17,1,0,0,1,2021-01-28,Female,52,45-54,13
17,0,0,0,0,2021-01-28,Male,42,35-44,17
17,4,0,0,4,2021-01-28,Male,18,15-19,3
17,1,0,0,1,2021-01-29,Female,56,55-64,17
17,2,0,0,2,2021-01-28,Female,22,20-24,15
17,2,0,0,2,2021-01-28,Male,52,45-54,15
17,0,0,0,0,2021-01-30,Male,85,85+,15
17,3,0,0,3,2021-01-28,Male,4,1-4,7
17,0,0,0,0,2021-01-30,Female,5,5-9,6
17,0,0,0,0,2021-01-28,Male,19,15-19,10
17,1,0,0,1,2021-01-28,Male,58,55-64,15
17,1,0,0,1,2021-01-29,Male,72,70-74,10
17,0,0,0,0,2021-01-29,Male,26,25-34,4
17,1,2,0,3,2021-01-28,Male,71,70-74,15
17,0,0,0,0,2021-01-29,Male,44,35-44,7
17,1,1,0,2,2021-01-29,Male,39,35-44,14
17,3,0,0,3,2021-01-28,Male,6,5-9,2
17,2,1,0,3,2021-01-29,Male,69,65-69,13
17,1,0,0,1,2021-01-31,Female,55,55-64,6
17,4,0,0,4,2021-01-28,Male,4,1-4,3
17,1,0,0,1,2021-01-30,Female,67,65-69,14
17,1,1,0,2,2021-01-29,Male,38,35-44,15
17,1,0,0,1,2021-01-28,Male,62,55-64,14
17,0,1,0,1,2021-01-29,Male,72,70-74,10
17,0,0,0,0,2021-01-28,Female,19,15-19,4
17,0,2,0,2,2021-01-30,Male,85,85+,12
17,1,0,0,1,2021-01-29,Female,71,70-74,12
17,3,21,0,24,2021-01-29,Female,22,20-24,3
17,2,2,10,14,2021-01-28,Male,54,45-54,16
17,1,1,0,2,2021-01-28,Male,70,70-74,14
17,2,0,0,2,2021-01-29,Female,69,65-69,13
17,1,0,0,1,2021-01-28,Female,65,65-69,16
17,4,0,0,4,2021-01-29,Female,12,10-14,9
17,1,1,0,2,2021-01-29,Male,67,65-69,13
17,2,0,0,2,2021-01-29,Male,70,70-74,7
17,0,0,0,0,2021-01-28,Female,11,10-14,3
17,7,0,0,7,2021-01-28,Female,23,20-24,10
17,0,0,0,0,2021-01-28,Male,43,35-44,13
17,0,0,0,0,2021-01-29,Male,33,25-34,12
17,1,0,0,1,2021-01-29,Male,69,65-69,17
17,2,0,0,2,2021-01-29,Female,60,55-64,15
17,1,0,0,1,2021-01-28,Male,31,25-34,12
17,0,0,0,0,2021-01-28,Male,49,45-54,15
17,0,2,0,2,2021-01-29,Female,63,55-64,15
17,1,0,0,1,2021-01-28,Female,29,25-34,8
17,0,1,0,1,2021-01-28,Female,31,25-34,16
17,1,0,0,1,2021-01-28,Female,62,55-64,15
17,0,0,0,0,2021-01-28,Female,47,45-54,13
17,0,1,0,1,2021-01-28,Male,55,55-64,14
17,0,0,0,0,2021-01-28,Male,33,25-34,11
17,1,0,0,1,2021-01-28,Male,57,55-64,12
17,0,1,0,1,2021-01-29,Male,32,25-34,17
17,0,0,0,0,2021-01-28,Male,65,65-69,12
17,2,0,0,2,2021-01-29,Female,45,45-54,5
17,0,0,0,0,2021-01-28,Female,30,25-34,11
17,0,3,0,3,2021-01-28,Female,33,25-34,13
17,0,0,0,0,2021-01-28,Male,37,35-44,13
17,1,2,0,3,2021-01-30,Female,62,55-64,13
17,1,0,0,1,2021-01-29,Female,22,20-24,4
17,1,0,0,1,2021-01-28,Male,65,65-69,12
17,0,0,0,0,2021-01-28,Male,63,55-64,15
17,3,0,0,3,2021-01-28,Male,8,5-9,8
17,0,0,0,0,2021-01-28,Male,29,25-34,10
17,2,0,0,2,2021-01-29,Female,26,25-34,12
17,0,1,0,1,2021-01-29,Male,69,65-69,12
17,1,0,0,1,2021-01-28,Male,58,55-64,16
17,0,0,0,0,2021-01-29,Female,62,55-64,13
17,0,0,0,0,2021-01-29,Male,69,65-69,13
17,2,0,0,2,2021-01-28,Male,70,70-74,9
17,0,0,0,0,2021-01-28,Male,24,20-24,9
17,0,0,0,0,2021-01-29,Male,22,20-24,11
17,3,0,0,3,2021-01-28,Female,16,15-19,14
17,1,0,0,1,2021-01-28,Male,65,65-69,15
17,1,0,0,1,2021-01-30,Female,79,75-79,13
17,0,0,0,0,2021-01-28,Male,23,20-24,6
17,0,0,0,0,2021-01-28,Female,56,55-64,12
17,1,0,0,1,2021-01-28,Male,28,25-34,8
17,1,1,0,2,2021-01-29,Male,70,70-74,14
17,0,0,0,0,2021-01-29,Female,58,55-64,17
17,2,0,0,2,2021-01-28,Male,29,25-34,13
17,3,0,0,3,2021-01-29,Male,9,5-9,12
17,0,3,0,3,2021-01-30,Female,32,25-34,3
17,3,0,0,3,2021-01-28,Male,65,65-69,13
17,1,0,0,1,2021-01-29,Female,58,55-64,14
17,1,0,0,1,2021-01-28,Female,42,35-44,8
17,1,1,0,2,2021-01-28,Female,60,55-64,13
17,0,2,0,2,2021-01-29,Male,71,70-74,17
17,2,2,0,4,2021-01-28,Male,16,15-19,12
17,0,0,0,0,2021-01-29,Female,71,70-74,12
17,1,2,0,3,2021-01-29,Male,74,70-74,15
17,2,0,0,2,2021-01-28,Female,21,20-24,9
17,1,0,0,1,2021-01-29,Male,33,25-34,9
17,0,0,0,0,2021-01-28,Male,54,45-54,13
17,1,0,0,1,2021-01-29,Female,29,25-34,9
17,0,0,0,0,2021-01-30,Male,10,10-14,12
17,2,79,100,181,2021-01-28,Male,16,15-19,13
17,0,0,0,0,2021-01-29,Male,65,65-69,11
17,1,2,0,3,2021-01-31,Male,68,65-69,14
17,0,0,0,0,2021-01-28,Male,50,45-54,15
17,0,0,0,0,2021-01-29,Male,71,70-74,15
17,0,1,0,1,2021-01-28,Male,48,45-54,11
17,2,0,0,2,2021-01-29,Female,69,65-69,17
17,0,0,0,0,2021-01-28,Male,38,35-44,11
17,2,0,0,2,2021-01-28,Female,34,25-34,6
17,2,0,0,2,2021-01-29,Female,73,70-74,10
17,0,0,0,0,2021-01-28,Male,52,45-54,11
17,1,0,0,1,2021-01-28,Female,57,55-64,14
17,1,0,0,1,2021-01-28,Female,60,55-64,17
17,0,0,0,0,2021-01-29,Male,43,35-44,16
17,2,0,0,2,2021-01-29,Male,73,70-74,13
17,1,1,0,2,2021-01-28,Female,31,25-34,4
17,2,5,0,7,2021-01-28,Female,53,45-54,16
17,2,0,0,2,2021-01-28,Male,69,65-69,12
17,1,0,0,1,2021-01-29,Male,34,25-34,16
17,3,3,0,6,2021-01-29,Male,70,70-74,12
17,0,0,0,0,2021-01-28,Male,66,65-69,16
17,3,0,0,3,2021-01-28,Male,9,5-9,13
17,2,0,0,2,2021-01-29,Male,68,65-69,15
17,1,4,0,5,2021-01-29,Male,71,70-74,12
17,0,0,0,0,2021-02-02,Male,44,35-44,10
17,0,0,0,0,2021-01-28,Female,56,55-64,15
17,0,0,0,0,2021-01-28,Female,58,55-64,13
17,3,10,0,13,2021-01-29,Male,23,20-24,7
17,1,2,0,3,2021-02-02,Female,25,25-34,8
17,1,1,0,2,2021-01-29,Female,61,55-64,17
17,2,0,0,2,2021-01-28,Male,49,45-54,12
17,1,0,0,1,2021-01-28,Female,54,45-54,17
17,0,0,0,0,2021-01-28,Male,34,25-34,12
17,0,0,0,0,2021-01-29,Female,65,65-69,17
17,3,15,0,18,2021-01-29,Female,5,5-9,11
17,3,1,0,4,2021-01-29,Male,5,5-9,10
17,2,0,0,2,2021-01-28,Male,10,10-14,4
17,0,0,0,0,2021-01-29,Female,67,65-69,12
17,0,0,0,0,2021-01-29,Male,39,35-44,13
17,2,3,0,5,2021-01-28,Female,15,15-19,10
17,0,0,0,0,2021-01-29,Female,55,55-64,14
17,2,0,0,2,2021-01-30,Female,70,70-74,5
17,0,0,0,0,2021-01-28,Male,53,45-54,11
17,1,0,0,1,2021-01-28,Male,48,45-54,11
17,1,1,0,2,2021-01-28,Male,69,65-69,15
17,0,1,0,1,2021-01-28,Male,36,35-44,17
17,1,0,0,1,2021-01-28,Male,40,35-44,17
17,2,0,0,2,2021-01-28,Female,61,55-64,13
17,0,0,0,0,2021-01-28,Male,32,25-34,13
17,2,0,0,2,2021-01-30,Male,62,55-64,16
17,0,0,0,0,2021-01-28,Male,6,5-9,13
17,0,0,0,0,2021-01-29,Male,37,35-44,9
17,0,0,0,0,2021-01-28,Female,53,45-54,13
17,0,0,0,0,2021-01-29,Male,31,25-34,4
17,0,0,0,0,2021-01-29,Male,77,75-79,9
17,1,1,0,2,2021-01-29,Male,47,45-54,11
17,1,4,0,5,2021-01-28,Male,52,45-54,14
17,1,1,1,3,2021-01-29,Male,33,25-34,12
17,3,0,0,3,2021-01-29,Male,69,65-69,12
17,3,0,0,3,2021-01-28,Male,19,15-19,14
17,2,0,0,2,2021-01-28,Male,65,65-69,13
17,0,1,0,1,2021-01-28,Male,49,45-54,14
17,2,0,0,2,2021-01-28,Female,67,65-69,9
17,2,5,1,8,2021-01-28,Female,67,65-69,16
17,1,0,0,1,2021-01-29,Male,68,65-69,15
17,0,2,0,2,2021-01-29,Female,26,25-34,4
17,1,0,0,1,2021-01-29,Female,44,35-44,8
17,2,0,0,2,2021-01-29,Male,70,70-74,9
17,0,0,0,0,2021-01-29,Female,52,45-54,15
17,5,0,0,5,2021-01-29,Male,14,10-14,14
17,3,4,0,7,2021-01-29,Female,3,1-4,10
17,1,1,2,4,2021-01-30,Male,81,80-84,15
17,4,0,0,4,2021-01-28,Female,6,5-9,7
17,0,0,0,0,2021-01-28,Female,58,55-64,11
17,0,0,0,0,2021-01-28,Male,49,45-54,13
17,0,0,0,0,2021-01-28,Male,25,25-34,14
17,2,0,0,2,2021-01-29,Male,71,70-74,15
17,0,0,0,0,2021-01-29,Male,35,35-44,16
17,0,0,0,0,2021-01-28,Female,45,45-54,5
17,0,0,0,0,2021-01-28,Female,23,20-24,16
17,3,0,0,3,2021-01-29,Male,23,20-24,12
17,3,0,0,3,2021-01-29,Female,8,5-9,13
17,2,0,0,2,2021-01-29,Male,41,35-44,17
17,0,0,0,0,2021-01-29,Male,71,70-74,11
17,2,0,3,5,2021-01-28,Male,58,55-64,13
17,2,0,0,2,2021-01-28,Male,12,10-14,4
17,1,0,0,1,2021-01-30,Male,79,75-79,15
17,0,3,0,3,2021-01-30,Female,67,65-69,14
17,2,1,0,3,2021-01-28,Female,25,25-34,6
17,0,1,0,1,2021-01-29,Female,28,25-34,4
17,0,3,0,3,2021-01-29,Female,64,55-64,12
17,0,0,0,0,2021-01-29,Female,9,5-9,14
17,3,0,0,3,2021-01-28,Female,52,45-54,12
17,2,0,0,2,2021-01-28,Male,61,55-64,14
17,0,0,0,0,2021-01-28,Female,19,15-19,7
17,1,1,0,2,2021-01-29,Female,69,65-69,13
17,0,0,0,0,2021-01-29,Female,76,75-79,15
17,3,0,0,3,2021-01-28,Male,37,35-44,12
17,1,0,0,1,2021-01-28,Female,49,45-54,14
17,1,0,0,1,2021-01-28,Male,61,55-64,11
17,0,0,0,0,2021-01-28,Male,14,10-14,5
17,0,0,0,0,2021-01-29,Female,18,15-19,6
17,2,0,0,2,2021-01-30,Male,57,55-64,8
17,0,0,0,0,2021-01-28,Male,62,55-64,13
17,2,3,0,5,2021-01-28,Female,1,1-4,4
17,0,3,0,3,2021-01-29,Female,33,25-34,3
17,0,0,0,0,2021-01-29,Female,33,25-34,7
17,0,0,0,0,2021-01-28,Female,61,55-64,8
17,1,1,3,5,2021-01-30,Female,61,55-64,13
17,0,0,0,0,2021-01-29,Male,74,70-74,16
17,3,0,0,3,2021-01-29,Female,17,15-19,16
17,2,0,0,2,2021-01-29,Male,66,65-69,7
17,3,1,0,4,2021-01-28,Female,10,10-14,15
17,1,0,0,1,2021-01-28,Male,29,25-34,15
17,4,0,0,4,2021-01-28,Male,7,5-9,4
17,2,0,0,2,2021-01-29,Female,11,10-14,13
17,1,0,0,1,2021-01-29,Female,26,25-34,14
17,2,1,0,3,2021-01-29,Male,76,75-79,15
17,0,0,0,0,2021-01-28,Female,24,20-24,15
17,0,1,0,1,2021-01-29,Male,64,55-64,14
17,2,0,0,2,2021-01-28,Male,54,45-54,16
17,0,0,0,0,2021-01-28,Male,60,55-64,9
17,0,0,0,0,2021-01-29,Male,72,70-74,11
17,2,0,0,2,2021-01-29,Male,73,70-74,11
17,1,0,0,1,2021-01-28,Female,52,45-54,15
17,0,0,0,0,2021-01-28,Male,33,25-34,9
17,0,2,0,2,2021-01-29,Female,71,70-74,13
17,0,0,0,0,2021-01-29,Female,57,55-64,16
17,0,0,0,0,2021-01-28,Male,52,45-54,14
17,0,1,0,1,2021-01-28,Male,54,45-54,14
17,1,3,0,4,2021-01-28,Male,6,5-9,14
17,2,0,0,2,2021-01-28,Male,66,65-69,16
17,0,2,0,2,2021-01-29,Female,69,65-69,9
17,0,0,0,0,2021-02-02,Female,30,25-34,12
17,0,0,0,0,2021-01-29,Male,46,45-54,14
17,2,0,0,2,2021-01-29,Female,69,65-69,12
17,1,0,0,1,2021-01-29,Male,55,55-64,10
17,1,0,0,1,2021-01-28,Female,25,25-34,10
17,1,2,0,3,2021-01-28,Female,47,45-54,10
17,0,1,0,1,2021-01-28,Female,42,35-44,4
17,2,0,0,2,2021-01-29,Female,9,5-9,4
17,1,0,0,1,2021-01-28,Male,63,55-64,15
17,1,9,0,10,2021-01-29,Male,66,65-69,14
17,2,0,0,2,2021-01-29,Male,7,5-9,16
17,0,0,0,0,2021-01-28,Female,17,15-19,9
17,2,1,0,3,2021-01-29,Male,60,55-64,14
17,0,1,2,3,2021-01-29,Male,58,55-64,16
17,1,0,0,1,2021-01-28,Female,65,65-69,17
17,1,0,0,1,2021-01-28,Male,52,45-54,9
17,2,0,0,2,2021-01-28,Female,10,10-14,12
17,2,0,0,2,2021-01-29,Female,24,20-24,13
17,4,0,0,4,2021-01-28,Male,12,10-14,17
17,2,5,0,7,2021-01-28,Male,50,45-54,15
17,0,0,0,0,2021-01-28,Male,19,15-19,7
17,0,0,0,0,2021-01-28,Female,69,65-69,16
17,0,10,0,10,2021-01-29,Male,68,65-69,6
17,0,1,0,1,2021-01-28,Female,32,25-34,3
17,2,0,0,2,2021-01-28,Male,25,25-34,9
17,1,0,0,1,2021-01-28,Female,64,55-64,9
17,2,0,0,2,2021-01-28,Female,67,65-69,7
17,1,0,0,1,2021-01-29,Male,60,55-64,16
17,1,0,0,1,2021-01-29,Male,54,45-54,13
17,1,0,0,1,2021-02-02,Male,63,55-64,4
17,0,0,0,0,2021-01-28,Female,25,25-34,16
17,0,0,0,0,2021-01-28,Male,38,35-44,13
17,0,54,0,54,2021-01-28,Female,24,20-24,14
17,1,0,0,1,2021-01-28,Male,34,25-34,13
17,0,1,0,1,2021-01-28,Female,49,45-54,17
17,0,23,0,23,2021-01-28,Male,40,35-44,11
17,0,0,0,0,2021-01-29,Male,70,70-74,14
17,2,0,0,2,2021-01-28,Female,64,55-64,16
17,0,0,0,0,2021-01-28,Female,20,20-24,4
17,0,0,0,0,2021-01-29,Female,66,65-69,17
17,0,3,0,3,2021-01-30,Female,66,65-69,14
17,0,3,0,3,2021-01-29,Female,70,70-74,11
17,0,0,0,0,2021-01-28,Male,54,45-54,13
17,2,0,0,2,2021-01-28,Male,65,65-69,14
17,1,0,0,1,2021-01-29,Male,57,55-64,12
17,1,0,0,1,2021-01-28,Female,55,55-64,14
17,0,1,0,1,2021-01-30,Male,39,35-44,14
17,2,0,0,2,2021-01-30,Female,9,5-9,16
17,0,1,0,1,2021-01-30,Male,61,55-64,13
17,0,0,0,0,2021-01-28,Male,73,70-74,14
17,3,2,6,11,2021-01-29,Male,43,35-44,11
17,2,0,0,2,2021-01-29,Male,70,70-74,15
17,0,0,0,0,2021-01-29,Female,17,15-19,16
17,1,0,0,1,2021-01-29,Male,63,55-64,16
17,1,1,0,2,2021-01-29,Male,67,65-69,17
17,1,0,0,1,2021-01-29,Female,71,70-74,13
17,0,2,0,2,2021-01-29,Male,51,45-54,7
17,3,0,0,3,2021-01-28,Male,8,5-9,17
17,2,0,0,2,2021-01-28,Female,55,55-64,16
17,0,0,0,0,2021-01-28,Female,22,20-24,13
17,0,0,0,0,2021-01-28,Female,35,35-44,13
17,1,1,0,2,2021-01-28,Male,62,55-64,13
17,3,3,0,6,2021-01-28,Female,21,20-24,4
17,0,0,0,0,2021-01-28,Male,12,10-14,15
17,1,0,0,1,2021-01-28,Female,65,65-69,13
17,5,0,0,5,2021-01-28,Female,13,10-14,12
17,1,0,0,1,2021-01-28,Male,64,55-64,17
17,0,0,0,0,2021-01-29,Female,73,70-74,10
17,1,0,22,23,2021-01-28,Male,53,45-54,12
17,2,3,0,5,2021-01-29,Male,56,55-64,17
17,3,0,0,3,2021-01-28,Female,22,20-24,5
17,1,0,0,1,2021-01-29,Female,55,55-64,13
17,0,0,0,0,2021-01-30,Female,59,55-64,15
17,0,1,0,1,2021-01-31,Female,67,65-69,8
17,0,0,0,0,2021-01-29,Female,24,20-24,3
17,0,0,0,0,2021-01-29,Female,23,20-24,15
17,1,0,0,1,2021-01-28,Female,26,25-34,3
17,1,0,0,1,2021-01-28,Male,32,25-34,14
17,0,0,0,0,2021-01-28,Male,28,25-34,16
17,2,8,0,10,2021-01-28,Male,58,55-64,11
17,0,2,0,2,2021-01-29,Male,47,45-54,13
17,3,0,0,3,2021-01-28,Male,0,<1,6
17,0,0,0,0,2021-01-28,Female,41,35-44,17
17,1,1,0,2,2021-01-29,Male,68,65-69,14
17,2,0,0,2,2021-01-28,Female,73,70-74,10
17,2,0,0,2,2021-01-29,Male,66,65-69,14
17,3,6,0,9,2021-01-28,Male,10,10-14,7
17,1,0,0,1,2021-01-28,Male,33,25-34,13
17,1,0,0,1,2021-01-28,Female,62,55-64,12
17,0,0,0,0,2021-01-28,Male,69,65-69,14
17,0,0,0,0,2021-01-29,Female,31,25-34,15
17,0,1,0,1,2021-01-29,Female,73,70-74,13
17,1,1,0,2,2021-01-28,Male,68,65-69,16
17,0,11,0,11,2021-01-29,Male,59,55-64,12
17,1,0,0,1,2021-01-28,Male,58,55-64,13
17,1,0,0,1,2021-01-29,Male,66,65-69,12
17,0,1,0,1,2021-01-29,Female,53,45-54,12
17,2,1,0,3,2021-01-29,Male,18,15-19,12
17,0,0,0,0,2021-01-28,Female,31,25-34,13
17,1,5,0,6,2021-01-29,Male,47,45-54,5
17,0,0,0,0,2021-01-29,Female,24,20-24,4
17,1,0,0,1,2021-01-29,Male,35,35-44,10
17,0,1,0,1,2021-01-28,Female,21,20-24,3
17,0,0,0,0,2021-02-02,Male,27,25-34,10
17,0,0,0,0,2021-01-28,Female,63,55-64,4
17,2,0,0,2,2021-01-29,Female,48,45-54,11
17,0,0,0,0,2021-01-28,Male,37,35-44,15
17,0,0,0,0,2021-01-29,Male,52,45-54,14
17,1,1,0,2,2021-01-28,Female,46,45-54,15
17,2,2,0,4,2021-01-30,Male,68,65-69,10
17,0,0,0,0,2021-01-29,Male,42,35-44,10
17,1,0,0,1,2021-01-29,Male,55,55-64,14
17,1,0,0,1,2021-01-28,Female,52,45-54,11
17,2,1,0,3,2021-01-29,Female,70,70-74,13
17,0,0,0,0,2021-01-28,Female,65,65-69,11
17,0,1,0,1,2021-01-29,Male,55,55-64,14
17,0,0,0,0,2021-01-29,Male,31,25-34,12
17,1,0,0,1,2021-01-29,Female,21,20-24,14
17,2,0,0,2,2021-01-29,Male,51,45-54,15
17,1,0,0,1,2021-01-28,Male,48,45-54,11
17,0,0,8,8,2021-01-30,Male,60,55-64,13
17,1,0,0,1,2021-01-29,Male,69,65-69,12
17,0,3,0,3,2021-01-28,Male,30,25-34,14
17,0,0,0,0,2021-01-29,Male,36,35-44,13
17,1,0,0,1,2021-01-28,Female,69,65-69,14
17,0,1,0,1,2021-01-28,Female,26,25-34,14
17,0,0,0,0,2021-01-29,Female,24,20-24,3
17,0,0,28,28,2021-01-28,Male,40,35-44,10
17,0,1,0,1,2021-01-28,Male,65,65-69,17
17,1,3,0,4,2021-01-29,Male,52,45-54,11
17,0,1,0,1,2021-01-29,Male,70,70-74,10
17,2,0,0,2,2021-01-28,Female,65,65-69,17
17,1,1,0,2,2021-01-29,Male,70,70-74,14
17,0,0,0,0,2021-01-28,Female,65,65-69,13
17,1,1,0,2,2021-01-29,Male,72,70-74,10
17,2,0,0,2,2021-01-29,Female,26,25-34,4
17,1,0,0,1,2021-01-29,Male,59,55-64,17
17,2,0,0,2,2021-01-29,Male,70,70-74,16
17,1,0,0,1,2021-01-28,Male,38,35-44,4
17,1,3,0,4,2021-01-28,Male,51,45-54,16
17,0,0,0,0,2021-01-28,Female,26,25-34,3
17,1,0,0,1,2021-01-28,Male,72,70-74,13
17,2,0,0,2,2021-01-31,Male,72,70-74,15
17,1,1,0,2,2021-01-29,Female,64,55-64,12
17,3,0,0,3,2021-01-28,Female,17,15-19,15
17,2,0,0,2,2021-01-29,Male,2,1-4,9
17,1,0,0,1,2021-01-29,Female,58,55-64,15
17,1,0,0,1,2021-01-30,Male,78,75-79,10
17,0,2,0,2,2021-01-28,Male,40,35-44,14
17,1,0,0,1,2021-01-28,Female,67,65-69,12
17,1,0,0,1,2021-01-29,Female,68,65-69,16
17,3,0,0,3,2021-01-28,Female,16,15-19,12
17,0,0,0,0,2021-01-29,Female,28,25-34,15
17,0,0,0,0,2021-01-28,Female,33,25-34,13
17,2,0,0,2,2021-01-28,Female,18,15-19,13
17,2,4,0,6,2021-01-28,Female,50,45-54,10
17,0,0,0,0,2021-01-28,Male,43,35-44,10
17,7,0,0,7,2021-01-29,Male,3,1-4,7
17,1,1,0,2,2021-01-31,Female,60,55-64,3
17,2,0,0,2,2021-01-29,Male,26,25-34,14
17,0,0,0,0,2021-01-29,Male,47,45-54,3
17,2,0,0,2,2021-01-29,Male,70,70-74,12
17,0,0,0,0,2021-01-29,Male,69,65-69,15
17,1,1,0,2,2021-01-28,Male,60,55-64,14
17,2,11,0,13,2021-01-29,Male,30,25-34,13
17,3,0,0,3,2021-01-29,Female,0,<1,14
17,1,0,0,1,2021-01-29,Female,63,55-64,11
17,0,0,0,0,2021-01-28,Male,42,35-44,14
17,1,0,0,1,2021-01-28,Male,36,35-44,14
17,3,0,0,3,2021-01-30,Male,17,15-19,13
17,0,0,0,0,2021-01-28,Male,25,25-34,8
17,2,1,0,3,2021-01-29,Female,50,45-54,11
17,1,0,0,1,2021-01-29,Male,50,45-54,14
17,0,0,0,0,2021-02-02,Female,24,20-24,10
17,1,1,0,2,2021-01-28,Male,51,45-54,16
17,1,0,0,1,2021-01-29,Male,43,35-44,4
17,0,0,0,0,2021-01-29,Female,25,25-34,9
17,2,3,0,5,2021-01-29,Male,70,70-74,14
17,0,0,0,0,2021-01-30,Female,46,45-54,4
17,0,0,0,0,2021-01-29,Male,53,45-54,12
17,0,0,0,0,2021-01-29,Male,33,25-34,16
17,0,5,0,5,2021-01-28,Male,46,45-54,11
17,0,1,0,1,2021-01-28,Female,66,65-69,15
17,2,0,0,2,2021-01-29,Female,12,10-14,10
17,0,0,0,0,2021-01-28,Female,68,65-69,12
17,0,1,0,1,2021-01-28,Female,22,20-24,4
17,0,2,0,2,2021-01-29,Female,69,65-69,13
17,2,0,0,2,2021-01-28,Male,46,45-54,17
17,0,0,0,0,2021-01-29,Female,55,55-64,15
17,3,0,0,3,2021-01-28,Male,2,1-4,8
17,1,1,0,2,2021-01-28,Female,29,25-34,10
17,1,6,1,8,2021-01-28,Male,68,65-69,14
17,3,0,0,3,2021-01-29,Male,10,10-14,10
17,0,0,0,0,2021-01-29,Male,23,20-24,9
17,2,0,0,2,2021-01-30,Male,10,10-14,11
17,1,0,0,1,2021-02-02,Female,46,45-54,7
17,0,0,0,0,2021-01-29,Male,47,45-54,8
17,0,0,0,0,2021-01-29,Female,30,25-34,4
17,2,1,0,3,2021-01-29,Male,76,75-79,10
17,2,0,0,2,2021-01-29,Male,18,15-19,3
17,2,0,0,2,2021-01-29,Male,12,10-14,8
17,1,1,0,2,2021-01-28,Male,58,55-64,14
17,2,0,0,2,2021-01-28,Female,29,25-34,7
17,0,3,0,3,2021-01-29,Male,42,35-44,13
17,0,3,0,3,2021-01-29,Female,28,25-34,2
17,3,1,0,4,2021-01-29,Male,13,10-14,14
17,0,0,0,0,2021-01-29,Male,65,65-69,13
17,0,0,0,0,2021-01-29,Male,51,45-54,12
17,0,0,0,0,2021-01-28,Female,21,20-24,9
17,1,0,0,1,2021-01-29,Female,53,45-54,10
17,1,0,0,1,2021-01-29,Male,71,70-74,13
17,0,0,0,0,2021-01-30,Female,30,25-34,11
17,0,0,0,0,2021-01-28,Female,20,20-24,14
17,0,0,0,0,2021-01-29,Male,27,25-34,13
17,2,0,0,2,2021-01-29,Female,69,65-69,5
17,1,0,0,1,2021-01-28,Female,62,55-64,15
17,0,0,0,0,2021-01-29,Male,66,65-69,16
17,0,0,0,0,2021-01-29,Male,57,55-64,11
17,0,0,0,0,2021-01-29,Male,66,65-69,15
17,1,0,0,1,2021-01-28,Male,63,55-64,16
17,2,0,0,2,2021-01-28,Female,69,65-69,10
17,1,1,0,2,2021-01-29,Male,31,25-34,9
17,0,0,0,0,2021-01-29,Female,30,25-34,12
17,1,0,0,1,2021-01-29,Male,72,70-74,15
17,0,0,0,0,2021-01-29,Female,63,55-64,14
17,0,0,0,0,2021-01-30,Female,36,35-44,15
17,2,0,0,2,2021-01-28,Male,71,70-74,12
17,5,0,0,5,2021-01-28,Female,18,15-19,14
17,3,3,0,6,2021-01-28,Female,65,65-69,16
17,0,0,0,0,2021-01-29,Female,43,35-44,10
17,0,0,0,0,2021-01-29,Female,66,65-69,12
17,0,0,0,0,2021-01-28,Female,39,35-44,8
17,2,0,0,2,2021-01-29,Female,59,55-64,14
17,0,0,0,0,2021-01-29,Female,22,20-24,13
17,1,1,0,2,2021-01-29,Female,19,15-19,4
17,1,1,0,2,2021-01-29,Male,55,55-64,11
17,0,0,0,0,2021-01-29,Female,31,25-34,14
17,0,0,0,0,2021-01-28,Female,25,25-34,4
17,0,0,0,0,2021-01-29,Male,53,45-54,14
17,0,2,0,2,2021-01-29,Male,40,35-44,13
17,1,1,0,2,2021-01-29,Male,43,35-44,14
17,0,0,0,0,2021-01-29,Female,64,55-64,16
17,0,0,0,0,2021-01-29,Male,20,20-24,16
17,1,0,0,1,2021-01-28,Female,67,65-69,14
17,0,0,0,0,2021-01-28,Male,60,55-64,9
17,0,2,0,2,2021-01-28,Female,62,55-64,16
17,0,0,0,0,2021-01-28,Male,50,45-54,13
17,2,0,0,2,2021-01-28,Male,44,35-44,15
17,1,0,0,1,2021-01-28,Male,60,55-64,10
17,2,1,0,3,2021-01-29,Male,17,15-19,12
17,1,1,0,2,2021-01-29,Male,71,70-74,12
17,0,5,0,5,2021-01-28,Female,67,65-69,10
17,1,0,0,1,2021-01-28,Male,70,70-74,13
17,1,2,0,3,2021-01-28,Male,23,20-24,8
17,0,0,0,0,2021-01-29,Male,16,15-19,6
17,2,0,0,2,2021-01-28,Male,7,5-9,12
17,0,0,0,0,2021-01-30,Female,71,70-74,15
17,0,0,0,0,2021-01-29,Female,26,25-34,4
17,0,0,0,0,2021-01-28,Male,11,10-14,13
17,2,0,0,2,2021-01-29,Male,67,65-69,13
17,1,1,0,2,2021-01-29,Male,66,65-69,14
17,0,0,0,0,2021-01-28,Female,32,25-34,3
17,0,0,0,0,2021-01-29,Male,70,70-74,13
17,0,0,0,0,2021-01-28,Female,34,25-34,16
17,0,0,0,0,2021-01-28,Male,52,45-54,16
17,1,0,0,1,2021-01-28,Male,68,65-69,17
17,0,0,1,1,2021-01-29,Female,52,45-54,11
17,1,1,0,2,2021-01-28,Male,79,75-79,11
17,0,0,0,0,2021-01-29,Female,24,20-24,3
17,0,0,0,0,2021-01-29,Male,24,20-24,11
17,0,0,0,0,2021-01-28,Male,19,15-19,14
17,1,1,0,2,2021-01-29,Female,58,55-64,4
17,0,1,0,1,2021-01-28,Male,42,35-44,9
17,3,0,0,3,2021-01-29,Male,14,10-14,13
17,0,0,0,0,2021-01-28,Female,61,55-64,10
17,2,2,0,4,2021-01-30,Male,79,75-79,12
17,2,0,0,2,2021-01-28,Male,53,45-54,14
17,0,0,0,0,2021-01-29,Male,51,45-54,10
17,0,1,0,1,2021-01-29,Male,24,20-24,4
17,3,0,0,3,2021-01-29,Female,43,35-44,16
17,1,1,0,2,2021-01-31,Female,65,65-69,6
17,1,11,0,12,2021-01-29,Female,24,20-24,15
17,0,0,0,0,2021-01-29,Male,31,25-34,12
17,0,0,0,0,2021-01-28,Female,65,65-69,17
17,2,0,0,2,2021-01-29,Male,10,10-14,13
17,2,0,0,2,2021-01-29,Male,24,20-24,7
17,1,0,0,1,2021-01-29,Male,70,70-74,10
17,0,0,0,0,2021-01-29,Female,69,65-69,11
17,3,0,0,3,2021-01-28,Female,2,1-4,14
17,1,7,0,8,2021-01-29,Male,59,55-64,9
17,1,0,0,1,2021-01-28,Male,38,35-44,8
17,0,0,0,0,2021-01-28,Male,45,45-54,12
17,0,0,0,0,2021-01-28,Male,6,5-9,4
17,1,0,0,1,2021-01-29,Female,59,55-64,15
17,0,0,0,0,2021-01-28,Female,54,45-54,15
17,0,0,0,0,2021-01-28,Female,41,35-44,16
17,3,1,0,4,2021-01-29,Female,24,20-24,5
17,1,0,0,1,2021-01-28,Male,20,20-24,2
17,0,0,0,0,2021-01-28,Male,40,35-44,10
17,2,1,0,3,2021-02-02,Female,70,70-74,9
17,3,3,0,6,2021-01-28,Female,12,10-14,11
17,0,1,0,1,2021-01-28,Male,22,20-24,9
17,1,0,0,1,2021-01-29,Female,52,45-54,17
17,0,0,0,0,2021-01-28,Male,40,35-44,13
17,3,0,0,3,2021-01-28,Male,18,15-19,13
17,0,1,0,1,2021-01-30,Male,78,75-79,16
17,0,0,0,0,2021-01-29,Male,44,35-44,11
17,1,0,0,1,2021-01-28,Female,21,20-24,4
17,1,0,0,1,2021-01-28,Male,67,65-69,17
17,2,0,0,2,2021-01-29,Female,66,65-69,16
17,0,0,0,0,2021-01-29,Female,66,65-69,10
17,3,0,0,3,2021-01-29,Male,2,1-4,9
17,0,0,0,0,2021-01-28,Male,48,45-54,16
17,1,6,0,7,2021-01-29,Female,66,65-69,17
17,0,40,100,140,2021-01-29,Male,38,35-44,14
17,0,0,0,0,2021-01-30,Male,30,25-34,14
17,0,0,0,0,2021-01-28,Male,19,15-19,12
17,0,0,0,0,2021-01-28,Female,54,45-54,13
17,1,0,0,1,2021-01-28,Female,67,65-69,15
17,0,0,0,0,2021-01-28,Female,38,35-44,5
17,1,0,0,1,2021-01-28,Male,48,45-54,10
17,2,0,20,22,2021-01-28,Female,43,35-44,9
17,0,0,0,0,2021-01-29,Male,40,35-44,16
17,0,4,0,4,2021-01-28,Female,19,15-19,6
17,0,1,0,1,2021-01-29,Female,38,35-44,8
17,1,0,0,1,2021-01-28,Male,64,55-64,14
17,1,0,0,1,2021-01-29,Male,60,55-64,11
17,0,0,0,0,2021-01-30,Male,41,35-44,15
17,0,0,0,0,2021-01-28,Female,12,10-14,9
17,2,0,0,2,2021-01-28,Female,11,10-14,17
17,2,0,0,2,2021-01-29,Female,52,45-54,13
17,2,0,0,2,2021-01-29,Female,58,55-64,9
17,1,0,0,1,2021-01-28,Female,59,55-64,15
17,0,0,0,0,2021-01-28,Male,14,10-14,14
17,0,0,0,0,2021-01-28,Male,18,15-19,13
17,2,0,0,2,2021-01-28,Female,17,15-19,15
17,1,1,0,2,2021-01-29,Male,55,55-64,7
17,1,0,0,1,2021-02-02,Female,49,45-54,15
17,0,0,0,0,2021-01-28,Female,21,20-24,12
17,2,0,0,2,2021-01-29,Female,14,10-14,11
17,3,0,0,3,2021-01-28,Female,24,20-24,11
17,1,0,0,1,2021-01-30,Female,5,5-9,8
17,0,0,0,0,2021-01-29,Female,37,35-44,3
17,1,2,0,3,2021-01-29,Male,74,70-74,10
17,0,0,0,0,2021-01-28,Male,39,35-44,14
17,0,0,0,0,2021-01-29,Male,35,35-44,9
17,3,0,0,3,2021-01-29,Male,19,15-19,10
17,0,3,0,3,2021-01-28,Male,35,35-44,11
17,0,0,0,0,2021-01-28,Female,16,15-19,12
17,1,0,0,1,2021-01-28,Male,66,65-69,14
17,3,1,0,4,2021-01-28,Female,0,<1,8
17,0,0,0,0,2021-01-29,Female,25,25-34,4
17,0,0,0,0,2021-01-28,Female,65,65-69,12
17,0,0,0,0,2021-01-28,Male,33,25-34,7
17,1,0,0,1,2021-01-28,Male,52,45-54,8
17,0,2,0,2,2021-01-28,Female,31,25-34,13
17,2,9,0,11,2021-01-28,Male,67,65-69,15
17,0,1,0,1,2021-01-29,Female,58,55-64,4
17,2,0,0,2,2021-01-28,Female,8,5-9,13
17,2,0,0,2,2021-01-28,Male,12,10-14,12
17,0,0,0,0,2021-01-29,Female,69,65-69,14
17,0,3,0,3,2021-01-29,Male,28,25-34,14
17,0,0,0,0,2021-01-29,Male,73,70-74,13
17,1,2,1,4,2021-01-28,Female,21,20-24,6
17,0,0,0,0,2021-01-29,Female,29,25-34,5
17,0,0,0,0,2021-01-28,Male,44,35-44,13
17,2,0,0,2,2021-01-29,Female,63,55-64,10
17,1,0,0,1,2021-01-29,Female,68,65-69,14
17,1,0,0,1,2021-01-28,Male,55,55-64,17
17,1,0,0,1,2021-01-28,Female,61,55-64,16
17,0,0,0,0,2021-01-28,Female,4,1-4,7
17,2,0,0,2,2021-01-29,Female,61,55-64,16
17,2,0,0,2,2021-01-29,Male,1,1-4,4
17,1,3,0,4,2021-01-29,Male,52,45-54,16
17,0,0,0,0,2021-01-28,Male,65,65-69,14
17,1,0,0,1,2021-01-29,Male,65,65-69,13
17,1,0,0,1,2021-01-28,Male,24,20-24,4
17,0,0,0,0,2021-01-31,Female,68,65-69,12
17,2,0,0,2,2021-01-28,Male,14,10-14,11
17,0,0,0,0,2021-01-28,Female,52,45-54,15
17,0,0,0,0,2021-01-29,Female,10,10-14,10
17,0,0,0,0,2021-01-28,Female,55,55-64,13
17,2,0,0,2,2021-01-28,Female,48,45-54,14
17,0,1,0,1,2021-01-28,Female,30,25-34,4
17,0,0,0,0,2021-01-28,Male,29,25-34,12
17,0,0,0,0,2021-01-28,Female,44,35-44,16
17,0,2,0,2,2021-01-28,Male,22,20-24,9
17,1,0,0,1,2021-01-29,Male,72,70-74,12
17,2,0,0,2,2021-01-28,Female,68,65-69,13
17,2,1,0,3,2021-01-29,Male,23,20-24,14
17,1,2,0,3,2021-01-28,Male,58,55-64,16
17,0,0,0,0,2021-01-28,Male,14,10-14,14
17,3,0,0,3,2021-01-28,Male,2,1-4,13
17,0,0,0,0,2021-01-29,Male,16,15-19,13
17,0,0,0,0,2021-01-31,Male,67,65-69,5
17,2,0,0,2,2021-01-30,Male,29,25-34,15
17,2,0,0,2,2021-01-29,Male,33,25-34,10
17,1,0,0,1,2021-01-28,Female,69,65-69,14
17,0,1,0,1,2021-01-29,Male,67,65-69,13
17,0,0,0,0,2021-01-28,Male,35,35-44,13
17,2,0,0,2,2021-01-28,Female,6,5-9,15
17,2,0,0,2,2021-01-28,Male,42,35-44,14
17,0,1,0,1,2021-01-29,Female,76,75-79,7
17,5,0,0,5,2021-01-28,Female,2,1-4,13
17,0,0,0,0,2021-01-28,Male,40,35-44,11
17,4,0,0,4,2021-01-28,Male,7,5-9,17
17,2,1,0,3,2021-01-28,Female,1,1-4,12
17,2,0,0,2,2021-01-28,Male,51,45-54,12
17,1,4,0,5,2021-01-30,Female,61,55-64,13
17,1,2,0,3,2021-01-29,Male,65,65-69,16
17,1,10,0,11,2021-01-29,Female,39,35-44,11
17,2,0,0,2,2021-01-29,Male,52,45-54,16
17,0,0,0,0,2021-01-28,Male,51,45-54,11
17,1,10,0,11,2021-01-28,Male,53,45-54,12
17,0,0,0,0,2021-01-28,Male,12,10-14,4
17,1,3,0,4,2021-01-30,Female,56,55-64,16
17,1,1,0,2,2021-01-28,Male,32,25-34,13
17,0,0,0,0,2021-01-28,Female,49,45-54,13
17,1,0,0,1,2021-01-29,Male,67,65-69,15
17,0,0,0,0,2021-01-28,Male,59,55-64,13
17,0,5,0,5,2021-01-28,Male,42,35-44,17
17,0,0,0,0,2021-01-28,Female,34,25-34,14
17,1,2,0,3,2021-01-28,Male,63,55-64,12
17,0,0,0,0,2021-01-29,Female,69,65-69,13
17,4,0,0,4,2021-01-28,Male,2,1-4,14
17,0,2,0,2,2021-01-28,Male,58,55-64,15
17,0,1,0,1,2021-01-29,Female,34,25-34,13
17,1,2,0,3,2021-01-29,Male,62,55-64,6
17,1,2,0,3,2021-01-29,Male,62,55-64,17
17,0,2,0,2,2021-01-28,Female,67,65-69,17
17,5,0,0,5,2021-01-28,Female,37,35-44,13
17,0,0,0,0,2021-01-28,Male,47,45-54,15
17,0,0,0,0,2021-01-30,Female,58,55-64,12
17,1,0,0,1,2021-01-29,Female,24,20-24,10
17,2,4,0,6,2021-01-28,Female,66,65-69,11
17,0,0,0,0,2021-01-29,Male,27,25-34,13
17,0,1,0,1,2021-01-28,Male,48,45-54,14
17,0,0,0,0,2021-01-29,Male,32,25-34,12
17,2,2,0,4,2021-01-29,Male,49,45-54,10
17,0,0,0,0,2021-01-29,Male,52,45-54,14
17,0,3,0,3,2021-01-29,Male,72,70-74,6
17,0,1,0,1,2021-01-28,Male,29,25-34,3
17,4,0,0,4,2021-01-29,Female,3,1-4,8
17,2,0,0,2,2021-01-29,Female,14,10-14,10
17,0,0,0,0,2021-01-28,Male,62,55-64,12
17,2,0,0,2,2021-01-28,Male,14,10-14,16
17,2,3,0,5,2021-01-29,Female,63,55-64,13
17,0,0,100,100,2021-01-28,Male,43,35-44,16
17,2,0,0,2,2021-01-29,Female,64,55-64,17
17,1,0,0,1,2021-01-29,Female,48,45-54,16
17,0,1,0,1,2021-01-28,Male,54,45-54,9
17,0,0,0,0,2021-01-29,Female,54,45-54,12
17,1,0,0,1,2021-01-28,Female,33,25-34,11
17,2,0,0,2,2021-01-30,Male,5,5-9,10
17,2,0,0,2,2021-01-30,Female,10,10-14,13
17,1,0,0,1,2021-01-28,Female,51,45-54,13
17,0,0,0,0,2021-01-28,Female,24,20-24,9
17,0,3,0,3,2021-01-30,Female,42,35-44,4
17,0,0,0,0,2021-01-28,Female,59,55-64,12
17,0,1,0,1,2021-01-29,Male,65,65-69,17
17,4,1,0,5,2021-01-30,Female,6,5-9,8
17,1,1,0,2,2021-01-29,Male,61,55-64,16
17,1,1,0,2,2021-01-28,Male,66,65-69,16
17,1,2,0,3,2021-01-29,Female,56,55-64,8
17,1,0,0,1,2021-01-29,Female,59,55-64,15
17,2,0,0,2,2021-01-29,Male,73,70-74,10
17,2,0,0,2,2021-01-28,Female,65,65-69,12
17,0,0,0,0,2021-01-31,Male,56,55-64,14
17,1,2,0,3,2021-01-28,Female,56,55-64,15
17,0,2,0,2,2021-01-28,Female,67,65-69,16
17,1,0,0,1,2021-01-29,Female,24,20-24,4
17,0,0,0,0,2021-01-29,Male,71,70-74,12
17,2,0,0,2,2021-01-31,Female,70,70-74,14
17,0,0,0,0,2021-01-29,Female,71,70-74,12
17,0,1,0,1,2021-01-29,Male,67,65-69,17
17,0,0,0,0,2021-01-29,Female,74,70-74,10
17,1,0,0,1,2021-01-30,Male,80,80-84,12
17,0,0,0,0,2021-01-29,Male,40,35-44,12
17,0,3,0,3,2021-01-30,Female,67,65-69,5
17,1,1,0,2,2021-01-29,Male,63,55-64,15
17,0,0,0,0,2021-01-29,Male,37,35-44,16
17,1,1,0,2,2021-01-29,Female,28,25-34,15
17,0,0,0,0,2021-01-28,Female,10,10-14,13
17,2,0,0,2,2021-01-29,Female,13,10-14,17
17,1,0,0,1,2021-01-28,Male,35,35-44,16
17,0,1,0,1,2021-01-29,Female,72,70-74,15
17,0,0,0,0,2021-01-28,Female,26,25-34,9
17,3,0,0,3,2021-01-28,Male,35,35-44,11
17,3,1,0,4,2021-01-28,Male,41,35-44,14
17,0,0,0,0,2021-01-28,Female,63,55-64,4
17,0,17,0,17,2021-01-29,Male,13,10-14,10
17,0,0,0,0,2021-01-28,Female,43,35-44,14
17,1,2,0,3,2021-01-28,Male,32,25-34,6
17,3,8,0,11,2021-01-28,Male,6,5-9,14
17,2,2,0,4,2021-01-28,Female,36,35-44,16
17,1,0,0,1,2021-01-29,Female,59,55-64,15
17,1,0,0,1,2021-01-29,Male,28,25-34,3
17,3,0,0,3,2021-01-29,Male,49,45-54,8
17,0,0,0,0,2021-01-28,Female,58,55-64,14
17,0,1,0,1,2021-01-29,Male,76,75-79,11
17,0,0,0,0,2021-01-28,Male,52,45-54,15
17,1,6,0,7,2021-01-29,Female,75,75-79,10
17,2,0,0,2,2021-01-28,Male,65,65-69,13
17,0,0,0,0,2021-01-28,Male,35,35-44,4
17,0,0,0,0,2021-01-30,Male,35,35-44,4
17,0,3,0,3,2021-01-28,Female,66,65-69,16
17,0,0,0,0,2021-01-28,Male,26,25-34,4
17,1,1,0,2,2021-01-28,Female,46,45-54,14
17,0,6,0,6,2021-01-29,Male,70,70-74,11
17,2,0,0,2,2021-01-29,Male,53,45-54,12
17,0,0,0,0,2021-01-28,Female,63,55-64,14
17,0,0,0,0,2021-01-29,Female,23,20-24,8
17,1,1,0,2,2021-01-29,Female,26,25-34,3
17,1,0,0,1,2021-01-29,Female,70,70-74,17
17,1,1,0,2,2021-01-28,Female,54,45-54,4
17,1,2,0,3,2021-01-29,Male,74,70-74,9
17,0,0,0,0,2021-01-29,Male,27,25-34,16
17,1,1,0,2,2021-01-30,Male,28,25-34,17
17,1,1,0,2,2021-01-29,Female,31,25-34,11
17,1,0,0,1,2021-01-28,Male,42,35-44,14
17,0,1,0,1,2021-01-29,Male,71,70-74,15
17,0,0,0,0,2021-01-29,Female,68,65-69,17
17,0,1,0,1,2021-01-29,Female,62,55-64,14
17,0,0,0,0,2021-01-28,Male,27,25-34,11
17,1,0,5,6,2021-01-30,Male,7,5-9,13
17,0,0,0,0,2021-01-28,Female,34,25-34,13
17,1,1,0,2,2021-01-29,Male,69,65-69,16
17,1,0,0,1,2021-01-29,Female,40,35-44,4
17,1,2,0,3,2021-01-29,Male,68,65-69,15
17,0,0,0,0,2021-01-28,Male,19,15-19,4
17,0,0,0,0,2021-01-28,Male,34,25-34,13
17,3,1,0,4,2021-01-28,Male,19,15-19,10
17,0,0,0,0,2021-01-28,Female,62,55-64,14
17,0,1,0,1,2021-01-28,Female,56,55-64,16
17,1,1,0,2,2021-01-29,Male,66,65-69,12
17,3,0,0,3,2021-01-28,Male,6,5-9,11
17,1,0,0,1,2021-01-28,Male,42,35-44,10
17,0,0,0,0,2021-01-28,Female,59,55-64,17
17,3,0,0,3,2021-01-28,Female,1,1-4,13
17,1,0,0,1,2021-01-29,Female,23,20-24,2
17,1,1,0,2,2021-01-29,Female,59,55-64,13
17,3,4,0,7,2021-01-28,Male,7,5-9,9
17,4,0,0,4,2021-01-29,Female,54,45-54,12
17,2,0,0,2,2021-01-29,Female,56,55-64,13
17,1,2,0,3,2021-01-29,Male,61,55-64,16
17,0,0,0,0,2021-01-28,Male,70,70-74,16
17,4,0,0,4,2021-01-28,Male,47,45-54,8
17,0,1,0,1,2021-01-28,Female,54,45-54,12
17,1,0,0,1,2021-01-29,Male,69,65-69,11
17,3,6,0,9,2021-01-29,Male,71,70-74,12
17,2,4,0,6,2021-01-30,Male,77,75-79,12
17,2,0,0,2,2021-01-29,Male,52,45-54,10
17,1,1,0,2,2021-01-29,Male,70,70-74,14
17,3,1,0,4,2021-01-28,Male,19,15-19,3
17,3,0,0,3,2021-01-28,Female,17,15-19,13
17,0,0,0,0,2021-01-29,Female,41,35-44,3
17,1,0,0,1,2021-01-29,Female,65,65-69,16
17,4,0,0,4,2021-01-29,Female,19,15-19,10
17,0,0,0,0,2021-01-28,Female,37,35-44,14
17,1,0,0,1,2021-01-28,Female,28,25-34,3
17,1,0,5,6,2021-01-28,Female,48,45-54,9
17,0,0,0,0,2021-01-28,Female,55,55-64,14
17,3,0,0,3,2021-01-30,Female,2,1-4,11
17,2,0,0,2,2021-01-28,Female,53,45-54,10
17,1,1,4,6,2021-01-29,Male,19,15-19,4
17,2,0,0,2,2021-01-28,Male,64,55-64,12
17,2,2,0,4,2021-01-29,Female,52,45-54,11
17,1,1,0,2,2021-01-28,Female,73,70-74,9
17,2,0,0,2,2021-01-28,Male,14,10-14,10
17,0,5,0,5,2021-01-30,Male,61,55-64,14
17,1,1,0,2,2021-01-28,Female,55,55-64,10
17,2,0,0,2,2021-01-28,Male,19,15-19,4
17,1,1,0,2,2021-01-28,Male,50,45-54,4
17,1,1,0,2,2021-01-29,Male,52,45-54,3
17,1,0,0,1,2021-01-28,Male,54,45-54,13
17,2,0,0,2,2021-01-28,Female,65,65-69,15
17,1,0,0,1,2021-01-29,Male,61,55-64,14
17,3,0,0,3,2021-01-29,Male,16,15-19,15
17,0,2,0,2,2021-01-28,Male,52,45-54,12
17,3,0,0,3,2021-01-28,Male,14,10-14,16
17,1,0,0,1,2021-01-28,Female,27,25-34,4
17,0,1,0,1,2021-01-29,Male,64,55-64,8
17,0,3,0,3,2021-01-28,Female,24,20-24,8
17,1,1,0,2,2021-01-28,Female,64,55-64,12
17,0,0,0,0,2021-01-31,Female,67,65-69,16
17,0,1,0,1,2021-01-28,Female,68,65-69,14
17,0,0,0,0,2021-01-28,Male,33,25-34,8
17,1,0,0,1,2021-01-30,Female,60,55-64,8
17,0,0,0,0,2021-01-29,Female,46,45-54,7
17,1,0,0,1,2021-01-28,Female,33,25-34,13
17,1,0,0,1,2021-01-28,Female,52,45-54,16
17,0,0,0,0,2021-01-29,Female,24,20-24,14
17,3,0,0,3,2021-01-28,Female,55,55-64,8
17,0,0,0,0,2021-01-29,Female,44,35-44,12
17,2,0,0,2,2021-01-29,Female,63,55-64,14
17,0,0,0,0,2021-01-29,Female,67,65-69,14
17,1,0,0,1,2021-01-30,Male,36,35-44,8
17,0,0,0,0,2021-01-29,Male,58,55-64,16
17,2,0,0,2,2021-01-29,Female,11,10-14,11
17,0,1,0,1,2021-01-29,Female,23,20-24,11
17,1,0,0,1,2021-01-29,Female,52,45-54,12
17,2,0,0,2,2021-01-31,Male,68,65-69,14
17,1,5,0,6,2021-01-29,Female,55,55-64,14
17,1,0,0,1,2021-01-29,Female,61,55-64,12
17,1,0,0,1,2021-01-29,Male,68,65-69,12
17,1,0,0,1,2021-01-29,Male,64,55-64,17
17,2,3,0,5,2021-01-29,Male,73,70-74,14
17,0,0,0,0,2021-01-28,Male,26,25-34,2
17,0,1,0,1,2021-01-29,Female,72,70-74,15
17,2,2,0,4,2021-01-29,Female,72,70-74,13
17,1,2,0,3,2021-01-29,Female,49,45-54,16
17,4,0,0,4,2021-02-02,Female,59,55-64,14
17,0,0,0,0,2021-01-28,Female,34,25-34,12
17,0,1,0,1,2021-01-28,Female,34,25-34,3
17,1,0,0,1,2021-01-29,Female,51,45-54,10
17,0,0,0,0,2021-01-28,Female,41,35-44,16
17,0,0,0,0,2021-01-29,Male,55,55-64,16
17,0,0,0,0,2021-01-29,Male,23,20-24,11
17,0,0,0,0,2021-01-29,Female,36,35-44,15
17,3,7,0,10,2021-01-28,Female,8,5-9,13
17,1,0,0,1,2021-01-29,Male,55,55-64,13
17,4,0,0,4,2021-01-28,Male,18,15-19,14
17,1,3,0,4,2021-01-28,Female,57,55-64,12
17,1,0,0,1,2021-01-28,Female,67,65-69,12
17,0,0,0,0,2021-01-29,Female,70,70-74,15
17,1,0,0,1,2021-01-29,Male,74,70-74,17
17,3,0,0,3,2021-01-29,Male,13,10-14,15
17,0,0,0,0,2021-01-29,Male,73,70-74,14
17,1,0,0,1,2021-01-29,Female,39,35-44,2
17,1,3,0,4,2021-01-29,Male,67,65-69,5
17,0,0,0,0,2021-01-29,Female,37,35-44,14
17,1,0,0,1,2021-01-30,Female,61,55-64,14
17,3,0,0,3,2021-01-29,Female,11,10-14,14
17,1,1,0,2,2021-01-29,Male,71,70-74,7
17,0,0,0,0,2021-01-29,Female,51,45-54,12
17,1,1,0,2,2021-01-29,Female,51,45-54,7
17,0,3,0,3,2021-01-29,Male,22,20-24,13
17,1,0,0,1,2021-01-29,Male,66,65-69,16
17,0,0,0,0,2021-01-28,Female,25,25-34,9
17,3,1,0,4,2021-01-29,Female,65,65-69,16
17,2,0,0,2,2021-01-29,Female,66,65-69,14
17,0,0,0,0,2021-01-29,Female,75,75-79,15
17,0,0,0,0,2021-01-29,Female,37,35-44,11
17,0,0,0,0,2021-01-28,Male,19,15-19,14
17,1,0,0,1,2021-01-28,Male,66,65-69,15
17,0,0,0,0,2021-01-28,Male,56,55-64,6
17,3,0,0,3,2021-01-29,Female,13,10-14,17
17,0,0,0,0,2021-01-28,Female,65,65-69,11
17,1,0,0,1,2021-01-28,Male,59,55-64,11
17,2,0,0,2,2021-01-28,Male,66,65-69,15
17,0,0,0,0,2021-01-29,Male,28,25-34,11
17,1,4,0,5,2021-01-28,Female,30,25-34,11
17,1,0,0,1,2021-01-28,Female,49,45-54,15
17,0,2,0,2,2021-01-29,Female,73,70-74,9
17,0,0,0,0,2021-01-28,Female,13,10-14,7
17,0,0,0,0,2021-01-30,Female,19,15-19,2
17,4,2,0,6,2021-01-30,Male,30,25-34,7
17,0,0,0,0,2021-01-29,Female,25,25-34,16
17,0,0,0,0,2021-01-29,Female,22,20-24,14
17,1,0,0,1,2021-01-28,Male,40,35-44,14
17,0,0,0,0,2021-01-29,Female,68,65-69,12
17,0,0,0,0,2021-01-28,Male,7,5-9,3
17,1,0,0,1,2021-01-28,Male,68,65-69,15
17,2,0,0,2,2021-01-28,Male,9,5-9,17
17,5,0,0,5,2021-01-29,Female,14,10-14,11
17,0,0,0,0,2021-01-30,Male,56,55-64,14
17,1,1,0,2,2021-01-29,Male,71,70-74,12
17,3,1,0,4,2021-01-28,Female,15,15-19,5
17,1,0,0,1,2021-01-28,Male,64,55-64,12
17,1,1,0,2,2021-01-29,Male,2,1-4,7
17,3,0,0,3,2021-01-28,Female,23,20-24,3
17,0,0,0,0,2021-01-28,Female,34,25-34,13
17,2,0,0,2,2021-01-28,Male,64,55-64,16
17,1,0,0,1,2021-01-29,Female,62,55-64,15
17,3,0,0,3,2021-01-28,Female,43,35-44,13
17,1,0,0,1,2021-01-28,Male,53,45-54,13
17,1,10,0,11,2021-01-29,Male,50,45-54,15
17,1,1,0,2,2021-01-28,Female,67,65-69,15
17,5,0,0,5,2021-01-28,Male,6,5-9,7
17,0,0,0,0,2021-01-29,Male,17,15-19,17
17,0,0,0,0,2021-01-28,Male,33,25-34,14
17,1,0,0,1,2021-01-29,Female,65,65-69,12
17,1,2,0,3,2021-01-29,Male,68,65-69,17
17,0,0,0,0,2021-01-28,Male,11,10-14,14
17,1,0,0,1,2021-01-29,Female,58,55-64,17
17,6,0,0,6,2021-01-28,Female,16,15-19,16
17,1,0,0,1,2021-01-29,Female,68,65-69,11
17,3,0,0,3,2021-01-29,Male,11,10-14,13
17,2,0,0,2,2021-01-28,Male,24,20-24,9
17,0,0,0,0,2021-01-29,Male,3,1-4,12
17,2,0,0,2,2021-01-29,Male,18,15-19,11
17,2,1,0,3,2021-01-28,Male,51,45-54,13
17,0,3,0,3,2021-01-28,Male,39,35-44,13
17,0,0,0,0,2021-01-28,Female,34,25-34,15
17,0,4,0,4,2021-01-28,Male,30,25-34,6
17,6,0,0,6,2021-01-28,Female,19,15-19,4
17,0,1,0,1,2021-01-28,Male,45,45-54,13
17,0,3,0,3,2021-01-29,Female,65,65-69,13
17,0,0,0,0,2021-01-29,Female,76,75-79,8
17,0,0,0,0,2021-01-29,Female,52,45-54,13
17,0,4,0,4,2021-01-28,Female,28,25-34,4
17,2,0,0,2,2021-01-30,Male,26,25-34,11
17,0,4,0,4,2021-01-28,Male,43,35-44,4
17,0,0,0,0,2021-01-29,Female,74,70-74,11
17,0,0,0,0,2021-01-28,Male,17,15-19,8
17,0,2,0,2,2021-01-28,Female,57,55-64,13
17,0,0,0,0,2021-01-29,Female,67,65-69,9
17,0,0,0,0,2021-01-29,Female,69,65-69,15
17,0,0,7,7,2021-01-28,Male,30,25-34,3
17,1,1,0,2,2021-01-29,Female,52,45-54,3
17,1,3,0,4,2021-01-29,Female,31,25-34,6
17,2,3,0,5,2021-01-29,Female,55,55-64,13
17,2,0,0,2,2021-01-28,Male,48,45-54,16
17,0,0,0,0,2021-01-29,Female,53,45-54,16
17,1,0,0,1,2021-01-29,Female,39,35-44,4
17,0,1,0,1,2021-01-28,Male,49,45-54,13
17,3,0,0,3,2021-01-28,Female,23,20-24,6
17,1,0,0,1,2021-01-28,Male,26,25-34,13
17,1,0,0,1,2021-01-28,Male,49,45-54,14
17,1,1,0,2,2021-01-28,Female,51,45-54,8
17,0,0,0,0,2021-01-28,Female,53,45-54,12
17,2,0,0,2,2021-01-30,Male,68,65-69,15
17,3,1,0,4,2021-01-28,Male,20,20-24,14
17,2,0,0,2,2021-02-02,Female,65,65-69,3
17,1,0,0,1,2021-01-29,Female,54,45-54,14
17,2,0,0,2,2021-01-29,Male,14,10-14,10
17,2,0,0,2,2021-01-29,Female,71,70-74,6
17,0,4,0,4,2021-01-28,Male,47,45-54,11
17,0,2,0,2,2021-01-28,Male,50,45-54,17
17,0,0,0,0,2021-01-28,Male,0,<1,7
17,0,0,0,0,2021-01-28,Female,19,15-19,3
17,0,1,0,1,2021-01-29,Male,30,25-34,14
17,0,1,0,1,2021-01-28,Male,43,35-44,15
17,1,0,0,1,2021-01-30,Female,70,70-74,15
17,0,0,0,0,2021-01-29,Female,69,65-69,17
17,1,1,0,2,2021-01-29,Male,71,70-74,15
17,0,0,0,0,2021-01-29,Male,12,10-14,10
17,0,0,0,0,2021-01-28,Male,61,55-64,16
17,0,0,0,0,2021-01-28,Male,11,10-14,13
17,2,0,0,2,2021-01-28,Male,18,15-19,9
17,3,0,0,3,2021-01-29,Male,8,5-9,7
17,2,0,0,2,2021-01-29,Male,20,20-24,13
18,0,0,0,0,2021-02-26,Male,60,55-64,13
18,1,2,0,3,2021-03-02,Male,68,65-69,13
18,2,1,0,3,2021-02-27,Female,58,55-64,10
18,1,0,0,1,2021-02-27,Female,70,70-74,13
18,2,0,0,2,2021-02-27,Female,66,65-69,18
18,0,1,0,1,2021-02-26,Female,72,70-74,14
18,2,2,0,4,2021-02-26,Female,4,1-4,3
18,0,0,0,0,2021-02-26,Female,50,45-54,13
18,1,0,0,1,2021-02-25,Female,72,70-74,18
18,0,1,0,1,2021-02-25,Female,63,55-64,9
18,0,0,0,0,2021-03-02,Female,54,45-54,13
18,0,0,0,0,2021-02-25,Female,67,65-69,11
18,0,0,0,0,2021-02-26,Female,34,25-34,5
18,1,0,0,1,2021-02-28,Female,59,55-64,14
18,0,0,0,0,2021-02-27,Male,51,45-54,14
18,1,0,0,1,2021-02-25,Male,51,45-54,13
18,1,2,0,3,2021-02-24,Female,35,35-44,15
18,0,28,0,28,2021-02-25,Female,22,20-24,3
18,3,0,0,3,2021-02-25,Female,46,45-54,14
18,0,0,0,0,2021-02-24,Male,42,35-44,11
18,0,0,0,0,2021-02-25,Male,32,25-34,14
18,0,0,0,0,2021-02-25,Male,66,65-69,13
18,1,0,0,1,2021-02-25,Male,63,55-64,18
18,1,1,0,2,2021-02-25,Male,14,10-14,12
18,0,0,0,0,2021-03-01,Male,16,15-19,16
18,0,2,0,2,2021-02-27,Male,49,45-54,15
18,3,0,0,3,2021-02-27,Male,58,55-64,12
18,2,0,0,2,2021-02-26,Male,51,45-54,5
18,1,0,0,1,2021-03-02,Male,35,35-44,11
18,0,0,0,0,2021-03-01,Male,53,45-54,12
18,0,0,0,0,2021-03-01,Female,71,70-74,17
18,1,1,0,2,2021-03-02,Male,68,65-69,15
18,0,0,0,0,2021-02-25,Male,20,20-24,12
18,1,0,0,1,2021-02-25,Female,52,45-54,14
18,1,0,0,1,2021-02-26,Female,69,65-69,13
18,0,0,0,0,2021-02-24,Male,42,35-44,18
18,4,0,0,4,2021-02-26,Male,19,15-19,4
18,1,0,0,1,2021-03-01,Male,58,55-64,11
18,1,1,0,2,2021-02-28,Female,56,55-64,18
18,2,0,0,2,2021-02-26,Female,22,20-24,16
18,2,0,0,2,2021-02-25,Male,52,45-54,16
18,3,0,0,3,2021-02-28,Male,24,20-24,3
18,2,0,0,2,2021-03-01,Male,85,85+,16
18,0,0,0,0,2021-02-28,Female,69,65-69,13
18,0,0,0,0,2021-03-02,Female,66,65-69,7
18,3,0,0,3,2021-03-01,Female,11,10-14,6
18,0,0,0,0,2021-02-25,Male,17,15-19,11
18,1,0,0,1,2021-03-01,Male,58,55-64,16
18,0,0,0,0,2021-03-01,Male,68,65-69,16
18,1,0,0,1,2021-03-02,Male,72,70-74,11
18,0,0,0,0,2021-03-01,Male,77,75-79,13
18,0,2,0,2,2021-02-24,Male,26,25-34,5
18,1,0,0,1,2021-02-24,Male,71,70-74,16
18,0,0,0,0,2021-02-27,Male,44,35-44,8
18,0,0,0,0,2021-02-26,Male,52,45-54,15
18,0,0,0,0,2021-02-28,Male,53,45-54,11
18,1,0,0,1,2021-03-01,Male,44,35-44,10
18,3,8,0,11,2021-02-27,Male,44,35-44,11
18,0,0,0,0,2021-02-28,Male,4,1-4,4
18,3,0,0,3,2021-02-24,Male,31,25-34,10
18,0,0,0,0,2021-02-26,Male,37,35-44,4
18,1,0,0,1,2021-02-26,Male,39,35-44,15
18,3,8,15,26,2021-02-27,Male,9,5-9,3
18,2,1,0,3,2021-02-26,Male,69,65-69,14
18,0,0,0,0,2021-03-02,Female,77,75-79,14
18,4,1,0,5,2021-03-03,Male,1,1-4,10
18,3,2,0,5,2021-02-26,Male,2,1-4,4
18,1,0,0,1,2021-03-01,Female,68,65-69,15
18,0,2,0,2,2021-03-01,Female,52,45-54,9
18,5,2,0,7,2021-02-25,Female,4,1-4,6
18,1,2,0,3,2021-02-25,Male,62,55-64,15
18,3,0,0,3,2021-02-28,Female,10,10-14,11
18,0,5,0,5,2021-03-01,Male,72,70-74,11
18,2,0,0,2,2021-02-25,Female,19,15-19,5
18,0,2,0,2,2021-03-01,Male,85,85+,13
18,2,0,0,2,2021-03-02,Female,72,70-74,13
18,0,0,0,0,2021-02-25,Female,22,20-24,4
18,2,0,0,2,2021-02-27,Female,39,35-44,2
18,1,0,0,1,2021-03-02,Male,45,45-54,7
18,2,2,0,4,2021-02-25,Male,54,45-54,17
18,1,0,0,1,2021-02-24,Male,70,70-74,15
18,2,0,0,2,2021-03-02,Female,69,65-69,14
18,2,0,0,2,2021-03-01,Male,67,65-69,10
18,1,1,0,2,2021-02-25,Female,65,65-69,17
18,3,2,0,5,2021-02-26,Male,11,10-14,9
18,2,0,0,2,2021-02-26,Male,66,65-69,16
18,0,0,0,0,2021-03-01,Male,69,65-69,11
18,4,0,0,4,2021-02-26,Female,10,10-14,10
18,1,0,0,1,2021-02-26,Male,40,35-44,8
18,1,0,0,1,2021-03-01,Male,67,65-69,14
18,2,0,0,2,2021-02-26,Male,70,70-74,8
18,0,0,0,0,2021-02-24,Female,10,10-14,4
18,7,0,0,7,2021-03-01,Female,23,20-24,11
18,0,0,0,0,2021-02-27,Male,43,35-44,14
18,3,0,0,3,2021-02-28,Female,9,5-9,13
18,0,0,0,0,2021-02-26,Male,71,70-74,13
18,1,3,0,4,2021-02-27,Male,69,65-69,18
18,0,0,0,0,2021-02-28,Female,2,1-4,12
18,2,0,0,2,2021-02-27,Female,60,55-64,16
18,3,0,0,3,2021-02-25,Male,19,15-19,14
18,1,0,0,1,2021-02-24,Male,31,25-34,13
18,0,2,0,2,2021-03-01,Female,53,45-54,15
18,0,0,0,0,2021-02-25,Male,49,45-54,16
18,0,1,0,1,2021-02-28,Male,69,65-69,11
18,0,1,0,1,2021-03-02,Female,27,25-34,7
18,0,0,0,0,2021-02-25,Female,63,55-64,16
18,0,0,0,0,2021-03-02,Female,43,35-44,13
18,1,0,0,1,2021-02-25,Female,29,25-34,9
18,1,2,0,3,2021-02-24,Female,31,25-34,17
18,2,0,0,2,2021-03-01,Female,67,65-69,12
18,1,0,0,1,2021-02-28,Male,15,15-19,9
18,1,0,0,1,2021-02-26,Female,62,55-64,16
18,0,1,0,1,2021-02-27,Male,55,55-64,15
18,0,0,0,0,2021-02-26,Male,33,25-34,12
18,0,0,0,0,2021-02-26,Female,60,55-64,9
18,1,1,0,2,2021-02-26,Male,57,55-64,13
18,0,1,0,1,2021-02-24,Female,33,25-34,18
18,0,0,0,0,2021-03-02,Male,65,65-69,13
18,2,0,0,2,2021-02-28,Female,45,45-54,6
18,2,2,0,4,2021-02-28,Male,27,25-34,6
18,0,0,0,0,2021-02-24,Female,31,25-34,12
18,0,0,0,0,2021-02-28,Male,35,35-44,6
18,2,1,0,3,2021-03-03,Female,66,65-69,4
18,0,1,0,1,2021-02-25,Female,33,25-34,14
18,3,0,0,3,2021-02-25,Male,37,35-44,14
18,1,1,0,2,2021-02-28,Female,62,55-64,14
18,1,1,0,2,2021-02-26,Female,23,20-24,5
18,1,2,0,3,2021-02-27,Male,65,65-69,13
18,0,0,0,0,2021-02-28,Male,63,55-64,16
18,3,0,0,3,2021-02-28,Male,8,5-9,9
18,0,0,0,0,2021-02-25,Male,30,25-34,11
18,1,3,0,4,2021-02-25,Female,26,25-34,13
18,0,1,0,1,2021-03-01,Male,69,65-69,13
18,2,0,0,2,2021-02-24,Male,42,35-44,12
18,1,0,0,1,2021-02-25,Male,58,55-64,17
18,0,0,0,0,2021-02-26,Female,62,55-64,14
18,4,0,0,4,2021-02-25,Male,11,10-14,5
18,3,0,0,3,2021-03-02,Male,32,25-34,12
18,2,0,0,2,2021-03-01,Male,35,35-44,14
18,2,0,0,2,2021-03-02,Male,70,70-74,10
18,1,0,40,41,2021-02-24,Male,25,25-34,10
18,4,0,0,4,2021-02-25,Male,20,20-24,12
18,3,0,0,3,2021-02-24,Female,15,15-19,15
18,1,0,0,1,2021-03-01,Male,65,65-69,16
18,1,4,0,5,2021-03-02,Female,69,65-69,4
18,1,0,0,1,2021-03-01,Female,25,25-34,5
18,1,0,0,1,2021-02-24,Female,29,25-34,14
18,1,1,0,2,2021-03-01,Female,66,65-69,12
18,0,2,0,2,2021-02-25,Female,56,55-64,13
18,1,0,0,1,2021-03-01,Male,52,45-54,12
18,0,0,0,0,2021-02-26,Male,52,45-54,9
18,1,1,0,2,2021-02-26,Male,70,70-74,15
18,1,1,0,2,2021-02-24,Female,68,65-69,18
18,0,0,0,0,2021-03-01,Female,52,45-54,16
18,1,0,0,1,2021-02-26,Male,29,25-34,14
18,3,0,0,3,2021-02-26,Male,8,5-9,13
18,0,0,0,0,2021-02-26,Female,32,25-34,4
18,3,0,0,3,2021-02-26,Male,65,65-69,14
18,1,2,0,3,2021-03-02,Female,24,20-24,3
18,1,2,0,3,2021-02-24,Female,58,55-64,15
18,0,0,0,0,2021-03-02,Female,66,65-69,16
18,1,0,0,1,2021-02-26,Female,60,55-64,14
18,0,0,0,0,2021-03-01,Female,66,65-69,7
18,0,0,0,0,2021-02-24,Male,71,70-74,18
18,2,0,0,2,2021-02-28,Male,22,20-24,13
18,0,0,0,0,2021-03-02,Female,71,70-74,13
18,1,5,0,6,2021-02-27,Male,74,70-74,16
18,2,1,0,3,2021-03-03,Female,65,65-69,10
18,0,0,0,0,2021-02-24,Male,50,45-54,11
18,1,0,0,1,2021-02-24,Female,31,25-34,13
18,0,0,0,0,2021-02-25,Male,54,45-54,14
18,0,0,0,0,2021-02-28,Female,25,25-34,6
18,2,0,0,2,2021-02-28,Male,68,65-69,5
18,1,0,0,1,2021-03-01,Female,50,45-54,13
18,4,0,0,4,2021-02-26,Male,11,10-14,13
18,2,8,0,10,2021-02-28,Male,15,15-19,14
18,0,0,0,0,2021-03-02,Male,65,65-69,12
18,1,2,0,3,2021-03-01,Male,68,65-69,15
18,1,0,0,1,2021-03-01,Female,58,55-64,15
18,0,0,0,0,2021-02-25,Male,50,45-54,16
18,3,0,0,3,2021-03-01,Male,10,10-14,14
18,0,0,0,0,2021-03-01,Female,59,55-64,10
18,0,0,0,0,2021-02-24,Male,71,70-74,16
18,0,0,0,0,2021-02-25,Male,48,45-54,12
18,2,0,0,2,2021-03-01,Female,69,65-69,18
18,0,0,0,0,2021-02-24,Male,38,35-44,12
18,3,0,0,3,2021-02-26,Male,20,20-24,10
18,1,0,0,1,2021-02-28,Female,9,5-9,11
18,4,1,0,5,2021-02-24,Male,22,20-24,5
18,2,0,0,2,2021-02-27,Female,73,70-74,11
18,0,1,0,1,2021-02-28,Male,52,45-54,12
18,1,0,0,1,2021-03-01,Female,60,55-64,18
18,0,0,0,0,2021-02-25,Male,43,35-44,17
18,2,0,0,2,2021-03-01,Male,73,70-74,14
18,1,1,0,2,2021-02-24,Female,32,25-34,5
18,2,0,0,2,2021-02-27,Male,69,65-69,13
18,1,0,0,1,2021-02-25,Male,34,25-34,17
18,1,0,0,1,2021-02-25,Female,23,20-24,4
18,0,0,0,0,2021-02-26,Male,48,45-54,12
18,3,1,0,4,2021-03-02,Male,70,70-74,13
18,1,0,0,1,2021-03-02,Male,66,65-69,17
18,1,0,0,1,2021-03-01,Male,68,65-69,16
18,0,0,0,0,2021-02-27,Male,39,35-44,5
18,0,6,0,6,2021-02-26,Male,62,55-64,13
18,1,0,0,1,2021-03-01,Male,71,70-74,13
18,2,0,0,2,2021-02-26,Male,20,20-24,3
18,0,0,0,0,2021-02-28,Female,16,15-19,7
18,0,0,0,0,2021-03-01,Male,43,35-44,11
18,0,1,0,1,2021-02-25,Female,56,55-64,16
18,0,0,0,0,2021-02-26,Female,58,55-64,14
18,3,10,0,13,2021-02-27,Male,23,20-24,8
18,0,0,0,0,2021-03-01,Female,66,65-69,15
18,0,0,0,0,2021-02-27,Male,45,45-54,10
18,0,2,0,2,2021-03-02,Female,25,25-34,9
18,0,1,0,1,2021-03-03,Female,64,55-64,12
18,1,1,0,2,2021-02-24,Female,61,55-64,18
18,2,0,0,2,2021-02-25,Male,49,45-54,13
18,1,0,0,1,2021-02-24,Female,54,45-54,18
18,0,0,0,0,2021-03-01,Male,56,55-64,13
18,1,0,0,1,2021-02-28,Female,38,35-44,4
18,0,1,0,1,2021-02-26,Female,65,65-69,18
18,2,0,0,2,2021-02-24,Male,19,15-19,12
18,1,0,0,1,2021-03-02,Male,73,70-74,14
18,3,0,0,3,2021-03-01,Female,8,5-9,12
18,3,3,0,6,2021-02-25,Male,6,5-9,11
18,2,0,0,2,2021-02-28,Male,13,10-14,5
18,1,0,0,1,2021-03-01,Male,79,75-79,12
18,0,0,0,0,2021-03-01,Female,67,65-69,13
18,0,0,0,0,2021-02-26,Male,39,35-44,14
18,2,0,0,2,2021-02-25,Female,15,15-19,11
18,1,0,0,1,2021-02-25,Female,55,55-64,15
18,0,0,0,0,2021-02-25,Male,53,45-54,12
18,1,1,0,2,2021-02-27,Male,48,45-54,12
18,1,0,0,1,2021-02-24,Male,69,65-69,16
18,2,1,0,3,2021-02-26,Male,15,15-19,12
18,0,0,0,0,2021-02-26,Female,32,25-34,6
18,0,0,0,0,2021-02-25,Male,36,35-44,18
18,1,3,0,4,2021-02-24,Male,40,35-44,18
18,2,0,0,2,2021-02-26,Female,61,55-64,14
18,0,0,0,0,2021-02-28,Male,32,25-34,14
18,2,0,0,2,2021-02-28,Male,62,55-64,17
18,2,0,0,2,2021-02-25,Female,4,1-4,6
18,1,1,0,2,2021-03-02,Female,68,65-69,11
18,0,0,0,0,2021-02-25,Male,5,5-9,14
18,1,0,0,1,2021-02-26,Female,34,25-34,12
18,0,0,0,0,2021-03-01,Male,68,65-69,16
18,0,0,0,0,2021-03-02,Male,37,35-44,10
18,0,2,1,3,2021-02-25,Male,29,25-34,14
18,0,0,0,0,2021-02-24,Female,53,45-54,14
18,3,20,0,23,2021-02-24,Male,5,5-9,13
18,0,0,0,0,2021-02-25,Male,31,25-34,5
18,0,0,0,0,2021-03-01,Male,77,75-79,10
18,0,1,0,1,2021-03-01,Male,47,45-54,12
18,3,0,0,3,2021-03-02,Female,2,1-4,3
18,1,3,0,4,2021-02-26,Male,52,45-54,15
18,2,4,22,28,2021-03-01,Female,69,65-69,7
18,1,0,0,1,2021-02-25,Male,33,25-34,13
18,3,0,0,3,2021-02-27,Male,70,70-74,13
18,2,0,0,2,2021-02-28,Female,69,65-69,14
18,3,0,0,3,2021-02-24,Male,15,15-19,15
18,2,0,0,2,2021-02-25,Male,65,65-69,14
18,0,0,0,0,2021-02-28,Male,49,45-54,15
18,1,0,0,1,2021-03-03,Male,66,65-69,9
18,1,0,0,1,2021-02-24,Female,67,65-69,10
18,0,0,0,0,2021-02-27,Female,60,55-64,11
18,0,0,0,0,2021-02-28,Male,16,15-19,8
18,1,0,0,1,2021-03-01,Female,65,65-69,11
18,0,0,0,0,2021-02-26,Male,67,65-69,16
18,0,0,0,0,2021-03-01,Male,65,65-69,16
18,2,1,0,3,2021-03-01,Female,68,65-69,17
18,1,1,0,2,2021-02-27,Male,68,65-69,16
18,0,0,0,0,2021-02-26,Male,41,35-44,10
18,1,2,0,3,2021-02-28,Male,75,75-79,12
18,0,0,0,0,2021-02-26,Female,5,5-9,8
18,0,2,3,5,2021-02-24,Female,26,25-34,5
18,1,0,0,1,2021-02-28,Female,44,35-44,9
18,2,0,0,2,2021-03-03,Male,70,70-74,10
18,3,19,0,22,2021-02-25,Female,15,15-19,13
18,0,0,0,0,2021-02-28,Female,47,45-54,8
18,2,5,0,7,2021-03-01,Female,61,55-64,8
18,2,1,0,3,2021-03-02,Male,18,15-19,14
18,0,0,0,0,2021-03-01,Female,52,45-54,16
18,5,0,0,5,2021-03-01,Male,14,10-14,15
18,5,0,0,5,2021-03-01,Male,28,25-34,9
18,0,0,0,0,2021-03-01,Female,60,55-64,13
18,0,0,0,0,2021-02-24,Male,11,10-14,16
18,3,17,15,35,2021-03-02,Female,4,1-4,11
18,4,0,0,4,2021-02-28,Female,6,5-9,8
18,0,0,0,0,2021-02-28,Female,58,55-64,12
18,0,0,0,0,2021-02-25,Female,1,1-4,11
18,2,2,0,4,2021-03-02,Male,60,55-64,9
18,2,0,0,2,2021-02-26,Male,26,25-34,2
18,0,0,0,0,2021-02-25,Female,50,45-54,4
18,1,0,0,1,2021-02-28,Female,53,45-54,12
18,0,1,0,1,2021-03-01,Female,28,25-34,5
18,0,0,0,0,2021-02-25,Male,25,25-34,15
18,0,0,0,0,2021-02-25,Male,23,20-24,11
18,2,0,0,2,2021-02-26,Male,71,70-74,16
18,0,0,0,0,2021-02-27,Male,35,35-44,17
18,0,0,0,0,2021-02-24,Female,24,20-24,17
18,0,0,0,0,2021-02-28,Female,66,65-69,12
18,3,0,0,3,2021-02-27,Male,23,20-24,13
18,5,0,0,5,2021-02-27,Female,7,5-9,14
18,1,0,0,1,2021-03-01,Female,67,65-69,11
18,0,0,0,0,2021-03-01,Male,68,65-69,15
18,1,0,0,1,2021-02-24,Male,22,20-24,9
18,2,0,0,2,2021-02-24,Male,41,35-44,18
18,1,0,0,1,2021-03-02,Male,65,65-69,14
18,0,0,0,0,2021-03-01,Male,71,70-74,12
18,2,0,3,5,2021-02-25,Male,59,55-64,14
18,2,0,0,2,2021-02-24,Male,13,10-14,5
18,1,1,0,2,2021-03-02,Male,79,75-79,16
18,0,1,0,1,2021-02-24,Female,68,65-69,11
18,3,60,0,63,2021-03-01,Male,65,65-69,10
18,1,0,0,1,2021-02-26,Male,63,55-64,11
18,0,2,0,2,2021-03-01,Female,67,65-69,15
18,2,1,0,3,2021-02-25,Female,25,25-34,7
18,0,0,0,0,2021-03-01,Female,69,65-69,15
18,0,1,0,1,2021-02-27,Female,33,25-34,2
18,0,1,0,1,2021-02-24,Female,28,25-34,5
18,0,0,0,0,2021-02-25,Male,28,25-34,6
18,0,0,0,0,2021-03-01,Female,78,75-79,15
18,0,0,0,0,2021-03-02,Female,66,65-69,11
18,0,2,0,2,2021-02-26,Male,68,65-69,5
18,0,1,2,3,2021-03-01,Female,64,55-64,13
18,1,1,0,2,2021-02-28,Male,69,65-69,16
18,0,0,0,0,2021-02-27,Male,12,10-14,7
18,0,0,0,0,2021-03-02,Female,34,25-34,12
18,2,0,0,2,2021-03-01,Female,14,10-14,11
18,0,0,0,0,2021-02-27,Female,68,65-69,4
18,0,1,0,1,2021-02-24,Male,30,25-34,16
18,0,1,0,1,2021-02-27,Female,71,70-74,9
18,0,0,0,0,2021-02-24,Female,5,5-9,15
18,3,0,0,3,2021-02-26,Female,52,45-54,13
18,2,2,0,4,2021-02-24,Female,52,45-54,15
18,4,0,3,7,2021-02-25,Female,16,15-19,8
18,2,0,0,2,2021-03-01,Female,78,75-79,13
18,0,1,0,1,2021-02-24,Female,22,20-24,2
18,0,0,0,0,2021-03-02,Male,54,45-54,11
18,0,1,0,1,2021-02-26,Male,66,65-69,17
18,0,0,0,0,2021-02-26,Male,42,35-44,12
18,1,0,0,1,2021-03-01,Female,69,65-69,14
18,0,0,0,0,2021-03-02,Female,76,75-79,16
18,3,0,0,3,2021-02-26,Male,37,35-44,13
18,0,0,0,0,2021-02-25,Male,26,25-34,4
18,1,10,0,11,2021-02-25,Male,61,55-64,12
18,1,0,0,1,2021-03-01,Female,51,45-54,11
18,3,0,0,3,2021-02-25,Female,18,15-19,7
18,1,0,0,1,2021-03-01,Male,69,65-69,16
18,2,0,0,2,2021-02-24,Male,57,55-64,9
18,2,1,0,3,2021-02-25,Female,54,45-54,13
18,1,1,0,2,2021-02-24,Male,22,20-24,5
18,0,0,0,0,2021-03-01,Female,66,65-69,11
18,0,0,0,0,2021-02-27,Female,33,25-34,8
18,0,2,0,2,2021-02-26,Female,61,55-64,9
18,0,0,0,0,2021-02-26,Male,51,45-54,13
18,0,0,0,0,2021-02-27,Female,50,45-54,14
18,0,0,0,0,2021-03-01,Male,74,70-74,17
18,3,0,0,3,2021-02-26,Female,16,15-19,17
18,3,0,0,3,2021-02-26,Female,14,10-14,16
18,1,0,0,1,2021-02-25,Male,32,25-34,16
18,1,2,0,3,2021-03-01,Female,70,70-74,14
18,0,0,0,0,2021-03-02,Female,81,80-84,6
18,4,15,0,19,2021-02-25,Male,7,5-9,5
18,2,0,0,2,2021-02-27,Female,14,10-14,14
18,0,0,0,0,2021-03-01,Female,66,65-69,13
18,1,0,0,1,2021-02-26,Female,27,25-34,15
18,2,2,0,4,2021-02-25,Male,76,75-79,16
18,1,4,0,5,2021-03-01,Male,74,70-74,13
18,0,0,0,0,2021-02-24,Male,31,25-34,12
18,0,0,0,0,2021-02-25,Female,24,20-24,16
18,0,0,5,5,2021-02-27,Female,43,35-44,4
18,3,1,0,4,2021-03-01,Male,63,55-64,15
18,2,1,0,3,2021-03-02,Female,55,55-64,11
18,3,0,0,3,2021-02-24,Male,16,15-19,13
18,2,0,0,2,2021-03-02,Male,54,45-54,17
18,0,0,0,0,2021-02-25,Male,60,55-64,10
18,3,0,0,3,2021-02-25,Female,7,5-9,15
18,0,0,0,0,2021-03-01,Male,72,70-74,12
18,2,0,0,2,2021-03-02,Male,73,70-74,12
18,1,0,0,1,2021-02-28,Female,53,45-54,16
18,0,0,0,0,2021-02-26,Male,33,25-34,10
18,0,1,0,1,2021-03-01,Female,71,70-74,14
18,0,0,0,0,2021-02-28,Male,11,10-14,11
18,0,0,0,0,2021-02-26,Female,54,45-54,15
18,2,0,0,2,2021-02-24,Female,15,15-19,10
18,0,0,0,0,2021-02-28,Female,57,55-64,17
18,0,0,0,0,2021-03-02,Male,68,65-69,13
18,0,0,0,0,2021-02-25,Male,52,45-54,15
18,0,0,0,0,2021-02-28,Male,9,5-9,15
18,2,0,0,2,2021-02-24,Male,67,65-69,17
18,0,1,0,1,2021-02-28,Female,69,65-69,10
18,0,0,0,0,2021-03-02,Female,70,70-74,6
18,0,0,0,0,2021-02-24,Female,30,25-34,13
18,0,0,0,0,2021-02-24,Male,46,45-54,15
18,2,0,0,2,2021-03-01,Female,69,65-69,13
18,1,0,0,1,2021-03-03,Male,55,55-64,11
18,1,1,0,2,2021-02-26,Female,25,25-34,11
18,1,0,0,1,2021-03-01,Female,48,45-54,11
18,0,1,0,1,2021-02-26,Female,42,35-44,5
18,0,0,0,0,2021-02-25,Female,9,5-9,5
18,1,0,0,1,2021-03-01,Male,64,55-64,16
18,1,8,0,9,2021-02-27,Male,66,65-69,15
18,2,0,0,2,2021-02-24,Male,5,5-9,17
18,0,1,0,1,2021-02-27,Male,25,25-34,6
18,0,0,0,0,2021-03-01,Male,58,55-64,17
18,1,1,0,2,2021-02-24,Female,65,65-69,18
18,1,0,0,1,2021-02-26,Male,52,45-54,10
18,3,0,0,3,2021-02-25,Female,7,5-9,8
18,2,0,0,2,2021-02-26,Female,13,10-14,13
18,2,18,1,21,2021-02-26,Female,24,20-24,14
18,4,0,0,4,2021-02-25,Male,11,10-14,18
18,2,3,0,5,2021-02-24,Male,50,45-54,16
18,0,0,0,0,2021-03-01,Male,74,70-74,17
18,0,0,0,0,2021-02-26,Male,19,15-19,8
18,0,0,0,0,2021-03-01,Female,67,65-69,12
18,1,0,0,1,2021-03-01,Male,55,55-64,15
18,0,1,0,1,2021-02-27,Female,69,65-69,17
18,2,0,0,2,2021-03-01,Male,68,65-69,7
18,2,0,10,12,2021-02-26,Male,16,15-19,4
18,0,0,0,0,2021-03-01,Male,78,75-79,13
18,0,1,0,1,2021-02-26,Female,32,25-34,4
18,1,0,0,1,2021-03-01,Female,56,55-64,12
18,0,0,0,0,2021-02-25,Male,32,25-34,10
18,1,0,0,1,2021-02-24,Female,64,55-64,10
18,1,0,0,1,2021-02-28,Female,67,65-69,8
18,2,0,0,2,2021-03-01,Male,66,65-69,14
18,1,0,0,1,2021-02-26,Male,60,55-64,17
18,1,0,0,1,2021-02-24,Male,54,45-54,14
18,1,0,0,1,2021-02-26,Female,68,65-69,14
18,0,0,0,0,2021-02-25,Female,25,25-34,17
18,1,0,0,1,2021-02-25,Male,43,35-44,14
18,1,0,0,1,2021-03-02,Male,52,45-54,17
18,0,0,0,0,2021-02-25,Male,30,25-34,16
18,0,0,0,0,2021-02-25,Female,24,20-24,15
18,1,0,0,1,2021-02-25,Male,34,25-34,14
18,0,0,0,0,2021-02-26,Female,49,45-54,18
18,0,3,0,3,2021-02-28,Male,40,35-44,12
18,0,0,0,0,2021-02-24,Male,70,70-74,15
18,2,0,0,2,2021-03-01,Female,64,55-64,17
18,1,1,0,2,2021-02-25,Male,63,55-64,14
18,1,0,0,1,2021-02-28,Male,37,35-44,9
18,0,0,0,0,2021-02-25,Female,20,20-24,5
18,2,3,0,5,2021-02-25,Female,37,35-44,15
18,2,0,0,2,2021-03-01,Female,61,55-64,15
18,1,0,0,1,2021-03-03,Male,70,70-74,13
18,1,0,1,2,2021-03-01,Female,57,55-64,10
18,0,1,0,1,2021-02-26,Male,33,25-34,4
18,1,0,0,1,2021-02-28,Male,53,45-54,14
18,0,0,0,0,2021-02-27,Male,51,45-54,10
18,0,2,0,2,2021-02-27,Female,66,65-69,18
18,3,3,0,6,2021-02-25,Female,7,5-9,12
18,0,1,0,1,2021-02-28,Female,53,45-54,11
18,0,0,0,0,2021-02-26,Male,54,45-54,14
18,3,1,0,4,2021-03-02,Female,46,45-54,10
18,0,2,0,2,2021-02-25,Male,55,55-64,14
18,4,0,0,4,2021-03-02,Male,3,1-4,6
18,0,0,20,20,2021-02-28,Male,41,35-44,2
18,2,0,0,2,2021-03-02,Male,65,65-69,15
18,1,0,0,1,2021-03-01,Male,57,55-64,13
18,2,0,0,2,2021-02-25,Male,40,35-44,16
18,0,1,0,1,2021-02-26,Male,39,35-44,15
18,5,0,0,5,2021-02-27,Female,15,15-19,7
18,0,2,0,2,2021-03-02,Male,39,35-44,13
18,3,3,0,6,2021-03-02,Male,42,35-44,4
18,1,0,0,1,2021-03-01,Female,45,45-54,6
18,3,0,0,3,2021-03-01,Female,21,20-24,13
18,1,0,0,1,2021-03-03,Female,62,55-64,11
18,0,0,0,0,2021-02-28,Female,19,15-19,8
18,0,0,0,0,2021-03-03,Female,56,55-64,8
18,1,0,0,1,2021-02-27,Male,66,65-69,16
18,0,0,0,0,2021-02-25,Male,61,55-64,14
18,2,0,0,2,2021-02-25,Male,63,55-64,14
18,1,0,0,1,2021-02-26,Female,19,15-19,3
18,0,2,0,2,2021-02-24,Male,73,70-74,15
18,0,0,0,0,2021-03-01,Female,57,55-64,14
18,1,0,0,1,2021-03-01,Male,71,70-74,16
18,0,0,0,0,2021-03-01,Female,19,15-19,17
18,1,0,0,1,2021-02-26,Male,63,55-64,17
18,1,0,0,1,2021-02-25,Male,68,65-69,18
18,2,2,0,4,2021-02-24,Male,77,75-79,6
18,0,0,0,0,2021-02-27,Male,57,55-64,15
18,1,0,0,1,2021-02-26,Female,71,70-74,14
18,0,1,0,1,2021-03-01,Female,60,55-64,9
18,1,0,0,1,2021-03-03,Female,61,55-64,3
18,3,0,0,3,2021-03-02,Male,7,5-9,18
18,2,0,0,2,2021-02-26,Female,55,55-64,17
18,0,0,0,0,2021-02-26,Female,22,20-24,14
18,0,0,0,0,2021-03-02,Female,35,35-44,14
18,2,1,0,3,2021-03-01,Male,56,55-64,12
18,1,1,0,2,2021-03-01,Male,62,55-64,14
18,0,1,0,1,2021-03-02,Male,54,45-54,11
18,2,0,0,2,2021-03-01,Female,73,70-74,8
18,3,1,0,4,2021-02-25,Female,21,20-24,5
18,2,0,0,2,2021-02-25,Male,3,1-4,4
18,0,0,0,0,2021-02-24,Male,11,10-14,16
18,0,0,0,0,2021-03-02,Female,20,20-24,4
18,1,0,0,1,2021-02-26,Female,65,65-69,14
18,5,0,0,5,2021-02-24,Female,10,10-14,13
18,1,0,0,1,2021-02-24,Male,64,55-64,18
18,1,2,0,3,2021-03-02,Female,52,45-54,13
18,2,10,0,12,2021-02-25,Female,15,15-19,17
18,0,0,0,0,2021-03-02,Female,73,70-74,11
18,4,0,0,4,2021-03-01,Female,35,35-44,11
18,0,3,0,3,2021-02-25,Female,56,55-64,11
18,1,0,35,36,2021-02-28,Male,54,45-54,13
18,0,1,0,1,2021-03-02,Female,60,55-64,6
18,2,2,0,4,2021-02-24,Male,56,55-64,18
18,3,0,0,3,2021-02-24,Female,22,20-24,6
18,1,0,0,1,2021-03-01,Female,55,55-64,14
18,0,0,0,0,2021-02-27,Male,60,55-64,16
18,0,3,0,3,2021-02-25,Female,59,55-64,16
18,0,1,0,1,2021-02-27,Female,67,65-69,9
18,0,0,0,0,2021-02-26,Female,24,20-24,4
18,0,0,0,0,2021-03-02,Female,23,20-24,16
18,1,0,0,1,2021-02-26,Male,32,25-34,15
18,0,0,0,0,2021-02-24,Male,28,25-34,17
18,2,0,0,2,2021-02-28,Male,58,55-64,12
18,0,0,0,0,2021-02-25,Male,47,45-54,14
18,3,0,0,3,2021-02-24,Male,0,<1,7
18,0,0,0,0,2021-02-26,Female,6,5-9,16
18,0,0,0,0,2021-02-24,Female,41,35-44,18
18,1,1,0,2,2021-02-25,Male,68,65-69,15
18,0,1,0,1,2021-03-02,Male,73,70-74,8
18,2,0,0,2,2021-03-01,Female,74,70-74,11
18,0,0,0,0,2021-02-27,Male,11,10-14,13
18,0,0,0,0,2021-03-01,Male,66,65-69,15
18,3,2,0,5,2021-02-26,Male,14,10-14,8
18,0,1,0,1,2021-03-01,Female,49,45-54,4
18,1,3,0,4,2021-02-24,Male,33,25-34,14
18,1,0,0,1,2021-02-28,Female,50,45-54,13
18,2,0,0,2,2021-03-01,Female,65,65-69,11
18,0,0,0,0,2021-02-27,Male,69,65-69,15
18,0,0,0,0,2021-02-25,Female,31,25-34,16
18,1,0,0,1,2021-03-01,Male,63,55-64,9
18,1,0,0,1,2021-02-26,Male,23,20-24,7
18,1,0,0,1,2021-02-28,Female,28,25-34,8
18,0,0,0,0,2021-03-02,Female,73,70-74,14
18,0,0,0,0,2021-02-25,Male,59,55-64,11
18,0,0,0,0,2021-03-01,Female,42,35-44,9
18,1,14,0,15,2021-02-24,Male,68,65-69,17
18,3,0,0,3,2021-03-01,Female,60,55-64,3
18,0,0,0,0,2021-02-25,Male,59,55-64,13
18,1,0,0,1,2021-02-25,Male,58,55-64,14
18,1,0,0,1,2021-03-01,Male,66,65-69,13
18,0,0,0,0,2021-02-28,Female,53,45-54,13
18,2,0,0,2,2021-02-24,Male,19,15-19,13
18,3,0,0,3,2021-02-26,Male,3,1-4,14
18,0,0,0,0,2021-02-25,Female,31,25-34,14
18,0,0,0,0,2021-03-01,Male,61,55-64,14
18,1,3,0,4,2021-03-01,Female,69,65-69,13
18,1,1,0,2,2021-02-27,Male,68,65-69,17
18,1,0,0,1,2021-02-28,Male,47,45-54,6
18,3,0,0,3,2021-03-02,Female,66,65-69,10
18,0,0,0,0,2021-02-25,Female,21,20-24,4
18,1,0,0,1,2021-02-26,Female,28,25-34,4
18,1,1,0,2,2021-02-25,Female,23,20-24,11
18,0,0,0,0,2021-02-25,Female,63,55-64,5
18,0,0,0,0,2021-03-01,Female,69,65-69,8
18,1,0,0,1,2021-03-02,Female,48,45-54,12
18,0,2,0,2,2021-03-01,Male,59,55-64,14
18,0,0,0,0,2021-02-25,Male,37,35-44,16
18,1,1,0,2,2021-02-28,Female,54,45-54,6
18,0,0,0,0,2021-02-28,Female,43,35-44,13
18,0,0,0,0,2021-02-26,Male,52,45-54,15
18,2,0,0,2,2021-02-24,Male,6,5-9,10
18,0,0,0,0,2021-02-28,Female,46,45-54,16
18,3,2,0,5,2021-02-27,Male,68,65-69,11
18,0,0,0,0,2021-02-25,Male,42,35-44,11
18,0,0,0,0,2021-02-27,Male,62,55-64,11
18,1,0,0,1,2021-03-01,Male,55,55-64,15
18,1,2,0,3,2021-03-01,Female,58,55-64,5
18,1,0,0,1,2021-02-28,Female,42,35-44,12
18,1,0,0,1,2021-02-24,Female,52,45-54,12
18,2,1,0,3,2021-02-28,Female,70,70-74,14
18,0,0,0,0,2021-03-02,Female,66,65-69,12
18,3,0,0,3,2021-02-27,Male,16,15-19,15
18,0,4,0,4,2021-02-28,Male,55,55-64,15
18,3,0,0,3,2021-02-25,Female,60,55-64,13
18,0,0,0,0,2021-03-01,Male,60,55-64,10
18,0,0,0,0,2021-02-25,Male,31,25-34,13
18,1,0,0,1,2021-02-25,Female,21,20-24,15
18,3,0,0,3,2021-03-03,Female,56,55-64,10
18,2,0,0,2,2021-02-24,Male,51,45-54,16
18,1,0,0,1,2021-03-01,Female,59,55-64,5
18,0,2,0,2,2021-03-01,Male,65,65-69,13
18,2,1,0,3,2021-02-25,Female,50,45-54,9
18,1,0,0,1,2021-02-24,Male,48,45-54,12
18,0,0,0,0,2021-03-01,Male,60,55-64,14
18,1,1,0,2,2021-03-01,Male,69,65-69,13
18,0,12,20,32,2021-02-24,Male,30,25-34,15
18,0,1,0,1,2021-02-27,Male,36,35-44,14
18,3,17,0,20,2021-03-03,Male,7,5-9,10
18,1,0,0,1,2021-03-01,Female,69,65-69,15
18,1,7,0,8,2021-02-27,Female,57,55-64,7
18,0,1,0,1,2021-02-24,Female,26,25-34,15
18,4,3,0,7,2021-02-25,Female,28,25-34,9
18,0,1,0,1,2021-02-27,Female,24,20-24,4
18,1,0,0,1,2021-02-28,Female,60,55-64,14
18,0,0,0,0,2021-02-26,Male,41,35-44,11
18,0,2,0,2,2021-02-27,Male,65,65-69,18
18,0,1,0,1,2021-02-27,Male,70,70-74,11
18,0,0,0,0,2021-02-26,Female,65,65-69,18
18,1,1,0,2,2021-02-24,Male,70,70-74,15
18,1,0,0,1,2021-02-25,Male,33,25-34,7
18,2,2,0,4,2021-03-02,Female,71,70-74,7
18,1,0,0,1,2021-03-01,Male,62,55-64,12
18,0,0,0,0,2021-02-25,Female,65,65-69,14
18,1,0,0,1,2021-03-01,Male,79,75-79,13
18,0,0,0,0,2021-02-24,Female,9,5-9,3
18,2,0,0,2,2021-02-26,Female,26,25-34,5
18,1,0,0,1,2021-03-01,Female,68,65-69,12
18,0,0,0,0,2021-03-02,Female,65,65-69,14
18,1,0,0,1,2021-02-26,Male,59,55-64,18
18,2,0,0,2,2021-03-02,Male,70,70-74,17
18,1,0,0,1,2021-02-24,Male,38,35-44,5
18,1,2,0,3,2021-02-25,Male,51,45-54,17
18,1,0,0,1,2021-02-24,Female,26,25-34,4
18,3,0,0,3,2021-02-28,Male,8,5-9,8
18,1,0,0,1,2021-02-28,Male,72,70-74,14
18,2,0,0,2,2021-03-03,Male,72,70-74,16
18,0,1,0,1,2021-03-02,Female,53,45-54,9
18,0,0,0,0,2021-02-27,Female,64,55-64,13
18,2,0,0,2,2021-03-02,Female,16,15-19,16
18,2,0,0,2,2021-02-25,Male,1,1-4,10
18,1,2,0,3,2021-02-24,Female,39,35-44,16
18,1,0,0,1,2021-02-28,Female,58,55-64,16
18,2,0,0,2,2021-03-01,Male,78,75-79,11
18,3,0,0,3,2021-02-27,Male,21,20-24,17
18,0,5,0,5,2021-02-26,Male,40,35-44,15
18,0,0,0,0,2021-02-26,Male,67,65-69,13
18,0,0,0,0,2021-03-02,Male,32,25-34,3
18,1,2,0,3,2021-02-27,Female,67,65-69,13
18,1,1,0,2,2021-02-27,Female,68,65-69,17
18,3,0,0,3,2021-02-26,Female,15,15-19,13
18,0,0,0,0,2021-02-24,Female,28,25-34,16
18,4,0,0,4,2021-02-27,Female,32,25-34,14
18,1,0,0,1,2021-02-26,Female,64,55-64,11
18,3,0,0,3,2021-02-25,Female,21,20-24,6
18,0,0,0,0,2021-02-25,Female,33,25-34,14
18,0,0,0,0,2021-03-01,Male,19,15-19,7
18,0,0,0,0,2021-02-27,Female,47,45-54,13
18,0,0,0,0,2021-02-24,Male,32,25-34,12
18,1,0,0,1,2021-03-01,Male,65,65-69,11
18,0,0,0,0,2021-03-01,Female,68,65-69,16
18,2,6,0,8,2021-02-25,Female,16,15-19,14
18,2,3,0,5,2021-02-24,Female,50,45-54,11
18,1,2,0,3,2021-03-02,Male,62,55-64,8
18,0,0,0,0,2021-03-02,Male,59,55-64,13
18,0,0,0,0,2021-02-25,Male,10,10-14,8
18,1,0,0,1,2021-03-02,Male,60,55-64,14
18,2,0,0,2,2021-03-03,Male,26,25-34,15
18,1,3,0,4,2021-03-02,Female,68,65-69,14
18,2,0,0,2,2021-03-01,Male,57,55-64,12
18,0,0,0,0,2021-03-03,Male,48,45-54,4
18,2,1,0,3,2021-02-27,Male,70,70-74,13
18,0,0,0,0,2021-03-01,Male,69,65-69,16
18,1,0,0,1,2021-03-01,Male,60,55-64,15
18,1,0,0,1,2021-03-02,Male,44,35-44,16
18,0,0,0,0,2021-02-26,Male,52,45-54,10
18,2,11,10,23,2021-02-24,Male,30,25-34,14
18,4,0,0,4,2021-03-02,Female,2,1-4,5
18,3,0,0,3,2021-02-25,Female,1,1-4,15
18,1,0,0,1,2021-03-01,Female,63,55-64,12
18,0,0,0,0,2021-02-27,Male,42,35-44,15
18,2,0,0,2,2021-02-28,Female,21,20-24,10
18,0,0,0,0,2021-02-25,Male,25,25-34,9
18,2,1,0,3,2021-02-27,Female,51,45-54,12
18,2,1,0,3,2021-03-02,Female,67,65-69,14
18,1,0,0,1,2021-03-02,Male,50,45-54,15
18,1,0,0,1,2021-02-28,Male,32,25-34,8
18,1,10,0,11,2021-02-27,Male,52,45-54,17
18,1,10,0,11,2021-02-27,Male,43,35-44,5
18,0,0,0,0,2021-03-01,Female,56,55-64,12
18,0,0,0,0,2021-02-26,Male,70,70-74,15
18,2,0,0,2,2021-02-24,Female,60,55-64,15
18,0,0,0,0,2021-02-26,Male,41,35-44,13
18,0,0,0,0,2021-02-25,Female,46,45-54,5
18,0,0,0,0,2021-03-01,Male,53,45-54,13
18,0,1,0,1,2021-02-26,Female,31,25-34,16
18,4,0,0,4,2021-02-28,Female,3,1-4,7
18,0,0,0,0,2021-02-26,Male,33,25-34,17
18,0,0,0,0,2021-02-25,Male,46,45-54,12
18,1,0,0,1,2021-03-02,Female,55,55-64,12
18,0,1,0,1,2021-02-25,Female,66,65-69,16
18,1,2,0,3,2021-03-02,Female,69,65-69,11
18,0,0,0,0,2021-02-25,Female,68,65-69,13
18,0,0,0,0,2021-02-25,Female,22,20-24,5
18,0,0,0,0,2021-03-03,Female,69,65-69,14
18,2,0,0,2,2021-02-24,Male,46,45-54,18
18,0,0,0,0,2021-02-27,Female,56,55-64,16
18,1,0,0,1,2021-02-25,Female,29,25-34,11
18,0,0,2,2,2021-02-24,Male,29,25-34,13
18,0,0,0,0,2021-02-25,Male,38,35-44,10
18,1,5,0,6,2021-03-01,Male,68,65-69,15
18,0,0,0,0,2021-02-25,Male,14,10-14,11
18,0,0,0,0,2021-03-02,Male,79,75-79,10
18,0,0,0,0,2021-03-01,Male,47,45-54,9
18,1,4,0,5,2021-02-27,Male,74,70-74,10
18,2,0,0,2,2021-02-24,Female,30,25-34,5
18,0,0,0,0,2021-02-28,Male,35,35-44,10
18,5,1,0,6,2021-03-01,Male,19,15-19,12
18,1,0,0,1,2021-03-01,Male,32,25-34,13
18,2,0,0,2,2021-02-28,Male,10,10-14,9
18,1,0,0,1,2021-02-27,Female,68,65-69,9
18,1,1,0,2,2021-02-25,Male,58,55-64,15
18,0,4,0,4,2021-02-27,Male,42,35-44,14
18,0,0,0,0,2021-02-26,Male,32,25-34,7
18,3,0,0,3,2021-03-01,Male,13,10-14,15
18,3,0,0,3,2021-02-25,Male,12,10-14,13
18,0,0,0,0,2021-03-02,Male,65,65-69,14
18,1,0,0,1,2021-03-01,Female,67,65-69,14
18,1,0,0,1,2021-03-02,Female,68,65-69,15
18,0,0,0,0,2021-03-01,Male,51,45-54,13
18,0,0,0,0,2021-02-25,Female,21,20-24,10
18,0,3,0,3,2021-02-27,Female,47,45-54,13
18,1,0,0,1,2021-03-01,Male,72,70-74,14
18,0,0,0,0,2021-02-24,Female,30,25-34,12
18,0,0,0,0,2021-02-24,Female,21,20-24,15
18,0,0,0,0,2021-02-26,Male,27,25-34,14
18,1,0,0,1,2021-02-25,Female,62,55-64,16
18,0,0,0,0,2021-02-27,Male,66,65-69,17
18,0,0,0,0,2021-02-26,Male,66,65-69,16
18,1,0,0,1,2021-02-24,Male,63,55-64,17
18,0,0,0,0,2021-02-27,Female,69,65-69,12
18,2,0,0,2,2021-03-02,Female,69,65-69,11
18,0,0,0,0,2021-02-24,Female,30,25-34,13
18,1,0,0,1,2021-02-25,Male,72,70-74,16
18,2,2,0,4,2021-03-01,Female,46,45-54,8
18,0,0,0,0,2021-02-24,Female,63,55-64,15
18,0,0,0,0,2021-02-25,Female,36,35-44,16
18,2,0,0,2,2021-02-27,Male,71,70-74,13
18,2,0,0,2,2021-02-26,Female,23,20-24,4
18,0,0,0,0,2021-03-01,Male,41,35-44,7
18,5,3,0,8,2021-02-28,Female,15,15-19,15
18,3,2,0,5,2021-03-01,Female,65,65-69,17
18,0,1,0,1,2021-03-01,Female,62,55-64,15
18,0,0,0,0,2021-02-26,Female,31,25-34,12
18,0,0,0,0,2021-02-26,Male,26,25-34,11
18,2,0,0,2,2021-02-25,Male,55,55-64,15
18,1,0,0,1,2021-03-03,Male,55,55-64,9
18,0,0,0,0,2021-02-28,Female,42,35-44,11
18,0,14,0,14,2021-02-28,Female,66,65-69,13
18,0,0,0,0,2021-02-26,Male,22,20-24,9
18,1,0,0,1,2021-02-25,Female,22,20-24,14
18,1,0,0,1,2021-02-24,Female,19,15-19,5
18,1,1,0,2,2021-02-26,Male,56,55-64,12
18,0,0,0,0,2021-03-01,Female,31,25-34,15
18,0,0,0,0,2021-02-24,Female,25,25-34,5
18,0,0,0,0,2021-02-27,Male,54,45-54,15
18,0,6,0,6,2021-02-28,Male,40,35-44,14
18,1,10,0,11,2021-02-25,Male,43,35-44,15
18,0,0,0,0,2021-02-27,Female,50,45-54,7
18,0,0,0,0,2021-02-25,Female,19,15-19,3
18,3,0,0,3,2021-03-01,Male,18,15-19,10
18,0,1,0,1,2021-02-25,Female,64,55-64,17
18,0,0,0,0,2021-02-25,Male,20,20-24,17
18,1,0,0,1,2021-02-26,Female,67,65-69,15
18,2,2,0,4,2021-03-01,Female,61,55-64,14
18,0,0,0,0,2021-02-26,Male,15,15-19,3
18,0,3,0,3,2021-02-25,Female,62,55-64,17
18,0,0,0,0,2021-02-26,Male,50,45-54,14
18,1,0,0,1,2021-02-26,Male,44,35-44,16
18,2,0,0,2,2021-02-28,Male,19,15-19,13
18,1,0,0,1,2021-02-27,Male,71,70-74,13
18,0,1,0,1,2021-02-24,Female,67,65-69,11
18,0,2,0,2,2021-03-02,Female,68,65-69,13
18,1,0,0,1,2021-02-24,Male,70,70-74,14
18,3,0,0,3,2021-03-02,Male,39,35-44,5
18,1,0,1,2,2021-02-24,Male,23,20-24,9
18,0,10,20,30,2021-02-26,Male,19,15-19,7
18,2,0,0,2,2021-03-01,Male,5,5-9,13
18,0,0,0,0,2021-02-27,Female,71,70-74,16
18,0,0,0,0,2021-02-25,Male,44,35-44,14
18,2,0,0,2,2021-02-28,Male,67,65-69,14
18,1,0,0,1,2021-02-28,Male,66,65-69,15
18,0,1,0,1,2021-03-02,Female,57,55-64,12
18,0,0,0,0,2021-03-01,Male,70,70-74,14
18,0,0,0,0,2021-02-26,Female,34,25-34,17
18,0,0,0,0,2021-02-25,Male,52,45-54,17
18,1,0,0,1,2021-02-26,Male,68,65-69,18
18,0,10,0,10,2021-02-26,Male,34,25-34,13
18,0,0,0,0,2021-02-27,Female,52,45-54,12
18,0,0,0,0,2021-03-02,Male,30,25-34,7
18,1,2,0,3,2021-02-25,Male,79,75-79,12
18,4,2,0,6,2021-02-28,Female,12,10-14,9
18,1,0,0,1,2021-03-01,Male,68,65-69,9
18,0,0,0,0,2021-02-25,Male,24,20-24,12
18,0,0,0,0,2021-02-25,Male,17,15-19,15
18,3,1,0,4,2021-02-27,Female,7,5-9,10
18,1,2,0,3,2021-02-26,Female,58,55-64,5
18,0,0,0,0,2021-02-26,Male,42,35-44,10
18,3,0,0,3,2021-02-24,Male,11,10-14,14
18,1,1,0,2,2021-02-28,Female,62,55-64,11
18,2,0,0,2,2021-03-02,Female,36,35-44,8
18,2,3,0,5,2021-02-27,Male,79,75-79,13
18,2,0,0,2,2021-02-25,Male,53,45-54,15
18,1,0,0,1,2021-03-01,Male,67,65-69,9
18,1,0,0,1,2021-03-01,Male,52,45-54,13
18,0,0,0,0,2021-02-24,Male,52,45-54,11
18,3,0,0,3,2021-02-27,Female,43,35-44,17
18,1,0,0,1,2021-03-01,Female,71,70-74,13
18,1,1,0,2,2021-02-26,Female,65,65-69,7
18,1,0,0,1,2021-02-26,Female,24,20-24,16
18,0,0,0,0,2021-03-02,Female,72,70-74,11
18,0,0,0,0,2021-02-26,Female,69,65-69,18
18,0,0,0,0,2021-03-01,Male,60,55-64,12
18,2,0,0,2,2021-02-26,Male,10,10-14,14
18,2,0,0,2,2021-02-26,Male,24,20-24,8
18,0,0,0,0,2021-02-28,Male,71,70-74,6
18,2,0,0,2,2021-02-25,Female,51,45-54,15
18,0,1,0,1,2021-02-24,Female,69,65-69,12
18,2,0,0,2,2021-02-26,Male,33,25-34,14
18,4,0,0,4,2021-02-28,Female,14,10-14,14
18,3,0,0,3,2021-02-26,Female,2,1-4,15
18,1,0,0,1,2021-02-25,Male,38,35-44,9
18,0,0,0,0,2021-02-25,Male,45,45-54,13
18,2,0,0,2,2021-02-24,Male,7,5-9,5
18,0,3,0,3,2021-03-02,Female,68,65-69,15
18,1,0,0,1,2021-02-28,Female,59,55-64,16
18,0,0,0,0,2021-03-01,Female,54,45-54,16
18,4,0,0,4,2021-03-02,Male,10,10-14,3
18,0,1,0,1,2021-03-01,Female,58,55-64,5
18,0,0,0,0,2021-02-26,Female,41,35-44,17
18,2,0,0,2,2021-02-24,Female,11,10-14,2
18,0,0,0,0,2021-02-26,Female,64,55-64,15
18,0,0,0,0,2021-02-25,Male,40,35-44,11
18,3,2,0,5,2021-02-26,Female,12,10-14,12
18,0,1,0,1,2021-02-24,Male,22,20-24,10
18,2,1,0,3,2021-02-25,Male,64,55-64,6
18,1,0,0,1,2021-03-01,Female,52,45-54,18
18,0,0,0,0,2021-02-24,Male,40,35-44,14
18,3,0,0,3,2021-03-02,Male,14,10-14,2
18,0,0,0,0,2021-03-03,Male,36,35-44,5
18,3,0,0,3,2021-02-25,Male,19,15-19,14
18,0,1,0,1,2021-03-01,Male,78,75-79,17
18,0,0,0,0,2021-02-25,Male,44,35-44,12
18,1,0,0,1,2021-02-24,Male,67,65-69,18
18,2,0,0,2,2021-02-25,Female,67,65-69,17
18,0,0,0,0,2021-02-25,Female,66,65-69,11
18,3,0,0,3,2021-02-24,Male,3,1-4,10
18,0,0,0,0,2021-02-24,Male,48,45-54,17
18,2,1,0,3,2021-02-27,Male,16,15-19,9
18,1,1,0,2,2021-03-03,Male,65,65-69,11
18,0,2,0,2,2021-02-24,Male,40,35-44,15
18,1,6,0,7,2021-02-27,Female,66,65-69,18
18,0,40,25,65,2021-02-25,Male,38,35-44,15
18,2,0,0,2,2021-03-03,Female,77,75-79,13
18,0,0,0,0,2021-02-24,Male,30,25-34,15
18,0,0,0,0,2021-02-25,Male,16,15-19,13
18,0,0,0,0,2021-02-25,Female,54,45-54,14
18,1,0,0,1,2021-02-24,Female,67,65-69,16
18,3,3,0,6,2021-02-28,Female,9,5-9,9
18,1,1,0,2,2021-02-24,Male,48,45-54,11
18,2,0,0,2,2021-02-26,Female,44,35-44,10
18,0,0,0,0,2021-02-26,Male,40,35-44,17
18,0,1,0,1,2021-03-02,Female,19,15-19,7
18,0,5,0,5,2021-02-24,Female,38,35-44,9
18,1,0,0,1,2021-03-01,Male,64,55-64,15
18,1,0,0,1,2021-02-26,Male,60,55-64,12
18,0,0,0,0,2021-02-26,Male,41,35-44,16
18,3,0,0,3,2021-02-24,Male,12,10-14,10
18,0,0,0,0,2021-02-28,Male,35,35-44,11
18,2,0,0,2,2021-02-26,Female,10,10-14,18
18,1,1,0,2,2021-03-02,Male,67,65-69,6
18,0,0,0,0,2021-03-03,Female,58,55-64,15
18,2,1,0,3,2021-03-02,Female,52,45-54,14
18,1,0,0,1,2021-02-28,Female,35,35-44,12
18,1,0,0,1,2021-02-27,Female,58,55-64,10
18,1,0,0,1,2021-03-02,Male,56,55-64,3
18,1,0,0,1,2021-02-26,Female,60,55-64,16
18,0,0,0,0,2021-02-24,Male,11,10-14,15
18,1,0,0,1,2021-02-28,Male,18,15-19,14
18,1,0,0,1,2021-03-01,Male,66,65-69,14
18,2,0,0,2,2021-02-26,Female,18,15-19,16
18,1,1,0,2,2021-02-26,Male,55,55-64,8
18,0,0,0,0,2021-02-24,Female,21,20-24,13
18,2,0,0,2,2021-02-27,Female,16,15-19,12
18,0,2,0,2,2021-03-01,Male,43,35-44,12
18,3,30,0,33,2021-03-02,Female,17,15-19,12
18,1,0,0,1,2021-03-01,Female,70,70-74,9
18,0,0,1,1,2021-02-25,Female,24,20-24,12
18,1,18,0,19,2021-02-26,Female,9,5-9,9
18,0,0,0,0,2021-02-24,Female,35,35-44,4
18,0,3,0,3,2021-03-02,Female,67,65-69,10
18,1,2,0,3,2021-03-03,Male,74,70-74,11
18,0,0,0,0,2021-02-24,Male,39,35-44,15
18,0,0,0,0,2021-02-26,Male,36,35-44,10
18,3,0,0,3,2021-02-24,Male,17,15-19,11
18,0,1,0,1,2021-02-25,Male,36,35-44,12
18,0,0,0,0,2021-03-01,Female,17,15-19,13
18,3,0,0,3,2021-02-24,Female,0,<1,9
18,1,0,0,1,2021-02-24,Female,25,25-34,5
18,0,0,0,0,2021-03-01,Female,66,65-69,14
18,0,0,0,0,2021-02-27,Female,65,65-69,13
18,4,0,0,4,2021-03-01,Male,33,25-34,8
18,1,0,0,1,2021-02-27,Male,52,45-54,9
18,1,0,0,1,2021-03-03,Female,68,65-69,11
18,0,5,0,5,2021-02-25,Male,52,45-54,17
18,1,0,0,1,2021-03-03,Female,41,35-44,11
18,0,0,0,0,2021-02-24,Female,31,25-34,14
18,1,0,0,1,2021-03-01,Male,57,55-64,12
18,1,5,0,6,2021-02-27,Male,66,65-69,12
18,2,7,0,9,2021-03-01,Male,67,65-69,16
18,0,2,0,2,2021-02-24,Female,58,55-64,5
18,1,1,0,2,2021-03-02,Female,76,75-79,10
18,2,0,0,2,2021-02-28,Female,6,5-9,14
18,2,0,0,2,2021-03-01,Male,63,55-64,8
18,0,0,0,0,2021-03-01,Male,19,15-19,4
18,1,0,0,1,2021-02-24,Female,62,55-64,17
18,1,0,0,1,2021-02-24,Female,29,25-34,10
18,2,0,0,2,2021-03-02,Male,11,10-14,13
18,1,5,0,6,2021-03-01,Male,20,20-24,2
18,0,1,2,3,2021-02-26,Female,69,65-69,15
18,0,0,0,0,2021-02-28,Male,28,25-34,15
18,0,0,0,0,2021-02-24,Male,73,70-74,14
18,1,0,0,1,2021-03-03,Male,62,55-64,10
18,1,0,0,1,2021-02-24,Female,21,20-24,7
18,4,0,0,4,2021-03-02,Female,5,5-9,9
18,2,0,10,12,2021-02-27,Male,6,5-9,4
18,0,1,0,1,2021-03-01,Male,62,55-64,12
18,4,1,0,5,2021-02-26,Male,20,20-24,12
18,0,0,0,0,2021-02-25,Male,31,25-34,2
18,0,0,0,0,2021-03-01,Male,69,65-69,15
18,0,1,0,1,2021-02-25,Female,29,25-34,6
18,0,0,0,0,2021-02-25,Male,45,45-54,14
18,0,1,0,1,2021-03-02,Female,30,25-34,11
18,1,0,0,1,2021-03-01,Male,55,55-64,12
18,2,0,0,2,2021-02-27,Male,18,15-19,16
18,1,0,0,1,2021-03-02,Female,69,65-69,12
18,2,0,0,2,2021-02-28,Female,63,55-64,11
18,0,0,0,0,2021-03-01,Female,73,70-74,7
18,1,3,0,4,2021-03-02,Female,68,65-69,15
18,1,0,0,1,2021-02-24,Male,55,55-64,18
18,1,0,0,1,2021-02-26,Female,62,55-64,17
18,0,0,0,0,2021-02-24,Female,3,1-4,8
18,2,0,0,2,2021-03-02,Male,55,55-64,8
18,2,0,0,2,2021-02-27,Female,61,55-64,17
18,2,15,0,17,2021-03-02,Male,3,1-4,5
18,1,1,0,2,2021-02-24,Male,52,45-54,17
18,0,0,0,0,2021-03-02,Female,51,45-54,9
18,0,10,0,10,2021-03-02,Female,66,65-69,17
18,4,0,0,4,2021-03-03,Female,46,45-54,9
18,0,0,0,0,2021-02-24,Male,65,65-69,15
18,1,0,0,1,2021-03-03,Female,59,55-64,14
18,1,1,0,2,2021-02-26,Male,66,65-69,14
18,0,0,0,0,2021-03-01,Female,68,65-69,13
18,2,0,0,2,2021-02-24,Female,12,10-14,13
18,2,1,0,3,2021-03-01,Male,10,10-14,12
18,1,1,0,2,2021-02-27,Female,63,55-64,16
18,0,0,0,0,2021-02-25,Female,52,45-54,16
18,0,0,0,0,2021-03-01,Female,17,15-19,11
18,0,1,0,1,2021-02-25,Female,55,55-64,14
18,2,0,0,2,2021-02-27,Female,53,45-54,14
18,2,0,0,2,2021-02-24,Female,48,45-54,15
18,1,0,0,1,2021-03-01,Male,67,65-69,14
18,0,1,0,1,2021-02-25,Female,30,25-34,5
18,0,1,0,1,2021-02-24,Male,29,25-34,13
18,1,10,0,11,2021-02-26,Male,58,55-64,10
18,1,5,0,6,2021-03-02,Male,71,70-74,17
18,0,0,0,0,2021-02-24,Female,44,35-44,17
18,0,3,0,3,2021-02-25,Male,22,20-24,10
18,1,0,0,1,2021-03-01,Male,65,65-69,13
18,2,0,0,2,2021-03-01,Female,68,65-69,14
18,0,1,0,1,2021-02-26,Female,64,55-64,9
18,1,4,0,5,2021-02-27,Male,70,70-74,11
18,2,1,0,3,2021-02-24,Male,22,20-24,15
18,1,6,0,7,2021-02-24,Female,66,65-69,10
18,1,2,0,3,2021-02-25,Male,58,55-64,17
18,1,0,0,1,2021-02-28,Male,67,65-69,12
18,0,0,0,0,2021-02-24,Male,13,10-14,15
18,3,18,14,35,2021-02-26,Male,4,1-4,14
18,0,0,0,0,2021-03-01,Male,35,35-44,11
18,1,0,0,1,2021-03-01,Female,59,55-64,8
18,0,0,0,0,2021-02-26,Male,18,15-19,14
18,0,0,0,0,2021-03-01,Male,50,45-54,13
18,0,0,0,0,2021-03-01,Male,67,65-69,6
18,2,0,12,14,2021-02-27,Female,25,25-34,17
18,3,0,0,3,2021-02-25,Male,30,25-34,16
18,0,0,0,0,2021-02-25,Male,34,25-34,12
18,2,0,0,2,2021-02-24,Male,71,70-74,11
18,2,3,0,5,2021-02-26,Female,10,10-14,13
18,1,0,0,1,2021-03-01,Female,69,65-69,15
18,1,0,0,1,2021-02-27,Male,66,65-69,10
18,0,0,0,0,2021-02-26,Male,67,65-69,14
18,2,0,0,2,2021-03-03,Female,68,65-69,10
18,0,0,0,0,2021-03-02,Male,35,35-44,14
18,2,0,0,2,2021-02-25,Female,5,5-9,16
18,0,1,0,1,2021-02-27,Female,66,65-69,17
18,0,0,0,0,2021-02-28,Female,50,45-54,10
18,2,0,0,2,2021-02-25,Male,42,35-44,15
18,0,0,0,0,2021-03-01,Female,77,75-79,8
18,0,0,0,0,2021-02-26,Female,1,1-4,14
18,0,0,0,0,2021-03-02,Male,40,35-44,12
18,1,1,0,2,2021-03-01,Female,62,55-64,11
18,2,0,0,2,2021-03-01,Male,48,45-54,8
18,1,0,0,1,2021-03-01,Male,68,65-69,15
18,4,0,0,4,2021-02-25,Male,5,5-9,18
18,2,5,0,7,2021-03-03,Male,43,35-44,5
18,2,2,0,4,2021-02-24,Female,3,1-4,13
18,3,0,0,3,2021-02-28,Female,30,25-34,12
18,2,0,0,2,2021-02-24,Male,52,45-54,13
18,1,0,0,1,2021-02-27,Female,68,65-69,10
18,2,1,0,3,2021-02-25,Male,61,55-64,14
18,0,0,0,0,2021-03-02,Male,65,65-69,11
18,3,2,0,5,2021-02-24,Female,62,55-64,14
18,1,0,0,1,2021-03-01,Female,39,35-44,12
18,2,2,0,4,2021-02-28,Male,53,45-54,17
18,0,0,0,0,2021-03-01,Male,51,45-54,12
18,0,0,0,0,2021-02-25,Female,5,5-9,10
18,1,0,0,1,2021-03-01,Male,54,45-54,13
18,0,15,0,15,2021-02-26,Female,60,55-64,12
18,1,16,0,17,2021-03-03,Female,16,15-19,10
18,1,0,0,1,2021-02-28,Female,56,55-64,17
18,1,0,0,1,2021-03-02,Male,32,25-34,14
18,4,0,0,4,2021-03-01,Female,8,5-9,3
18,0,0,0,0,2021-02-28,Female,49,45-54,14
18,4,2,0,6,2021-02-25,Female,42,35-44,8
18,0,0,0,0,2021-03-02,Male,66,65-69,11
18,1,0,0,1,2021-02-26,Male,67,65-69,16
18,1,0,0,1,2021-03-02,Male,55,55-64,9
18,0,0,0,0,2021-02-25,Male,41,35-44,15
18,2,0,3,5,2021-03-01,Male,59,55-64,14
18,0,2,0,2,2021-02-24,Male,42,35-44,18
18,0,0,0,0,2021-02-26,Male,67,65-69,17
18,1,0,0,1,2021-02-26,Male,63,55-64,13
18,0,0,0,0,2021-02-26,Female,69,65-69,14
18,2,0,0,2,2021-02-28,Male,51,45-54,9
18,4,0,0,4,2021-02-25,Male,2,1-4,15
18,0,0,0,0,2021-02-28,Male,55,55-64,13
18,0,0,0,0,2021-03-01,Male,58,55-64,16
18,1,2,0,3,2021-02-28,Male,47,45-54,13
18,3,0,0,3,2021-02-24,Male,10,10-14,4
18,0,1,0,1,2021-02-26,Female,34,25-34,14
18,1,0,0,1,2021-02-25,Male,62,55-64,7
18,1,0,0,1,2021-03-01,Female,39,35-44,6
18,0,0,0,0,2021-02-26,Male,62,55-64,18
18,2,0,0,2,2021-02-28,Female,23,20-24,7
18,0,4,0,4,2021-03-01,Female,67,65-69,18
18,3,17,0,20,2021-02-26,Male,13,10-14,17
18,3,0,0,3,2021-02-28,Female,38,35-44,13
18,2,0,3,5,2021-03-02,Male,77,75-79,12
18,0,0,0,0,2021-02-26,Female,38,35-44,14
18,0,0,0,0,2021-03-02,Male,47,45-54,16
18,1,0,0,1,2021-02-27,Male,67,65-69,13
18,4,0,0,4,2021-02-26,Male,52,45-54,8
18,0,0,0,0,2021-02-25,Female,20,20-24,11
18,0,0,0,0,2021-02-26,Female,20,20-24,7
18,2,2,0,4,2021-02-25,Female,66,65-69,12
18,0,0,0,0,2021-02-25,Male,27,25-34,14
18,0,1,0,1,2021-02-27,Male,48,45-54,15
18,0,0,0,0,2021-02-25,Male,32,25-34,13
18,2,0,0,2,2021-03-01,Male,49,45-54,11
18,0,0,0,0,2021-02-26,Male,52,45-54,15
18,0,0,0,0,2021-03-02,Male,29,25-34,4
18,4,0,0,4,2021-02-26,Female,1,1-4,9
18,2,0,0,2,2021-03-01,Female,10,10-14,11
18,2,0,0,2,2021-03-01,Male,62,55-64,13
18,0,2,0,2,2021-02-24,Female,30,25-34,4
18,2,0,0,2,2021-02-26,Male,12,10-14,17
18,2,0,0,2,2021-03-01,Female,63,55-64,14
18,1,0,0,1,2021-02-28,Male,45,45-54,9
18,0,0,28,28,2021-02-24,Male,43,35-44,17
18,2,0,0,2,2021-02-25,Female,64,55-64,18
18,1,0,0,1,2021-02-26,Female,48,45-54,17
18,0,1,0,1,2021-02-24,Male,54,45-54,10
18,3,0,0,3,2021-03-01,Male,3,1-4,5
18,0,0,0,0,2021-02-26,Female,54,45-54,13
18,1,1,0,2,2021-02-26,Female,33,25-34,12
18,2,0,0,2,2021-02-28,Male,9,5-9,11
18,2,0,0,2,2021-02-26,Female,14,10-14,14
18,1,0,0,1,2021-02-27,Female,51,45-54,14
18,0,0,0,0,2021-02-25,Female,24,20-24,10
18,2,0,0,2,2021-02-27,Male,57,55-64,14
18,0,4,0,4,2021-02-26,Female,42,35-44,5
18,0,5,1,6,2021-03-02,Female,62,55-64,11
18,0,0,0,0,2021-02-26,Female,59,55-64,13
18,1,0,0,1,2021-03-02,Male,57,55-64,12
18,2,0,0,2,2021-03-02,Male,65,65-69,18
18,1,0,0,1,2021-03-02,Female,54,45-54,7
18,1,0,0,1,2021-02-25,Female,34,25-34,7
18,4,2,0,6,2021-02-27,Female,7,5-9,9
18,0,0,2,2,2021-02-26,Female,36,35-44,3
18,1,0,0,1,2021-03-01,Male,71,70-74,8
18,0,0,0,0,2021-02-25,Male,61,55-64,17
18,0,0,0,0,2021-02-27,Male,66,65-69,17
18,1,0,0,1,2021-03-01,Female,56,55-64,9
18,1,0,0,1,2021-02-28,Male,34,25-34,14
18,1,0,0,1,2021-02-26,Female,59,55-64,16
18,2,0,0,2,2021-02-28,Male,73,70-74,13
18,2,1,0,3,2021-02-26,Male,34,25-34,12
18,0,0,0,0,2021-02-24,Female,37,35-44,12
18,0,1,0,1,2021-03-01,Male,47,45-54,5
18,1,0,0,1,2021-03-03,Male,63,55-64,10
18,1,0,0,1,2021-02-26,Female,47,45-54,9
18,2,1,0,3,2021-02-26,Female,22,20-24,9
18,0,0,0,0,2021-02-27,Male,63,55-64,13
18,0,0,0,0,2021-02-26,Male,25,25-34,10
18,0,0,0,0,2021-02-28,Male,38,35-44,7
18,0,1,0,1,2021-03-01,Female,69,65-69,13
18,2,0,0,2,2021-02-24,Female,65,65-69,13
18,0,2,0,2,2021-03-01,Female,35,35-44,10
18,0,10,0,10,2021-02-25,Male,56,55-64,15
18,1,4,0,5,2021-02-25,Female,56,55-64,16
18,0,0,0,0,2021-03-01,Female,67,65-69,17
18,2,0,0,2,2021-02-28,Male,42,35-44,9
18,1,1,0,2,2021-03-02,Male,66,65-69,12
18,1,0,0,1,2021-03-01,Female,73,70-74,11
18,3,0,0,3,2021-03-03,Female,59,55-64,9
18,0,0,0,0,2021-03-01,Male,71,70-74,13
18,1,0,0,1,2021-03-02,Female,55,55-64,8
18,2,0,0,2,2021-03-01,Female,70,70-74,15
18,0,0,0,0,2021-03-01,Female,71,70-74,13
18,0,1,0,1,2021-02-25,Male,67,65-69,18
18,0,0,0,0,2021-02-26,Female,26,25-34,13
18,1,0,0,1,2021-02-25,Female,55,55-64,9
18,0,0,0,0,2021-03-02,Female,74,70-74,11
18,2,0,0,2,2021-03-01,Male,80,80-84,13
18,0,3,0,3,2021-02-28,Female,53,45-54,16
18,1,0,0,1,2021-02-24,Male,63,55-64,16
18,0,0,0,0,2021-02-26,Male,37,35-44,17
18,0,0,2,2,2021-03-01,Female,68,65-69,11
18,1,0,0,1,2021-02-25,Female,28,25-34,16
18,4,0,0,4,2021-03-03,Female,47,45-54,6
18,0,0,0,0,2021-02-26,Female,10,10-14,14
18,0,0,0,0,2021-03-01,Male,54,45-54,15
18,2,0,0,2,2021-02-25,Male,5,5-9,18
18,2,0,0,2,2021-02-28,Male,16,15-19,9
18,1,0,0,1,2021-02-24,Male,35,35-44,17
18,0,0,0,0,2021-03-01,Female,72,70-74,16
18,0,0,0,0,2021-02-24,Female,26,25-34,10
18,3,0,1,4,2021-03-01,Male,23,20-24,12
18,3,2,0,5,2021-02-27,Male,41,35-44,15
18,0,0,0,0,2021-03-02,Female,63,55-64,5
18,1,0,0,1,2021-03-02,Female,24,20-24,17
18,1,0,0,1,2021-02-26,Female,35,35-44,11
18,1,0,0,1,2021-02-27,Male,32,25-34,13
18,0,0,0,0,2021-02-24,Female,43,35-44,15
18,0,0,0,0,2021-02-24,Male,32,25-34,7
18,1,2,0,3,2021-02-26,Male,55,55-64,13
18,3,4,0,7,2021-03-01,Male,9,5-9,15
18,3,0,0,3,2021-02-24,Female,36,35-44,17
18,1,0,0,1,2021-02-24,Female,59,55-64,16
18,1,5,0,6,2021-02-26,Male,69,65-69,12
18,1,0,0,1,2021-02-24,Male,66,65-69,16
18,1,0,0,1,2021-02-24,Male,28,25-34,4
18,3,0,0,3,2021-02-24,Male,49,45-54,9
18,0,1,0,1,2021-02-28,Male,10,10-14,2
18,0,0,0,0,2021-03-01,Male,76,75-79,12
18,0,1,0,1,2021-03-02,Female,49,45-54,4
18,0,0,0,0,2021-03-01,Male,52,45-54,16
18,2,0,0,2,2021-03-01,Female,63,55-64,10
18,2,0,0,2,2021-03-02,Male,65,65-69,14
18,3,0,0,3,2021-02-28,Male,18,15-19,8
18,3,0,0,3,2021-03-01,Female,19,15-19,12
18,0,0,0,0,2021-03-02,Male,75,75-79,13
18,0,0,0,0,2021-02-24,Male,37,35-44,5
18,0,6,0,6,2021-02-26,Female,66,65-69,17
18,4,15,0,19,2021-02-27,Female,17,15-19,8
18,0,0,0,0,2021-02-24,Male,19,15-19,5
18,0,0,0,0,2021-03-01,Female,54,45-54,13
18,1,0,0,1,2021-02-26,Female,46,45-54,15
18,1,0,0,1,2021-03-01,Male,70,70-74,12
18,0,0,0,0,2021-02-26,Male,53,45-54,13
18,0,0,0,0,2021-02-28,Female,63,55-64,15
18,0,0,0,0,2021-02-26,Female,23,20-24,9
18,1,3,0,4,2021-02-25,Female,26,25-34,4
18,2,0,0,2,2021-03-01,Male,74,70-74,13
18,1,0,0,1,2021-02-24,Female,54,45-54,5
18,1,0,3,4,2021-03-01,Male,74,70-74,10
18,0,1,0,1,2021-02-24,Male,27,25-34,17
18,1,2,0,3,2021-02-25,Male,28,25-34,18
18,0,0,0,0,2021-02-24,Female,31,25-34,12
18,0,0,0,0,2021-03-01,Female,65,65-69,13
18,1,0,0,1,2021-02-27,Male,42,35-44,15
18,0,0,0,0,2021-02-27,Male,71,70-74,16
18,1,0,0,1,2021-02-26,Male,40,35-44,7
18,0,1,0,1,2021-02-27,Female,68,65-69,18
18,0,1,0,1,2021-03-01,Female,62,55-64,15
18,0,0,0,0,2021-03-01,Male,60,55-64,14
18,0,8,0,8,2021-02-24,Male,36,35-44,12
18,0,0,0,0,2021-02-27,Female,34,25-34,14
18,1,0,0,1,2021-03-01,Male,69,65-69,17
18,2,2,0,4,2021-03-01,Female,69,65-69,3
18,0,0,0,0,2021-02-25,Female,40,35-44,5
18,1,2,0,3,2021-02-24,Male,68,65-69,16
18,3,3,0,6,2021-03-02,Male,17,15-19,6
18,3,0,0,3,2021-03-01,Male,19,15-19,5
18,0,0,0,0,2021-02-24,Male,34,25-34,14
18,2,0,0,2,2021-03-01,Male,16,15-19,11
18,0,0,0,0,2021-02-24,Female,62,55-64,15
18,0,0,0,0,2021-03-01,Female,56,55-64,17
18,3,0,0,3,2021-03-02,Female,53,45-54,13
18,1,0,0,1,2021-03-01,Male,66,65-69,13
18,1,0,0,1,2021-03-01,Male,55,55-64,12
18,3,0,0,3,2021-03-02,Male,9,5-9,12
18,1,0,0,1,2021-02-26,Male,42,35-44,11
18,0,0,0,0,2021-03-03,Female,55,55-64,10
18,0,0,0,0,2021-02-24,Female,60,55-64,18
18,3,0,0,3,2021-02-24,Female,4,1-4,14
18,1,0,0,1,2021-02-26,Female,30,25-34,10
18,3,3,10,16,2021-02-25,Male,7,5-9,10
18,4,0,0,4,2021-02-25,Female,54,45-54,13
18,2,0,0,2,2021-02-26,Female,56,55-64,14
18,1,0,0,1,2021-02-25,Female,60,55-64,17
18,2,0,0,2,2021-03-01,Male,60,55-64,13
18,0,1,0,1,2021-03-02,Male,70,70-74,17
18,1,0,0,1,2021-02-26,Male,47,45-54,9
18,0,3,0,3,2021-02-28,Female,54,45-54,13
18,1,0,0,1,2021-03-01,Male,61,55-64,10
18,2,0,0,2,2021-03-02,Female,52,45-54,16
18,0,0,0,0,2021-02-27,Male,69,65-69,12
18,2,1,0,3,2021-02-27,Male,71,70-74,13
18,2,2,0,4,2021-03-01,Male,78,75-79,13
18,3,0,0,3,2021-03-01,Male,14,10-14,7
18,2,0,0,2,2021-03-01,Male,52,45-54,11
18,1,1,0,2,2021-03-02,Male,70,70-74,15
18,0,0,0,0,2021-02-26,Male,52,45-54,16
18,3,0,0,3,2021-02-28,Female,16,15-19,14
18,0,0,0,0,2021-02-26,Female,41,35-44,4
18,1,1,0,2,2021-02-26,Female,65,65-69,17
18,4,0,0,4,2021-03-02,Female,18,15-19,11
18,0,0,0,0,2021-02-26,Female,37,35-44,15
18,4,0,0,4,2021-03-01,Male,10,10-14,7
18,0,0,7,7,2021-02-25,Female,48,45-54,10
18,0,2,0,2,2021-03-02,Female,59,55-64,4
18,0,0,0,0,2021-02-25,Male,60,55-64,11
18,0,0,0,0,2021-02-24,Female,56,55-64,15
18,0,0,0,0,2021-02-26,Male,60,55-64,14
18,0,0,0,0,2021-02-26,Male,36,35-44,11
18,0,0,0,0,2021-03-01,Male,37,35-44,13
18,1,0,0,1,2021-02-26,Male,15,15-19,5
18,2,0,0,2,2021-02-25,Male,51,45-54,11
18,0,0,0,0,2021-03-02,Male,74,70-74,10
18,2,0,0,2,2021-03-01,Female,52,45-54,12
18,1,6,0,7,2021-02-26,Female,73,70-74,10
18,1,1,0,2,2021-02-26,Female,18,15-19,14
18,1,0,0,1,2021-03-02,Female,55,55-64,11
18,2,0,0,2,2021-02-25,Male,17,15-19,5
18,1,2,0,3,2021-02-24,Male,50,45-54,5
18,0,0,0,0,2021-02-28,Male,53,45-54,9
18,1,0,0,1,2021-02-28,Male,52,45-54,4
18,1,0,0,1,2021-02-25,Male,54,45-54,14
18,2,1,0,3,2021-02-24,Female,65,65-69,16
18,0,0,0,0,2021-03-01,Male,79,75-79,8
18,1,1,0,2,2021-02-27,Male,61,55-64,15
18,0,0,0,0,2021-02-25,Male,19,15-19,7
18,0,1,0,1,2021-02-26,Male,52,45-54,13
18,1,0,0,1,2021-03-01,Female,51,45-54,12
18,0,0,0,0,2021-03-01,Female,61,55-64,14
18,3,0,0,3,2021-02-25,Male,12,10-14,17
18,1,0,0,1,2021-02-24,Female,27,25-34,5
18,0,12,0,12,2021-02-28,Male,40,35-44,12
18,2,0,0,2,2021-02-24,Male,51,45-54,2
18,3,0,0,3,2021-02-25,Female,3,1-4,3
18,0,0,0,0,2021-02-26,Female,66,65-69,16
18,0,0,0,0,2021-02-25,Male,64,55-64,9
18,1,1,0,2,2021-02-28,Male,37,35-44,14
18,0,0,0,0,2021-02-24,Female,24,20-24,9
18,1,0,0,1,2021-02-26,Female,64,55-64,13
18,0,1,0,1,2021-03-02,Female,68,65-69,17
18,1,0,0,1,2021-02-25,Female,40,35-44,13
18,0,1,0,1,2021-02-26,Female,68,65-69,15
18,0,0,0,0,2021-02-28,Male,38,35-44,9
18,1,0,0,1,2021-03-02,Female,37,35-44,10
18,0,0,0,0,2021-02-25,Female,5,5-9,6
18,0,0,0,0,2021-03-02,Female,46,45-54,8
18,1,0,0,1,2021-02-24,Female,34,25-34,14
18,1,0,0,1,2021-02-24,Female,52,45-54,17
18,0,0,0,0,2021-02-26,Female,24,20-24,15
18,3,0,0,3,2021-03-02,Female,55,55-64,9
18,0,0,0,0,2021-02-28,Female,18,15-19,13
18,0,0,0,0,2021-02-26,Female,44,35-44,13
18,0,0,0,0,2021-02-28,Female,21,20-24,4
18,1,0,0,1,2021-03-01,Male,67,65-69,10
18,2,0,0,2,2021-02-26,Female,63,55-64,15
18,0,4,0,4,2021-02-24,Female,51,45-54,11
18,0,5,0,5,2021-02-24,Male,42,35-44,2
18,0,0,0,0,2021-03-01,Female,67,65-69,15
18,1,0,0,1,2021-02-25,Female,73,70-74,13
18,1,0,0,1,2021-02-28,Male,36,35-44,9
18,0,0,0,0,2021-03-01,Male,58,55-64,17
18,0,0,0,0,2021-03-01,Female,24,20-24,12
18,0,0,0,0,2021-03-01,Male,79,75-79,13
18,2,0,0,2,2021-02-28,Female,9,5-9,13
18,1,0,0,1,2021-03-02,Female,63,55-64,12
18,2,2,0,4,2021-03-01,Male,68,65-69,15
18,1,50,16,67,2021-02-25,Female,55,55-64,15
18,2,0,0,2,2021-03-01,Female,61,55-64,9
18,0,0,0,0,2021-02-26,Female,43,35-44,8
18,1,0,0,1,2021-02-24,Female,61,55-64,13
18,1,0,0,1,2021-03-01,Male,68,65-69,13
18,1,0,0,1,2021-02-26,Male,64,55-64,18
18,2,0,0,2,2021-03-01,Male,73,70-74,15
18,1,0,0,1,2021-03-01,Female,65,65-69,14
18,2,0,0,2,2021-02-26,Male,54,45-54,13
18,0,2,0,2,2021-03-01,Female,67,65-69,14
18,0,0,0,0,2021-02-27,Female,31,25-34,8
18,0,0,2,2,2021-02-24,Male,12,10-14,3
18,0,2,0,2,2021-03-02,Female,72,70-74,16
18,2,0,0,2,2021-02-26,Female,72,70-74,14
18,1,1,0,2,2021-03-03,Female,49,45-54,17
18,3,0,0,3,2021-03-02,Female,59,55-64,15
18,0,0,0,0,2021-02-25,Female,34,25-34,13
18,0,1,0,1,2021-02-26,Female,34,25-34,4
18,1,0,0,1,2021-03-03,Male,74,70-74,9
18,2,0,0,2,2021-02-28,Female,1,1-4,9
18,2,0,0,2,2021-03-01,Female,51,45-54,11
18,0,0,0,0,2021-02-25,Female,41,35-44,17
18,3,0,0,3,2021-02-25,Male,22,20-24,17
18,0,0,0,0,2021-02-25,Male,55,55-64,17
18,0,0,0,0,2021-02-25,Male,53,45-54,12
18,0,4,0,4,2021-03-02,Female,36,35-44,16
18,3,7,0,10,2021-02-25,Female,9,5-9,14
18,1,0,0,1,2021-02-25,Male,55,55-64,14
18,2,2,0,4,2021-03-01,Male,62,55-64,15
18,5,0,0,5,2021-02-25,Male,18,15-19,15
18,1,4,0,5,2021-02-24,Female,57,55-64,13
18,1,0,0,1,2021-03-02,Female,67,65-69,13
18,0,0,4,4,2021-02-26,Male,11,10-14,11
18,0,2,0,2,2021-03-02,Female,85,85+,7
18,0,2,0,2,2021-03-01,Female,70,70-74,16
18,1,2,0,3,2021-03-02,Male,74,70-74,18
18,3,1,0,4,2021-03-02,Male,13,10-14,16
18,0,4,2,6,2021-02-27,Male,73,70-74,15
18,1,0,0,1,2021-03-02,Female,40,35-44,3
18,0,0,0,0,2021-02-25,Female,36,35-44,10
18,0,0,0,0,2021-03-01,Male,67,65-69,6
18,0,0,0,0,2021-02-24,Female,37,35-44,15
18,1,0,0,1,2021-02-27,Female,61,55-64,15
18,1,2,0,3,2021-03-02,Female,66,65-69,11
18,1,0,0,1,2021-03-01,Male,67,65-69,14
18,3,0,0,3,2021-02-24,Female,12,10-14,15
18,1,5,0,6,2021-02-26,Male,71,70-74,8
18,0,0,0,0,2021-02-26,Female,51,45-54,13
18,1,0,0,1,2021-03-01,Female,3,1-4,12
18,2,0,0,2,2021-03-01,Male,26,25-34,5
18,1,30,0,31,2021-02-26,Male,66,65-69,17
18,1,0,0,1,2021-02-27,Female,29,25-34,13
18,0,0,0,0,2021-02-25,Male,32,25-34,12
18,1,0,0,1,2021-03-02,Male,75,75-79,3
18,2,0,0,2,2021-03-01,Female,11,10-14,12
18,2,3,0,5,2021-02-28,Female,25,25-34,10
18,3,0,0,3,2021-02-25,Female,65,65-69,17
18,2,0,0,2,2021-02-24,Female,66,65-69,15
18,0,0,0,0,2021-03-01,Female,75,75-79,16
18,2,0,0,2,2021-02-27,Female,45,45-54,10
18,1,0,0,1,2021-02-27,Male,32,25-34,14
18,3,0,0,3,2021-02-27,Male,15,15-19,15
18,3,0,0,3,2021-02-25,Male,34,25-34,11
18,2,1,0,3,2021-02-26,Female,23,20-24,14
18,0,0,0,0,2021-02-28,Male,35,35-44,10
18,0,0,0,0,2021-02-25,Male,19,15-19,15
18,0,0,0,0,2021-03-01,Female,64,55-64,12
18,1,1,0,2,2021-02-24,Male,66,65-69,16
18,1,0,0,1,2021-03-02,Male,56,55-64,7
18,3,0,0,3,2021-02-24,Female,10,10-14,18
18,0,0,0,0,2021-02-25,Female,65,65-69,12
18,1,0,0,1,2021-03-01,Male,76,75-79,13
18,0,0,0,0,2021-02-27,Male,21,20-24,7
18,1,0,0,1,2021-02-27,Male,59,55-64,12
18,1,0,0,1,2021-03-02,Male,62,55-64,17
18,0,0,0,0,2021-03-01,Female,38,35-44,6
18,1,3,0,4,2021-03-02,Male,38,35-44,12
18,1,3,0,4,2021-03-02,Female,66,65-69,11
18,0,0,0,0,2021-02-25,Male,30,25-34,6
18,1,0,9,10,2021-03-02,Female,62,55-64,12
18,1,1,0,2,2021-03-01,Female,53,45-54,15
18,1,0,0,1,2021-02-24,Female,49,45-54,16
18,0,2,0,2,2021-03-03,Female,73,70-74,10
18,0,0,0,0,2021-03-01,Female,10,10-14,8
18,0,0,0,0,2021-02-26,Female,22,20-24,3
18,1,0,0,1,2021-03-02,Male,65,65-69,13
18,1,2,0,3,2021-03-02,Female,32,25-34,4
18,0,0,0,0,2021-03-02,Female,26,25-34,17
18,0,1,0,1,2021-02-24,Female,22,20-24,15
18,1,0,0,1,2021-02-26,Male,40,35-44,15
18,0,0,0,0,2021-02-28,Male,34,25-34,12
18,1,2,0,3,2021-03-01,Male,62,55-64,14
18,0,0,0,0,2021-02-26,Female,68,65-69,13
18,2,0,0,2,2021-03-02,Male,9,5-9,4
18,1,0,0,1,2021-02-27,Male,68,65-69,16
18,2,0,0,2,2021-02-24,Male,5,5-9,18
18,1,0,0,1,2021-02-24,Female,24,20-24,11
18,4,0,0,4,2021-03-01,Female,12,10-14,12
18,1,1,0,2,2021-02-28,Male,71,70-74,13
18,1,0,0,1,2021-02-27,Female,29,25-34,7
18,2,0,0,2,2021-02-25,Female,60,55-64,14
18,3,0,0,3,2021-02-26,Female,19,15-19,6
18,0,0,0,0,2021-03-01,Male,46,45-54,10
18,0,0,0,0,2021-02-28,Female,19,15-19,12
18,1,0,0,1,2021-02-25,Male,2,1-4,8
18,2,6,0,8,2021-02-27,Male,57,55-64,15
18,1,0,0,1,2021-03-02,Female,67,65-69,7
18,0,0,0,0,2021-03-02,Female,70,70-74,9
18,3,0,0,3,2021-02-25,Female,23,20-24,4
18,1,0,0,1,2021-03-02,Male,46,45-54,12
18,0,20,0,20,2021-02-24,Female,34,25-34,14
18,3,1,0,4,2021-02-27,Female,33,25-34,15
18,0,0,0,0,2021-03-01,Male,58,55-64,16
18,2,0,0,2,2021-02-24,Male,64,55-64,17
18,1,0,0,1,2021-02-25,Female,63,55-64,16
18,1,0,0,1,2021-03-01,Female,64,55-64,15
18,3,0,0,3,2021-02-25,Female,43,35-44,14
18,1,0,0,1,2021-02-24,Male,53,45-54,14
18,2,10,0,12,2021-02-25,Male,50,45-54,16
18,1,0,0,1,2021-03-01,Female,63,55-64,10
18,1,1,0,2,2021-02-24,Female,67,65-69,16
18,1,0,0,1,2021-02-25,Male,9,5-9,8
18,0,0,0,0,2021-03-02,Female,66,65-69,9
18,1,0,0,1,2021-03-01,Male,59,55-64,15
18,3,3,0,6,2021-02-27,Male,10,10-14,9
18,0,0,0,0,2021-02-24,Male,33,25-34,15
18,3,0,0,3,2021-02-28,Male,6,5-9,6
18,0,0,0,0,2021-02-27,Male,42,35-44,12
18,1,2,0,3,2021-02-24,Male,68,65-69,18
18,0,0,0,0,2021-02-24,Male,10,10-14,15
18,0,0,0,0,2021-02-28,Male,35,35-44,4
18,5,0,0,5,2021-02-24,Female,16,15-19,17
18,1,0,0,1,2021-03-01,Male,67,65-69,6
18,1,0,0,1,2021-03-02,Female,66,65-69,7
18,2,0,0,2,2021-03-03,Male,10,10-14,14
18,2,0,0,2,2021-02-26,Male,24,20-24,10
18,0,0,0,0,2021-02-24,Male,1,1-4,13
18,0,0,0,0,2021-03-02,Female,39,35-44,10
18,2,0,0,2,2021-02-25,Male,15,15-19,12
18,2,0,0,2,2021-02-25,Male,51,45-54,14
18,1,0,0,1,2021-02-28,Male,47,45-54,7
18,0,3,0,3,2021-02-26,Male,39,35-44,14
18,0,0,0,0,2021-02-25,Female,34,25-34,16
18,0,0,0,0,2021-02-26,Male,30,25-34,7
18,3,0,0,3,2021-02-26,Female,19,15-19,5
18,0,1,0,1,2021-02-26,Male,45,45-54,14
18,0,4,0,4,2021-02-28,Female,65,65-69,14
18,1,4,0,5,2021-02-24,Female,70,70-74,3
18,1,0,0,1,2021-03-01,Male,72,70-74,3
18,5,0,0,5,2021-02-25,Female,19,15-19,9
18,0,0,0,0,2021-02-27,Female,52,45-54,14
18,0,2,0,2,2021-02-24,Female,28,25-34,5
18,2,0,0,2,2021-02-26,Male,26,25-34,12
18,0,2,0,2,2021-02-24,Female,28,25-34,14
18,0,3,0,3,2021-02-25,Male,43,35-44,5
18,0,0,0,0,2021-02-26,Male,16,15-19,9
18,0,4,0,4,2021-02-24,Female,67,65-69,14
18,0,0,0,0,2021-02-25,Female,67,65-69,10
18,0,0,0,0,2021-02-28,Female,69,65-69,16
18,0,0,0,0,2021-02-26,Male,36,35-44,4
18,1,0,0,1,2021-02-25,Female,31,25-34,7
18,5,0,0,5,2021-03-03,Male,15,15-19,15
18,2,2,0,4,2021-02-26,Female,55,55-64,14
18,0,1,0,1,2021-02-26,Female,27,25-34,11
18,2,0,0,2,2021-02-24,Male,48,45-54,17
18,0,0,0,0,2021-02-25,Female,53,45-54,17
18,0,2,0,2,2021-03-01,Female,38,35-44,12
18,0,0,0,0,2021-03-02,Male,54,45-54,11
18,1,0,0,1,2021-02-24,Female,39,35-44,5
18,0,0,0,0,2021-02-24,Male,49,45-54,14
18,1,0,0,1,2021-02-25,Male,64,55-64,13
18,0,0,0,0,2021-02-25,Male,27,25-34,9
18,1,0,0,1,2021-02-24,Male,36,35-44,14
18,1,0,0,1,2021-03-01,Male,49,45-54,15
18,1,0,0,1,2021-03-03,Female,69,65-69,8
18,1,1,0,2,2021-03-02,Female,52,45-54,9
18,0,0,0,0,2021-03-02,Female,53,45-54,13
18,2,0,0,2,2021-03-01,Male,68,65-69,16
18,1,22,5,28,2021-02-27,Female,48,45-54,14
18,3,10,0,13,2021-02-25,Male,20,20-24,15
18,3,0,0,3,2021-03-01,Male,85,85+,12
18,1,0,0,1,2021-02-28,Female,31,25-34,8
18,1,0,0,1,2021-02-25,Female,54,45-54,15
18,2,0,0,2,2021-02-25,Male,11,10-14,11
18,2,0,0,2,2021-02-25,Female,20,20-24,7
18,0,0,0,0,2021-03-01,Male,48,45-54,12
18,2,0,0,2,2021-03-01,Female,67,65-69,12
18,0,2,0,2,2021-02-24,Male,50,45-54,18
18,0,0,0,0,2021-02-24,Male,0,<1,8
18,1,1,0,2,2021-03-01,Female,71,70-74,5
18,0,0,0,0,2021-02-24,Female,19,15-19,4
18,0,0,0,0,2021-03-01,Male,54,45-54,16
18,2,2,0,4,2021-03-01,Female,12,10-14,7
18,2,2,0,4,2021-03-02,Female,67,65-69,6
18,0,0,0,0,2021-02-24,Male,43,35-44,16
18,2,0,0,2,2021-02-28,Female,80,80-84,14
18,1,2,0,3,2021-03-02,Female,70,70-74,16
18,2,2,0,4,2021-02-24,Male,16,15-19,4
18,0,2,0,2,2021-03-01,Female,70,70-74,18
18,1,1,0,2,2021-03-01,Male,41,35-44,16
18,0,0,0,0,2021-02-25,Male,13,10-14,11
18,0,1,0,1,2021-02-24,Male,61,55-64,17
18,4,1,0,5,2021-02-26,Female,11,10-14,12
18,0,1,0,1,2021-03-02,Male,67,65-69,8
18,3,0,0,3,2021-02-28,Female,9,5-9,14
18,0,0,0,0,2021-02-28,Male,11,10-14,14
18,0,0,0,0,2021-02-25,Male,34,25-34,16
18,2,0,0,2,2021-03-01,Male,17,15-19,10
18,3,1,0,4,2021-02-25,Male,8,5-9,8
18,2,0,0,2,2021-02-26,Male,20,20-24,14
19,1,2,0,3,2021-03-21,Male,68,65-69,14
19,2,0,0,2,2021-03-20,Female,58,55-64,11
19,2,0,0,2,2021-03-26,Male,14,10-14,1
19,2,0,0,2,2021-03-20,Female,66,65-69,19
19,0,0,0,0,2021-03-21,Female,15,15-19,7
19,0,1,0,1,2021-03-17,Female,72,70-74,15
19,2,1,0,3,2021-03-22,Female,1,1-4,4
19,1,0,0,1,2021-03-17,Female,72,70-74,19
19,0,0,0,0,2021-03-18,Male,30,25-34,15
19,0,1,0,1,2021-03-21,Female,53,45-54,10
19,1,0,0,1,2021-03-17,Female,54,45-54,14
19,0,0,0,0,2021-03-17,Female,68,65-69,12
19,3,17,0,20,2021-03-26,Male,18,15-19,1
19,0,0,0,0,2021-03-17,Female,34,25-34,6
19,1,0,0,1,2021-03-21,Female,59,55-64,15
19,1,1,0,2,2021-03-22,Female,61,55-64,10
19,0,0,0,0,2021-03-20,Male,51,45-54,15
19,1,0,0,1,2021-03-18,Male,51,45-54,14
19,0,0,0,0,2021-03-17,Female,35,35-44,16
19,2,0,0,2,2021-03-26,Female,29,25-34,1
19,3,0,0,3,2021-03-19,Female,57,55-64,15
19,0,0,0,0,2021-03-17,Female,22,20-24,4
19,0,0,0,0,2021-03-17,Male,42,35-44,12
19,0,0,0,0,2021-03-17,Male,32,25-34,15
19,1,2,1,4,2021-03-18,Male,67,65-69,11
19,1,0,0,1,2021-03-19,Male,66,65-69,14
19,1,2,0,3,2021-03-18,Male,63,55-64,19
19,0,0,0,0,2021-03-17,Male,7,5-9,13
19,1,0,0,1,2021-03-19,Male,19,15-19,17
19,0,0,0,0,2021-03-18,Male,49,45-54,16
19,3,0,0,3,2021-03-17,Male,58,55-64,13
19,2,0,0,2,2021-03-17,Male,51,45-54,6
19,0,0,0,0,2021-03-21,Female,71,70-74,18
19,0,0,0,0,2021-03-17,Male,20,20-24,13
19,1,0,0,1,2021-03-17,Female,52,45-54,15
19,0,0,0,0,2021-03-17,Male,42,35-44,19
19,4,0,0,4,2021-03-18,Male,19,15-19,5
19,1,1,0,2,2021-03-20,Male,58,55-64,12
19,1,1,0,2,2021-03-20,Female,56,55-64,19
19,2,0,0,2,2021-03-17,Female,22,20-24,17
19,2,0,0,2,2021-03-17,Male,52,45-54,17
19,1,0,0,1,2021-03-26,Male,43,35-44,1
19,3,0,0,3,2021-03-18,Male,24,20-24,4
19,0,0,0,0,2021-03-17,Female,69,65-69,14
19,0,0,0,0,2021-03-17,Male,15,15-19,12
19,1,0,0,1,2021-03-17,Male,58,55-64,17
19,0,0,0,0,2021-03-19,Male,68,65-69,17
19,1,0,0,1,2021-03-21,Male,72,70-74,12
19,0,2,0,2,2021-03-17,Male,77,75-79,14
19,0,0,0,0,2021-03-17,Male,26,25-34,6
19,1,0,0,1,2021-03-17,Male,71,70-74,17
19,0,0,0,0,2021-03-17,Male,44,35-44,9
19,0,0,0,0,2021-03-18,Male,52,45-54,16
19,0,0,0,0,2021-03-19,Male,37,35-44,8
19,0,0,0,0,2021-03-22,Male,53,45-54,12
19,1,0,0,1,2021-03-21,Male,44,35-44,11
19,3,6,0,9,2021-03-19,Male,44,35-44,12
19,0,0,0,0,2021-03-21,Male,1,1-4,5
19,0,0,0,0,2021-03-17,Male,2,1-4,11
19,0,0,0,0,2021-03-20,Female,6,5-9,5
19,1,1,0,2,2021-03-17,Male,39,35-44,16
19,2,0,0,2,2021-03-17,Male,69,65-69,15
19,0,0,0,0,2021-03-19,Female,77,75-79,15
19,4,1,0,5,2021-03-17,Male,4,1-4,5
19,1,0,0,1,2021-03-19,Female,68,65-69,16
19,1,1,0,2,2021-03-17,Male,62,55-64,16
19,0,0,0,0,2021-03-18,Female,43,35-44,12
19,0,1,0,1,2021-03-21,Male,72,70-74,12
19,0,0,0,0,2021-03-17,Female,19,15-19,6
19,0,1,0,1,2021-03-17,Male,85,85+,14
19,2,0,0,2,2021-03-21,Female,72,70-74,14
19,0,0,0,0,2021-03-17,Female,22,20-24,5
19,2,3,0,5,2021-03-18,Male,54,45-54,18
19,1,0,0,1,2021-03-17,Male,70,70-74,16
19,2,2,0,4,2021-03-18,Female,72,70-74,15
19,1,0,0,1,2021-03-20,Male,67,65-69,11
19,1,1,0,2,2021-03-18,Female,65,65-69,18
19,3,1,0,4,2021-03-21,Male,11,10-14,10
19,2,0,0,2,2021-03-21,Male,70,70-74,17
19,0,0,0,0,2021-03-19,Male,40,35-44,9
19,1,1,0,2,2021-03-19,Male,67,65-69,15
19,2,2,0,4,2021-03-18,Male,70,70-74,9
19,0,0,0,0,2021-03-17,Female,10,10-14,5
19,0,0,0,0,2021-03-20,Female,22,20-24,12
19,0,0,0,0,2021-03-17,Male,43,35-44,15
19,1,0,0,1,2021-03-21,Male,70,70-74,14
19,1,5,0,6,2021-03-21,Male,69,65-69,19
19,4,0,0,4,2021-03-20,Female,4,1-4,13
19,0,0,0,0,2021-03-26,Female,20,20-24,1
19,2,0,0,2,2021-03-17,Female,67,65-69,17
19,3,0,0,3,2021-03-17,Male,18,15-19,15
19,0,2,0,2,2021-03-20,Female,53,45-54,16
19,0,0,0,0,2021-03-17,Male,49,45-54,17
19,0,0,0,0,2021-03-20,Male,69,65-69,12
19,1,3,0,4,2021-03-21,Female,66,65-69,10
19,0,0,0,0,2021-03-19,Female,63,55-64,17
19,1,0,0,1,2021-03-19,Female,29,25-34,10
19,0,1,0,1,2021-03-17,Female,31,25-34,18
19,0,0,0,0,2021-03-21,Female,67,65-69,13
19,1,0,0,1,2021-03-20,Male,17,15-19,10
19,0,0,0,0,2021-03-18,Female,62,55-64,17
19,0,0,0,0,2021-03-17,Male,55,55-64,16
19,0,0,0,0,2021-03-20,Male,29,25-34,10
19,1,1,0,2,2021-03-20,Male,57,55-64,14
19,2,0,0,2,2021-03-17,Male,1,1-4,4
19,0,1,0,1,2021-03-17,Male,32,25-34,19
19,0,0,0,0,2021-03-19,Male,65,65-69,14
19,2,0,0,2,2021-03-22,Male,28,25-34,7
19,2,0,0,2,2021-03-17,Female,31,25-34,13
19,0,0,0,0,2021-03-21,Male,35,35-44,7
19,2,10,0,12,2021-03-20,Female,66,65-69,5
19,0,0,0,0,2021-03-18,Male,5,5-9,7
19,0,1,0,1,2021-03-19,Female,33,25-34,15
19,0,0,0,0,2021-03-17,Male,37,35-44,15
19,1,3,0,4,2021-03-18,Female,62,55-64,15
19,1,1,0,2,2021-03-19,Female,23,20-24,6
19,1,2,0,3,2021-03-18,Male,65,65-69,14
19,0,0,0,0,2021-03-19,Male,64,55-64,17
19,3,0,0,3,2021-03-20,Male,7,5-9,10
19,0,0,0,0,2021-03-20,Male,30,25-34,12
19,1,0,0,1,2021-03-18,Female,26,25-34,14
19,0,1,0,1,2021-03-21,Male,69,65-69,14
19,2,0,0,2,2021-03-17,Male,42,35-44,13
19,2,0,0,2,2021-03-17,Male,58,55-64,18
19,0,0,0,0,2021-03-20,Female,62,55-64,15
19,4,0,0,4,2021-03-20,Male,10,10-14,6
19,0,0,0,0,2021-03-21,Male,69,65-69,14
19,3,0,0,3,2021-03-17,Male,32,25-34,13
19,2,0,0,2,2021-03-20,Male,35,35-44,15
19,3,0,0,3,2021-03-17,Male,25,25-34,11
19,0,0,0,0,2021-03-17,Male,22,20-24,13
19,1,0,0,1,2021-03-18,Male,65,65-69,17
19,1,1,0,2,2021-03-17,Female,79,75-79,14
19,1,0,0,1,2021-03-19,Female,29,25-34,15
19,1,0,0,1,2021-03-26,Male,52,45-54,2
19,1,3,0,4,2021-03-18,Female,66,65-69,13
19,0,0,0,0,2021-03-20,Male,23,20-24,7
19,0,0,0,0,2021-03-20,Female,57,55-64,14
19,1,0,0,1,2021-03-20,Male,52,45-54,13
19,0,0,0,0,2021-03-19,Male,52,45-54,10
19,1,3,0,4,2021-03-23,Male,28,25-34,9
19,1,2,0,3,2021-03-18,Male,71,70-74,16
19,1,2,0,3,2021-03-20,Female,68,65-69,19
19,0,0,0,0,2021-03-22,Female,52,45-54,17
19,3,0,0,3,2021-03-17,Male,7,5-9,14
19,0,0,0,0,2021-03-18,Female,32,25-34,5
19,3,0,0,3,2021-03-18,Male,66,65-69,15
19,0,5,0,5,2021-03-20,Female,24,20-24,4
19,1,1,0,2,2021-03-19,Female,58,55-64,16
19,0,0,0,0,2021-03-18,Female,66,65-69,17
19,1,0,0,1,2021-03-17,Female,42,35-44,9
19,1,0,0,1,2021-03-21,Female,60,55-64,15
19,0,0,0,0,2021-03-18,Female,66,65-69,8
19,0,2,2,4,2021-03-17,Male,71,70-74,19
19,0,0,0,0,2021-03-21,Female,71,70-74,14
19,1,1,0,2,2021-03-17,Male,74,70-74,17
19,2,0,0,2,2021-03-21,Female,73,70-74,11
19,0,0,0,0,2021-03-17,Male,51,45-54,12
19,1,0,0,1,2021-03-17,Female,31,25-34,14
19,0,0,0,0,2021-03-26,Male,38,35-44,6
19,0,0,0,0,2021-03-19,Male,54,45-54,15
19,1,0,0,1,2021-03-25,Male,51,45-54,14
19,1,0,0,1,2021-03-17,Female,50,45-54,14
19,0,0,0,0,2021-03-17,Female,29,25-34,10
19,0,0,0,0,2021-03-18,Male,10,10-14,14
19,2,100,100,202,2021-03-20,Male,17,15-19,15
19,0,0,0,0,2021-03-17,Male,65,65-69,13
19,1,1,0,2,2021-03-21,Male,68,65-69,16
19,1,1,0,2,2021-03-22,Male,53,45-54,12
19,1,0,0,1,2021-03-19,Female,58,55-64,16
19,0,0,0,0,2021-03-21,Male,50,45-54,17
19,0,0,0,0,2021-03-21,Male,12,10-14,15
19,0,1,0,1,2021-03-26,Female,26,25-34,3
19,0,0,0,0,2021-03-21,Male,71,70-74,17
19,0,0,0,0,2021-03-18,Male,40,35-44,13
19,2,0,0,2,2021-03-17,Female,69,65-69,19
19,0,0,0,0,2021-03-18,Male,38,35-44,13
19,3,0,0,3,2021-03-17,Male,20,20-24,11
19,1,0,0,1,2021-03-17,Female,5,5-9,12
19,4,0,0,4,2021-03-17,Male,22,20-24,6
19,2,1,0,3,2021-03-17,Female,73,70-74,12
19,0,0,0,0,2021-03-17,Male,52,45-54,13
19,1,0,0,1,2021-03-17,Female,57,55-64,15
19,1,0,0,1,2021-03-17,Female,60,55-64,19
19,0,0,0,0,2021-03-19,Male,43,35-44,18
19,2,1,0,3,2021-03-21,Male,63,55-64,8
19,2,0,0,2,2021-03-17,Female,63,55-64,13
19,2,0,0,2,2021-03-21,Male,73,70-74,15
19,2,1,0,3,2021-03-17,Female,53,45-54,17
19,1,1,0,2,2021-03-21,Male,69,65-69,14
19,1,0,0,1,2021-03-17,Male,34,25-34,18
19,1,1,0,2,2021-03-17,Female,23,20-24,5
19,0,0,0,0,2021-03-19,Male,48,45-54,13
19,3,1,0,4,2021-03-19,Male,70,70-74,14
19,3,0,0,3,2021-03-17,Male,39,35-44,14
19,1,0,0,1,2021-03-21,Male,68,65-69,17
19,0,3,0,3,2021-03-23,Male,62,55-64,14
19,0,0,0,0,2021-03-19,Female,17,15-19,8
19,0,0,0,0,2021-03-21,Male,44,35-44,12
19,0,0,0,0,2021-03-17,Female,56,55-64,17
19,0,0,0,0,2021-03-17,Female,58,55-64,15
19,3,10,0,13,2021-03-24,Male,23,20-24,9
19,0,0,0,0,2021-03-20,Female,66,65-69,16
19,0,0,0,0,2021-03-19,Male,45,45-54,11
19,0,2,0,2,2021-03-22,Female,64,55-64,13
19,2,16,0,18,2021-03-26,Female,12,10-14,1
19,1,2,0,3,2021-03-17,Female,61,55-64,19
19,1,0,0,1,2021-03-17,Male,49,45-54,14
19,1,0,0,1,2021-03-17,Female,54,45-54,19
19,0,0,0,0,2021-03-17,Male,34,25-34,13
19,0,0,0,0,2021-03-22,Male,56,55-64,14
19,0,0,0,0,2021-03-18,Female,65,65-69,19
19,0,0,0,0,2021-03-23,Male,13,10-14,13
19,3,0,0,3,2021-03-20,Female,6,5-9,13
19,3,16,0,19,2021-03-18,Male,9,5-9,12
19,1,0,0,1,2021-03-17,Male,79,75-79,13
19,0,0,0,0,2021-03-19,Female,67,65-69,14
19,0,0,0,0,2021-03-17,Male,39,35-44,15
19,2,1,0,3,2021-03-17,Female,18,15-19,12
19,1,1,0,2,2021-03-19,Female,55,55-64,16
19,2,0,0,2,2021-03-22,Female,70,70-74,6
19,0,0,0,0,2021-03-18,Male,53,45-54,13
19,1,1,0,2,2021-03-17,Male,69,65-69,17
19,2,0,11,13,2021-03-19,Male,18,15-19,13
19,1,0,0,1,2021-03-18,Female,32,25-34,7
19,0,0,0,0,2021-03-18,Male,37,35-44,19
19,2,0,0,2,2021-03-23,Female,49,45-54,9
19,1,2,0,3,2021-03-17,Male,40,35-44,19
19,2,0,0,2,2021-03-17,Female,71,70-74,15
19,0,0,0,0,2021-03-17,Male,40,35-44,15
19,2,0,0,2,2021-03-17,Male,62,55-64,18
19,0,0,0,0,2021-03-19,Female,4,1-4,7
19,1,2,0,3,2021-03-17,Female,68,65-69,12
19,1,0,0,1,2021-03-21,Male,68,65-69,10
19,0,0,4,4,2021-03-17,Male,9,5-9,15
19,1,0,0,1,2021-03-19,Female,34,25-34,13
19,0,0,0,0,2021-03-18,Male,68,65-69,17
19,0,0,0,0,2021-03-17,Male,37,35-44,11
19,0,0,0,0,2021-03-21,Male,29,25-34,15
19,0,0,0,0,2021-03-22,Female,54,45-54,15
19,3,2,0,5,2021-03-20,Male,5,5-9,14
19,0,0,0,0,2021-03-17,Male,31,25-34,6
19,0,0,0,0,2021-03-17,Male,77,75-79,11
19,0,0,0,0,2021-03-26,Female,18,15-19,1
19,0,1,0,1,2021-03-21,Male,47,45-54,13
19,3,2,0,5,2021-03-20,Female,2,1-4,4
19,1,4,0,5,2021-03-17,Male,52,45-54,16
19,0,1,0,1,2021-03-21,Female,70,70-74,11
19,2,0,0,2,2021-03-21,Female,69,65-69,8
19,3,0,0,3,2021-03-18,Male,70,70-74,14
19,0,0,0,0,2021-03-17,Male,16,15-19,16
19,2,0,0,2,2021-03-20,Male,65,65-69,15
19,0,1,0,1,2021-03-20,Male,49,45-54,16
19,1,1,0,2,2021-03-19,Male,66,65-69,10
19,0,0,0,0,2021-03-22,Female,60,55-64,12
19,0,0,0,0,2021-03-17,Male,16,15-19,9
19,1,0,0,1,2021-03-18,Female,65,65-69,12
19,1,0,0,1,2021-03-19,Male,67,65-69,17
19,0,0,0,0,2021-03-18,Male,65,65-69,17
19,2,1,0,3,2021-03-17,Female,68,65-69,18
19,1,1,0,2,2021-03-17,Male,68,65-69,17
19,0,0,0,0,2021-03-17,Male,51,45-54,11
19,0,1,3,4,2021-03-18,Female,26,25-34,6
19,2,0,0,2,2021-03-21,Male,70,70-74,11
19,3,19,0,22,2021-03-20,Female,15,15-19,14
19,1,0,0,1,2021-03-19,Male,16,15-19,15
19,0,0,2,2,2021-03-17,Female,20,20-24,10
19,0,0,0,0,2021-03-20,Female,52,45-54,17
19,5,0,0,5,2021-03-19,Male,11,10-14,16
19,5,0,0,5,2021-03-19,Male,28,25-34,10
19,0,0,0,0,2021-03-21,Female,60,55-64,14
19,0,0,0,0,2021-03-19,Male,10,10-14,17
19,2,5,0,7,2021-03-17,Female,1,1-4,12
19,0,0,0,0,2021-03-20,Male,47,45-54,9
19,1,1,0,2,2021-03-17,Male,82,80-84,16
19,3,0,0,3,2021-03-17,Female,9,5-9,9
19,3,15,0,18,2021-03-26,Male,4,1-4,2
19,0,0,0,0,2021-03-17,Female,9,5-9,12
19,2,0,0,2,2021-03-21,Male,60,55-64,10
19,0,0,0,0,2021-03-20,Female,51,45-54,5
19,0,0,0,0,2021-03-17,Male,25,25-34,16
19,0,0,0,0,2021-03-20,Male,15,15-19,12
19,2,0,0,2,2021-03-18,Male,71,70-74,17
19,0,0,0,0,2021-03-17,Male,35,35-44,18
19,0,0,0,0,2021-03-17,Female,35,35-44,10
19,0,0,0,0,2021-03-17,Female,24,20-24,18
19,0,0,0,0,2021-03-21,Female,66,65-69,13
19,3,0,0,3,2021-03-17,Male,23,20-24,14
19,1,0,0,1,2021-03-19,Female,67,65-69,12
19,0,0,0,0,2021-03-19,Male,68,65-69,16
19,1,0,0,1,2021-03-17,Male,22,20-24,10
19,2,0,0,2,2021-03-17,Male,41,35-44,19
19,1,0,0,1,2021-03-18,Male,65,65-69,15
19,3,1,0,4,2021-03-20,Male,50,45-54,11
19,2,1,0,3,2021-03-17,Male,59,55-64,15
19,3,0,0,3,2021-03-17,Male,11,10-14,6
19,1,1,0,2,2021-03-17,Male,79,75-79,17
19,2,0,0,2,2021-03-17,Male,78,75-79,14
19,0,1,0,1,2021-03-19,Female,68,65-69,12
19,2,60,0,62,2021-03-18,Male,65,65-69,11
19,1,0,0,1,2021-03-17,Male,63,55-64,12
19,0,5,0,5,2021-03-19,Female,67,65-69,16
19,0,0,0,0,2021-03-20,Male,14,10-14,7
19,2,1,0,3,2021-03-17,Female,25,25-34,8
19,0,1,0,1,2021-03-17,Female,69,65-69,16
19,0,0,0,0,2021-03-17,Female,33,25-34,3
19,0,2,0,2,2021-03-18,Female,28,25-34,6
19,2,0,0,2,2021-03-17,Male,31,25-34,4
19,0,1,0,1,2021-03-18,Male,28,25-34,7
19,2,0,0,2,2021-03-17,Female,78,75-79,16
19,0,0,0,0,2021-03-18,Female,66,65-69,12
19,0,31,0,31,2021-03-21,Female,64,55-64,14
19,0,0,0,0,2021-03-17,Male,19,15-19,8
19,0,0,0,0,2021-03-22,Female,34,25-34,13
19,2,0,0,2,2021-03-24,Female,14,10-14,12
19,0,1,0,1,2021-03-20,Male,30,25-34,17
19,0,0,0,0,2021-03-20,Female,72,70-74,10
19,0,0,0,0,2021-03-17,Female,5,5-9,16
19,3,0,0,3,2021-03-19,Female,52,45-54,14
19,2,0,0,2,2021-03-18,Female,52,45-54,16
19,1,0,0,1,2021-03-17,Female,3,1-4,9
19,2,0,0,2,2021-03-17,Female,78,75-79,14
19,0,0,0,0,2021-03-17,Female,22,20-24,3
19,0,0,0,0,2021-03-22,Female,27,25-34,7
19,0,2,0,2,2021-03-18,Male,66,65-69,18
19,0,0,0,0,2021-03-19,Male,42,35-44,13
19,1,0,0,1,2021-03-21,Female,69,65-69,15
19,0,0,0,0,2021-03-17,Female,76,75-79,17
19,0,0,0,0,2021-03-19,Male,37,35-44,14
19,0,0,0,0,2021-03-21,Male,26,25-34,5
19,1,2,0,3,2021-03-17,Male,61,55-64,13
19,1,0,0,1,2021-03-20,Female,51,45-54,12
19,0,0,0,0,2021-03-17,Male,13,10-14,6
19,3,0,0,3,2021-03-19,Female,18,15-19,8
19,1,0,0,1,2021-03-21,Male,69,65-69,17
19,2,0,0,2,2021-03-22,Male,57,55-64,10
19,1,1,0,2,2021-03-24,Female,54,45-54,14
19,0,1,0,1,2021-03-17,Male,62,55-64,14
19,2,1,0,3,2021-03-17,Male,39,35-44,6
19,0,0,0,0,2021-03-18,Female,66,65-69,12
19,0,0,0,0,2021-03-19,Female,33,25-34,4
19,0,0,0,0,2021-03-19,Female,33,25-34,9
19,0,3,0,3,2021-03-18,Female,61,55-64,10
19,1,0,0,1,2021-03-19,Female,61,55-64,14
19,0,1,0,1,2021-03-18,Male,52,45-54,14
19,0,0,0,0,2021-03-20,Female,50,45-54,15
19,2,0,0,2,2021-03-21,Male,67,65-69,8
19,0,2,0,2,2021-03-26,Male,64,55-64,1
19,3,0,0,3,2021-03-19,Female,10,10-14,17
19,1,0,0,1,2021-03-17,Male,16,15-19,17
19,1,2,0,3,2021-03-18,Female,70,70-74,15
19,4,0,0,4,2021-03-17,Male,7,5-9,6
19,3,0,0,3,2021-03-18,Female,10,10-14,15
19,0,0,0,0,2021-03-19,Female,66,65-69,14
19,1,0,0,1,2021-03-18,Female,27,25-34,16
19,2,1,0,3,2021-03-17,Male,76,75-79,17
19,0,3,0,3,2021-03-26,Female,29,25-34,1
19,1,0,0,1,2021-03-18,Male,74,70-74,14
19,0,0,0,0,2021-03-19,Male,52,45-54,9
19,0,0,0,0,2021-03-17,Male,31,25-34,13
19,0,0,0,0,2021-03-17,Female,24,20-24,17
19,1,0,0,1,2021-03-19,Female,23,20-24,7
19,0,0,0,0,2021-03-17,Female,43,35-44,5
19,1,10,0,11,2021-03-17,Male,63,55-64,16
19,2,0,0,2,2021-03-20,Female,55,55-64,12
19,0,1,0,1,2021-03-17,Male,64,55-64,15
19,3,1,0,4,2021-03-17,Male,18,15-19,14
19,2,0,0,2,2021-03-20,Male,54,45-54,18
19,0,0,0,0,2021-03-17,Male,60,55-64,11
19,0,0,0,0,2021-03-17,Female,5,5-9,16
19,1,0,0,1,2021-03-21,Male,72,70-74,13
19,2,0,0,2,2021-03-21,Male,73,70-74,13
19,1,0,0,1,2021-03-20,Female,53,45-54,17
19,0,0,0,0,2021-03-17,Male,19,15-19,11
19,0,1,0,1,2021-03-17,Male,85,85+,8
19,0,0,0,0,2021-03-20,Male,30,25-34,16
19,2,0,0,2,2021-03-17,Female,16,15-19,11
19,5,2,0,7,2021-03-18,Male,4,1-4,4
19,0,1,0,1,2021-03-20,Female,57,55-64,18
19,0,0,0,0,2021-03-21,Male,68,65-69,14
19,0,0,0,0,2021-03-18,Male,52,45-54,16
19,0,0,0,0,2021-03-20,Male,54,45-54,15
19,0,0,0,0,2021-03-21,Male,5,5-9,16
19,2,0,0,2,2021-03-17,Male,67,65-69,18
19,0,0,0,0,2021-03-21,Female,69,65-69,11
19,0,0,0,0,2021-03-17,Female,30,25-34,14
19,0,0,0,0,2021-03-18,Male,46,45-54,16
19,2,0,0,2,2021-03-21,Female,69,65-69,14
19,1,0,0,1,2021-03-17,Male,55,55-64,12
19,1,0,0,1,2021-03-21,Female,48,45-54,12
19,0,2,0,2,2021-03-17,Female,42,35-44,6
19,2,0,8,10,2021-03-17,Female,5,5-9,6
19,1,0,0,1,2021-03-17,Male,64,55-64,17
19,1,4,0,5,2021-03-17,Male,66,65-69,16
19,2,0,0,2,2021-03-18,Male,5,5-9,18
19,0,0,0,0,2021-03-17,Female,15,15-19,10
19,0,0,0,0,2021-03-20,Male,25,25-34,7
19,3,10,0,13,2021-03-19,Male,60,55-64,15
19,0,2,6,8,2021-03-21,Male,58,55-64,18
19,1,0,0,1,2021-03-17,Female,65,65-69,19
19,1,0,0,1,2021-03-20,Male,52,45-54,11
19,2,2,0,4,2021-03-18,Female,53,45-54,5
19,3,0,0,3,2021-03-20,Female,6,5-9,9
19,2,2,0,4,2021-03-17,Female,11,10-14,14
19,0,0,0,0,2021-03-21,Female,72,70-74,7
19,2,0,0,2,2021-03-20,Female,25,25-34,15
19,4,4,0,8,2021-03-19,Male,11,10-14,19
19,1,6,0,7,2021-03-17,Male,51,45-54,17
19,0,0,0,0,2021-03-19,Male,74,70-74,18
19,1,0,0,1,2021-03-17,Male,55,55-64,16
19,0,0,0,0,2021-03-17,Female,69,65-69,18
19,0,0,0,0,2021-03-17,Male,78,75-79,14
19,0,0,0,0,2021-03-17,Female,32,25-34,5
19,0,0,0,0,2021-03-19,Male,85,85+,12
19,0,0,0,0,2021-03-18,Male,32,25-34,11
19,1,0,0,1,2021-03-21,Female,64,55-64,11
19,1,0,0,1,2021-03-20,Female,77,75-79,9
19,1,0,0,1,2021-03-22,Male,60,55-64,18
19,1,0,0,1,2021-03-17,Male,54,45-54,15
19,1,6,0,7,2021-03-21,Male,63,55-64,5
19,0,0,0,0,2021-03-18,Female,25,25-34,18
19,0,0,0,0,2021-03-17,Male,35,35-44,15
19,1,0,0,1,2021-03-21,Male,52,45-54,18
19,0,0,0,0,2021-03-19,Female,24,20-24,16
19,1,0,0,1,2021-03-17,Male,34,25-34,15
19,0,0,0,0,2021-03-17,Female,49,45-54,19
19,0,0,0,0,2021-03-17,Male,70,70-74,16
19,2,0,0,2,2021-03-19,Female,64,55-64,18
19,1,0,0,1,2021-03-21,Male,63,55-64,15
19,1,0,0,1,2021-03-17,Male,37,35-44,10
19,0,0,0,0,2021-03-18,Female,21,20-24,6
19,2,0,0,2,2021-03-19,Female,37,35-44,16
19,2,0,0,2,2021-03-26,Male,34,25-34,1
19,2,0,0,2,2021-03-21,Female,61,55-64,16
19,2,3,0,5,2021-03-17,Female,6,5-9,2
19,1,0,0,1,2021-03-17,Male,70,70-74,14
19,1,3,0,4,2021-03-19,Female,57,55-64,11
19,0,0,0,0,2021-03-17,Male,33,25-34,5
19,1,0,0,1,2021-03-17,Male,53,45-54,15
19,0,0,0,0,2021-03-20,Male,51,45-54,11
19,0,2,0,2,2021-03-17,Female,66,65-69,19
19,1,10,0,11,2021-03-19,Male,36,35-44,2
19,0,2,0,2,2021-03-17,Female,67,65-69,15
19,0,2,0,2,2021-03-21,Female,70,70-74,12
19,3,0,0,3,2021-03-17,Female,5,5-9,13
19,0,4,0,4,2021-03-20,Female,53,45-54,12
19,1,0,0,1,2021-03-17,Female,32,25-34,3
19,0,0,0,0,2021-03-17,Male,54,45-54,15
19,0,2,0,2,2021-03-20,Male,55,55-64,15
19,2,0,0,2,2021-03-18,Male,65,65-69,16
19,1,0,0,1,2021-03-20,Male,57,55-64,14
19,1,2,0,3,2021-03-20,Female,55,55-64,15
19,2,0,0,2,2021-03-18,Male,40,35-44,17
19,0,0,0,0,2021-03-17,Male,39,35-44,16
19,0,1,0,1,2021-03-19,Male,40,35-44,14
19,1,0,0,1,2021-03-23,Female,45,45-54,7
19,3,0,0,3,2021-03-17,Female,21,20-24,14
19,1,2,0,3,2021-03-23,Female,62,55-64,12
19,1,8,16,25,2021-03-19,Female,31,25-34,2
19,0,0,0,0,2021-03-20,Female,15,15-19,9
19,2,15,0,17,2021-03-18,Female,9,5-9,17
19,0,0,0,0,2021-03-19,Male,66,65-69,17
19,2,0,0,2,2021-03-21,Male,64,55-64,15
19,0,0,0,0,2021-03-17,Female,23,20-24,4
19,0,1,0,1,2021-03-17,Male,73,70-74,16
19,1,0,0,1,2021-03-24,Female,33,25-34,7
19,1,0,0,1,2021-03-21,Male,71,70-74,17
19,0,0,0,0,2021-03-20,Female,19,15-19,18
19,1,0,0,1,2021-03-17,Male,63,55-64,18
19,1,0,0,1,2021-03-21,Male,68,65-69,19
19,0,0,0,0,2021-03-19,Male,77,75-79,7
19,0,0,0,0,2021-03-19,Male,57,55-64,16
19,1,3,0,4,2021-03-21,Female,71,70-74,15
19,0,1,2,3,2021-03-20,Male,51,45-54,8
19,0,0,0,0,2021-03-21,Female,60,55-64,10
19,1,0,0,1,2021-03-22,Female,61,55-64,4
19,3,0,0,3,2021-03-19,Male,9,5-9,19
19,2,0,0,2,2021-03-18,Female,56,55-64,18
19,0,0,0,0,2021-03-18,Female,27,25-34,10
19,3,0,0,3,2021-03-24,Female,7,5-9,10
19,0,0,0,0,2021-03-20,Male,53,45-54,11
19,2,0,0,2,2021-03-17,Female,22,20-24,15
19,0,0,0,0,2021-03-17,Female,35,35-44,15
19,2,4,0,6,2021-03-20,Male,56,55-64,13
19,1,1,0,2,2021-03-18,Male,62,55-64,15
19,0,0,0,0,2021-03-19,Male,66,65-69,10
19,0,1,0,1,2021-03-20,Male,54,45-54,12
19,3,0,0,3,2021-03-17,Female,22,20-24,6
19,2,0,0,2,2021-03-17,Male,1,1-4,5
19,0,0,0,0,2021-03-17,Male,10,10-14,17
19,2,0,0,2,2021-03-17,Male,79,75-79,10
19,0,0,0,0,2021-03-22,Female,20,20-24,5
19,1,0,0,1,2021-03-21,Female,23,20-24,3
19,1,1,0,2,2021-03-20,Female,65,65-69,15
19,5,15,0,20,2021-03-18,Female,14,10-14,14
19,1,0,0,1,2021-03-17,Male,64,55-64,19
19,1,0,0,1,2021-03-21,Female,52,45-54,14
19,2,0,0,2,2021-03-18,Female,23,20-24,18
19,0,0,0,0,2021-03-21,Female,73,70-74,12
19,4,0,0,4,2021-03-18,Female,35,35-44,12
19,0,0,0,0,2021-03-18,Female,56,55-64,12
19,1,0,0,1,2021-03-22,Male,51,45-54,3
19,1,0,50,51,2021-03-21,Male,54,45-54,14
19,0,0,0,0,2021-03-17,Female,22,20-24,7
19,1,0,0,1,2021-03-20,Female,55,55-64,15
19,0,0,0,0,2021-03-21,Male,60,55-64,17
19,0,2,0,2,2021-03-21,Female,59,55-64,17
19,0,0,0,0,2021-03-17,Female,24,20-24,5
19,1,0,5,6,2021-03-17,Female,26,25-34,4
19,1,0,0,1,2021-03-17,Male,32,25-34,16
19,1,0,0,1,2021-03-17,Male,28,25-34,18
19,2,8,0,10,2021-03-19,Male,58,55-64,13
19,0,0,0,0,2021-03-17,Male,47,45-54,15
19,0,0,0,0,2021-03-17,Male,0,<1,8
19,0,0,0,0,2021-03-17,Female,34,25-34,17
19,0,0,0,0,2021-03-17,Female,41,35-44,19
19,1,1,0,2,2021-03-19,Male,68,65-69,16
19,2,5,0,7,2021-03-18,Female,74,70-74,12
19,2,0,0,2,2021-03-26,Female,0,<1,1
19,2,0,0,2,2021-03-19,Male,66,65-69,16
19,3,1,0,4,2021-03-17,Male,14,10-14,9
19,1,1,0,2,2021-03-17,Male,33,25-34,15
19,1,0,0,1,2021-03-18,Female,62,55-64,14
19,2,0,0,2,2021-03-18,Female,65,65-69,12
19,0,0,0,0,2021-03-18,Male,69,65-69,16
19,0,0,0,0,2021-03-19,Female,31,25-34,17
19,1,7,0,8,2021-03-18,Male,63,55-64,10
19,1,0,0,1,2021-03-17,Male,23,20-24,8
19,1,0,0,1,2021-03-26,Female,0,<1,2
19,0,0,0,0,2021-03-21,Female,73,70-74,15
19,0,0,0,0,2021-03-17,Male,59,55-64,12
19,0,0,0,0,2021-03-17,Female,52,45-54,10
19,1,4,0,5,2021-03-21,Male,68,65-69,18
19,3,5,0,8,2021-03-21,Female,60,55-64,4
19,0,2,0,2,2021-03-17,Male,59,55-64,14
19,1,0,0,1,2021-03-21,Male,59,55-64,15
19,1,0,0,1,2021-03-18,Male,66,65-69,14
19,0,0,0,0,2021-03-21,Female,53,45-54,14
19,2,0,0,2,2021-03-17,Male,16,15-19,14
19,3,0,0,3,2021-03-19,Male,1,1-4,15
19,1,0,0,1,2021-03-20,Female,31,25-34,15
19,0,2,0,2,2021-03-22,Male,61,55-64,15
19,0,2,0,2,2021-03-21,Male,68,65-69,18
19,1,0,0,1,2021-03-17,Male,47,45-54,7
19,0,0,0,0,2021-03-19,Female,24,20-24,5
19,0,1,0,1,2021-03-26,Male,60,55-64,1
19,3,0,0,3,2021-03-17,Female,66,65-69,11
19,0,1,0,1,2021-03-20,Female,21,20-24,5
19,1,0,0,1,2021-03-19,Female,28,25-34,5
19,2,1,0,3,2021-03-17,Female,23,20-24,12
19,0,0,0,0,2021-03-17,Female,63,55-64,6
19,0,0,0,0,2021-03-21,Female,69,65-69,9
19,2,0,0,2,2021-03-18,Female,48,45-54,13
19,0,4,0,4,2021-03-21,Male,59,55-64,15
19,0,0,0,0,2021-03-18,Male,37,35-44,17
19,0,0,0,0,2021-03-19,Female,43,35-44,14
19,1,0,0,1,2021-03-26,Female,36,35-44,1
19,0,0,0,0,2021-03-17,Male,52,45-54,16
19,4,0,0,4,2021-03-17,Female,31,25-34,12
19,2,0,0,2,2021-03-17,Male,9,5-9,11
19,0,0,0,0,2021-03-21,Female,46,45-54,17
19,3,2,0,5,2021-03-19,Male,68,65-69,12
19,0,0,3,3,2021-03-18,Male,42,35-44,12
19,0,0,0,0,2021-03-17,Male,63,55-64,12
19,1,0,0,1,2021-03-17,Male,55,55-64,16
19,1,0,0,1,2021-03-21,Female,42,35-44,13
19,1,0,0,1,2021-03-20,Female,52,45-54,13
19,2,1,0,3,2021-03-21,Female,70,70-74,15
19,0,0,0,0,2021-03-17,Female,66,65-69,13
19,3,0,0,3,2021-03-17,Male,16,15-19,16
19,0,0,0,0,2021-03-21,Male,55,55-64,16
19,1,0,0,1,2021-03-26,Male,58,55-64,1
19,1,0,0,1,2021-03-19,Female,36,35-44,11
19,0,0,0,0,2021-03-21,Male,60,55-64,11
19,2,0,0,2,2021-03-20,Female,51,45-54,7
19,0,0,0,0,2021-03-17,Male,31,25-34,14
19,1,0,0,1,2021-03-17,Female,21,20-24,16
19,3,0,0,3,2021-03-22,Female,56,55-64,11
19,0,0,0,0,2021-03-17,Male,52,45-54,17
19,0,2,0,2,2021-03-20,Male,65,65-69,14
19,2,0,0,2,2021-03-17,Female,50,45-54,10
19,1,0,0,1,2021-03-17,Male,48,45-54,13
19,0,0,0,0,2021-03-18,Male,60,55-64,15
19,1,0,0,1,2021-03-21,Male,69,65-69,14
19,0,12,0,12,2021-03-17,Male,31,25-34,16
19,0,0,0,0,2021-03-18,Male,36,35-44,15
19,2,0,0,2,2021-03-17,Female,69,65-69,16
19,1,5,7,13,2021-03-21,Female,57,55-64,8
19,0,1,0,1,2021-03-17,Female,26,25-34,16
19,0,0,0,0,2021-03-17,Female,24,20-24,5
19,1,0,0,1,2021-03-21,Female,60,55-64,15
19,0,0,0,0,2021-03-19,Male,41,35-44,12
19,0,0,0,0,2021-03-18,Male,65,65-69,19
19,0,1,0,1,2021-03-21,Male,70,70-74,12
19,0,0,0,0,2021-03-26,Female,24,20-24,3
19,0,0,0,0,2021-03-17,Female,66,65-69,19
19,1,0,0,1,2021-03-21,Male,70,70-74,16
19,1,0,0,1,2021-03-17,Male,34,25-34,8
19,1,0,0,1,2021-03-23,Male,62,55-64,13
19,0,0,0,0,2021-03-19,Male,46,45-54,10
19,0,0,0,0,2021-03-17,Female,65,65-69,15
19,1,0,0,1,2021-03-17,Male,79,75-79,14
19,2,10,0,12,2021-03-21,Male,72,70-74,11
19,0,0,0,0,2021-03-18,Female,7,5-9,4
19,0,0,0,0,2021-03-19,Male,67,65-69,13
19,2,0,0,2,2021-03-17,Female,26,25-34,6
19,1,0,0,1,2021-03-18,Female,68,65-69,13
19,0,0,0,0,2021-03-19,Female,65,65-69,15
19,1,0,0,1,2021-03-17,Male,59,55-64,19
19,2,1,0,3,2021-03-21,Male,70,70-74,18
19,1,0,0,1,2021-03-17,Male,38,35-44,6
19,1,0,0,1,2021-03-18,Male,51,45-54,18
19,1,0,0,1,2021-03-17,Female,26,25-34,5
19,1,0,0,1,2021-03-17,Male,72,70-74,15
19,1,0,0,1,2021-03-17,Female,78,75-79,11
19,1,0,0,1,2021-03-18,Female,64,55-64,14
19,2,0,0,2,2021-03-21,Female,19,15-19,17
19,0,30,0,30,2021-03-19,Female,23,20-24,3
19,2,0,0,2,2021-03-17,Male,1,1-4,11
19,1,1,0,2,2021-03-18,Female,39,35-44,17
19,1,0,0,1,2021-03-17,Female,58,55-64,17
19,0,0,0,0,2021-03-17,Male,78,75-79,12
19,2,0,0,2,2021-03-17,Male,22,20-24,18
19,0,1,0,1,2021-03-18,Male,40,35-44,16
19,0,0,0,0,2021-03-17,Male,67,65-69,14
19,1,0,0,1,2021-03-20,Female,67,65-69,14
19,1,0,0,1,2021-03-17,Female,68,65-69,18
19,3,0,0,3,2021-03-17,Female,15,15-19,14
19,0,1,0,1,2021-03-18,Female,28,25-34,17
19,4,0,0,4,2021-03-19,Female,32,25-34,15
19,1,0,0,1,2021-03-22,Female,64,55-64,12
19,0,0,0,0,2021-03-17,Female,21,20-24,7
19,0,0,0,0,2021-03-22,Male,17,15-19,8
19,1,0,0,1,2021-03-17,Female,47,45-54,14
19,1,0,0,1,2021-03-18,Male,65,65-69,12
19,2,1,0,3,2021-03-17,Female,50,45-54,12
19,1,1,0,2,2021-03-22,Male,62,55-64,9
19,0,0,0,0,2021-03-17,Male,59,55-64,14
19,0,0,0,0,2021-03-17,Male,4,1-4,9
19,1,0,0,1,2021-03-21,Male,60,55-64,15
19,0,1,0,1,2021-03-21,Female,60,55-64,4
19,2,0,0,2,2021-03-18,Male,26,25-34,16
19,0,0,0,0,2021-03-21,Female,23,20-24,4
19,2,6,0,8,2021-03-17,Male,57,55-64,13
19,2,0,0,2,2021-03-18,Male,70,70-74,14
19,2,0,0,2,2021-03-21,Male,69,65-69,17
19,1,1,0,2,2021-03-21,Male,60,55-64,16
19,0,0,0,0,2021-03-17,Male,52,45-54,11
19,2,11,0,13,2021-03-19,Male,30,25-34,15
19,1,0,0,1,2021-03-18,Male,21,20-24,9
19,3,0,0,3,2021-03-17,Female,2,1-4,16
19,1,0,0,1,2021-03-21,Female,63,55-64,13
19,0,0,0,0,2021-03-21,Male,42,35-44,16
19,2,0,2,4,2021-03-26,Male,35,35-44,1
19,3,0,4,7,2021-03-20,Male,14,10-14,14
19,0,0,0,0,2021-03-26,Male,60,55-64,1
19,0,0,0,0,2021-03-17,Male,25,25-34,10
19,4,1,0,5,2021-03-26,Male,25,25-34,1
19,2,1,0,3,2021-03-18,Female,51,45-54,13
19,2,0,0,2,2021-03-19,Female,67,65-69,15
19,1,0,0,1,2021-03-19,Male,63,55-64,16
19,1,0,0,1,2021-03-17,Male,32,25-34,9
19,0,1,0,1,2021-03-17,Female,24,20-24,11
19,1,0,0,1,2021-03-21,Male,52,45-54,18
19,1,2,0,3,2021-03-18,Male,43,35-44,6
19,0,1,0,1,2021-03-17,Female,56,55-64,13
19,0,0,0,0,2021-03-18,Female,26,25-34,10
19,0,0,0,0,2021-03-21,Male,70,70-74,16
19,0,0,0,0,2021-03-17,Female,60,55-64,16
19,1,0,0,1,2021-03-17,Male,41,35-44,14
19,0,0,0,0,2021-03-17,Female,46,45-54,6
19,0,0,0,0,2021-03-17,Male,53,45-54,14
19,0,0,0,0,2021-03-17,Female,31,25-34,17
19,4,1,0,5,2021-03-17,Female,3,1-4,8
19,0,0,0,0,2021-03-17,Male,33,25-34,18
19,0,13,0,13,2021-03-20,Male,47,45-54,13
19,0,2,0,2,2021-03-17,Female,66,65-69,17
19,2,15,0,17,2021-03-18,Female,10,10-14,11
19,1,0,0,1,2021-03-19,Female,68,65-69,14
19,0,0,0,0,2021-03-17,Female,69,65-69,15
19,2,0,0,2,2021-03-17,Male,46,45-54,19
19,0,1,0,1,2021-03-22,Female,60,55-64,6
19,0,0,0,0,2021-03-19,Female,66,65-69,17
19,3,2,0,5,2021-03-17,Male,4,1-4,9
19,1,0,0,1,2021-03-21,Female,29,25-34,12
19,0,0,0,0,2021-03-22,Male,30,25-34,14
19,0,0,0,0,2021-03-21,Male,18,15-19,6
19,0,0,0,0,2021-03-17,Male,39,35-44,11
19,1,7,0,8,2021-03-18,Male,68,65-69,16
19,2,0,0,2,2021-03-21,Male,10,10-14,12
19,2,1,0,3,2021-03-22,Female,55,55-64,6
19,3,0,0,3,2021-03-21,Female,16,15-19,10
19,1,0,0,1,2021-03-17,Male,79,75-79,11
19,1,0,0,1,2021-03-22,Female,46,45-54,8
19,2,0,0,2,2021-03-21,Male,68,65-69,9
19,0,0,0,0,2021-03-21,Male,47,45-54,10
19,1,0,0,1,2021-03-18,Male,74,70-74,11
19,4,0,13,17,2021-03-23,Male,7,5-9,4
19,0,0,0,0,2021-03-23,Female,30,25-34,6
19,5,3,0,8,2021-03-21,Male,19,15-19,13
19,2,2,0,4,2021-03-20,Male,76,75-79,11
19,1,2,0,3,2021-03-19,Male,32,25-34,14
19,3,0,0,3,2021-03-21,Male,13,10-14,10
19,0,0,0,0,2021-03-17,Male,58,55-64,16
19,2,0,0,2,2021-03-18,Female,29,25-34,8
19,0,3,0,3,2021-03-17,Male,42,35-44,15
19,5,12,0,17,2021-03-19,Female,2,1-4,3
19,0,0,0,0,2021-03-17,Male,21,20-24,8
19,3,1,0,4,2021-03-21,Male,12,10-14,16
19,0,0,0,0,2021-03-19,Male,65,65-69,15
19,1,1,0,2,2021-03-19,Female,67,65-69,15
19,2,7,0,9,2021-03-17,Male,81,80-84,12
19,0,0,0,0,2021-03-21,Male,51,45-54,14
19,0,0,0,0,2021-03-17,Female,21,20-24,11
19,2,0,0,2,2021-03-21,Female,68,65-69,10
19,0,0,0,0,2021-03-17,Female,47,45-54,14
19,1,0,0,1,2021-03-21,Male,72,70-74,15
19,0,0,0,0,2021-03-24,Female,30,25-34,13
19,0,0,0,0,2021-03-17,Female,23,20-24,16
19,0,0,0,0,2021-03-19,Male,28,25-34,15
19,1,0,0,1,2021-03-17,Female,62,55-64,17
19,1,0,0,1,2021-03-22,Female,53,45-54,11
19,0,0,0,0,2021-03-20,Male,66,65-69,18
19,0,0,0,0,2021-03-18,Male,76,75-79,12
19,0,2,0,2,2021-03-19,Male,66,65-69,17
19,1,0,0,1,2021-03-21,Male,63,55-64,18
19,0,2,0,2,2021-03-22,Female,69,65-69,13
19,2,0,0,2,2021-03-21,Female,69,65-69,12
19,0,0,0,0,2021-03-18,Female,28,25-34,14
19,1,0,0,1,2021-03-21,Male,72,70-74,17
19,0,0,0,0,2021-03-18,Female,63,55-64,16
19,0,0,0,0,2021-03-17,Female,36,35-44,17
19,0,8,0,8,2021-03-20,Male,45,45-54,4
19,2,0,0,2,2021-03-21,Male,71,70-74,14
19,2,0,0,2,2021-03-19,Female,23,20-24,5
19,5,14,0,19,2021-03-20,Female,18,15-19,16
19,3,2,0,5,2021-03-18,Female,65,65-69,18
19,0,0,0,0,2021-03-17,Female,31,25-34,13
19,2,0,0,2,2021-03-17,Male,55,55-64,16
19,0,0,0,0,2021-03-21,Female,67,65-69,14
19,0,0,0,0,2021-03-17,Male,21,20-24,10
19,2,0,0,2,2021-03-21,Female,60,55-64,15
19,0,1,0,1,2021-03-17,Female,22,20-24,15
19,1,1,0,2,2021-03-18,Female,19,15-19,6
19,0,0,0,0,2021-03-19,Female,31,25-34,16
19,0,0,0,0,2021-03-17,Female,25,25-34,6
19,0,0,0,0,2021-03-18,Male,54,45-54,16
19,0,0,0,0,2021-03-18,Male,61,55-64,8
19,0,0,0,0,2021-03-17,Male,40,35-44,15
19,1,10,0,11,2021-03-17,Male,43,35-44,16
19,0,0,0,0,2021-03-19,Female,50,45-54,8
19,0,0,0,0,2021-03-21,Female,19,15-19,4
19,3,1,0,4,2021-03-19,Male,19,15-19,11
19,2,0,0,2,2021-03-20,Male,66,65-69,8
19,0,0,0,0,2021-03-17,Female,64,55-64,18
19,0,0,0,0,2021-03-17,Male,20,20-24,18
19,1,0,0,1,2021-03-17,Female,67,65-69,16
19,3,2,0,5,2021-03-17,Male,17,15-19,4
19,0,0,0,0,2021-03-20,Male,60,55-64,10
19,0,0,0,0,2021-03-20,Female,62,55-64,18
19,0,0,0,0,2021-03-17,Male,50,45-54,15
19,1,0,0,1,2021-03-17,Male,44,35-44,17
19,2,0,0,2,2021-03-21,Male,18,15-19,14
19,1,1,0,2,2021-03-21,Male,71,70-74,14
19,0,3,0,3,2021-03-18,Female,67,65-69,12
19,0,1,0,1,2021-03-19,Male,70,70-74,15
19,3,0,12,15,2021-03-22,Male,39,35-44,6
19,0,1,0,1,2021-03-17,Male,23,20-24,10
19,0,0,0,0,2021-03-17,Male,19,15-19,8
19,2,0,0,2,2021-03-20,Male,7,5-9,14
19,0,0,0,0,2021-03-21,Female,71,70-74,17
19,0,0,0,0,2021-03-17,Male,10,10-14,15
19,1,0,0,1,2021-03-18,Male,66,65-69,16
19,0,0,0,0,2021-03-17,Female,30,25-34,4
19,0,0,0,0,2021-03-20,Female,57,55-64,13
19,0,0,0,0,2021-03-26,Female,26,25-34,1
19,0,0,0,0,2021-03-21,Male,70,70-74,15
19,0,0,0,0,2021-03-18,Female,34,25-34,18
19,0,0,0,0,2021-03-17,Male,52,45-54,18
19,1,0,0,1,2021-03-17,Male,68,65-69,19
19,1,4,0,5,2021-03-26,Male,53,45-54,1
19,0,0,0,0,2021-03-18,Male,34,25-34,14
19,0,0,0,0,2021-03-19,Female,53,45-54,13
19,1,2,0,3,2021-03-17,Male,79,75-79,13
19,4,0,0,4,2021-03-21,Female,12,10-14,10
19,0,0,0,0,2021-03-17,Female,24,20-24,4
19,0,0,0,0,2021-03-18,Male,24,20-24,13
19,0,0,0,0,2021-03-18,Male,17,15-19,16
19,3,0,0,3,2021-03-21,Female,7,5-9,11
19,1,2,0,3,2021-03-26,Female,30,25-34,2
19,1,0,0,1,2021-03-17,Female,58,55-64,6
19,0,0,0,0,2021-03-19,Male,42,35-44,11
19,4,17,5,26,2021-03-20,Female,6,5-9,5
19,3,6,0,9,2021-03-17,Male,12,10-14,15
19,0,1,0,1,2021-03-19,Female,62,55-64,12
19,2,0,0,2,2021-03-21,Female,36,35-44,9
19,0,0,0,0,2021-03-17,Female,23,20-24,13
19,2,2,0,4,2021-03-17,Male,79,75-79,14
19,2,0,0,2,2021-03-17,Male,53,45-54,16
19,1,0,0,1,2021-03-21,Female,33,25-34,10
19,1,1,0,2,2021-03-18,Male,67,65-69,10
19,1,0,0,1,2021-03-22,Male,52,45-54,14
19,0,3,0,3,2021-03-17,Male,52,45-54,12
19,0,0,0,0,2021-03-22,Male,24,20-24,5
19,3,0,0,3,2021-03-18,Female,43,35-44,18
19,0,0,0,0,2021-03-21,Female,71,70-74,14
19,1,1,0,2,2021-03-18,Female,66,65-69,8
19,1,0,0,1,2021-03-18,Female,24,20-24,17
19,0,0,0,0,2021-03-19,Female,72,70-74,12
19,0,0,0,0,2021-03-18,Male,32,25-34,13
19,0,0,0,0,2021-03-17,Female,69,65-69,19
19,0,0,0,0,2021-03-19,Male,60,55-64,13
19,2,0,0,2,2021-03-17,Male,11,10-14,15
19,2,0,0,2,2021-03-17,Male,24,20-24,9
19,2,0,0,2,2021-03-21,Male,70,70-74,11
19,2,0,3,5,2021-03-18,Female,34,25-34,3
19,2,1,0,3,2021-03-23,Female,51,45-54,16
19,0,1,0,1,2021-03-17,Female,69,65-69,13
19,2,0,0,2,2021-03-17,Male,33,25-34,15
19,1,0,0,1,2021-03-17,Female,32,25-34,6
19,3,0,0,3,2021-03-18,Female,4,1-4,16
19,1,4,15,20,2021-03-18,Male,60,55-64,10
19,1,1,0,2,2021-03-18,Male,38,35-44,10
19,0,0,0,0,2021-03-19,Male,45,45-54,14
19,0,0,0,0,2021-03-17,Male,9,5-9,6
19,0,0,0,0,2021-03-22,Female,68,65-69,16
19,1,0,0,1,2021-03-18,Female,59,55-64,17
19,0,0,0,0,2021-03-19,Female,54,45-54,17
19,0,0,0,0,2021-03-17,Female,41,35-44,18
19,2,0,0,2,2021-03-18,Female,11,10-14,3
19,0,0,0,0,2021-03-17,Female,64,55-64,16
19,2,0,0,2,2021-03-21,Female,70,70-74,10
19,3,0,0,3,2021-03-17,Female,11,10-14,13
19,1,0,0,1,2021-03-22,Male,64,55-64,7
19,1,0,0,1,2021-03-20,Female,52,45-54,19
19,0,0,0,0,2021-03-17,Male,40,35-44,15
19,3,0,0,3,2021-03-17,Male,19,15-19,15
19,0,2,0,2,2021-03-17,Male,78,75-79,18
19,0,0,0,0,2021-03-17,Female,21,20-24,5
19,1,1,0,2,2021-03-17,Male,67,65-69,19
19,1,0,0,1,2021-03-18,Male,34,25-34,10
19,2,0,0,2,2021-03-17,Female,67,65-69,18
19,0,0,0,0,2021-03-18,Female,66,65-69,12
19,2,0,0,2,2021-03-22,Female,12,10-14,10
19,2,0,0,2,2021-03-18,Male,2,1-4,11
19,0,0,0,0,2021-03-22,Male,48,45-54,18
19,1,0,0,1,2021-03-21,Female,68,65-69,6
19,0,1,1,2,2021-03-19,Male,40,35-44,16
19,1,6,0,7,2021-03-18,Female,66,65-69,19
19,0,40,0,40,2021-03-17,Male,38,35-44,16
19,2,0,0,2,2021-03-18,Male,74,70-74,14
19,0,0,0,0,2021-03-17,Male,30,25-34,16
19,2,1,0,3,2021-03-20,Female,65,65-69,14
19,0,0,0,0,2021-03-17,Male,17,15-19,14
19,0,0,0,0,2021-03-17,Female,54,45-54,15
19,2,0,0,2,2021-03-21,Male,68,65-69,9
19,1,0,0,1,2021-03-18,Female,68,65-69,17
19,1,3,0,4,2021-03-17,Male,49,45-54,12
19,2,0,0,2,2021-03-18,Female,44,35-44,11
19,0,0,0,0,2021-03-17,Male,75,75-79,18
19,0,3,0,3,2021-03-20,Female,19,15-19,8
19,1,0,0,1,2021-03-21,Male,64,55-64,16
19,0,0,0,0,2021-03-18,Male,41,35-44,17
19,0,0,0,0,2021-03-17,Female,10,10-14,11
19,2,1,0,3,2021-03-21,Male,69,65-69,10
19,2,0,0,2,2021-03-22,Female,14,10-14,19
19,1,1,0,2,2021-03-19,Male,67,65-69,7
19,0,0,0,0,2021-03-20,Female,58,55-64,16
19,2,0,0,2,2021-03-18,Female,52,45-54,15
19,1,0,0,1,2021-03-18,Female,35,35-44,13
19,2,0,0,2,2021-03-21,Female,58,55-64,11
19,1,0,0,1,2021-03-17,Female,60,55-64,17
19,0,0,0,0,2021-03-17,Male,13,10-14,16
19,1,0,22,23,2021-03-21,Male,19,15-19,15
19,1,1,0,2,2021-03-19,Male,66,65-69,15
19,2,0,0,2,2021-03-17,Female,18,15-19,17
19,2,0,0,2,2021-03-20,Female,54,45-54,11
19,1,0,0,1,2021-03-21,Female,24,20-24,11
19,0,0,0,0,2021-03-17,Female,22,20-24,14
19,3,0,0,3,2021-03-24,Female,12,10-14,7
19,0,2,0,2,2021-03-19,Male,43,35-44,13
19,1,16,0,17,2021-03-19,Female,7,5-9,10
19,0,2,0,2,2021-03-19,Female,67,65-69,11
19,0,2,0,2,2021-03-20,Female,53,45-54,16
19,0,0,0,0,2021-03-17,Male,39,35-44,16
19,3,0,0,3,2021-03-17,Male,19,15-19,12
19,0,3,0,3,2021-03-17,Male,36,35-44,13
19,0,0,0,0,2021-03-26,Female,19,15-19,14
19,1,1,0,2,2021-03-17,Male,66,65-69,15
19,3,0,0,3,2021-03-19,Female,0,<1,10
19,0,0,0,0,2021-03-18,Female,25,25-34,6
19,0,0,0,0,2021-03-19,Female,66,65-69,15
19,2,0,0,2,2021-03-24,Male,42,35-44,6
19,0,0,0,0,2021-03-19,Male,52,45-54,10
19,0,0,0,0,2021-03-17,Male,52,45-54,18
19,0,1,0,1,2021-03-17,Female,31,25-34,15
19,1,0,0,1,2021-03-20,Male,57,55-64,13
19,1,1,0,2,2021-03-19,Male,66,65-69,13
19,0,0,0,0,2021-03-20,Female,58,55-64,6
19,1,0,0,1,2021-03-19,Female,76,75-79,11
19,2,2,0,4,2021-03-19,Female,6,5-9,15
19,1,0,0,1,2021-03-22,Male,17,15-19,5
19,0,0,0,0,2021-03-21,Male,6,5-9,3
19,1,0,0,1,2021-03-21,Female,29,25-34,11
19,2,0,0,2,2021-03-17,Male,11,10-14,14
19,0,3,0,3,2021-03-21,Female,71,70-74,6
19,0,1,0,1,2021-03-21,Female,69,65-69,16
19,0,0,0,0,2021-03-21,Male,28,25-34,16
19,0,0,0,0,2021-03-17,Male,73,70-74,15
19,1,0,0,1,2021-03-19,Female,21,20-24,8
19,4,2,0,6,2021-03-19,Female,9,5-9,10
19,2,0,16,18,2021-03-18,Male,8,5-9,5
19,0,1,0,1,2021-03-21,Male,62,55-64,13
19,2,0,0,2,2021-03-18,Male,69,65-69,16
19,0,0,0,0,2021-03-17,Male,45,45-54,15
19,0,5,0,5,2021-03-18,Female,30,25-34,12
19,1,0,0,1,2021-03-18,Male,55,55-64,13
19,2,0,0,2,2021-03-20,Male,16,15-19,17
19,1,0,0,1,2021-03-21,Female,69,65-69,13
19,2,1,0,3,2021-03-18,Female,63,55-64,12
19,2,0,0,2,2021-03-21,Female,73,70-74,8
19,1,0,0,1,2021-03-21,Female,68,65-69,16
19,1,0,0,1,2021-03-17,Male,55,55-64,19
19,0,3,0,3,2021-03-21,Female,62,55-64,18
19,0,0,0,0,2021-03-17,Female,1,1-4,9
19,0,0,0,0,2021-03-22,Male,55,55-64,9
19,2,0,0,2,2021-03-19,Female,61,55-64,18
19,2,1,0,3,2021-03-17,Male,1,1-4,6
19,1,0,0,1,2021-03-21,Male,53,45-54,18
19,4,1,0,5,2021-03-17,Female,46,45-54,10
19,0,0,0,0,2021-03-17,Male,65,65-69,16
19,1,1,0,2,2021-03-21,Female,59,55-64,15
19,0,0,0,0,2021-03-21,Female,68,65-69,14
19,0,0,0,0,2021-03-17,Female,11,10-14,14
19,2,0,0,2,2021-03-21,Male,13,10-14,13
19,1,0,0,1,2021-03-17,Female,63,55-64,17
19,0,0,0,0,2021-03-17,Female,52,45-54,17
19,0,0,0,0,2021-03-18,Female,27,25-34,12
19,0,2,0,2,2021-03-17,Female,65,65-69,15
19,2,0,0,2,2021-03-19,Female,53,45-54,15
19,2,0,0,2,2021-03-17,Female,48,45-54,16
19,1,0,0,1,2021-03-19,Male,67,65-69,15
19,0,0,0,0,2021-03-19,Female,67,65-69,5
19,0,0,0,0,2021-03-19,Female,31,25-34,6
19,1,0,0,1,2021-03-18,Male,71,70-74,18
19,0,0,0,0,2021-03-17,Female,44,35-44,18
19,0,4,0,4,2021-03-20,Male,22,20-24,11
19,1,0,0,1,2021-03-19,Male,72,70-74,14
19,0,1,0,1,2021-03-17,Female,64,55-64,10
19,2,1,0,3,2021-03-17,Male,22,20-24,16
19,1,0,0,1,2021-03-19,Female,67,65-69,11
19,1,2,0,3,2021-03-17,Male,58,55-64,18
19,0,31,0,31,2021-03-26,Male,52,45-54,1
19,1,0,0,1,2021-03-19,Male,67,65-69,13
19,3,0,0,3,2021-03-18,Male,2,1-4,15
19,1,0,0,1,2021-03-19,Male,40,35-44,15
19,0,0,0,0,2021-03-22,Male,50,45-54,14
19,0,1,0,1,2021-03-19,Male,67,65-69,7
19,0,0,0,0,2021-03-19,Male,57,55-64,10
19,0,0,0,0,2021-03-17,Female,21,20-24,4
19,2,0,0,2,2021-03-17,Female,25,25-34,18
19,2,0,0,2,2021-03-20,Male,30,25-34,17
19,0,0,0,0,2021-03-17,Male,34,25-34,13
19,2,2,0,4,2021-03-17,Female,12,10-14,14
19,1,2,0,3,2021-03-17,Female,69,65-69,16
19,1,0,0,1,2021-03-17,Male,66,65-69,11
19,0,2,0,2,2021-03-18,Male,67,65-69,15
19,0,0,0,0,2021-03-21,Female,49,45-54,10
19,2,0,0,2,2021-03-21,Female,68,65-69,11
19,2,0,0,2,2021-03-19,Female,5,5-9,17
19,0,0,0,0,2021-03-18,Female,66,65-69,18
19,0,0,0,0,2021-03-20,Female,50,45-54,11
19,2,0,0,2,2021-03-20,Male,42,35-44,16
19,0,12,2,14,2021-03-17,Female,77,75-79,9
19,4,0,0,4,2021-03-18,Female,1,1-4,15
19,1,0,0,1,2021-03-19,Male,68,65-69,16
19,4,0,0,4,2021-03-17,Male,9,5-9,19
19,5,0,0,5,2021-03-22,Male,23,20-24,6
19,2,0,0,2,2021-03-21,Male,43,35-44,6
19,1,0,0,1,2021-03-26,Male,30,25-34,1
19,2,100,100,202,2021-03-21,Female,45,45-54,3
19,1,2,0,3,2021-03-17,Female,2,1-4,14
19,3,0,0,3,2021-03-17,Female,28,25-34,13
19,2,0,0,2,2021-03-17,Male,52,45-54,14
19,1,0,0,1,2021-03-18,Female,68,65-69,11
19,2,2,0,4,2021-03-21,Male,61,55-64,15
19,1,3,1,5,2021-03-19,Female,62,55-64,15
19,0,1,0,1,2021-03-26,Male,62,55-64,1
19,1,1,0,2,2021-03-17,Male,65,65-69,17
19,1,10,0,11,2021-03-19,Female,39,35-44,13
19,3,3,0,6,2021-03-20,Male,53,45-54,18
19,0,0,0,0,2021-03-17,Male,51,45-54,13
19,1,0,0,1,2021-03-22,Female,27,25-34,5
19,1,10,0,11,2021-03-18,Male,54,45-54,14
19,3,0,0,3,2021-03-18,Male,11,10-14,5
19,0,0,0,0,2021-03-17,Female,60,55-64,13
19,1,0,0,1,2021-03-21,Female,16,15-19,11
19,1,2,0,3,2021-03-18,Female,56,55-64,18
19,1,0,0,1,2021-03-17,Male,32,25-34,15
19,2,10,0,12,2021-03-17,Female,7,5-9,4
19,1,0,0,1,2021-03-17,Female,49,45-54,15
19,4,0,0,4,2021-03-17,Female,42,35-44,9
19,0,0,0,0,2021-03-20,Male,66,65-69,12
19,0,0,0,0,2021-03-21,Male,55,55-64,10
19,0,0,0,0,2021-03-17,Male,41,35-44,16
19,2,0,3,5,2021-03-17,Male,59,55-64,15
19,0,7,0,7,2021-03-17,Male,42,35-44,19
19,0,0,0,0,2021-03-19,Male,67,65-69,18
19,1,0,0,1,2021-03-17,Female,34,25-34,15
19,1,1,0,2,2021-03-18,Male,63,55-64,14
19,0,0,0,0,2021-03-22,Female,69,65-69,15
19,2,0,0,2,2021-03-17,Male,51,45-54,10
19,4,0,0,4,2021-03-17,Male,3,1-4,16
19,0,0,0,0,2021-03-18,Male,55,55-64,14
19,0,0,0,0,2021-03-18,Male,58,55-64,17
19,1,1,0,2,2021-03-19,Male,47,45-54,14
19,3,0,0,3,2021-03-17,Male,10,10-14,5
19,1,2,0,3,2021-03-18,Female,39,35-44,7
19,1,0,0,1,2021-03-17,Male,62,55-64,19
19,0,0,2,2,2021-03-17,Female,23,20-24,8
19,0,4,0,4,2021-03-17,Female,67,65-69,19
19,2,2,0,4,2021-03-22,Male,58,55-64,8
19,3,19,0,22,2021-03-20,Male,13,10-14,18
19,3,0,0,3,2021-03-19,Female,38,35-44,14
19,2,0,4,6,2021-03-19,Male,77,75-79,13
19,0,0,0,0,2021-03-17,Female,43,35-44,15
19,1,0,0,1,2021-03-18,Female,22,20-24,6
19,0,0,0,0,2021-03-20,Female,18,15-19,14
19,0,1,0,1,2021-03-17,Male,47,45-54,17
19,0,0,0,0,2021-03-20,Male,67,65-69,14
19,4,0,0,4,2021-03-19,Female,18,15-19,9
19,2,1,0,3,2021-03-19,Female,66,65-69,13
19,0,0,0,0,2021-03-21,Female,15,15-19,7
19,0,0,0,0,2021-03-17,Male,27,25-34,15
19,0,1,0,1,2021-03-17,Male,48,45-54,16
19,0,0,0,0,2021-03-18,Male,52,45-54,16
19,2,0,0,2,2021-03-18,Male,20,20-24,12
19,0,1,0,1,2021-03-22,Male,29,25-34,5
19,4,2,0,6,2021-03-17,Female,1,1-4,10
19,2,0,0,2,2021-03-17,Female,14,10-14,12
19,2,0,0,2,2021-03-21,Male,62,55-64,14
19,0,5,0,5,2021-03-18,Female,31,25-34,5
19,2,0,0,2,2021-03-17,Male,12,10-14,18
19,2,0,0,2,2021-03-21,Male,71,70-74,3
19,2,0,0,2,2021-03-20,Female,63,55-64,15
19,1,0,0,1,2021-03-17,Male,45,45-54,10
19,0,0,62,62,2021-03-21,Male,43,35-44,18
19,2,2,0,4,2021-03-21,Female,64,55-64,19
19,0,1,0,1,2021-03-22,Male,54,45-54,11
19,0,1,0,1,2021-03-18,Male,77,75-79,9
19,0,0,0,0,2021-03-19,Female,54,45-54,14
19,1,0,0,1,2021-03-17,Female,33,25-34,13
19,2,0,0,2,2021-03-20,Male,6,5-9,12
19,2,16,0,18,2021-03-17,Female,10,10-14,15
19,1,0,0,1,2021-03-17,Female,51,45-54,15
19,1,0,0,1,2021-03-17,Female,22,20-24,11
19,2,0,0,2,2021-03-17,Male,57,55-64,15
19,0,2,0,2,2021-03-17,Female,43,35-44,6
19,0,0,0,0,2021-03-19,Female,59,55-64,14
19,1,2,0,3,2021-03-23,Female,54,45-54,8
19,1,0,0,1,2021-03-19,Female,34,25-34,8
19,4,2,0,6,2021-03-17,Female,5,5-9,10
19,0,0,3,3,2021-03-17,Female,36,35-44,4
19,2,0,0,2,2021-03-21,Male,71,70-74,9
19,1,0,0,1,2021-03-21,Male,61,55-64,18
19,0,0,0,0,2021-03-19,Male,66,65-69,18
19,1,0,0,1,2021-03-20,Female,56,55-64,10
19,0,0,0,0,2021-03-19,Male,34,25-34,15
19,1,0,0,1,2021-03-17,Female,59,55-64,17
19,2,0,0,2,2021-03-19,Male,73,70-74,14
19,2,0,0,2,2021-03-17,Male,34,25-34,13
19,0,0,0,0,2021-03-17,Female,37,35-44,13
19,0,4,0,4,2021-03-19,Male,47,45-54,6
19,1,2,0,3,2021-03-22,Male,63,55-64,11
19,1,1,0,2,2021-03-20,Female,47,45-54,10
19,0,1,0,1,2021-03-17,Female,22,20-24,10
19,0,2,0,2,2021-03-19,Male,63,55-64,14
19,0,3,0,3,2021-03-21,Male,25,25-34,11
19,0,0,0,0,2021-03-21,Male,38,35-44,8
19,0,1,0,1,2021-03-21,Female,69,65-69,14
19,2,0,0,2,2021-03-17,Female,65,65-69,14
19,0,0,0,0,2021-03-20,Male,54,45-54,16
19,0,2,0,2,2021-03-21,Female,35,35-44,11
19,0,1,0,1,2021-03-17,Male,56,55-64,16
19,1,2,0,3,2021-03-18,Female,56,55-64,17
19,0,4,0,4,2021-03-20,Female,67,65-69,18
19,0,0,0,0,2021-03-19,Male,43,35-44,2
19,2,0,0,2,2021-03-20,Male,42,35-44,10
19,1,2,0,3,2021-03-21,Male,72,70-74,13
19,1,2,0,3,2021-03-18,Male,66,65-69,13
19,1,0,0,1,2021-03-18,Female,24,20-24,5
19,0,0,0,0,2021-03-17,Male,31,25-34,12
19,0,0,0,0,2021-03-21,Male,71,70-74,14
19,0,0,0,0,2021-03-21,Female,71,70-74,14
19,0,0,0,0,2021-03-17,Male,67,65-69,19
19,0,0,0,0,2021-03-17,Female,26,25-34,14
19,0,0,0,0,2021-03-20,Female,55,55-64,10
19,0,0,0,0,2021-03-17,Female,74,70-74,12
19,2,0,0,2,2021-03-17,Male,80,80-84,14
19,0,0,0,0,2021-03-17,Female,66,65-69,13
19,1,0,0,1,2021-03-21,Female,53,45-54,17
19,1,0,0,1,2021-03-21,Male,63,55-64,17
19,0,0,0,0,2021-03-17,Male,38,35-44,18
19,1,0,0,1,2021-03-18,Female,28,25-34,17
19,0,0,0,0,2021-03-26,Male,26,25-34,1
19,4,0,0,4,2021-03-17,Female,47,45-54,7
19,0,0,0,0,2021-03-19,Female,11,10-14,15
19,3,0,0,3,2021-03-21,Female,29,25-34,19
19,3,12,0,15,2021-03-26,Male,2,1-4,1
19,2,0,0,2,2021-03-19,Male,17,15-19,10
19,1,0,0,1,2021-03-17,Male,35,35-44,18
19,0,0,0,0,2021-03-21,Female,72,70-74,17
19,0,0,0,0,2021-03-18,Female,26,25-34,11
19,3,0,0,3,2021-03-19,Male,33,25-34,13
19,3,2,0,5,2021-03-20,Male,41,35-44,16
19,0,0,0,0,2021-03-17,Female,63,55-64,6
19,1,0,0,1,2021-03-17,Male,32,25-34,14
19,0,3,0,3,2021-03-17,Female,43,35-44,16
19,0,1,0,1,2021-03-24,Male,58,55-64,13
19,1,0,0,1,2021-03-19,Male,66,65-69,14
19,3,2,0,5,2021-03-21,Male,5,5-9,16
19,1,0,1,2,2021-03-26,Male,20,20-24,1
19,3,0,0,3,2021-03-17,Female,36,35-44,18
19,1,0,0,1,2021-03-17,Female,59,55-64,17
19,1,0,0,1,2021-03-17,Male,66,65-69,17
19,0,1,0,1,2021-03-18,Male,28,25-34,5
19,3,0,0,3,2021-03-18,Male,49,45-54,10
19,0,0,0,0,2021-03-22,Female,58,55-64,15
19,0,0,0,0,2021-03-17,Male,76,75-79,13
19,0,10,0,10,2021-03-18,Female,49,45-54,5
19,0,0,0,0,2021-03-20,Male,52,45-54,17
19,1,4,0,5,2021-03-17,Male,80,80-84,2
19,1,2,1,4,2021-03-17,Female,76,75-79,11
19,0,0,0,0,2021-03-21,Male,25,25-34,8
19,2,0,0,2,2021-03-20,Male,65,65-69,15
19,3,0,0,3,2021-03-21,Male,16,15-19,9
19,3,0,0,3,2021-03-20,Female,15,15-19,13
19,0,0,0,0,2021-03-19,Male,75,75-79,14
19,0,0,0,0,2021-03-17,Male,28,25-34,6
19,0,10,0,10,2021-03-17,Male,36,35-44,5
19,0,0,0,0,2021-03-17,Female,66,65-69,18
19,0,1,0,1,2021-03-21,Female,54,45-54,14
19,1,0,0,1,2021-03-17,Female,46,45-54,16
19,1,0,0,1,2021-03-21,Male,70,70-74,13
19,1,0,0,1,2021-03-18,Male,53,45-54,14
19,5,0,0,5,2021-03-20,Male,15,15-19,8
19,0,0,0,0,2021-03-20,Female,63,55-64,16
19,0,0,0,0,2021-03-19,Female,23,20-24,10
19,1,0,0,1,2021-03-21,Female,70,70-74,18
19,1,1,0,2,2021-03-17,Female,54,45-54,6
19,2,0,0,2,2021-03-21,Female,63,55-64,10
19,1,0,0,1,2021-03-17,Male,74,70-74,11
19,1,0,0,1,2021-03-18,Male,32,25-34,8
19,0,0,0,0,2021-03-20,Male,27,25-34,18
19,1,0,0,1,2021-03-17,Male,28,25-34,19
19,1,1,0,2,2021-03-18,Female,31,25-34,13
19,1,0,0,1,2021-03-18,Female,65,65-69,14
19,1,0,0,1,2021-03-18,Male,42,35-44,16
19,0,0,0,0,2021-03-21,Male,71,70-74,17
19,1,0,0,1,2021-03-20,Male,40,35-44,8
19,0,1,0,1,2021-03-17,Female,68,65-69,19
19,0,0,0,0,2021-03-21,Female,72,70-74,16
19,0,0,0,0,2021-03-18,Male,60,55-64,15
19,2,0,0,2,2021-03-17,Female,27,25-34,13
19,3,0,6,9,2021-03-17,Male,5,5-9,14
19,0,0,0,0,2021-03-17,Female,48,45-54,15
19,1,0,0,1,2021-03-21,Male,69,65-69,18
19,2,0,0,2,2021-03-17,Female,67,65-69,14
19,0,0,0,0,2021-03-17,Female,40,35-44,6
19,1,2,0,3,2021-03-18,Male,68,65-69,17
19,1,0,0,1,2021-03-18,Male,62,55-64,12
19,3,2,0,5,2021-03-23,Male,18,15-19,7
19,3,0,4,7,2021-03-17,Male,19,15-19,6
19,0,0,0,0,2021-03-20,Male,34,25-34,15
19,3,0,12,15,2021-03-19,Male,19,15-19,12
19,0,0,0,0,2021-03-17,Female,78,75-79,16
19,0,0,0,0,2021-03-20,Female,56,55-64,18
19,3,0,0,3,2021-03-17,Female,53,45-54,14
19,1,0,0,1,2021-03-17,Male,66,65-69,14
19,1,0,0,1,2021-03-20,Male,55,55-64,13
19,3,0,0,3,2021-03-18,Male,6,5-9,13
19,1,0,0,1,2021-03-19,Male,42,35-44,12
19,0,0,0,0,2021-03-21,Female,53,45-54,11
19,0,0,0,0,2021-03-22,Female,55,55-64,11
19,0,1,0,1,2021-03-17,Female,62,55-64,19
19,3,0,0,3,2021-03-19,Female,3,1-4,15
19,3,0,0,3,2021-03-18,Male,9,5-9,11
19,4,0,0,4,2021-03-17,Female,55,55-64,14
19,2,0,0,2,2021-03-17,Female,56,55-64,15
19,1,2,0,3,2021-03-17,Female,60,55-64,18
19,2,0,0,2,2021-03-18,Male,60,55-64,14
19,0,0,0,0,2021-03-17,Male,70,70-74,18
19,2,0,0,2,2021-03-17,Male,48,45-54,10
19,0,3,0,3,2021-03-18,Female,54,45-54,14
19,1,3,0,4,2021-03-21,Male,61,55-64,11
19,2,0,0,2,2021-03-18,Male,66,65-69,6
19,1,0,0,1,2021-03-20,Female,52,45-54,17
19,1,0,0,1,2021-03-21,Male,69,65-69,13
19,3,2,0,5,2021-03-21,Male,71,70-74,14
19,2,2,0,4,2021-03-17,Male,78,75-79,14
19,2,1,0,3,2021-03-20,Female,67,65-69,9
19,2,0,0,2,2021-03-20,Male,52,45-54,12
19,0,0,0,0,2021-03-18,Male,52,45-54,17
19,3,0,0,3,2021-03-19,Female,19,15-19,15
19,0,0,0,0,2021-03-17,Female,42,35-44,5
19,1,0,0,1,2021-03-18,Female,65,65-69,18
19,10,0,0,10,2021-03-20,Female,19,15-19,12
19,2,0,0,2,2021-03-19,Female,37,35-44,16
19,0,3,0,3,2021-03-21,Male,58,55-64,11
19,1,0,0,1,2021-03-18,Female,28,25-34,4
19,0,0,6,6,2021-03-17,Female,48,45-54,11
19,2,10,0,12,2021-03-17,Male,14,10-14,6
19,0,1,0,1,2021-03-18,Female,59,55-64,5
19,1,0,0,1,2021-03-18,Male,60,55-64,12
19,0,0,0,0,2021-03-17,Female,22,20-24,16
19,0,0,0,0,2021-03-18,Male,64,55-64,15
19,0,0,0,0,2021-03-22,Male,36,35-44,12
19,0,0,0,0,2021-03-18,Male,37,35-44,14
19,3,0,0,3,2021-03-19,Female,4,1-4,12
19,1,0,0,1,2021-03-17,Male,19,15-19,6
19,2,0,0,2,2021-03-18,Male,64,55-64,13
19,0,0,0,0,2021-03-18,Male,74,70-74,11
19,2,1,0,3,2021-03-20,Female,52,45-54,13
19,2,0,0,2,2021-03-17,Female,73,70-74,11
19,2,0,0,2,2021-03-21,Male,11,10-14,11
19,1,0,0,1,2021-03-18,Female,18,15-19,15
19,0,4,0,4,2021-03-17,Male,61,55-64,15
19,1,30,0,31,2021-03-20,Female,55,55-64,12
19,2,0,0,2,2021-03-18,Male,19,15-19,6
19,1,0,0,1,2021-03-17,Male,50,45-54,6
19,0,0,0,0,2021-03-18,Male,53,45-54,10
19,1,0,0,1,2021-03-22,Male,52,45-54,5
19,1,0,0,1,2021-03-18,Male,54,45-54,15
19,2,1,0,3,2021-03-17,Female,65,65-69,17
19,0,0,0,0,2021-03-17,Male,79,75-79,9
19,1,0,0,1,2021-03-22,Male,62,55-64,16
19,3,0,3,6,2021-03-20,Male,18,15-19,16
19,4,0,0,4,2021-03-18,Male,15,15-19,8
19,0,0,0,0,2021-03-17,Male,52,45-54,14
19,0,0,0,0,2021-03-21,Female,61,55-64,15
19,3,0,0,3,2021-03-17,Male,12,10-14,18
19,1,0,0,1,2021-03-18,Female,27,25-34,6
19,2,0,0,2,2021-03-18,Male,51,45-54,3
19,1,2,0,3,2021-03-18,Female,4,1-4,4
19,0,0,0,0,2021-03-20,Female,66,65-69,17
19,0,0,0,0,2021-03-18,Male,37,35-44,15
19,0,10,0,10,2021-03-17,Female,24,20-24,10
19,0,2,0,2,2021-03-22,Female,68,65-69,18
19,0,0,0,0,2021-03-19,Female,43,35-44,10
19,1,0,0,1,2021-03-17,Female,40,35-44,14
19,0,0,0,0,2021-03-17,Female,68,65-69,16
19,1,1,0,2,2021-03-17,Male,38,35-44,10
19,1,0,0,1,2021-03-19,Female,37,35-44,11
19,0,0,0,0,2021-03-21,Female,46,45-54,9
19,1,0,0,1,2021-03-17,Female,34,25-34,15
19,0,0,60,60,2021-03-21,Male,66,65-69,13
19,1,0,0,1,2021-03-20,Female,52,45-54,18
19,0,0,0,0,2021-03-18,Female,24,20-24,16
19,3,0,0,3,2021-03-20,Female,55,55-64,10
19,0,0,12,12,2021-03-19,Female,15,15-19,14
19,0,0,0,0,2021-03-19,Female,44,35-44,14
19,2,0,0,2,2021-03-18,Female,63,55-64,16
19,0,8,0,8,2021-03-20,Female,51,45-54,12
19,0,6,0,6,2021-03-19,Male,42,35-44,3
19,0,0,0,0,2021-03-19,Female,67,65-69,16
19,1,0,0,1,2021-03-18,Female,73,70-74,14
19,1,0,0,1,2021-03-17,Male,36,35-44,10
19,0,1,1,2,2021-03-26,Female,35,35-44,1
19,0,0,0,0,2021-03-17,Male,58,55-64,18
19,1,0,0,1,2021-03-17,Male,79,75-79,14
19,2,18,0,20,2021-03-18,Female,8,5-9,14
19,1,1,0,2,2021-03-19,Male,43,35-44,11
19,2,2,0,4,2021-03-21,Female,63,55-64,13
19,2,0,0,2,2021-03-19,Male,68,65-69,16
19,1,2,60,63,2021-03-18,Female,55,55-64,16
19,1,0,0,1,2021-03-21,Female,61,55-64,10
19,0,0,0,0,2021-03-17,Male,23,20-24,9
19,1,0,0,1,2021-03-17,Female,61,55-64,14
19,1,2,0,3,2021-03-19,Male,64,55-64,19
19,2,0,0,2,2021-03-17,Male,73,70-74,16
19,1,0,0,1,2021-03-21,Female,65,65-69,15
19,2,0,0,2,2021-03-19,Male,54,45-54,14
19,0,0,0,0,2021-03-17,Female,31,25-34,9
19,0,0,0,0,2021-03-17,Male,12,10-14,4
19,0,3,0,3,2021-03-17,Female,72,70-74,17
19,2,0,0,2,2021-03-20,Female,72,70-74,15
19,1,2,0,3,2021-03-17,Female,49,45-54,18
19,3,0,0,3,2021-03-17,Female,59,55-64,16
19,0,0,0,0,2021-03-17,Female,34,25-34,14
19,1,0,0,1,2021-03-17,Male,74,70-74,10
19,2,0,0,2,2021-03-21,Female,3,1-4,10
19,1,0,0,1,2021-03-22,Female,51,45-54,12
19,0,0,0,0,2021-03-17,Female,41,35-44,18
19,0,0,0,0,2021-03-17,Male,22,20-24,18
19,0,0,0,0,2021-03-21,Male,55,55-64,18
19,0,0,0,0,2021-03-18,Male,23,20-24,13
19,0,3,0,3,2021-03-18,Female,36,35-44,17
19,3,6,0,9,2021-03-20,Female,8,5-9,15
19,1,0,0,1,2021-03-22,Male,55,55-64,15
19,2,1,0,3,2021-03-21,Male,62,55-64,16
19,5,0,0,5,2021-03-17,Male,16,15-19,16
19,1,5,0,6,2021-03-19,Female,57,55-64,14
19,1,0,0,1,2021-03-19,Female,67,65-69,14
19,0,0,0,0,2021-03-17,Female,13,10-14,12
19,0,0,0,0,2021-03-18,Female,85,85+,8
19,0,0,0,0,2021-03-21,Female,70,70-74,17
19,1,0,0,1,2021-03-17,Male,74,70-74,19
19,1,0,0,1,2021-03-17,Female,66,65-69,14
19,3,0,0,3,2021-03-26,Male,13,10-14,6
19,3,1,0,4,2021-03-18,Male,14,10-14,17
19,0,2,0,2,2021-03-21,Male,73,70-74,16
19,1,0,0,1,2021-03-17,Female,40,35-44,4
19,0,0,0,0,2021-03-18,Female,38,35-44,16
19,3,0,0,3,2021-03-19,Female,11,10-14,10
19,1,0,0,1,2021-03-22,Female,61,55-64,16
19,1,2,0,3,2021-03-19,Female,66,65-69,12
19,1,0,0,1,2021-03-20,Male,67,65-69,15
19,3,0,0,3,2021-03-17,Female,10,10-14,16
19,0,0,0,0,2021-03-19,Female,51,45-54,8
19,0,5,0,5,2021-03-18,Male,22,20-24,14
19,3,0,0,3,2021-03-18,Female,3,1-4,13
19,0,0,17,17,2021-03-26,Male,38,35-44,1
19,1,2,0,3,2021-03-18,Male,66,65-69,18
19,1,0,0,1,2021-03-19,Female,29,25-34,14
19,0,0,0,0,2021-03-17,Male,32,25-34,13
19,1,2,0,3,2021-03-18,Female,25,25-34,11
19,3,0,0,3,2021-03-21,Female,65,65-69,18
19,2,0,0,2,2021-03-20,Female,67,65-69,16
19,0,3,0,3,2021-03-22,Female,75,75-79,17
19,0,0,0,0,2021-03-19,Female,45,45-54,11
19,2,0,0,2,2021-03-19,Male,32,25-34,15
19,3,0,0,3,2021-03-17,Male,18,15-19,16
19,1,0,0,1,2021-03-17,Male,34,25-34,12
19,2,0,0,2,2021-03-22,Female,23,20-24,15
19,0,0,0,0,2021-03-18,Male,18,15-19,16
19,0,0,0,0,2021-03-22,Female,64,55-64,13
19,1,1,0,2,2021-03-17,Male,66,65-69,17
19,1,0,0,1,2021-03-21,Male,23,20-24,5
19,1,0,0,1,2021-03-18,Male,56,55-64,8
19,3,0,0,3,2021-03-20,Female,12,10-14,19
19,1,0,0,1,2021-03-17,Male,27,25-34,6
19,0,0,0,0,2021-03-17,Female,66,65-69,13
19,1,7,0,8,2021-03-17,Male,76,75-79,14
19,0,0,0,0,2021-03-17,Male,21,20-24,8
19,1,0,0,1,2021-03-20,Male,59,55-64,13
19,1,0,0,1,2021-03-18,Male,62,55-64,18
19,0,0,0,0,2021-03-26,Male,29,25-34,1
19,2,0,0,2,2021-03-18,Male,66,65-69,16
19,0,0,0,0,2021-03-19,Female,38,35-44,7
19,2,2,1,5,2021-03-23,Female,22,20-24,5
19,0,0,0,0,2021-03-22,Male,38,35-44,13
19,1,0,0,1,2021-03-19,Female,66,65-69,12
19,2,0,0,2,2021-03-26,Male,18,15-19,1
19,0,0,0,0,2021-03-18,Male,30,25-34,7
19,0,0,0,0,2021-03-18,Male,28,25-34,12
19,0,1,0,1,2021-03-21,Female,62,55-64,13
19,1,3,0,4,2021-03-17,Female,30,25-34,12
19,1,3,0,4,2021-03-21,Female,53,45-54,16
19,0,0,0,0,2021-03-17,Female,25,25-34,7
19,1,0,0,1,2021-03-17,Male,75,75-79,6
19,1,0,0,1,2021-03-20,Female,49,45-54,17
19,3,1,0,4,2021-03-18,Male,20,20-24,6
19,0,0,0,0,2021-03-19,Female,10,10-14,9
19,2,0,0,2,2021-03-17,Female,20,20-24,4
19,1,2,0,3,2021-03-17,Male,30,25-34,8
19,0,0,0,0,2021-03-18,Female,24,20-24,18
19,0,1,0,1,2021-03-17,Female,22,20-24,16
19,1,0,0,1,2021-03-17,Male,40,35-44,16
19,0,0,0,0,2021-03-17,Male,34,25-34,13
19,1,0,0,1,2021-03-21,Male,62,55-64,15
19,0,0,0,0,2021-03-17,Female,68,65-69,14
19,1,0,0,1,2021-03-17,Male,68,65-69,17
19,2,0,0,2,2021-03-19,Male,13,10-14,19
19,1,0,0,1,2021-03-22,Female,24,20-24,12
19,4,2,0,6,2021-03-20,Female,12,10-14,13
19,1,0,0,1,2021-03-21,Male,71,70-74,14
19,2,0,0,2,2021-03-20,Female,60,55-64,15
19,0,7,0,7,2021-03-21,Male,46,45-54,11
19,1,0,0,1,2021-03-19,Male,64,55-64,13
19,0,0,0,0,2021-03-17,Female,19,15-19,13
19,1,0,0,1,2021-03-18,Male,1,1-4,9
19,1,4,0,5,2021-03-17,Female,63,55-64,16
19,2,2,0,4,2021-03-21,Female,67,65-69,8
19,3,0,0,3,2021-03-17,Female,23,20-24,5
19,0,0,0,0,2021-03-20,Male,46,45-54,13
19,0,20,0,20,2021-03-20,Female,34,25-34,15
19,3,1,0,4,2021-03-18,Female,33,25-34,16
19,1,0,9,10,2021-03-22,Male,58,55-64,17
19,2,0,0,2,2021-03-17,Male,64,55-64,18
19,1,0,0,1,2021-03-18,Female,63,55-64,17
19,1,0,0,1,2021-03-22,Female,64,55-64,16
19,3,0,0,3,2021-03-19,Female,43,35-44,15
19,2,1,0,3,2021-03-21,Female,69,65-69,17
19,1,0,0,1,2021-03-17,Male,53,45-54,15
19,3,0,0,3,2021-03-17,Male,50,45-54,17
19,0,0,0,0,2021-03-21,Female,63,55-64,11
19,1,3,0,4,2021-03-17,Female,67,65-69,17
19,0,0,0,0,2021-03-21,Male,16,15-19,18
19,2,0,0,2,2021-03-18,Male,59,55-64,16
19,3,0,0,3,2021-03-19,Male,13,10-14,10
19,0,0,0,0,2021-03-17,Male,33,25-34,16
19,3,0,0,3,2021-03-17,Male,9,5-9,7
19,0,0,0,0,2021-03-21,Male,42,35-44,13
19,1,0,0,1,2021-03-19,Female,66,65-69,13
19,1,4,0,5,2021-03-17,Male,68,65-69,19
19,0,0,0,0,2021-03-18,Male,10,10-14,16
19,2,0,0,2,2021-03-18,Male,77,75-79,12
19,1,0,0,1,2021-03-18,Female,59,55-64,18
19,0,0,0,0,2021-03-18,Female,25,25-34,10
19,6,0,0,6,2021-03-17,Female,16,15-19,18
19,1,0,0,1,2021-03-20,Female,26,25-34,9
19,1,0,0,1,2021-03-20,Male,67,65-69,7
19,1,0,0,1,2021-03-18,Female,66,65-69,8
19,0,0,0,0,2021-03-21,Female,68,65-69,12
19,2,0,0,2,2021-03-20,Male,10,10-14,15
19,2,0,0,2,2021-03-18,Male,24,20-24,11
19,0,0,0,0,2021-03-17,Male,10,10-14,14
19,2,0,0,2,2021-03-19,Female,19,15-19,13
19,2,1,0,3,2021-03-17,Male,51,45-54,15
19,1,0,0,1,2021-03-22,Male,47,45-54,8
19,0,4,0,4,2021-03-17,Male,50,45-54,15
19,0,0,0,0,2021-03-17,Female,34,25-34,17
19,0,0,0,0,2021-03-24,Male,30,25-34,8
19,4,0,0,4,2021-03-17,Female,19,15-19,6
19,0,0,0,0,2021-03-18,Male,46,45-54,15
19,0,5,0,5,2021-03-18,Female,66,65-69,15
19,0,0,0,0,2021-03-17,Female,76,75-79,9
19,1,0,0,1,2021-03-21,Male,72,70-74,4
19,5,0,0,5,2021-03-17,Female,20,20-24,10
19,0,1,0,1,2021-03-20,Female,53,45-54,15
19,0,0,0,0,2021-03-17,Female,28,25-34,6
19,2,0,0,2,2021-03-18,Male,26,25-34,13
19,2,2,0,4,2021-03-26,Male,26,25-34,1
19,0,5,0,5,2021-03-20,Male,43,35-44,6
19,0,0,0,0,2021-03-17,Male,16,15-19,10
19,0,2,0,2,2021-03-17,Female,67,65-69,15
19,0,0,0,0,2021-03-17,Female,67,65-69,11
19,0,0,0,0,2021-03-18,Female,69,65-69,17
19,0,0,0,0,2021-03-21,Male,25,25-34,5
19,3,1,0,4,2021-03-21,Female,28,25-34,7
19,1,9,0,10,2021-03-18,Female,31,25-34,8
19,5,2,0,7,2021-03-18,Male,11,10-14,16
19,2,2,0,4,2021-03-17,Female,55,55-64,15
19,0,2,1,3,2021-03-19,Female,27,25-34,12
19,2,0,0,2,2021-03-17,Male,48,45-54,18
19,0,0,0,0,2021-03-17,Female,53,45-54,18
19,5,0,0,5,2021-03-17,Female,21,20-24,7
19,0,3,0,3,2021-03-20,Female,38,35-44,13
19,1,0,0,1,2021-03-22,Male,54,45-54,12
19,0,0,0,0,2021-03-17,Female,40,35-44,6
19,0,1,0,1,2021-03-17,Male,49,45-54,15
19,1,0,0,1,2021-03-17,Male,64,55-64,14
19,0,0,0,0,2021-03-26,Male,62,55-64,1
19,0,0,0,0,2021-03-17,Male,27,25-34,10
19,1,0,0,1,2021-03-17,Male,36,35-44,15
19,1,0,0,1,2021-03-20,Male,49,45-54,16
19,0,1,0,1,2021-03-26,Male,53,45-54,1
19,1,1,0,2,2021-03-19,Female,69,65-69,9
19,0,0,0,0,2021-03-17,Female,53,45-54,14
19,2,0,0,2,2021-03-18,Male,68,65-69,17
19,0,22,10,32,2021-03-18,Female,48,45-54,15
19,3,10,0,13,2021-03-17,Male,21,20-24,16
19,2,1,0,3,2021-03-18,Female,66,65-69,4
19,3,0,0,3,2021-03-17,Male,85,85+,13
19,1,0,0,1,2021-03-18,Female,32,25-34,9
19,1,1,0,2,2021-03-20,Female,54,45-54,16
19,2,1,0,3,2021-03-18,Male,13,10-14,12
19,2,0,0,2,2021-03-21,Female,71,70-74,7
19,2,0,0,2,2021-03-18,Female,20,20-24,8
19,0,0,0,0,2021-03-26,Male,48,45-54,13
19,1,0,0,1,2021-03-20,Female,67,65-69,13
19,0,0,0,0,2021-03-17,Male,50,45-54,19
19,0,0,0,0,2021-03-19,Male,0,<1,9
19,0,1,0,1,2021-03-17,Male,23,20-24,11
19,0,0,0,0,2021-03-18,Male,29,25-34,13
19,0,0,0,0,2021-03-19,Male,67,65-69,9
19,2,0,0,2,2021-03-17,Female,19,15-19,5
19,0,3,0,3,2021-03-20,Female,29,25-34,9
19,2,0,0,2,2021-03-21,Female,12,10-14,8
19,0,0,0,0,2021-03-17,Male,43,35-44,17
19,0,0,0,0,2021-03-17,Female,21,20-24,6
19,2,0,0,2,2021-03-19,Female,80,80-84,15
19,1,0,0,1,2021-03-22,Female,70,70-74,17
19,0,0,0,0,2021-03-21,Female,70,70-74,19
19,2,0,0,2,2021-03-17,Male,41,35-44,17
19,0,0,0,0,2021-03-20,Male,13,10-14,12
19,0,0,0,0,2021-03-21,Male,61,55-64,18
19,3,1,0,4,2021-03-17,Female,10,10-14,13
19,1,4,0,5,2021-03-20,Female,30,25-34,15
19,2,3,0,5,2021-03-17,Female,9,5-9,15
19,3,0,0,3,2021-03-18,Male,12,10-14,15
19,0,1,0,1,2021-03-17,Male,34,25-34,17
19,2,0,0,2,2021-03-17,Male,15,15-19,11
19,3,0,0,3,2021-03-18,Male,9,5-9,9
19,2,0,0,2,2021-03-17,Male,20,20-24,15
20,0,0,0,0,2021-04-09,Male,60,55-64,14
20,1,3,0,4,2021-04-10,Male,68,65-69,15
20,1,0,0,1,2021-04-09,Female,70,70-74,14
20,2,2,0,4,2021-04-07,Male,10,10-14,2
20,0,0,0,0,2021-04-11,Female,16,15-19,8
20,0,0,0,0,2021-04-10,Female,72,70-74,16
20,2,4,0,6,2021-04-13,Female,2,1-4,5
20,1,0,0,1,2021-04-10,Female,72,70-74,20
20,0,0,0,0,2021-04-12,Male,30,25-34,16
20,0,0,0,0,2021-04-08,Female,54,45-54,15
20,0,0,0,0,2021-04-10,Female,68,65-69,13
20,0,0,0,0,2021-04-12,Female,34,25-34,7
20,0,0,0,0,2021-04-10,Male,51,45-54,16
20,1,0,0,1,2021-04-09,Male,51,45-54,15
20,0,0,0,0,2021-04-09,Female,35,35-44,17
20,0,1,0,1,2021-04-12,Male,26,25-34,2
20,3,0,0,3,2021-04-08,Female,57,55-64,16
20,0,1,0,1,2021-04-08,Female,22,20-24,5
20,2,0,0,2,2021-04-12,Female,10,10-14,15
20,0,0,0,0,2021-04-07,Male,43,35-44,13
20,0,0,0,0,2021-04-07,Male,32,25-34,16
20,1,0,0,1,2021-04-12,Male,67,65-69,12
20,1,43,0,44,2021-04-09,Male,67,65-69,15
20,1,0,0,1,2021-04-11,Male,63,55-64,20
20,4,0,0,4,2021-04-12,Male,13,10-14,5
20,0,0,0,0,2021-04-10,Male,11,10-14,14
20,0,0,0,0,2021-04-08,Male,18,15-19,18
20,0,2,0,2,2021-04-09,Male,49,45-54,17
20,2,0,0,2,2021-04-10,Male,58,55-64,14
20,5,0,0,5,2021-04-09,Male,51,45-54,7
20,1,0,0,1,2021-04-13,Male,35,35-44,12
20,0,2,0,2,2021-04-07,Male,53,45-54,13
20,0,0,0,0,2021-04-10,Female,71,70-74,19
20,1,0,0,1,2021-04-11,Male,68,65-69,16
20,1,0,0,1,2021-04-09,Female,53,45-54,16
20,1,0,0,1,2021-04-12,Female,69,65-69,14
20,0,0,0,0,2021-04-08,Male,42,35-44,20
20,4,0,0,4,2021-04-08,Male,19,15-19,6
20,1,0,0,1,2021-04-10,Female,57,55-64,20
20,2,0,0,2,2021-04-12,Female,22,20-24,18
20,1,0,0,1,2021-04-07,Male,52,45-54,18
20,1,0,0,1,2021-04-12,Male,43,35-44,2
20,0,0,0,0,2021-04-09,Male,24,20-24,5
20,0,0,0,0,2021-04-12,Male,85,85+,17
20,0,0,0,0,2021-04-08,Female,69,65-69,15
20,0,0,0,0,2021-04-09,Male,7,5-9,7
20,0,0,0,0,2021-04-09,Male,17,15-19,13
20,1,0,0,1,2021-04-08,Male,58,55-64,18
20,0,0,0,0,2021-04-12,Male,68,65-69,18
20,0,3,0,3,2021-04-10,Male,51,45-54,12
20,1,0,0,1,2021-04-07,Male,72,70-74,13
20,0,0,0,0,2021-04-12,Male,77,75-79,15
20,0,0,0,0,2021-04-07,Male,26,25-34,7
20,1,0,0,1,2021-04-07,Male,72,70-74,18
20,0,0,0,0,2021-04-09,Male,44,35-44,10
20,0,0,0,0,2021-04-12,Male,52,45-54,17
20,0,0,0,0,2021-04-08,Male,7,5-9,6
20,1,0,0,1,2021-04-08,Male,39,35-44,17
20,3,7,15,25,2021-04-15,Male,9,5-9,4
20,2,0,0,2,2021-04-08,Male,69,65-69,16
20,4,3,0,7,2021-04-12,Male,4,1-4,11
20,1,0,0,1,2021-04-09,Female,68,65-69,17
20,5,0,0,5,2021-04-08,Female,3,1-4,7
20,1,1,1,3,2021-04-08,Male,62,55-64,17
20,3,1,0,4,2021-04-10,Female,43,35-44,13
20,0,1,0,1,2021-04-10,Male,72,70-74,13
20,0,0,0,0,2021-04-08,Female,20,20-24,7
20,2,0,0,2,2021-04-10,Female,72,70-74,15
20,0,0,0,0,2021-04-09,Female,22,20-24,6
20,1,0,0,1,2021-04-09,Female,39,35-44,3
20,2,3,0,5,2021-04-08,Male,54,45-54,19
20,0,0,0,0,2021-04-13,Male,32,25-34,9
20,1,0,0,1,2021-04-08,Male,70,70-74,17
20,2,0,0,2,2021-04-10,Female,69,65-69,16
20,1,0,0,1,2021-04-12,Female,66,65-69,19
20,3,0,0,3,2021-04-10,Male,10,10-14,11
20,2,0,0,2,2021-04-10,Male,66,65-69,18
20,2,0,0,2,2021-04-08,Male,69,65-69,12
20,4,0,0,4,2021-04-07,Female,13,10-14,11
20,2,0,0,2,2021-04-10,Male,70,70-74,10
20,0,0,0,0,2021-04-07,Female,6,5-9,6
20,0,0,0,0,2021-04-09,Male,43,35-44,16
20,3,0,0,3,2021-04-12,Female,8,5-9,14
20,0,0,0,0,2021-04-10,Male,71,70-74,15
20,1,3,0,4,2021-04-09,Male,69,65-69,20
20,0,0,0,0,2021-04-11,Female,4,1-4,14
20,4,0,0,4,2021-04-09,Female,20,20-24,2
20,2,0,0,2,2021-04-11,Female,68,65-69,18
20,3,1,0,4,2021-04-08,Male,18,15-19,16
20,1,0,0,1,2021-04-08,Male,31,25-34,14
20,0,5,0,5,2021-04-07,Female,53,45-54,17
20,0,0,0,0,2021-04-10,Male,49,45-54,18
20,0,1,0,1,2021-04-12,Male,70,70-74,13
20,1,0,0,1,2021-04-13,Female,27,25-34,8
20,0,3,0,3,2021-04-12,Female,63,55-64,18
20,0,0,2,2,2021-04-10,Female,32,25-34,14
20,0,0,0,0,2021-04-09,Female,31,25-34,19
20,0,0,0,0,2021-04-12,Female,67,65-69,14
20,1,0,0,1,2021-04-13,Male,19,15-19,11
20,0,0,0,0,2021-04-12,Female,63,55-64,18
20,0,0,0,0,2021-04-10,Male,18,15-19,8
20,2,0,2,4,2021-04-12,Female,47,45-54,14
20,0,2,0,2,2021-04-08,Male,55,55-64,17
20,1,0,0,1,2021-04-08,Male,57,55-64,15
20,0,0,0,0,2021-04-07,Male,4,1-4,5
20,0,0,0,0,2021-04-11,Female,73,70-74,13
20,0,1,0,1,2021-04-09,Male,33,25-34,20
20,2,0,0,2,2021-04-08,Female,31,25-34,14
20,0,0,0,0,2021-04-12,Male,35,35-44,8
20,2,0,0,2,2021-04-10,Female,66,65-69,6
20,0,0,0,0,2021-04-07,Male,37,35-44,16
20,1,0,0,1,2021-04-09,Female,23,20-24,7
20,1,0,0,1,2021-04-07,Male,65,65-69,15
20,2,0,0,2,2021-04-08,Male,6,5-9,11
20,1,0,0,1,2021-04-09,Female,26,25-34,15
20,0,1,0,1,2021-04-07,Male,69,65-69,15
20,1,0,0,1,2021-04-08,Female,68,65-69,11
20,2,1,0,3,2021-04-07,Male,42,35-44,14
20,2,0,0,2,2021-04-12,Male,59,55-64,19
20,4,6,2,12,2021-04-15,Male,22,20-24,1
20,0,0,0,0,2021-04-07,Female,63,55-64,16
20,4,0,0,4,2021-04-09,Male,10,10-14,7
20,0,0,0,0,2021-04-09,Male,69,65-69,15
20,2,0,0,2,2021-04-11,Male,35,35-44,16
20,2,0,0,2,2021-04-12,Male,70,70-74,11
20,0,0,0,0,2021-04-09,Male,25,25-34,12
20,0,0,0,0,2021-04-08,Male,23,20-24,14
20,1,0,0,1,2021-04-13,Male,65,65-69,18
20,0,0,0,0,2021-04-15,Male,41,35-44,1
20,1,1,2,4,2021-04-12,Female,79,75-79,15
20,1,0,0,1,2021-04-11,Male,57,55-64,14
20,1,0,0,1,2021-04-12,Female,29,25-34,16
20,1,0,0,1,2021-04-09,Male,52,45-54,3
20,1,21,0,22,2021-04-09,Female,66,65-69,14
20,1,0,0,1,2021-04-07,Male,53,45-54,14
20,1,1,0,2,2021-04-10,Male,71,70-74,17
20,1,2,0,3,2021-04-11,Female,68,65-69,20
20,0,0,0,0,2021-04-07,Female,52,45-54,18
20,1,0,0,1,2021-04-12,Male,29,25-34,15
20,3,0,0,3,2021-04-11,Male,6,5-9,15
20,3,1,0,4,2021-04-09,Male,66,65-69,16
20,1,3,0,4,2021-04-09,Female,24,20-24,5
20,1,0,0,1,2021-04-12,Female,59,55-64,17
20,0,0,0,0,2021-04-12,Female,66,65-69,18
20,1,0,0,1,2021-04-08,Female,42,35-44,10
20,1,1,0,2,2021-04-07,Female,60,55-64,16
20,0,1,0,1,2021-04-09,Male,71,70-74,20
20,0,0,0,0,2021-04-10,Female,71,70-74,15
20,1,1,0,2,2021-04-09,Male,74,70-74,18
20,2,1,0,3,2021-04-10,Female,48,45-54,12
20,0,0,3,3,2021-04-12,Male,51,45-54,13
20,2,0,0,2,2021-04-08,Female,31,25-34,15
20,0,0,0,0,2021-04-08,Male,38,35-44,7
20,0,1,0,1,2021-04-11,Female,21,20-24,10
20,0,2,0,2,2021-04-15,Female,45,45-54,1
20,0,0,0,0,2021-04-07,Male,54,45-54,16
20,0,0,0,0,2021-04-09,Female,25,25-34,7
20,1,0,0,1,2021-04-12,Female,50,45-54,15
20,1,1,0,2,2021-04-12,Female,61,55-64,4
20,0,0,0,0,2021-04-09,Male,13,10-14,15
20,2,4,100,106,2021-04-10,Male,17,15-19,16
20,0,0,0,0,2021-04-11,Male,65,65-69,14
20,1,1,0,2,2021-04-09,Male,68,65-69,17
20,1,0,0,1,2021-04-07,Male,53,45-54,13
20,1,0,0,1,2021-04-11,Female,58,55-64,17
20,2,0,0,2,2021-04-15,Female,23,20-24,1
20,0,0,0,0,2021-04-09,Male,50,45-54,18
20,0,0,0,0,2021-04-08,Male,11,10-14,16
20,0,4,0,4,2021-04-09,Female,26,25-34,4
20,0,0,0,0,2021-04-09,Male,71,70-74,18
20,0,0,0,0,2021-04-07,Male,40,35-44,14
20,2,0,0,2,2021-04-08,Female,69,65-69,20
20,0,0,0,0,2021-04-13,Male,38,35-44,14
20,0,0,0,0,2021-04-11,Female,8,5-9,13
20,4,0,0,4,2021-04-08,Male,22,20-24,7
20,2,0,0,2,2021-04-10,Female,73,70-74,13
20,0,1,0,1,2021-04-11,Male,52,45-54,14
20,1,0,0,1,2021-04-13,Female,57,55-64,16
20,1,0,0,1,2021-04-12,Female,60,55-64,20
20,0,0,0,0,2021-04-09,Male,43,35-44,19
20,0,0,0,0,2021-04-09,Female,63,55-64,14
20,2,0,0,2,2021-04-12,Male,74,70-74,16
20,2,0,0,2,2021-04-07,Female,53,45-54,18
20,0,0,0,0,2021-04-09,Male,69,65-69,15
20,2,0,2,4,2021-04-13,Male,11,10-14,3
20,1,0,0,1,2021-04-10,Male,34,25-34,19
20,0,0,0,0,2021-04-14,Male,48,45-54,14
20,3,3,2,8,2021-04-12,Male,70,70-74,15
20,0,0,0,0,2021-04-08,Male,66,65-69,18
20,3,0,0,3,2021-04-12,Male,36,35-44,15
20,1,0,0,1,2021-04-11,Male,68,65-69,18
20,4,0,0,4,2021-04-09,Female,4,1-4,5
20,0,0,0,0,2021-04-13,Male,44,35-44,13
20,1,0,0,1,2021-04-08,Female,56,55-64,18
20,0,0,0,0,2021-04-07,Female,58,55-64,16
20,0,0,0,0,2021-04-13,Male,45,45-54,12
20,1,0,0,1,2021-04-12,Female,25,25-34,10
20,0,1,0,1,2021-04-12,Female,64,55-64,14
20,2,0,0,2,2021-04-07,Female,10,10-14,2
20,1,1,0,2,2021-04-08,Female,61,55-64,20
20,2,0,0,2,2021-04-09,Male,49,45-54,15
20,1,0,0,1,2021-04-12,Female,54,45-54,20
20,0,0,0,0,2021-04-08,Male,34,25-34,14
20,0,1,0,1,2021-04-08,Male,56,55-64,15
20,1,0,0,1,2021-04-12,Male,73,70-74,15
20,3,0,0,3,2021-04-12,Female,8,5-9,14
20,4,2,0,6,2021-04-12,Male,5,5-9,13
20,1,0,0,1,2021-04-12,Male,79,75-79,14
20,0,0,0,0,2021-04-09,Male,39,35-44,16
20,2,1,0,3,2021-04-11,Female,18,15-19,13
20,1,0,0,1,2021-04-09,Female,56,55-64,17
20,0,0,0,0,2021-04-12,Female,70,70-74,7
20,0,0,0,0,2021-04-08,Male,53,45-54,14
20,1,0,0,1,2021-04-08,Male,69,65-69,18
20,2,1,0,3,2021-04-10,Male,18,15-19,14
20,0,3,0,3,2021-04-08,Male,37,35-44,20
20,0,0,0,0,2021-04-12,Male,66,65-69,7
20,0,2,0,2,2021-04-08,Male,39,35-44,20
20,2,0,0,2,2021-04-08,Female,71,70-74,16
20,0,0,0,0,2021-04-09,Male,33,25-34,16
20,2,0,0,2,2021-04-11,Male,62,55-64,19
20,0,0,0,0,2021-04-10,Female,5,5-9,8
20,1,0,0,1,2021-04-12,Female,68,65-69,13
20,0,0,0,0,2021-04-12,Female,70,70-74,11
20,0,0,0,0,2021-04-07,Male,6,5-9,16
20,1,0,0,1,2021-04-09,Female,34,25-34,14
20,1,15,11,27,2021-04-15,Male,39,35-44,1
20,1,0,0,1,2021-04-08,Female,71,70-74,10
20,0,0,0,0,2021-04-12,Male,68,65-69,18
20,3,0,0,3,2021-04-12,Female,64,55-64,6
20,0,0,0,0,2021-04-12,Male,37,35-44,12
20,0,2,0,2,2021-04-09,Male,29,25-34,16
20,0,0,0,0,2021-04-08,Female,54,45-54,16
20,0,0,0,0,2021-04-07,Female,25,25-34,5
20,3,0,0,3,2021-04-12,Male,7,5-9,15
20,0,0,0,0,2021-04-08,Male,31,25-34,7
20,0,0,0,0,2021-04-12,Male,77,75-79,12
20,0,0,0,0,2021-04-07,Female,18,15-19,2
20,0,1,0,1,2021-04-13,Male,47,45-54,14
20,1,2,0,3,2021-04-12,Male,52,45-54,17
20,1,10,0,11,2021-04-09,Male,33,25-34,14
20,3,0,0,3,2021-04-10,Male,70,70-74,15
20,0,0,0,0,2021-04-07,Male,18,15-19,17
20,2,0,0,2,2021-04-08,Male,65,65-69,16
20,0,1,0,1,2021-04-12,Male,49,45-54,17
20,1,1,0,2,2021-04-12,Male,66,65-69,11
20,1,1,0,2,2021-04-08,Female,67,65-69,11
20,0,0,0,0,2021-04-08,Male,17,15-19,10
20,1,0,0,1,2021-04-07,Male,67,65-69,18
20,0,0,0,0,2021-04-12,Male,65,65-69,18
20,2,5,0,7,2021-04-10,Female,68,65-69,19
20,1,2,0,3,2021-04-10,Male,68,65-69,18
20,0,0,0,0,2021-04-09,Male,41,35-44,12
20,0,0,0,0,2021-04-08,Female,26,25-34,7
20,1,0,0,1,2021-04-09,Female,44,35-44,10
20,2,0,0,2,2021-04-10,Male,70,70-74,12
20,3,0,0,3,2021-04-09,Female,15,15-19,15
20,3,0,0,3,2021-04-15,Male,18,15-19,1
20,2,0,0,2,2021-04-10,Female,61,55-64,9
20,2,1,0,3,2021-04-12,Male,16,15-19,16
20,0,0,4,4,2021-04-13,Female,20,20-24,11
20,0,0,0,0,2021-04-07,Female,52,45-54,18
20,5,0,0,5,2021-04-12,Male,11,10-14,17
20,5,0,0,5,2021-04-10,Male,58,55-64,11
20,0,0,0,0,2021-04-12,Female,60,55-64,15
20,0,0,0,0,2021-04-08,Male,82,80-84,17
20,2,0,0,2,2021-04-08,Female,6,5-9,10
20,3,0,0,3,2021-04-08,Male,4,1-4,3
20,0,0,0,0,2021-04-15,Female,7,5-9,13
20,0,0,0,0,2021-04-12,Male,60,55-64,11
20,0,2,0,2,2021-04-12,Female,51,45-54,6
20,0,0,0,0,2021-04-08,Male,49,45-54,14
20,1,3,0,4,2021-04-15,Male,44,35-44,1
20,0,0,0,0,2021-04-14,Male,25,25-34,17
20,3,1,0,4,2021-04-12,Male,22,20-24,13
20,2,0,0,2,2021-04-10,Male,71,70-74,18
20,0,0,0,0,2021-04-11,Male,35,35-44,19
20,1,0,0,1,2021-04-12,Female,35,35-44,11
20,0,0,0,0,2021-04-14,Female,45,45-54,6
20,3,0,0,3,2021-04-08,Female,24,20-24,19
20,0,0,0,0,2021-04-08,Female,66,65-69,14
20,3,0,0,3,2021-04-09,Male,23,20-24,15
20,5,0,0,5,2021-04-13,Female,6,5-9,15
20,0,0,0,0,2021-04-12,Male,68,65-69,17
20,1,0,0,1,2021-04-11,Male,22,20-24,11
20,2,0,0,2,2021-04-07,Male,41,35-44,20
20,1,0,0,1,2021-04-12,Male,65,65-69,16
20,0,2,0,2,2021-04-08,Male,50,45-54,12
20,0,2,0,2,2021-04-10,Male,71,70-74,13
20,2,0,3,5,2021-04-09,Male,59,55-64,16
20,1,0,0,1,2021-04-08,Male,79,75-79,18
20,0,0,0,0,2021-04-12,Male,54,45-54,15
20,1,4,0,5,2021-04-10,Female,69,65-69,13
20,2,60,0,62,2021-04-09,Male,65,65-69,12
20,1,0,0,1,2021-04-08,Male,64,55-64,13
20,0,3,0,3,2021-04-12,Female,67,65-69,17
20,0,0,0,0,2021-04-10,Male,13,10-14,8
20,2,0,0,2,2021-04-10,Female,26,25-34,10
20,0,1,0,1,2021-04-08,Female,69,65-69,17
20,0,0,0,0,2021-04-07,Female,33,25-34,4
20,0,1,0,1,2021-04-08,Female,28,25-34,7
20,1,0,0,1,2021-04-07,Male,31,25-34,5
20,0,0,0,0,2021-04-12,Male,28,25-34,8
20,2,0,0,2,2021-04-12,Female,78,75-79,17
20,0,0,0,0,2021-04-10,Female,66,65-69,13
20,0,1,0,1,2021-04-09,Female,64,55-64,15
20,1,1,0,2,2021-04-12,Male,69,65-69,17
20,0,0,0,0,2021-04-08,Male,19,15-19,9
20,0,1,0,1,2021-04-12,Female,34,25-34,14
20,0,1,0,1,2021-04-10,Female,72,70-74,11
20,0,0,0,0,2021-04-09,Female,5,5-9,17
20,3,0,0,3,2021-04-07,Female,52,45-54,15
20,2,0,0,2,2021-04-12,Female,78,75-79,15
20,0,1,0,1,2021-04-09,Female,22,20-24,4
20,0,0,0,0,2021-04-11,Female,51,45-54,8
20,0,1,0,1,2021-04-08,Male,54,45-54,12
20,1,0,0,1,2021-04-15,Female,30,25-34,1
20,0,0,0,0,2021-04-12,Male,66,65-69,19
20,1,2,0,3,2021-04-11,Female,69,65-69,16
20,0,0,0,0,2021-04-12,Female,76,75-79,18
20,3,0,0,3,2021-04-10,Male,37,35-44,15
20,1,0,0,1,2021-04-10,Female,49,45-54,15
20,1,2,0,3,2021-04-11,Male,61,55-64,14
20,1,1,0,2,2021-04-15,Male,31,25-34,1
20,1,0,0,1,2021-04-13,Female,51,45-54,13
20,0,0,0,0,2021-04-08,Male,11,10-14,7
20,3,0,0,3,2021-04-09,Female,18,15-19,9
20,1,0,0,1,2021-04-12,Male,69,65-69,18
20,2,0,0,2,2021-04-11,Male,57,55-64,11
20,2,1,0,3,2021-04-10,Female,54,45-54,15
20,0,0,0,0,2021-04-10,Male,62,55-64,15
20,2,0,3,5,2021-04-08,Male,30,25-34,7
20,0,1,0,1,2021-04-09,Female,33,25-34,5
20,0,0,0,0,2021-04-13,Female,33,25-34,10
20,1,0,0,1,2021-04-09,Female,61,55-64,15
20,0,1,0,1,2021-04-12,Male,52,45-54,15
20,0,0,0,0,2021-04-13,Female,50,45-54,16
20,1,1,0,2,2021-04-08,Male,66,65-69,5
20,0,0,0,0,2021-04-12,Male,74,70-74,18
20,3,0,0,3,2021-04-08,Female,15,15-19,18
20,0,2,0,2,2021-04-09,Male,64,55-64,2
20,3,0,0,3,2021-04-07,Female,13,10-14,18
20,1,0,0,1,2021-04-09,Male,27,25-34,18
20,1,3,0,4,2021-04-12,Female,70,70-74,16
20,0,1,0,1,2021-04-13,Female,81,80-84,7
20,4,0,0,4,2021-04-09,Male,7,5-9,7
20,3,0,0,3,2021-04-07,Female,10,10-14,16
20,0,0,0,0,2021-04-12,Female,66,65-69,15
20,1,0,0,1,2021-04-07,Female,27,25-34,17
20,2,1,0,3,2021-04-11,Male,76,75-79,18
20,0,0,0,0,2021-04-08,Female,29,25-34,2
20,1,0,0,1,2021-04-13,Male,74,70-74,15
20,0,0,0,0,2021-04-11,Male,52,45-54,10
20,0,0,0,0,2021-04-08,Male,31,25-34,14
20,0,0,0,0,2021-04-08,Female,25,25-34,18
20,1,3,0,4,2021-04-12,Female,23,20-24,8
20,0,0,0,0,2021-04-12,Female,43,35-44,6
20,1,10,0,11,2021-04-09,Male,63,55-64,17
20,0,0,0,0,2021-04-09,Male,64,55-64,16
20,3,1,0,4,2021-04-12,Male,19,15-19,15
20,3,3,0,6,2021-04-08,Male,22,20-24,2
20,2,0,0,2,2021-04-09,Male,54,45-54,19
20,0,0,0,0,2021-04-10,Male,61,55-64,12
20,0,0,0,0,2021-04-10,Female,6,5-9,17
20,1,0,0,1,2021-04-07,Female,53,45-54,18
20,0,0,0,0,2021-04-07,Male,33,25-34,12
20,0,0,0,0,2021-04-13,Female,71,70-74,15
20,0,0,0,0,2021-04-12,Male,11,10-14,12
20,0,0,0,0,2021-04-13,Male,30,25-34,17
20,2,0,0,2,2021-04-11,Female,15,15-19,12
20,5,0,0,5,2021-04-12,Male,1,1-4,5
20,0,0,0,0,2021-04-09,Female,57,55-64,19
20,0,0,0,0,2021-04-10,Male,68,65-69,15
20,0,0,0,0,2021-04-12,Male,52,45-54,17
20,0,0,0,0,2021-04-08,Male,55,55-64,16
20,1,0,0,1,2021-04-15,Female,5,5-9,1
20,0,0,0,0,2021-04-10,Male,8,5-9,17
20,2,0,0,2,2021-04-09,Male,67,65-69,19
20,0,1,0,1,2021-04-09,Female,69,65-69,12
20,1,0,0,1,2021-04-11,Female,70,70-74,7
20,0,0,0,0,2021-04-08,Female,30,25-34,15
20,0,1,0,1,2021-04-10,Male,46,45-54,17
20,2,0,0,2,2021-04-10,Female,69,65-69,15
20,1,5,0,6,2021-04-08,Male,55,55-64,13
20,1,1,0,2,2021-04-13,Female,25,25-34,12
20,1,0,0,1,2021-04-12,Female,48,45-54,13
20,0,0,0,0,2021-04-08,Female,42,35-44,7
20,0,0,0,0,2021-04-09,Female,8,5-9,7
20,1,0,0,1,2021-04-07,Male,65,65-69,18
20,1,0,0,1,2021-04-11,Male,66,65-69,17
20,2,0,0,2,2021-04-13,Male,6,5-9,19
20,0,0,0,0,2021-04-08,Female,16,15-19,11
20,2,3,0,5,2021-04-15,Female,18,15-19,1
20,0,0,0,0,2021-04-09,Male,58,55-64,19
20,1,0,0,1,2021-04-07,Female,66,65-69,20
20,1,0,0,1,2021-04-09,Male,52,45-54,12
20,2,0,0,2,2021-04-09,Female,53,45-54,6
20,3,0,0,3,2021-04-13,Female,6,5-9,10
20,2,0,0,2,2021-04-08,Female,10,10-14,15
20,2,0,4,6,2021-04-10,Female,72,70-74,8
20,4,0,0,4,2021-04-09,Male,10,10-14,20
20,2,0,0,2,2021-04-12,Male,51,45-54,18
20,0,0,0,0,2021-04-11,Male,74,70-74,19
20,0,0,0,0,2021-04-07,Male,19,15-19,9
20,0,0,0,0,2021-04-09,Male,71,70-74,12
20,1,0,0,1,2021-04-08,Male,55,55-64,17
20,0,1,0,1,2021-04-12,Female,69,65-69,19
20,0,0,0,0,2021-04-10,Male,68,65-69,8
20,0,0,0,0,2021-04-12,Male,78,75-79,15
20,0,1,0,1,2021-04-07,Female,32,25-34,6
20,1,0,0,1,2021-04-12,Female,56,55-64,13
20,2,0,0,2,2021-04-12,Female,67,65-69,10
20,1,0,0,1,2021-04-12,Male,66,65-69,15
20,1,0,0,1,2021-04-09,Male,60,55-64,19
20,1,0,0,1,2021-04-08,Male,54,45-54,16
20,1,1,0,2,2021-04-12,Male,63,55-64,6
20,0,0,0,0,2021-04-10,Female,25,25-34,19
20,0,0,0,0,2021-04-08,Male,36,35-44,16
20,1,0,0,1,2021-04-12,Male,52,45-54,19
20,0,0,0,0,2021-04-12,Male,30,25-34,17
20,0,1,0,1,2021-04-07,Female,24,20-24,17
20,1,0,0,1,2021-04-09,Male,34,25-34,16
20,0,2,0,2,2021-04-08,Female,49,45-54,20
20,0,6,0,6,2021-04-11,Male,40,35-44,13
20,0,5,0,5,2021-04-10,Male,70,70-74,17
20,2,1,0,3,2021-04-12,Female,64,55-64,19
20,1,1,1,3,2021-04-10,Male,63,55-64,16
20,2,0,0,2,2021-04-08,Male,43,35-44,1
20,1,0,0,1,2021-04-15,Female,23,20-24,1
20,1,0,0,1,2021-04-09,Male,38,35-44,11
20,0,0,0,0,2021-04-10,Female,21,20-24,7
20,2,2,0,4,2021-04-09,Female,37,35-44,17
20,2,3,0,5,2021-04-08,Male,34,25-34,2
20,1,0,2,3,2021-04-13,Female,23,20-24,7
20,2,0,0,2,2021-04-12,Female,61,55-64,17
20,3,1,0,4,2021-04-12,Female,9,5-9,3
20,1,3,0,4,2021-04-08,Female,57,55-64,12
20,0,0,0,0,2021-04-08,Male,53,45-54,16
20,0,1,0,1,2021-04-09,Female,66,65-69,20
20,0,1,0,1,2021-04-10,Female,67,65-69,16
20,0,1,0,1,2021-04-10,Female,70,70-74,13
20,3,2,0,5,2021-04-09,Female,9,5-9,14
20,0,2,0,2,2021-04-15,Female,53,45-54,13
20,0,1,0,1,2021-04-07,Male,54,45-54,16
20,1,0,0,1,2021-04-09,Male,57,55-64,15
20,1,3,0,4,2021-04-11,Female,55,55-64,16
20,2,0,0,2,2021-04-08,Male,40,35-44,18
20,0,0,0,0,2021-04-09,Male,39,35-44,17
20,0,1,0,1,2021-04-09,Male,40,35-44,15
20,3,0,0,3,2021-04-07,Female,21,20-24,15
20,1,1,0,2,2021-04-12,Female,63,55-64,13
20,0,0,0,0,2021-04-13,Female,19,15-19,10
20,2,0,0,2,2021-04-11,Female,7,5-9,18
20,0,0,0,0,2021-04-12,Male,66,65-69,18
20,0,10,0,10,2021-04-15,Male,40,35-44,1
20,0,0,0,0,2021-04-12,Male,61,55-64,15
20,2,0,0,2,2021-04-12,Male,64,55-64,16
20,0,0,0,0,2021-04-09,Female,19,15-19,5
20,0,1,0,1,2021-04-08,Male,73,70-74,17
20,0,0,0,0,2021-04-10,Female,57,55-64,15
20,3,0,0,3,2021-04-12,Male,43,35-44,12
20,1,0,0,1,2021-04-15,Female,52,45-54,1
20,1,0,0,1,2021-04-09,Male,71,70-74,18
20,5,0,0,5,2021-04-09,Female,16,15-19,19
20,1,0,0,1,2021-04-07,Male,63,55-64,19
20,1,4,0,5,2021-04-09,Male,68,65-69,20
20,0,0,0,0,2021-04-07,Male,57,55-64,17
20,1,1,0,2,2021-04-10,Female,71,70-74,16
20,0,3,0,3,2021-04-15,Male,52,45-54,9
20,0,0,0,0,2021-04-12,Female,60,55-64,11
20,3,0,0,3,2021-04-10,Male,7,5-9,20
20,0,4,0,4,2021-04-13,Male,58,55-64,10
20,0,0,0,0,2021-04-12,Female,36,35-44,16
20,2,5,31,38,2021-04-08,Male,56,55-64,14
20,1,1,0,2,2021-04-09,Male,62,55-64,16
20,0,1,0,1,2021-04-08,Male,54,45-54,13
20,2,1,0,3,2021-04-10,Female,73,70-74,9
20,3,0,0,3,2021-04-09,Female,22,20-24,7
20,1,0,0,1,2021-04-07,Male,14,10-14,18
20,2,0,0,2,2021-04-12,Male,79,75-79,11
20,0,0,0,0,2021-04-12,Female,20,20-24,6
20,0,1,0,1,2021-04-09,Female,23,20-24,4
20,1,0,0,1,2021-04-10,Female,66,65-69,16
20,5,11,0,16,2021-04-12,Female,11,10-14,15
20,1,0,0,1,2021-04-08,Male,64,55-64,20
20,1,0,0,1,2021-04-09,Female,52,45-54,15
20,2,0,0,2,2021-04-08,Female,24,20-24,19
20,0,1,0,1,2021-04-15,Female,23,20-24,1
20,0,0,0,0,2021-04-09,Female,73,70-74,13
20,4,0,0,4,2021-04-15,Female,35,35-44,13
20,0,1,0,1,2021-04-10,Female,56,55-64,13
20,1,0,0,1,2021-04-13,Male,16,15-19,4
20,1,0,55,56,2021-04-08,Male,54,45-54,15
20,2,2,0,4,2021-04-08,Male,56,55-64,19
20,0,0,0,0,2021-04-08,Female,22,20-24,8
20,1,0,0,1,2021-04-08,Female,55,55-64,16
20,0,1,0,1,2021-04-10,Male,60,55-64,18
20,0,0,0,0,2021-04-09,Female,59,55-64,18
20,0,1,0,1,2021-04-08,Female,67,65-69,10
20,0,0,0,0,2021-04-10,Female,23,20-24,17
20,0,0,2,2,2021-04-08,Female,26,25-34,5
20,1,0,0,1,2021-04-09,Male,32,25-34,17
20,1,0,1,2,2021-04-08,Male,28,25-34,19
20,3,7,0,10,2021-04-10,Male,58,55-64,14
20,0,0,0,0,2021-04-09,Male,48,45-54,16
20,0,0,0,0,2021-04-09,Male,1,1-4,9
20,0,0,0,0,2021-04-12,Female,34,25-34,18
20,1,0,0,1,2021-04-09,Female,41,35-44,20
20,1,2,0,3,2021-04-09,Male,68,65-69,17
20,0,0,0,0,2021-04-12,Male,73,70-74,9
20,2,0,0,2,2021-04-12,Female,74,70-74,13
20,0,0,0,0,2021-04-15,Male,19,15-19,14
20,2,0,0,2,2021-04-07,Female,0,<1,2
20,0,0,0,0,2021-04-12,Male,66,65-69,17
20,3,3,0,6,2021-04-08,Male,10,10-14,10
20,0,1,0,1,2021-04-15,Female,49,45-54,5
20,1,0,0,1,2021-04-09,Male,33,25-34,16
20,1,0,0,1,2021-04-07,Female,62,55-64,15
20,2,0,0,2,2021-04-12,Female,65,65-69,13
20,0,0,0,0,2021-04-10,Male,69,65-69,17
20,0,0,0,0,2021-04-08,Female,31,25-34,18
20,1,0,0,1,2021-04-13,Male,23,20-24,9
20,1,0,0,1,2021-04-09,Female,0,<1,3
20,0,1,0,1,2021-04-10,Female,73,70-74,16
20,0,0,0,0,2021-04-07,Male,59,55-64,13
20,0,0,0,0,2021-04-07,Female,42,35-44,11
20,1,3,0,4,2021-04-07,Male,68,65-69,19
20,0,0,0,0,2021-04-12,Male,79,75-79,7
20,1,0,0,1,2021-04-12,Male,70,70-74,13
20,0,1,0,1,2021-04-09,Male,59,55-64,15
20,1,0,0,1,2021-04-10,Male,59,55-64,16
20,1,0,0,1,2021-04-09,Male,67,65-69,15
20,0,2,0,2,2021-04-09,Female,53,45-54,15
20,2,0,0,2,2021-04-08,Male,17,15-19,15
20,3,1,0,4,2021-04-09,Male,1,1-4,16
20,2,0,0,2,2021-04-12,Female,31,25-34,16
20,1,4,0,5,2021-04-12,Female,69,65-69,14
20,0,0,0,0,2021-04-12,Male,68,65-69,19
20,1,1,0,2,2021-04-10,Male,47,45-54,8
20,0,0,0,0,2021-04-07,Female,24,20-24,6
20,0,4,0,4,2021-04-13,Male,60,55-64,2
20,0,1,0,1,2021-04-08,Female,21,20-24,6
20,1,0,0,1,2021-04-10,Female,28,25-34,6
20,1,0,0,1,2021-04-14,Female,23,20-24,13
20,0,0,0,0,2021-04-13,Male,27,25-34,11
20,1,0,0,1,2021-04-08,Female,63,55-64,7
20,0,0,0,0,2021-04-10,Female,69,65-69,10
20,0,6,0,6,2021-04-12,Male,59,55-64,16
20,0,0,0,0,2021-04-12,Male,37,35-44,18
20,0,1,0,1,2021-04-09,Female,43,35-44,15
20,1,0,0,1,2021-04-08,Female,36,35-44,2
20,0,0,0,0,2021-04-07,Male,52,45-54,17
20,2,0,0,2,2021-04-09,Male,8,5-9,12
20,0,0,0,0,2021-04-10,Female,46,45-54,18
20,3,2,0,5,2021-04-13,Male,68,65-69,13
20,0,0,3,3,2021-04-08,Male,42,35-44,13
20,0,0,0,0,2021-04-08,Male,63,55-64,13
20,1,0,0,1,2021-04-10,Male,55,55-64,17
20,1,0,0,1,2021-04-08,Female,52,45-54,14
20,2,0,0,2,2021-04-10,Female,70,70-74,16
20,0,0,0,0,2021-04-12,Female,66,65-69,14
20,3,0,0,3,2021-04-10,Male,18,15-19,17
20,0,3,0,3,2021-04-09,Male,55,55-64,17
20,1,0,0,1,2021-04-12,Male,58,55-64,2
20,3,0,0,3,2021-04-12,Female,60,55-64,14
20,1,0,0,1,2021-04-11,Female,36,35-44,12
20,0,0,0,0,2021-04-12,Male,60,55-64,12
20,2,0,0,2,2021-04-15,Female,51,45-54,8
20,0,0,0,0,2021-04-08,Male,31,25-34,15
20,1,0,0,1,2021-04-13,Female,21,20-24,17
20,3,1,0,4,2021-04-09,Female,56,55-64,12
20,3,0,0,3,2021-04-08,Female,67,65-69,15
20,0,0,0,0,2021-04-07,Male,52,45-54,18
20,1,0,0,1,2021-04-12,Female,59,55-64,6
20,0,0,0,0,2021-04-12,Male,65,65-69,15
20,3,1,6,10,2021-04-12,Female,50,45-54,11
20,1,0,0,1,2021-04-07,Male,48,45-54,14
20,0,0,0,0,2021-04-09,Male,60,55-64,16
20,1,0,0,1,2021-04-10,Male,69,65-69,15
20,0,5,0,5,2021-04-09,Male,31,25-34,17
20,0,0,0,0,2021-04-10,Male,36,35-44,16
20,1,0,0,1,2021-04-10,Female,69,65-69,17
20,0,1,0,1,2021-04-08,Female,26,25-34,17
20,4,3,0,7,2021-04-11,Female,28,25-34,10
20,0,0,0,0,2021-04-09,Female,24,20-24,6
20,1,0,0,1,2021-04-12,Female,60,55-64,16
20,0,0,29,29,2021-04-13,Male,41,35-44,13
20,0,1,0,1,2021-04-09,Male,66,65-69,20
20,1,0,0,1,2021-04-07,Male,53,45-54,12
20,0,1,0,1,2021-04-10,Male,70,70-74,13
20,0,3,0,3,2021-04-08,Female,24,20-24,4
20,0,0,0,0,2021-04-12,Female,66,65-69,20
20,1,1,0,2,2021-04-09,Male,70,70-74,17
20,1,0,0,1,2021-04-10,Male,34,25-34,9
20,0,0,0,0,2021-04-09,Female,65,65-69,16
20,1,0,0,1,2021-04-12,Male,79,75-79,15
20,2,5,0,7,2021-04-10,Male,72,70-74,12
20,0,0,0,0,2021-04-07,Female,6,5-9,5
20,0,0,0,0,2021-04-12,Male,68,65-69,14
20,2,0,0,2,2021-04-07,Female,26,25-34,7
20,1,0,0,1,2021-04-12,Female,68,65-69,14
20,0,0,0,0,2021-04-10,Female,65,65-69,16
20,1,0,0,1,2021-04-08,Male,59,55-64,20
20,2,1,0,3,2021-04-10,Male,70,70-74,19
20,1,0,0,1,2021-04-07,Male,39,35-44,7
20,1,0,0,1,2021-04-07,Male,51,45-54,19
20,1,0,0,1,2021-04-08,Female,26,25-34,6
20,0,1,0,1,2021-04-15,Male,8,5-9,9
20,1,1,0,2,2021-04-10,Male,72,70-74,16
20,0,1,0,1,2021-04-13,Female,78,75-79,12
20,0,5,0,5,2021-04-08,Female,53,45-54,10
20,1,0,0,1,2021-04-12,Female,64,55-64,15
20,2,0,0,2,2021-04-10,Female,19,15-19,18
20,2,9,0,11,2021-04-11,Female,23,20-24,4
20,1,5,0,6,2021-04-08,Female,39,35-44,18
20,1,0,0,1,2021-04-09,Female,58,55-64,18
20,1,0,0,1,2021-04-12,Male,78,75-79,13
20,0,2,0,2,2021-04-11,Male,40,35-44,17
20,0,0,0,0,2021-04-10,Male,67,65-69,15
20,0,0,0,0,2021-04-13,Female,32,25-34,4
20,1,0,0,1,2021-04-10,Female,67,65-69,15
20,1,0,0,1,2021-04-07,Female,68,65-69,19
20,3,0,0,3,2021-04-08,Female,17,15-19,15
20,2,0,0,2,2021-04-12,Male,67,65-69,6
20,0,0,0,0,2021-04-10,Female,29,25-34,18
20,4,0,0,4,2021-04-10,Female,32,25-34,16
20,1,0,0,1,2021-04-11,Female,64,55-64,13
20,0,0,0,0,2021-04-11,Female,33,25-34,15
20,1,0,0,1,2021-04-13,Male,19,15-19,9
20,0,0,0,0,2021-04-10,Female,47,45-54,15
20,1,0,0,1,2021-04-09,Male,65,65-69,13
20,0,0,0,0,2021-04-11,Female,68,65-69,17
20,3,0,0,3,2021-04-13,Female,16,15-19,15
20,2,0,0,2,2021-04-12,Female,50,45-54,13
20,0,0,0,0,2021-04-11,Male,23,20-24,14
20,0,0,0,0,2021-04-12,Male,59,55-64,15
20,0,0,0,0,2021-04-08,Male,2,1-4,10
20,1,0,0,1,2021-04-12,Male,60,55-64,16
20,0,1,0,1,2021-04-12,Female,60,55-64,5
20,2,0,0,2,2021-04-08,Male,26,25-34,17
20,0,0,0,0,2021-04-13,Female,23,20-24,5
20,2,0,0,2,2021-04-08,Male,57,55-64,14
20,0,0,0,0,2021-04-15,Male,51,45-54,5
20,2,2,0,4,2021-04-10,Male,70,70-74,15
20,2,0,0,2,2021-04-09,Male,70,70-74,18
20,0,0,0,0,2021-04-10,Male,52,45-54,12
20,2,11,0,13,2021-04-13,Male,31,25-34,16
20,2,0,0,2,2021-04-07,Female,0,<1,17
20,1,0,0,1,2021-04-12,Female,63,55-64,14
20,0,0,0,0,2021-04-10,Male,43,35-44,17
20,2,0,0,2,2021-04-07,Male,35,35-44,2
20,1,0,0,1,2021-04-11,Male,37,35-44,15
20,2,0,0,2,2021-04-12,Female,21,20-24,11
20,0,0,0,0,2021-04-07,Male,61,55-64,2
20,0,2,0,2,2021-04-09,Female,52,45-54,8
20,0,0,0,0,2021-04-10,Male,25,25-34,11
20,2,0,100,102,2021-04-13,Female,51,45-54,14
20,1,0,0,1,2021-04-13,Male,50,45-54,17
20,1,0,0,1,2021-04-10,Male,31,25-34,10
20,0,0,0,0,2021-04-11,Female,25,25-34,12
20,1,0,0,1,2021-04-11,Male,52,45-54,19
20,1,2,0,3,2021-04-11,Male,43,35-44,7
20,0,1,0,1,2021-04-08,Female,56,55-64,14
20,1,1,0,2,2021-04-08,Male,70,70-74,17
20,2,0,0,2,2021-04-07,Female,60,55-64,17
20,1,0,0,1,2021-04-12,Male,41,35-44,15
20,0,1,0,1,2021-04-12,Female,46,45-54,7
20,0,0,0,0,2021-04-10,Male,53,45-54,15
20,0,0,0,0,2021-04-12,Female,31,25-34,18
20,3,2,0,5,2021-04-12,Female,2,1-4,9
20,0,0,0,0,2021-04-07,Male,33,25-34,19
20,0,0,0,0,2021-04-10,Male,47,45-54,14
20,0,2,0,2,2021-04-07,Female,66,65-69,18
20,2,0,0,2,2021-04-12,Female,10,10-14,12
20,0,0,0,0,2021-04-10,Female,68,65-69,15
20,0,0,0,0,2021-04-10,Female,23,20-24,6
20,0,0,0,0,2021-04-08,Female,69,65-69,16
20,1,0,0,1,2021-04-09,Male,46,45-54,20
20,0,1,0,1,2021-04-09,Female,60,55-64,7
20,0,0,0,0,2021-04-12,Female,56,55-64,18
20,3,2,0,5,2021-04-11,Male,3,1-4,10
20,1,2,0,3,2021-04-11,Female,29,25-34,13
20,0,1,0,1,2021-04-08,Male,30,25-34,15
20,0,0,0,0,2021-04-11,Male,18,15-19,7
20,0,0,0,0,2021-04-09,Male,40,35-44,12
20,1,6,3,10,2021-04-07,Male,68,65-69,17
20,0,0,0,0,2021-04-10,Male,14,10-14,13
20,1,1,0,2,2021-04-15,Female,24,20-24,1
20,2,0,0,2,2021-04-10,Female,55,55-64,7
20,0,0,0,0,2021-04-10,Male,23,20-24,10
20,3,0,0,3,2021-04-10,Female,17,15-19,11
20,2,0,0,2,2021-04-12,Male,79,75-79,12
20,0,0,0,0,2021-04-08,Male,47,45-54,11
20,1,3,0,4,2021-04-11,Male,74,70-74,12
20,2,2,0,4,2021-04-08,Female,30,25-34,7
20,0,0,0,0,2021-04-12,Male,35,35-44,11
20,5,12,0,17,2021-04-08,Male,15,15-19,14
20,2,0,0,2,2021-04-12,Male,76,75-79,12
20,1,0,0,1,2021-04-08,Male,32,25-34,15
20,3,0,0,3,2021-04-13,Male,19,15-19,11
20,1,1,0,2,2021-04-09,Female,68,65-69,10
20,1,1,0,2,2021-04-09,Male,58,55-64,17
20,2,0,0,2,2021-04-07,Female,29,25-34,9
20,0,2,0,2,2021-04-10,Male,42,35-44,16
20,0,0,0,0,2021-04-12,Male,24,20-24,9
20,3,1,0,4,2021-04-11,Male,14,10-14,17
20,3,1,0,4,2021-04-08,Male,10,10-14,14
20,0,0,0,0,2021-04-12,Male,65,65-69,16
20,1,1,0,2,2021-04-12,Female,67,65-69,16
20,1,0,0,1,2021-04-12,Female,68,65-69,16
20,2,5,4,11,2021-04-12,Male,81,80-84,13
20,0,0,0,0,2021-04-12,Male,51,45-54,15
20,0,0,0,0,2021-04-08,Female,21,20-24,12
20,2,2,0,4,2021-04-10,Female,63,55-64,11
20,0,1,0,1,2021-04-08,Female,48,45-54,15
20,1,0,0,1,2021-04-13,Male,72,70-74,16
20,0,0,0,0,2021-04-13,Female,30,25-34,14
20,0,0,0,0,2021-04-08,Male,3,1-4,17
20,2,0,0,2,2021-04-12,Female,14,10-14,6
20,1,0,0,1,2021-04-08,Female,62,55-64,18
20,1,5,0,6,2021-04-09,Female,53,45-54,12
20,0,0,0,0,2021-04-12,Male,66,65-69,19
20,0,0,0,0,2021-04-09,Male,66,65-69,18
20,1,0,0,1,2021-04-07,Male,63,55-64,19
20,0,1,0,1,2021-04-12,Female,69,65-69,14
20,2,0,0,2,2021-04-10,Female,69,65-69,13
20,1,2,0,3,2021-04-09,Male,31,25-34,10
20,0,0,0,0,2021-04-11,Female,28,25-34,15
20,1,0,0,1,2021-04-09,Male,72,70-74,18
20,0,0,0,0,2021-04-09,Female,63,55-64,17
20,0,0,0,0,2021-04-09,Female,36,35-44,18
20,0,1,0,1,2021-04-11,Male,45,45-54,5
20,2,0,0,2,2021-04-10,Female,71,70-74,15
20,1,0,0,1,2021-04-09,Female,23,20-24,6
20,0,0,0,0,2021-04-13,Male,41,35-44,8
20,5,0,0,5,2021-04-07,Female,19,15-19,17
20,2,1,0,3,2021-04-08,Female,65,65-69,19
20,0,1,0,1,2021-04-09,Female,62,55-64,16
20,0,0,0,0,2021-04-11,Female,31,25-34,14
20,0,0,0,0,2021-04-13,Male,26,25-34,12
20,2,0,0,2,2021-04-08,Female,55,55-64,17
20,0,0,0,0,2021-04-09,Female,43,35-44,12
20,0,0,0,0,2021-04-12,Female,67,65-69,15
20,0,0,0,0,2021-04-08,Male,24,20-24,11
20,2,0,0,2,2021-04-12,Female,60,55-64,16
20,1,0,0,1,2021-04-07,Female,19,15-19,7
20,1,1,0,2,2021-04-08,Male,56,55-64,13
20,0,0,0,0,2021-04-07,Female,31,25-34,17
20,0,0,0,0,2021-04-07,Female,25,25-34,7
20,0,0,0,0,2021-04-08,Male,54,45-54,17
20,0,5,0,5,2021-04-09,Male,40,35-44,16
20,1,0,0,1,2021-04-15,Female,19,15-19,1
20,1,1,0,2,2021-04-12,Male,43,35-44,17
20,0,0,0,0,2021-04-12,Female,50,45-54,9
20,3,2,0,5,2021-04-09,Female,15,15-19,12
20,0,1,0,1,2021-04-13,Female,64,55-64,19
20,0,0,0,0,2021-04-08,Male,20,20-24,19
20,1,0,0,1,2021-04-07,Female,67,65-69,17
20,2,7,1,10,2021-04-13,Female,61,55-64,15
20,0,0,0,0,2021-04-09,Male,16,15-19,5
20,0,0,0,0,2021-04-09,Male,61,55-64,11
20,0,0,0,0,2021-04-09,Male,50,45-54,16
20,1,0,0,1,2021-04-08,Male,44,35-44,18
20,2,0,0,2,2021-04-07,Male,16,15-19,15
20,1,1,0,2,2021-04-08,Male,71,70-74,15
20,0,4,0,4,2021-04-10,Female,68,65-69,13
20,0,1,0,1,2021-04-12,Female,68,65-69,14
20,1,0,0,1,2021-04-10,Male,70,70-74,16
20,0,3,0,3,2021-04-09,Male,23,20-24,11
20,0,10,0,10,2021-04-10,Male,16,15-19,9
20,0,1,0,1,2021-04-10,Female,71,70-74,18
20,0,0,0,0,2021-04-09,Male,36,35-44,16
20,1,0,0,1,2021-04-11,Male,64,55-64,17
20,0,0,0,0,2021-04-08,Female,28,25-34,5
20,0,0,0,0,2021-04-07,Female,26,25-34,2
20,0,0,0,0,2021-04-10,Male,70,70-74,16
20,1,0,0,1,2021-04-15,Male,50,45-54,1
20,0,0,0,0,2021-04-12,Female,34,25-34,19
20,0,0,0,0,2021-04-08,Male,52,45-54,19
20,1,0,0,1,2021-04-09,Male,68,65-69,20
20,1,0,0,1,2021-04-08,Male,53,45-54,2
20,0,0,0,0,2021-04-10,Male,30,25-34,8
20,1,0,0,1,2021-04-09,Male,79,75-79,14
20,0,2,0,2,2021-04-15,Female,47,45-54,1
20,3,0,0,3,2021-04-13,Female,10,10-14,11
20,0,0,0,0,2021-04-07,Female,24,20-24,5
20,0,0,0,0,2021-04-08,Male,24,20-24,14
20,0,0,0,0,2021-04-08,Male,17,15-19,17
20,1,1,0,2,2021-04-13,Female,30,25-34,3
20,1,2,2,5,2021-04-07,Female,58,55-64,7
20,3,0,0,3,2021-04-12,Male,14,10-14,16
20,1,0,0,1,2021-04-07,Female,62,55-64,13
20,2,0,0,2,2021-04-12,Female,36,35-44,10
20,0,0,0,0,2021-04-07,Female,23,20-24,14
20,2,0,0,2,2021-04-12,Male,79,75-79,15
20,2,0,0,2,2021-04-07,Male,53,45-54,17
20,2,30,0,32,2021-04-13,Female,48,45-54,4
20,1,0,0,1,2021-04-12,Male,67,65-69,11
20,1,0,0,1,2021-04-09,Male,52,45-54,15
20,0,1,0,1,2021-04-09,Male,52,45-54,13
20,3,1,0,4,2021-04-11,Female,43,35-44,19
20,1,1,0,2,2021-04-11,Female,71,70-74,15
20,1,0,0,1,2021-04-10,Female,66,65-69,9
20,1,0,0,1,2021-04-08,Female,24,20-24,18
20,0,4,0,4,2021-04-12,Female,72,70-74,13
20,0,0,0,0,2021-04-10,Male,32,25-34,14
20,0,0,0,0,2021-04-09,Female,65,65-69,20
20,2,0,0,2,2021-04-07,Male,14,10-14,16
20,1,0,0,1,2021-04-09,Male,70,70-74,12
20,2,0,0,2,2021-04-09,Male,71,70-74,7
20,0,0,0,0,2021-04-10,Female,69,65-69,14
20,2,0,0,2,2021-04-07,Male,33,25-34,16
20,4,0,0,4,2021-04-14,Female,10,10-14,15
20,1,0,0,1,2021-04-15,Female,32,25-34,7
20,3,0,0,3,2021-04-08,Female,3,1-4,17
20,1,1,0,2,2021-04-12,Male,60,55-64,11
20,1,0,0,1,2021-04-11,Male,39,35-44,11
20,0,0,0,0,2021-04-12,Male,45,45-54,15
20,0,0,0,0,2021-04-08,Male,8,5-9,7
20,0,0,0,0,2021-04-08,Female,54,45-54,18
20,0,0,0,0,2021-04-09,Female,58,55-64,6
20,0,0,0,0,2021-04-09,Female,41,35-44,19
20,0,0,0,0,2021-04-15,Male,20,20-24,1
20,2,0,0,2,2021-04-09,Female,12,10-14,4
20,0,0,0,0,2021-04-14,Female,64,55-64,17
20,0,0,0,0,2021-04-08,Male,40,35-44,12
20,3,0,0,3,2021-04-07,Female,12,10-14,14
20,0,1,0,1,2021-04-07,Male,23,20-24,11
20,1,0,0,1,2021-04-09,Female,52,45-54,20
20,0,0,0,0,2021-04-09,Male,40,35-44,16
20,3,0,0,3,2021-04-09,Male,19,15-19,16
20,0,2,0,2,2021-04-12,Male,78,75-79,19
20,0,0,0,0,2021-04-15,Female,29,25-34,1
20,0,0,0,0,2021-04-08,Male,44,35-44,13
20,0,0,0,0,2021-04-07,Female,22,20-24,6
20,1,0,0,1,2021-04-09,Male,67,65-69,20
20,2,3,0,5,2021-04-12,Female,67,65-69,19
20,0,0,0,0,2021-04-12,Female,66,65-69,13
20,1,0,0,1,2021-04-12,Male,2,1-4,12
20,0,0,0,0,2021-04-13,Male,48,45-54,19
20,1,0,0,1,2021-04-12,Male,65,65-69,12
20,0,0,0,0,2021-04-09,Male,40,35-44,17
20,1,5,0,6,2021-04-09,Female,66,65-69,20
20,0,0,0,0,2021-04-09,Male,38,35-44,17
20,0,0,0,0,2021-04-07,Male,31,25-34,17
20,2,1,0,3,2021-04-11,Female,61,55-64,15
20,0,1,0,1,2021-04-08,Female,54,45-54,16
20,0,0,0,0,2021-04-12,Male,58,55-64,10
20,1,0,0,1,2021-04-09,Female,68,65-69,18
20,3,2,0,5,2021-04-12,Female,9,5-9,10
20,1,2,0,3,2021-04-08,Male,49,45-54,13
20,2,0,0,2,2021-04-10,Female,44,35-44,12
20,0,0,0,0,2021-04-11,Male,36,35-44,19
20,0,2,0,2,2021-04-07,Female,19,15-19,9
20,1,0,0,1,2021-04-12,Male,64,55-64,17
20,0,0,0,0,2021-04-11,Male,41,35-44,18
20,3,0,0,3,2021-04-07,Female,12,10-14,12
20,0,0,0,0,2021-04-09,Male,35,35-44,12
20,1,0,0,1,2021-04-10,Male,69,65-69,11
20,2,0,0,2,2021-04-09,Female,14,10-14,20
20,1,1,0,2,2021-04-12,Male,67,65-69,8
20,0,0,0,0,2021-04-12,Female,59,55-64,17
20,2,0,0,2,2021-04-10,Female,52,45-54,16
20,1,0,0,1,2021-04-09,Female,35,35-44,14
20,1,0,0,1,2021-04-11,Female,58,55-64,12
20,1,5,0,6,2021-04-08,Male,56,55-64,4
20,1,0,0,1,2021-04-12,Female,60,55-64,18
20,0,0,0,0,2021-04-08,Male,10,10-14,17
20,1,0,0,1,2021-04-10,Male,16,15-19,16
20,1,0,0,1,2021-04-12,Female,62,55-64,8
20,1,0,0,1,2021-04-12,Male,66,65-69,16
20,0,0,0,0,2021-04-09,Female,17,15-19,18
20,2,0,0,2,2021-04-15,Female,24,20-24,1
20,1,0,0,1,2021-04-12,Male,55,55-64,9
20,1,0,0,1,2021-04-15,Female,21,20-24,1
20,0,0,0,0,2021-04-09,Female,22,20-24,15
20,2,0,0,2,2021-04-09,Female,18,15-19,13
20,1,1,0,2,2021-04-10,Female,70,70-74,10
20,0,0,0,0,2021-04-12,Female,67,65-69,12
20,0,1,0,1,2021-04-09,Female,54,45-54,17
20,1,0,0,1,2021-04-12,Male,75,75-79,12
20,0,0,0,0,2021-04-08,Male,39,35-44,17
20,3,0,0,3,2021-04-13,Male,19,15-19,13
20,0,0,0,0,2021-04-07,Male,36,35-44,14
20,2,0,0,2,2021-04-12,Female,17,15-19,15
20,1,2,0,3,2021-04-10,Male,66,65-69,16
20,3,0,0,3,2021-04-09,Female,0,<1,11
20,1,4,0,5,2021-04-08,Female,25,25-34,7
20,0,1,0,1,2021-04-10,Female,65,65-69,14
20,1,0,0,1,2021-04-15,Female,38,35-44,1
20,1,1,0,2,2021-04-08,Female,55,55-64,9
20,1,0,0,1,2021-04-11,Male,52,45-54,11
20,1,0,0,1,2021-04-12,Female,68,65-69,12
20,0,0,0,0,2021-04-07,Male,53,45-54,19
20,1,0,0,1,2021-04-07,Female,41,35-44,12
20,0,1,0,1,2021-04-08,Female,31,25-34,16
20,1,0,0,1,2021-04-08,Male,57,55-64,14
20,1,2,0,3,2021-04-12,Male,66,65-69,14
20,2,8,0,10,2021-04-12,Male,67,65-69,17
20,0,1,0,1,2021-04-11,Female,58,55-64,7
20,2,0,0,2,2021-04-13,Female,76,75-79,12
20,2,0,0,2,2021-04-11,Female,8,5-9,16
20,1,0,0,1,2021-04-11,Female,29,25-34,12
20,2,0,0,2,2021-04-10,Male,12,10-14,15
20,0,0,0,0,2021-04-08,Female,11,10-14,14
20,0,0,0,0,2021-04-12,Female,71,70-74,7
20,0,6,0,6,2021-04-10,Female,69,65-69,17
20,0,0,0,0,2021-04-07,Male,73,70-74,16
20,0,0,1,1,2021-04-08,Female,21,20-24,9
20,0,0,0,0,2021-04-08,Male,5,5-9,6
20,0,1,0,1,2021-04-12,Male,63,55-64,14
20,2,0,0,2,2021-04-10,Male,69,65-69,17
20,0,2,0,2,2021-04-12,Female,29,25-34,7
20,0,0,2,2,2021-04-12,Male,45,45-54,16
20,1,0,0,1,2021-04-08,Male,55,55-64,14
20,2,1,0,3,2021-04-07,Male,15,15-19,18
20,1,0,0,1,2021-04-11,Female,69,65-69,14
20,2,2,0,4,2021-04-09,Female,63,55-64,13
20,2,0,0,2,2021-04-12,Female,74,70-74,9
20,1,0,0,1,2021-04-11,Female,68,65-69,17
20,1,3,0,4,2021-04-08,Male,55,55-64,20
20,1,0,0,1,2021-04-07,Female,62,55-64,19
20,0,0,0,0,2021-04-13,Male,67,65-69,14
20,0,0,0,0,2021-04-07,Female,4,1-4,10
20,0,0,0,0,2021-04-07,Male,55,55-64,10
20,2,0,0,2,2021-04-09,Female,62,55-64,19
20,1,1,0,2,2021-04-09,Male,53,45-54,19
20,0,0,0,0,2021-04-10,Female,51,45-54,10
20,0,3,0,3,2021-04-13,Female,66,65-69,18
20,4,0,0,4,2021-04-08,Female,46,45-54,11
20,0,0,0,0,2021-04-12,Male,66,65-69,17
20,1,1,0,2,2021-04-09,Female,59,55-64,16
20,1,0,0,1,2021-04-08,Male,25,25-34,5
20,0,0,1,1,2021-04-13,Female,68,65-69,15
20,3,0,0,3,2021-04-09,Female,14,10-14,15
20,2,0,0,2,2021-04-11,Male,11,10-14,14
20,1,0,0,1,2021-04-09,Female,63,55-64,18
20,0,9,0,9,2021-04-12,Female,52,45-54,18
20,0,2,0,2,2021-04-07,Female,62,55-64,16
20,2,0,0,2,2021-04-08,Female,53,45-54,16
20,2,0,0,2,2021-04-08,Female,48,45-54,17
20,1,0,0,1,2021-04-12,Male,67,65-69,16
20,0,0,0,0,2021-04-09,Female,31,25-34,7
20,1,1,0,2,2021-04-13,Male,58,55-64,11
20,1,1,0,2,2021-04-08,Male,59,55-64,19
20,0,0,0,0,2021-04-08,Female,44,35-44,19
20,2,0,0,2,2021-04-12,Male,22,20-24,12
20,1,0,0,1,2021-04-09,Male,72,70-74,15
20,0,1,0,1,2021-04-12,Female,64,55-64,11
20,2,1,0,3,2021-04-12,Male,21,20-24,17
20,1,0,0,1,2021-04-10,Female,67,65-69,12
20,1,0,0,1,2021-04-08,Male,58,55-64,19
20,0,0,0,0,2021-04-07,Male,52,45-54,2
20,1,6,0,7,2021-04-12,Male,67,65-69,14
20,0,0,0,0,2021-04-08,Male,17,15-19,16
20,3,0,0,3,2021-04-12,Male,4,1-4,16
20,0,0,0,0,2021-04-08,Male,22,20-24,16
20,0,0,0,0,2021-04-09,Male,50,45-54,15
20,0,0,0,0,2021-04-12,Male,57,55-64,11
20,2,0,12,14,2021-04-09,Female,26,25-34,19
20,2,0,0,2,2021-04-11,Male,30,25-34,18
20,0,0,0,0,2021-04-09,Male,34,25-34,14
20,2,0,0,2,2021-04-08,Male,71,70-74,12
20,2,2,0,4,2021-04-09,Female,11,10-14,15
20,1,0,0,1,2021-04-10,Female,69,65-69,17
20,1,0,0,1,2021-04-12,Male,66,65-69,12
20,0,0,0,0,2021-04-08,Male,67,65-69,16
20,2,0,0,2,2021-04-13,Female,68,65-69,12
20,0,0,0,0,2021-04-08,Male,35,35-44,15
20,0,0,0,0,2021-04-11,Female,50,45-54,12
20,2,0,0,2,2021-04-11,Male,42,35-44,17
20,0,3,0,3,2021-04-13,Female,77,75-79,10
20,3,0,6,9,2021-04-10,Female,2,1-4,16
20,1,0,0,1,2021-04-12,Female,62,55-64,12
20,1,0,0,1,2021-04-10,Male,68,65-69,17
20,4,0,0,4,2021-04-07,Male,7,5-9,20
20,0,0,0,0,2021-04-15,Female,0,<1,1
20,0,0,0,0,2021-04-15,Male,24,20-24,1
20,1,0,0,1,2021-04-07,Male,30,25-34,2
20,2,2,0,4,2021-04-07,Female,3,1-4,15
20,2,0,0,2,2021-04-08,Female,31,25-34,14
20,2,0,0,2,2021-04-07,Male,52,45-54,15
20,1,1,0,2,2021-04-11,Female,68,65-69,12
20,0,0,0,0,2021-04-10,Male,43,35-44,1
20,0,0,0,0,2021-04-11,Male,61,55-64,16
20,1,3,1,5,2021-04-10,Female,62,55-64,16
20,0,2,0,2,2021-04-08,Male,62,55-64,2
20,1,2,0,3,2021-04-13,Male,66,65-69,18
20,1,0,0,1,2021-04-12,Female,39,35-44,14
20,3,4,0,7,2021-04-07,Male,53,45-54,19
20,0,0,0,0,2021-04-09,Male,51,45-54,14
20,1,0,0,1,2021-04-11,Female,27,25-34,6
20,0,0,0,0,2021-04-15,Female,21,20-24,1
20,1,10,0,11,2021-04-08,Male,54,45-54,15
20,0,0,0,0,2021-04-09,Female,60,55-64,14
20,1,1,0,2,2021-04-09,Female,54,45-54,19
20,1,0,0,1,2021-04-11,Male,32,25-34,16
20,0,0,0,0,2021-04-07,Female,49,45-54,16
20,4,2,0,6,2021-04-13,Female,42,35-44,10
20,1,0,0,1,2021-04-08,Male,67,65-69,17
20,0,0,0,0,2021-04-08,Male,41,35-44,17
20,2,0,0,2,2021-04-12,Male,49,45-54,16
20,0,0,0,0,2021-04-07,Male,42,35-44,20
20,0,0,0,0,2021-04-09,Male,67,65-69,19
20,0,5,0,5,2021-04-10,Female,31,25-34,2
20,0,0,0,0,2021-04-10,Female,34,25-34,16
20,2,0,0,2,2021-04-15,Female,4,1-4,1
20,1,0,0,1,2021-04-11,Male,63,55-64,15
20,0,0,0,0,2021-04-10,Female,69,65-69,16
20,4,10,0,14,2021-04-11,Male,3,1-4,17
20,0,1,0,1,2021-04-09,Male,58,55-64,18
20,1,1,0,2,2021-04-08,Male,47,45-54,15
20,3,0,0,3,2021-04-08,Male,11,10-14,6
20,0,1,0,1,2021-04-13,Female,34,25-34,15
20,1,0,0,1,2021-04-12,Male,62,55-64,8
20,1,0,0,1,2021-04-09,Male,62,55-64,20
20,2,0,0,2,2021-04-10,Female,24,20-24,9
20,0,3,0,3,2021-04-07,Female,67,65-69,20
20,3,0,0,3,2021-04-12,Female,39,35-44,15
20,2,0,0,2,2021-04-13,Male,77,75-79,14
20,0,0,0,0,2021-04-07,Female,37,35-44,16
20,1,0,0,1,2021-04-12,Male,67,65-69,15
20,4,0,0,4,2021-04-09,Female,15,15-19,10
20,2,0,0,2,2021-04-11,Male,51,45-54,12
20,2,0,0,2,2021-04-09,Female,66,65-69,14
20,0,0,0,0,2021-04-08,Male,27,25-34,16
20,0,1,0,1,2021-04-08,Male,48,45-54,17
20,0,0,0,0,2021-04-07,Male,52,45-54,17
20,1,0,0,1,2021-04-10,Male,72,70-74,7
20,2,0,0,2,2021-04-09,Male,24,20-24,13
20,0,1,0,1,2021-04-07,Male,29,25-34,6
20,4,0,0,4,2021-04-10,Female,1,1-4,11
20,2,0,0,2,2021-04-08,Female,13,10-14,13
20,0,0,0,0,2021-04-09,Male,62,55-64,15
20,0,0,0,0,2021-04-09,Female,31,25-34,6
20,2,0,0,2,2021-04-07,Male,12,10-14,19
20,1,1,0,2,2021-04-11,Male,71,70-74,4
20,2,0,0,2,2021-04-09,Female,63,55-64,16
20,1,0,0,1,2021-04-09,Male,45,45-54,11
20,0,0,100,100,2021-04-11,Male,43,35-44,19
20,2,2,0,4,2021-04-12,Female,64,55-64,20
20,1,0,0,1,2021-04-12,Female,74,70-74,18
20,0,1,0,1,2021-04-12,Male,54,45-54,12
20,0,0,0,0,2021-04-13,Male,77,75-79,10
20,0,0,0,0,2021-04-11,Female,54,45-54,15
20,1,10,0,11,2021-04-15,Female,54,45-54,1
20,2,0,0,2,2021-04-12,Male,7,5-9,13
20,3,0,0,3,2021-04-15,Female,21,20-24,1
20,2,0,0,2,2021-04-08,Female,13,10-14,16
20,1,0,0,1,2021-04-07,Female,51,45-54,16
20,0,0,0,0,2021-04-09,Female,27,25-34,12
20,0,0,0,0,2021-04-10,Male,57,55-64,16
20,0,2,0,2,2021-04-07,Female,43,35-44,7
20,0,2,0,2,2021-04-13,Female,62,55-64,12
20,0,0,0,0,2021-04-10,Female,59,55-64,15
20,1,0,0,1,2021-04-13,Male,57,55-64,13
20,2,0,0,2,2021-04-10,Male,66,65-69,19
20,1,0,0,1,2021-04-12,Female,54,45-54,9
20,1,0,0,1,2021-04-08,Female,34,25-34,9
20,3,0,0,3,2021-04-08,Female,34,25-34,10
20,0,0,4,4,2021-04-07,Female,36,35-44,5
20,2,0,0,2,2021-04-10,Male,71,70-74,10
20,1,0,0,1,2021-04-10,Male,61,55-64,19
20,0,0,0,0,2021-04-10,Male,66,65-69,19
20,1,0,0,1,2021-04-08,Female,56,55-64,11
20,1,1,0,2,2021-04-11,Female,53,45-54,6
20,1,0,0,1,2021-04-08,Female,59,55-64,18
20,2,0,0,2,2021-04-12,Male,73,70-74,15
20,2,0,0,2,2021-04-09,Male,73,70-74,11
20,2,0,0,2,2021-04-10,Male,34,25-34,14
20,0,0,0,0,2021-04-15,Male,47,45-54,7
20,1,0,0,1,2021-04-13,Female,47,45-54,11
20,0,1,0,1,2021-04-08,Female,22,20-24,11
20,0,0,0,0,2021-04-12,Male,63,55-64,15
20,0,0,0,0,2021-04-10,Male,25,25-34,12
20,0,0,0,0,2021-04-08,Male,38,35-44,9
20,0,0,0,0,2021-04-09,Female,69,65-69,15
20,2,0,0,2,2021-04-08,Female,65,65-69,15
20,0,0,0,0,2021-04-08,Male,54,45-54,17
20,0,3,0,3,2021-04-11,Female,35,35-44,12
20,0,1,0,1,2021-04-08,Male,56,55-64,17
20,1,1,0,2,2021-04-08,Female,56,55-64,18
20,0,2,0,2,2021-04-10,Female,67,65-69,19
20,2,0,0,2,2021-04-10,Male,42,35-44,11
20,1,3,0,4,2021-04-12,Male,72,70-74,14
20,1,2,2,5,2021-04-12,Male,66,65-69,14
20,1,0,0,1,2021-04-13,Female,24,20-24,6
20,1,1,0,2,2021-04-10,Female,73,70-74,12
20,0,0,0,0,2021-04-08,Male,31,25-34,13
20,0,0,1,1,2021-04-15,Male,31,25-34,1
20,0,0,0,0,2021-04-10,Male,71,70-74,15
20,2,0,0,2,2021-04-12,Female,70,70-74,16
20,0,0,0,0,2021-04-11,Female,71,70-74,15
20,0,4,0,4,2021-04-08,Male,67,65-69,20
20,0,0,0,0,2021-04-10,Female,26,25-34,15
20,0,0,0,0,2021-04-08,Female,56,55-64,11
20,0,0,0,0,2021-04-09,Female,74,70-74,13
20,2,0,0,2,2021-04-12,Male,81,80-84,15
20,0,0,0,0,2021-04-10,Male,61,55-64,14
20,0,3,0,3,2021-04-10,Female,67,65-69,6
20,1,1,0,2,2021-04-07,Male,63,55-64,18
20,0,0,0,0,2021-04-07,Male,38,35-44,19
20,0,7,0,7,2021-04-12,Female,68,65-69,12
20,1,0,0,1,2021-04-11,Female,28,25-34,18
20,4,1,0,5,2021-04-14,Female,47,45-54,8
20,0,0,0,0,2021-04-11,Female,15,15-19,16
20,0,0,0,0,2021-04-08,Male,54,45-54,16
20,3,0,0,3,2021-04-13,Male,3,1-4,20
20,3,10,0,13,2021-04-07,Male,1,1-4,2
20,0,0,0,0,2021-04-15,Male,8,5-9,1
20,2,0,0,2,2021-04-08,Male,19,15-19,11
20,3,0,0,3,2021-04-08,Female,12,10-14,2
20,1,0,0,1,2021-04-07,Male,35,35-44,19
20,0,2,0,2,2021-04-10,Female,72,70-74,18
20,0,0,0,0,2021-04-09,Female,26,25-34,12
20,3,0,0,3,2021-04-07,Male,34,25-34,14
20,3,2,0,5,2021-04-12,Male,41,35-44,17
20,0,0,0,0,2021-04-08,Female,63,55-64,7
20,2,2,0,4,2021-04-13,Female,35,35-44,12
20,1,0,0,1,2021-04-13,Male,32,25-34,15
20,0,3,0,3,2021-04-07,Female,43,35-44,17
20,2,0,0,2,2021-04-10,Female,72,70-74,13
20,0,0,0,0,2021-04-11,Male,59,55-64,14
20,1,1,0,2,2021-04-13,Male,54,45-54,15
20,1,2,0,3,2021-04-13,Male,20,20-24,2
20,3,0,0,3,2021-04-07,Female,36,35-44,19
20,1,0,0,1,2021-04-07,Female,59,55-64,18
20,1,0,0,1,2021-04-08,Male,67,65-69,18
20,0,0,0,0,2021-04-15,Female,9,5-9,1
20,1,0,0,1,2021-04-08,Male,28,25-34,6
20,3,0,0,3,2021-04-10,Male,49,45-54,11
20,0,0,0,0,2021-04-12,Female,58,55-64,16
20,0,0,0,0,2021-04-12,Male,76,75-79,14
20,0,1,1,2,2021-04-08,Female,49,45-54,6
20,0,0,0,0,2021-04-09,Male,52,45-54,18
20,1,0,0,1,2021-04-12,Female,76,75-79,12
20,0,1,0,1,2021-04-12,Male,25,25-34,9
20,1,0,0,1,2021-04-13,Female,64,55-64,11
20,2,0,0,2,2021-04-11,Male,65,65-69,16
20,3,0,0,3,2021-04-10,Male,18,15-19,10
20,0,0,0,0,2021-04-10,Male,31,25-34,3
20,3,0,0,3,2021-04-10,Female,18,15-19,14
20,0,0,0,0,2021-04-08,Male,37,35-44,7
20,0,0,0,0,2021-04-12,Male,36,35-44,6
20,0,0,0,0,2021-04-09,Female,66,65-69,19
20,2,0,0,2,2021-04-08,Female,15,15-19,9
20,0,0,0,0,2021-04-07,Male,19,15-19,6
20,0,2,0,2,2021-04-08,Female,54,45-54,15
20,1,0,0,1,2021-04-07,Female,46,45-54,17
20,1,3,0,4,2021-04-10,Male,71,70-74,14
20,0,0,0,0,2021-04-08,Male,54,45-54,15
20,0,0,0,0,2021-04-11,Female,63,55-64,17
20,1,1,0,2,2021-04-08,Female,26,25-34,5
20,1,2,0,3,2021-04-10,Female,71,70-74,19
20,1,1,0,2,2021-04-08,Female,53,45-54,7
20,1,0,0,1,2021-04-09,Male,35,35-44,9
20,2,0,0,2,2021-04-13,Female,63,55-64,11
20,1,0,7,8,2021-04-12,Male,74,70-74,12
20,1,0,0,1,2021-04-12,Female,78,75-79,6
20,1,1,0,2,2021-04-07,Male,28,25-34,20
20,1,0,0,1,2021-04-08,Female,31,25-34,14
20,2,4,0,6,2021-04-10,Male,42,35-44,17
20,3,0,0,3,2021-04-15,Female,4,1-4,1
20,0,0,0,0,2021-04-09,Male,71,70-74,18
20,0,12,0,12,2021-04-09,Female,68,65-69,20
20,0,1,0,1,2021-04-10,Female,62,55-64,17
20,1,4,0,5,2021-04-11,Male,73,70-74,7
20,2,0,0,2,2021-04-09,Male,27,25-34,14
20,0,0,0,0,2021-04-10,Male,9,5-9,15
20,0,0,0,0,2021-04-08,Female,34,25-34,16
20,1,0,0,1,2021-04-10,Male,69,65-69,19
20,0,2,0,2,2021-04-11,Male,68,65-69,9
20,0,0,0,0,2021-04-09,Female,40,35-44,7
20,1,10,0,11,2021-04-08,Male,69,65-69,18
20,0,0,0,0,2021-04-11,Male,19,15-19,7
20,0,0,0,0,2021-04-10,Male,34,25-34,16
20,3,0,0,3,2021-04-09,Male,16,15-19,13
20,0,0,0,0,2021-04-07,Female,78,75-79,17
20,0,0,0,0,2021-04-08,Female,56,55-64,19
20,3,0,0,3,2021-04-08,Female,53,45-54,15
20,3,0,0,3,2021-04-15,Female,3,1-4,10
20,1,2,0,3,2021-04-08,Male,66,65-69,15
20,1,0,0,1,2021-04-08,Male,56,55-64,14
20,3,0,0,3,2021-04-13,Male,9,5-9,14
20,1,0,0,1,2021-04-11,Male,42,35-44,13
20,0,0,0,0,2021-04-08,Female,54,45-54,12
20,0,0,0,0,2021-04-12,Female,55,55-64,12
20,0,0,0,0,2021-04-07,Female,60,55-64,20
20,3,0,0,3,2021-04-12,Female,1,1-4,16
20,1,10,2,13,2021-04-09,Female,60,55-64,14
20,2,0,0,2,2021-04-08,Female,56,55-64,16
20,1,1,0,2,2021-04-12,Female,60,55-64,19
20,2,0,0,2,2021-04-09,Male,60,55-64,15
20,0,0,0,0,2021-04-12,Male,70,70-74,19
20,3,0,0,3,2021-04-10,Male,48,45-54,11
20,0,20,0,20,2021-04-08,Female,54,45-54,15
20,1,0,0,1,2021-04-13,Male,61,55-64,12
20,1,0,0,1,2021-04-12,Female,52,45-54,18
20,1,0,0,1,2021-04-09,Male,69,65-69,14
20,2,2,0,4,2021-04-09,Male,71,70-74,15
20,2,3,0,5,2021-04-12,Female,67,65-69,10
20,2,0,0,2,2021-04-07,Male,52,45-54,13
20,1,1,0,2,2021-04-13,Male,70,70-74,16
20,3,0,0,3,2021-04-09,Female,15,15-19,16
20,1,0,0,1,2021-04-07,Female,65,65-69,19
20,8,0,0,8,2021-04-07,Female,45,45-54,13
20,3,0,0,3,2021-04-09,Female,13,10-14,6
20,4,0,0,4,2021-04-12,Male,11,10-14,8
20,0,0,0,0,2021-04-11,Male,58,55-64,12
20,1,0,1,2,2021-04-13,Female,28,25-34,5
20,1,0,4,5,2021-04-12,Female,48,45-54,12
20,0,6,0,6,2021-04-13,Female,59,55-64,6
20,0,0,0,0,2021-04-09,Male,60,55-64,13
20,0,0,0,0,2021-04-08,Female,56,55-64,17
20,0,0,0,0,2021-04-08,Female,64,55-64,16
20,0,0,0,0,2021-04-08,Male,36,35-44,13
20,0,0,0,0,2021-04-13,Male,37,35-44,15
20,1,1,0,2,2021-04-07,Male,18,15-19,7
20,2,0,0,2,2021-04-09,Male,64,55-64,14
20,2,1,0,3,2021-04-13,Male,51,45-54,12
20,1,0,0,1,2021-04-13,Male,74,70-74,12
20,2,0,1,3,2021-04-12,Female,52,45-54,14
20,2,3,0,5,2021-04-07,Female,74,70-74,12
20,1,0,0,1,2021-04-13,Female,18,15-19,16
20,0,2,0,2,2021-04-09,Male,61,55-64,16
20,1,0,0,1,2021-04-08,Female,55,55-64,13
20,2,1,0,3,2021-04-09,Male,19,15-19,7
20,1,2,0,3,2021-04-07,Male,50,45-54,7
20,0,0,0,0,2021-04-08,Male,54,45-54,11
20,1,0,0,1,2021-04-12,Male,52,45-54,6
20,2,1,0,3,2021-04-07,Female,65,65-69,18
20,0,0,0,0,2021-04-12,Male,79,75-79,10
20,1,0,0,1,2021-04-11,Male,62,55-64,17
20,0,0,0,0,2021-04-09,Male,17,15-19,9
20,0,0,0,0,2021-04-07,Male,53,45-54,15
20,1,0,0,1,2021-04-11,Female,51,45-54,13
20,0,0,0,0,2021-04-10,Female,61,55-64,16
20,3,0,0,3,2021-04-08,Male,10,10-14,19
20,1,0,0,1,2021-04-10,Female,27,25-34,7
20,0,0,0,0,2021-04-13,Male,40,35-44,13
20,3,0,0,3,2021-04-09,Female,2,1-4,5
20,0,0,0,0,2021-04-12,Female,66,65-69,18
20,0,0,0,0,2021-04-11,Male,64,55-64,10
20,0,0,0,0,2021-04-09,Male,37,35-44,16
20,0,1,0,1,2021-04-08,Female,24,20-24,11
20,1,0,0,1,2021-04-12,Female,64,55-64,14
20,0,1,0,1,2021-04-12,Female,68,65-69,19
20,0,0,0,0,2021-04-09,Female,44,35-44,11
20,0,0,0,0,2021-04-09,Female,68,65-69,17
20,0,1,0,1,2021-04-13,Male,33,25-34,9
20,1,1,0,2,2021-04-10,Male,38,35-44,11
20,0,0,0,0,2021-04-13,Female,6,5-9,7
20,0,5,0,5,2021-04-10,Female,46,45-54,10
20,1,0,0,1,2021-04-08,Female,34,25-34,16
20,1,0,0,1,2021-04-10,Female,52,45-54,19
20,0,0,0,0,2021-04-13,Female,24,20-24,17
20,3,0,0,3,2021-04-07,Female,55,55-64,11
20,0,0,0,0,2021-04-10,Female,19,15-19,15
20,0,0,0,0,2021-04-07,Female,44,35-44,15
20,1,0,0,1,2021-04-13,Male,67,65-69,11
20,2,0,0,2,2021-04-08,Female,63,55-64,17
20,0,7,0,7,2021-04-14,Female,51,45-54,13
20,0,1,0,1,2021-04-12,Male,42,35-44,4
20,0,0,0,0,2021-04-12,Female,67,65-69,17
20,1,0,0,1,2021-04-11,Female,73,70-74,15
20,1,0,0,1,2021-04-12,Male,36,35-44,11
20,0,0,0,0,2021-04-09,Male,58,55-64,19
20,0,0,0,0,2021-04-13,Female,24,20-24,13
20,1,1,0,2,2021-04-12,Male,79,75-79,15
20,2,2,0,4,2021-04-12,Female,7,5-9,15
20,1,5,0,6,2021-04-11,Male,44,35-44,12
20,2,1,0,3,2021-04-13,Female,63,55-64,14
20,0,0,0,0,2021-04-15,Female,52,45-54,13
20,2,3,0,5,2021-04-10,Male,69,65-69,17
20,1,50,0,51,2021-04-08,Female,56,55-64,17
20,2,0,0,2,2021-04-13,Female,61,55-64,11
20,0,0,0,0,2021-04-10,Male,44,35-44,10
20,1,0,0,1,2021-04-12,Female,61,55-64,15
20,1,3,0,4,2021-04-09,Male,68,65-69,14
20,1,0,0,1,2021-04-12,Male,64,55-64,20
20,2,2,0,4,2021-04-10,Male,73,70-74,17
20,1,0,0,1,2021-04-12,Female,65,65-69,16
20,2,0,0,2,2021-04-08,Male,54,45-54,15
20,0,23,0,23,2021-04-12,Female,67,65-69,15
20,0,0,0,0,2021-04-08,Male,29,25-34,5
20,2,0,0,2,2021-04-10,Female,72,70-74,16
20,1,1,0,2,2021-04-08,Female,50,45-54,19
20,0,0,0,0,2021-04-07,Female,34,25-34,15
20,2,0,0,2,2021-04-12,Female,1,1-4,11
20,1,0,0,1,2021-04-15,Female,51,45-54,13
20,0,0,0,0,2021-04-08,Female,41,35-44,19
20,0,0,0,0,2021-04-10,Male,22,20-24,19
20,0,0,0,0,2021-04-07,Male,55,55-64,19
20,0,4,0,4,2021-04-12,Female,36,35-44,18
20,3,0,0,3,2021-04-09,Female,5,5-9,16
20,1,0,0,1,2021-04-09,Male,55,55-64,16
20,2,2,0,4,2021-04-13,Male,62,55-64,17
20,1,0,0,1,2021-04-11,Female,20,20-24,6
20,1,4,0,5,2021-04-09,Female,57,55-64,15
20,0,0,0,0,2021-04-13,Female,68,65-69,15
20,0,0,0,0,2021-04-10,Female,71,70-74,18
20,1,1,0,2,2021-04-12,Male,74,70-74,20
20,1,0,0,1,2021-04-13,Female,66,65-69,15
20,3,0,0,3,2021-04-07,Male,10,10-14,7
20,0,3,0,3,2021-04-12,Male,73,70-74,17
20,1,0,0,1,2021-04-10,Female,40,35-44,5
20,0,0,0,0,2021-04-12,Male,67,65-69,7
20,0,0,0,0,2021-04-09,Female,38,35-44,17
20,3,0,0,3,2021-04-12,Female,13,10-14,11
20,1,0,0,1,2021-04-12,Male,66,65-69,13
20,1,0,0,1,2021-04-11,Female,61,55-64,17
20,1,3,0,4,2021-04-12,Female,66,65-69,13
20,3,0,0,3,2021-04-12,Female,14,10-14,17
20,0,0,0,0,2021-04-15,Female,51,45-54,14
20,3,11,0,14,2021-04-12,Female,12,10-14,7
20,0,1,0,1,2021-04-12,Female,51,45-54,9
20,0,1,0,1,2021-04-11,Male,22,20-24,15
20,3,0,0,3,2021-04-11,Female,2,1-4,14
20,0,0,7,7,2021-04-08,Male,38,35-44,2
20,1,32,0,33,2021-04-09,Male,66,65-69,19
20,2,0,0,2,2021-04-13,Male,67,65-69,2
20,1,0,0,1,2021-04-11,Female,29,25-34,15
20,0,0,0,0,2021-04-09,Male,32,25-34,14
20,2,0,0,2,2021-04-12,Female,14,10-14,13
20,2,2,0,4,2021-04-10,Female,25,25-34,12
20,3,1,0,4,2021-04-11,Female,65,65-69,19
20,2,0,0,2,2021-04-12,Female,67,65-69,17
20,0,2,0,2,2021-04-13,Female,75,75-79,18
20,0,0,0,0,2021-04-10,Female,37,35-44,12
20,0,0,0,0,2021-04-12,Female,45,45-54,12
20,3,0,0,3,2021-04-12,Male,17,15-19,17
20,0,0,0,0,2021-04-11,Male,34,25-34,13
20,1,1,0,2,2021-04-08,Female,23,20-24,16
20,0,0,0,0,2021-04-08,Male,35,35-44,11
20,0,0,0,0,2021-04-09,Male,17,15-19,17
20,1,0,0,1,2021-04-07,Male,66,65-69,18
20,0,0,0,0,2021-04-08,Male,56,55-64,9
20,3,0,0,3,2021-04-08,Female,13,10-14,20
20,1,0,2,3,2021-04-08,Male,27,25-34,7
20,0,0,0,0,2021-04-08,Female,66,65-69,14
20,1,0,0,1,2021-04-12,Male,71,70-74,15
20,0,0,0,0,2021-04-08,Male,21,20-24,9
20,1,0,0,1,2021-04-10,Male,63,55-64,19
20,0,0,0,0,2021-04-08,Male,29,25-34,2
20,2,0,0,2,2021-04-07,Male,66,65-69,17
20,0,0,0,0,2021-04-09,Male,38,35-44,14
20,1,1,0,2,2021-04-13,Female,67,65-69,13
20,0,0,0,0,2021-04-07,Male,30,25-34,8
20,0,0,0,0,2021-04-09,Male,28,25-34,13
20,0,0,0,0,2021-04-12,Female,44,35-44,15
20,1,0,0,1,2021-04-12,Female,29,25-34,3
20,1,0,1,2,2021-04-10,Female,62,55-64,14
20,1,0,0,1,2021-04-09,Female,31,25-34,13
20,1,0,0,1,2021-04-07,Female,53,45-54,17
20,1,0,0,1,2021-04-10,Female,49,45-54,18
20,0,1,0,1,2021-04-11,Female,73,70-74,11
20,0,0,0,0,2021-04-13,Female,14,10-14,10
20,1,0,0,1,2021-04-09,Male,21,20-24,5
20,3,1,0,4,2021-04-08,Male,30,25-34,9
20,0,0,0,0,2021-04-08,Female,25,25-34,19
20,0,2,0,2,2021-04-09,Female,22,20-24,17
20,1,0,0,1,2021-04-12,Male,40,35-44,17
20,0,0,0,0,2021-04-12,Male,34,25-34,14
20,1,1,0,2,2021-04-12,Male,62,55-64,16
20,0,0,0,0,2021-04-09,Female,68,65-69,15
20,1,0,0,1,2021-04-11,Male,68,65-69,18
20,2,2,0,4,2021-04-15,Female,35,35-44,1
20,2,0,0,2,2021-04-12,Male,11,10-14,20
20,1,1,0,2,2021-04-10,Female,24,20-24,13
20,4,3,0,7,2021-04-07,Female,11,10-14,14
20,0,0,0,0,2021-04-08,Male,56,55-64,15
20,1,1,0,2,2021-04-09,Male,71,70-74,15
20,2,0,0,2,2021-04-08,Female,60,55-64,16
20,3,0,21,24,2021-04-15,Female,18,15-19,1
20,5,0,0,5,2021-04-09,Female,33,25-34,10
20,3,0,0,3,2021-04-11,Female,18,15-19,7
20,0,0,0,0,2021-04-11,Male,46,45-54,12
20,0,0,0,0,2021-04-10,Female,19,15-19,14
20,1,1,0,2,2021-04-08,Male,3,1-4,10
20,2,0,0,2,2021-04-12,Female,63,55-64,17
20,2,0,0,2,2021-04-12,Female,67,65-69,9
20,3,0,0,3,2021-04-08,Female,23,20-24,6
20,1,0,0,1,2021-04-12,Male,46,45-54,14
20,0,0,0,0,2021-04-11,Female,34,25-34,16
20,3,1,0,4,2021-04-12,Female,33,25-34,17
20,0,0,0,0,2021-04-10,Male,58,55-64,18
20,2,1,0,3,2021-04-09,Male,64,55-64,19
20,1,0,0,1,2021-04-08,Female,63,55-64,18
20,2,2,0,4,2021-04-15,Male,4,1-4,1
20,0,0,0,0,2021-04-12,Female,64,55-64,17
20,0,0,0,0,2021-04-09,Female,44,35-44,16
20,2,0,0,2,2021-04-11,Female,69,65-69,18
20,1,0,0,1,2021-04-07,Male,53,45-54,16
20,3,10,0,13,2021-04-08,Male,50,45-54,18
20,1,0,0,1,2021-04-12,Female,63,55-64,12
20,1,0,0,1,2021-04-12,Female,67,65-69,18
20,0,0,0,0,2021-04-08,Male,16,15-19,19
20,2,0,0,2,2021-04-12,Male,59,55-64,17
20,3,0,0,3,2021-04-10,Male,11,10-14,11
20,0,0,0,0,2021-04-08,Male,33,25-34,17
20,0,0,0,0,2021-04-10,Male,42,35-44,14
20,1,0,0,1,2021-04-12,Female,65,65-69,14
20,1,0,0,1,2021-04-07,Male,68,65-69,20
20,0,0,0,0,2021-04-09,Male,12,10-14,17
20,2,0,0,2,2021-04-12,Male,77,75-79,13
20,1,0,0,1,2021-04-07,Female,59,55-64,19
20,6,0,0,6,2021-04-07,Female,16,15-19,19
20,0,1,0,1,2021-04-10,Male,63,55-64,5
20,1,7,0,8,2021-04-13,Male,67,65-69,8
20,0,0,0,0,2021-04-13,Female,66,65-69,9
20,2,0,0,2,2021-04-14,Male,13,10-14,16
20,2,0,0,2,2021-04-10,Male,24,20-24,12
20,0,0,0,0,2021-04-09,Male,3,1-4,15
20,0,0,0,0,2021-04-13,Female,40,35-44,11
20,2,0,0,2,2021-04-12,Male,19,15-19,14
20,2,0,0,2,2021-04-08,Male,51,45-54,16
20,1,0,0,1,2021-04-12,Male,47,45-54,9
20,0,0,0,0,2021-04-07,Male,40,35-44,16
20,0,0,0,0,2021-04-07,Female,34,25-34,18
20,0,0,0,0,2021-04-10,Female,67,65-69,8
20,4,0,0,4,2021-04-07,Female,19,15-19,7
20,0,1,0,1,2021-04-12,Male,46,45-54,16
20,0,3,0,3,2021-04-12,Female,66,65-69,16
20,0,0,0,0,2021-04-15,Female,19,15-19,1
20,9,0,0,9,2021-04-15,Female,20,20-24,11
20,0,0,0,0,2021-04-09,Female,53,45-54,16
20,0,1,0,1,2021-04-08,Female,28,25-34,7
20,0,0,0,0,2021-04-13,Male,71,70-74,6
20,2,0,0,2,2021-04-09,Male,26,25-34,14
20,2,3,0,5,2021-04-10,Male,26,25-34,2
20,0,0,0,0,2021-04-13,Female,28,25-34,15
20,0,9,0,9,2021-04-12,Male,44,35-44,7
20,2,0,3,5,2021-04-07,Male,15,15-19,11
20,0,0,0,0,2021-04-10,Female,67,65-69,16
20,0,0,0,0,2021-04-07,Female,67,65-69,12
20,0,0,0,0,2021-04-08,Female,69,65-69,18
20,0,0,0,0,2021-04-14,Male,33,25-34,6
20,1,2,0,3,2021-04-09,Female,31,25-34,9
20,5,0,0,5,2021-04-12,Male,17,15-19,17
20,2,2,0,4,2021-04-13,Female,55,55-64,16
20,2,0,0,2,2021-04-07,Male,48,45-54,19
20,0,0,0,0,2021-04-10,Female,53,45-54,19
20,3,0,0,3,2021-04-09,Female,21,20-24,8
20,1,0,0,1,2021-04-08,Male,54,45-54,13
20,2,0,0,2,2021-04-09,Male,67,65-69,9
20,1,0,0,1,2021-04-08,Female,40,35-44,7
20,0,0,0,0,2021-04-08,Male,49,45-54,16
20,1,0,0,1,2021-04-09,Male,64,55-64,15
20,0,3,0,3,2021-04-08,Male,62,55-64,2
20,0,0,0,0,2021-04-13,Male,27,25-34,11
20,2,0,0,2,2021-04-07,Male,36,35-44,16
20,1,0,0,1,2021-04-12,Male,49,45-54,17
20,0,1,0,1,2021-04-08,Male,53,45-54,2
20,1,1,0,2,2021-04-13,Female,52,45-54,10
20,0,0,0,0,2021-04-09,Female,53,45-54,15
20,2,0,0,2,2021-04-09,Male,68,65-69,18
20,1,6,0,7,2021-04-08,Female,48,45-54,16
20,3,0,0,3,2021-04-10,Male,21,20-24,17
20,3,0,0,3,2021-04-12,Male,85,85+,14
20,1,1,0,2,2021-04-13,Female,32,25-34,10
20,1,2,0,3,2021-04-10,Female,54,45-54,17
20,2,0,0,2,2021-04-11,Female,71,70-74,8
20,2,0,0,2,2021-04-08,Female,20,20-24,9
20,0,0,0,0,2021-04-12,Male,48,45-54,14
20,2,0,0,2,2021-04-13,Female,67,65-69,14
20,0,0,0,0,2021-04-09,Male,50,45-54,20
20,0,0,2,2,2021-04-11,Male,0,<1,10
20,1,17,0,18,2021-04-15,Male,1,1-4,1
20,0,1,0,1,2021-04-11,Male,23,20-24,12
20,0,0,0,0,2021-04-12,Male,32,25-34,14
20,0,0,0,0,2021-04-11,Male,61,55-64,10
20,2,0,0,2,2021-04-07,Female,19,15-19,6
20,0,2,0,2,2021-04-13,Female,29,25-34,10
20,2,0,0,2,2021-04-09,Male,55,55-64,17
20,2,2,0,4,2021-04-10,Female,10,10-14,9
20,0,0,0,0,2021-04-07,Male,31,25-34,15
20,0,0,0,0,2021-04-07,Male,43,35-44,18
20,1,0,0,1,2021-04-12,Female,70,70-74,18
20,0,0,0,0,2021-04-12,Male,18,15-19,5
20,0,0,0,0,2021-04-09,Female,70,70-74,20
20,1,3,0,4,2021-04-10,Male,71,70-74,18
20,0,0,0,0,2021-04-12,Male,61,55-64,19
20,4,0,0,4,2021-04-12,Female,12,10-14,14
20,3,0,0,3,2021-04-12,Female,5,5-9,16
20,1,0,0,1,2021-04-15,Female,22,20-24,1
20,3,0,0,3,2021-04-09,Male,12,10-14,16
20,0,0,0,0,2021-04-08,Male,34,25-34,18
20,2,0,0,2,2021-04-13,Male,17,15-19,12
20,3,0,0,3,2021-04-10,Male,6,5-9,10
20,2,0,0,2,2021-04-09,Male,20,20-24,16
21,1,0,0,1,2021-05-17,Male,68,65-69,16
21,1,0,0,1,2021-05-19,Female,70,70-74,15
21,2,0,0,2,2021-05-13,Male,11,10-14,3
21,0,0,0,0,2021-05-18,Male,65,65-69,1
21,0,0,0,0,2021-05-19,Female,49,45-54,1
21,0,0,0,0,2021-05-22,Male,23,20-24,1
21,2,0,0,2,2021-05-14,Female,66,65-69,20
21,0,0,0,0,2021-05-13,Female,18,15-19,9
21,0,1,0,1,2021-05-12,Female,72,70-74,17
21,2,2,0,4,2021-05-17,Female,4,1-4,6
21,1,0,0,1,2021-05-13,Female,72,70-74,21
21,1,3,0,4,2021-05-19,Male,70,70-74,1
21,0,0,0,0,2021-05-14,Male,30,25-34,17
21,0,0,0,0,2021-05-16,Female,53,45-54,11
21,2,4,0,6,2021-05-20,Male,17,15-19,1
21,0,0,0,0,2021-05-19,Female,54,45-54,16
21,0,0,0,0,2021-05-13,Female,68,65-69,14
21,0,0,0,0,2021-05-18,Male,62,55-64,1
21,3,0,0,3,2021-05-18,Male,19,15-19,2
21,1,5,0,6,2021-05-19,Female,68,65-69,1
21,0,0,0,0,2021-05-18,Female,34,25-34,8
21,1,0,0,1,2021-05-17,Female,59,55-64,16
21,0,0,0,0,2021-05-18,Male,52,45-54,1
21,1,5,0,6,2021-05-18,Female,61,55-64,11
21,0,0,0,0,2021-05-13,Male,51,45-54,17
21,0,0,0,0,2021-05-19,Male,68,65-69,6
21,1,2,0,3,2021-05-13,Male,51,45-54,16
21,0,0,0,0,2021-05-13,Female,35,35-44,18
21,2,0,0,2,2021-05-20,Female,45,45-54,1
21,3,1,0,4,2021-05-17,Female,58,55-64,17
21,0,0,0,0,2021-05-18,Male,7,5-9,1
21,0,0,0,0,2021-05-18,Female,66,65-69,1
21,1,0,0,1,2021-05-18,Male,34,25-34,2
21,0,2,0,2,2021-05-19,Male,50,45-54,1
21,2,8,0,10,2021-05-18,Female,19,15-19,1
21,2,0,0,2,2021-05-13,Female,13,10-14,16
21,0,0,0,0,2021-05-16,Male,43,35-44,14
21,3,2,0,5,2021-05-18,Female,54,45-54,1
21,1,0,0,1,2021-05-18,Male,57,55-64,1
21,2,1,0,3,2021-05-19,Female,9,5-9,1
21,1,1,0,2,2021-05-19,Male,67,65-69,13
21,1,0,0,1,2021-05-18,Male,67,65-69,16
21,1,0,0,1,2021-05-19,Female,56,55-64,1
21,1,0,0,1,2021-05-14,Male,63,55-64,21
21,0,0,0,0,2021-05-19,Male,34,25-34,1
21,1,4,0,5,2021-05-19,Male,59,55-64,1
21,1,3,0,4,2021-05-18,Male,65,65-69,1
21,0,0,0,0,2021-05-17,Male,13,10-14,15
21,0,0,0,0,2021-05-19,Male,48,45-54,1
21,0,0,0,0,2021-05-13,Male,49,45-54,18
21,0,3,0,3,2021-05-20,Male,42,35-44,1
21,3,0,0,3,2021-05-17,Male,59,55-64,15
21,3,0,0,3,2021-05-14,Male,52,45-54,8
21,1,0,0,1,2021-05-17,Male,35,35-44,13
21,1,1,0,2,2021-05-19,Male,34,25-34,1
21,0,1,0,1,2021-05-17,Male,53,45-54,14
21,1,0,0,1,2021-05-19,Male,76,75-79,1
21,0,0,0,0,2021-05-19,Male,27,25-34,1
21,0,0,0,0,2021-05-18,Female,71,70-74,20
21,1,1,0,2,2021-05-19,Male,68,65-69,17
21,0,0,0,0,2021-05-19,Male,44,35-44,1
21,1,0,0,1,2021-05-13,Female,53,45-54,17
21,1,0,0,1,2021-05-17,Female,69,65-69,15
21,0,0,0,0,2021-05-14,Male,42,35-44,21
21,0,1,0,1,2021-05-19,Female,78,75-79,1
21,0,0,0,0,2021-05-18,Female,56,55-64,1
21,4,0,0,4,2021-05-13,Male,19,15-19,7
21,1,1,0,2,2021-05-14,Female,57,55-64,21
21,0,0,0,0,2021-05-20,Male,47,45-54,1
21,2,0,0,2,2021-05-12,Female,22,20-24,19
21,2,0,0,2,2021-05-13,Male,52,45-54,19
21,1,0,0,1,2021-05-13,Male,43,35-44,3
21,0,0,0,0,2021-05-13,Male,85,85+,18
21,2,15,17,34,2021-05-18,Male,19,15-19,1
21,0,0,0,0,2021-05-13,Female,69,65-69,16
21,0,1,0,1,2021-05-17,Female,66,65-69,8
21,3,0,0,3,2021-05-13,Male,2,1-4,8
21,0,1,0,1,2021-05-19,Male,54,45-54,6
21,0,0,0,0,2021-05-13,Male,16,15-19,14
21,1,0,0,1,2021-05-18,Male,62,55-64,1
21,0,2,0,2,2021-05-19,Female,70,70-74,1
21,1,0,0,1,2021-05-13,Male,58,55-64,19
21,0,0,0,0,2021-05-17,Male,68,65-69,19
21,0,0,0,0,2021-05-20,Male,35,35-44,1
21,0,2,0,2,2021-05-18,Male,51,45-54,13
21,1,0,0,1,2021-05-14,Male,72,70-74,14
21,0,0,0,0,2021-05-13,Male,77,75-79,16
21,0,0,0,0,2021-05-12,Male,27,25-34,8
21,0,0,0,0,2021-05-14,Male,44,35-44,11
21,0,0,0,0,2021-05-19,Male,9,5-9,1
21,0,0,0,0,2021-05-17,Male,52,45-54,18
21,0,1,0,1,2021-05-18,Female,38,35-44,1
21,0,0,0,0,2021-05-18,Male,60,55-64,1
21,0,0,0,0,2021-05-18,Male,53,45-54,13
21,1,0,0,1,2021-05-18,Male,44,35-44,12
21,0,0,0,0,2021-05-18,Female,56,55-64,1
21,0,7,0,7,2021-05-19,Male,43,35-44,1
21,3,4,0,7,2021-05-13,Male,44,35-44,13
21,1,4,0,5,2021-05-18,Male,39,35-44,1
21,1,0,0,1,2021-05-19,Female,71,70-74,1
21,1,3,0,4,2021-05-18,Male,67,65-69,1
21,1,0,0,1,2021-05-17,Male,41,35-44,18
21,2,1,0,3,2021-05-17,Male,69,65-69,17
21,3,1,0,4,2021-05-17,Male,1,1-4,6
21,2,0,0,2,2021-05-19,Male,66,65-69,1
21,1,0,0,1,2021-05-13,Female,68,65-69,18
21,0,3,0,3,2021-05-20,Female,52,45-54,10
21,1,0,0,1,2021-05-14,Male,62,55-64,18
21,3,0,0,3,2021-05-14,Female,43,35-44,14
21,0,14,0,14,2021-05-17,Male,72,70-74,14
21,0,0,0,0,2021-05-19,Male,55,55-64,1
21,0,0,0,0,2021-05-20,Male,35,35-44,1
21,1,0,0,1,2021-05-19,Female,60,55-64,1
21,0,0,0,0,2021-05-13,Male,85,85+,15
21,2,0,0,2,2021-05-17,Female,72,70-74,16
21,0,0,0,0,2021-05-19,Male,72,70-74,1
21,0,0,0,0,2021-05-12,Female,22,20-24,7
21,1,0,0,1,2021-05-19,Female,28,25-34,1
21,1,0,0,1,2021-05-17,Female,39,35-44,4
21,1,1,0,2,2021-05-13,Male,45,45-54,8
21,2,1,0,3,2021-05-20,Male,6,5-9,1
21,2,2,0,4,2021-05-13,Male,55,55-64,20
21,1,0,0,1,2021-05-17,Male,70,70-74,18
21,2,0,0,2,2021-05-19,Female,69,65-69,17
21,2,6,0,8,2021-05-13,Male,67,65-69,12
21,1,1,0,2,2021-05-14,Female,66,65-69,20
21,3,2,0,5,2021-05-13,Male,12,10-14,12
21,2,0,0,2,2021-05-17,Male,66,65-69,19
21,2,0,0,2,2021-05-19,Male,65,65-69,1
21,4,0,0,4,2021-05-19,Female,2,1-4,2
21,0,0,0,0,2021-05-18,Female,54,45-54,1
21,4,0,0,4,2021-05-17,Female,11,10-14,12
21,1,0,0,1,2021-05-13,Male,68,65-69,16
21,1,1,0,2,2021-05-19,Male,32,25-34,1
21,2,0,0,2,2021-05-18,Male,70,70-74,11
21,2,7,12,21,2021-05-19,Male,2,1-4,1
21,1,0,0,1,2021-05-19,Female,58,55-64,1
21,0,0,0,0,2021-05-13,Female,13,10-14,7
21,2,2,0,4,2021-05-18,Male,32,25-34,1
21,0,0,0,0,2021-05-13,Male,43,35-44,17
21,3,15,0,18,2021-05-18,Female,9,5-9,15
21,2,0,0,2,2021-05-18,Male,11,10-14,1
21,0,0,0,0,2021-05-19,Female,75,75-79,1
21,0,0,0,0,2021-05-19,Male,68,65-69,1
21,0,0,0,0,2021-05-20,Female,27,25-34,1
21,2,0,0,2,2021-05-17,Male,71,70-74,16
21,1,3,0,4,2021-05-14,Male,69,65-69,21
21,4,0,0,4,2021-05-16,Female,2,1-4,15
21,1,0,0,1,2021-05-18,Male,55,55-64,1
21,0,1,0,1,2021-05-18,Female,20,20-24,3
21,0,0,0,0,2021-05-20,Female,28,25-34,1
21,2,0,0,2,2021-05-13,Female,60,55-64,19
21,3,15,0,18,2021-05-12,Male,16,15-19,17
21,1,0,0,1,2021-05-12,Male,31,25-34,15
21,0,3,0,3,2021-05-18,Female,53,45-54,18
21,0,0,0,0,2021-05-14,Male,49,45-54,19
21,0,1,0,1,2021-05-18,Male,70,70-74,14
21,1,0,0,1,2021-05-19,Female,65,65-69,1
21,1,9,0,10,2021-05-18,Female,18,15-19,1
21,1,0,0,1,2021-05-18,Male,60,55-64,1
21,4,2,0,6,2021-05-21,Male,6,5-9,1
21,1,3,0,4,2021-05-18,Female,61,55-64,2
21,2,0,0,2,2021-05-18,Male,63,55-64,1
21,3,7,10,20,2021-05-21,Male,19,15-19,1
21,1,0,0,1,2021-05-18,Female,67,65-69,11
21,1,1,0,2,2021-05-19,Female,27,25-34,9
21,2,0,16,18,2021-05-19,Male,10,10-14,1
21,0,2,0,2,2021-05-17,Female,63,55-64,19
21,0,0,0,0,2021-05-18,Male,75,75-79,5
21,1,0,0,1,2021-05-13,Female,31,25-34,20
21,1,0,0,1,2021-05-18,Female,60,55-64,1
21,0,0,0,0,2021-05-17,Female,68,65-69,15
21,3,0,0,3,2021-05-19,Female,8,5-9,1
21,1,0,0,1,2021-05-20,Female,24,20-24,1
21,0,0,0,0,2021-05-18,Male,52,45-54,1
21,1,0,0,1,2021-05-13,Female,63,55-64,19
21,0,0,0,0,2021-05-18,Male,18,15-19,9
21,2,11,6,19,2021-05-20,Female,27,25-34,1
21,0,0,0,0,2021-05-19,Female,47,45-54,15
21,0,0,0,0,2021-05-14,Male,55,55-64,18
21,0,0,0,0,2021-05-14,Male,34,25-34,13
21,2,0,0,2,2021-05-17,Male,30,25-34,11
21,1,0,0,1,2021-05-17,Male,57,55-64,16
21,0,0,0,0,2021-05-13,Male,2,1-4,6
21,0,0,0,0,2021-05-13,Male,33,25-34,21
21,1,0,0,1,2021-05-19,Male,68,65-69,1
21,2,0,0,2,2021-05-18,Female,0,<1,1
21,0,0,0,0,2021-05-20,Male,49,45-54,1
21,0,0,0,0,2021-05-20,Female,31,25-34,1
21,1,0,0,1,2021-05-19,Female,71,70-74,2
21,1,0,0,1,2021-05-19,Female,44,35-44,1
21,2,1,0,3,2021-05-13,Female,31,25-34,15
21,0,0,0,0,2021-05-14,Female,67,65-69,7
21,3,2,2,7,2021-05-13,Female,23,20-24,3
21,0,0,0,0,2021-05-20,Male,47,45-54,1
21,0,0,0,0,2021-05-13,Male,37,35-44,17
21,1,0,0,1,2021-05-19,Female,67,65-69,1
21,1,2,0,3,2021-05-17,Female,62,55-64,16
21,0,0,0,0,2021-05-19,Female,64,55-64,1
21,1,0,0,1,2021-05-19,Male,14,10-14,1
21,1,0,0,1,2021-05-12,Female,23,20-24,8
21,1,0,0,1,2021-05-13,Male,66,65-69,16
21,1,0,0,1,2021-05-20,Female,27,25-34,1
21,0,0,0,0,2021-05-18,Male,64,55-64,18
21,3,0,0,3,2021-05-12,Male,9,5-9,12
21,1,0,0,1,2021-05-19,Male,69,65-69,1
21,0,0,0,0,2021-05-17,Male,30,25-34,13
21,2,1,0,3,2021-05-13,Female,26,25-34,16
21,0,0,0,0,2021-05-19,Female,44,35-44,1
21,0,0,0,0,2021-05-17,Male,69,65-69,16
21,1,0,0,1,2021-05-14,Female,68,65-69,12
21,0,1,0,1,2021-05-20,Male,52,45-54,1
21,2,0,0,2,2021-05-16,Male,42,35-44,15
21,2,0,0,2,2021-05-13,Male,59,55-64,20
21,4,2,0,6,2021-05-17,Male,22,20-24,2
21,0,0,0,0,2021-05-17,Female,63,55-64,17
21,0,1,0,1,2021-05-20,Female,34,25-34,1
21,1,1,0,2,2021-05-18,Male,61,55-64,1
21,4,0,0,4,2021-05-14,Male,10,10-14,8
21,1,0,0,1,2021-05-18,Female,30,25-34,1
21,1,0,0,1,2021-05-19,Male,54,45-54,1
21,0,0,0,0,2021-05-13,Male,69,65-69,16
21,1,0,1,2,2021-05-18,Male,65,65-69,1
21,0,1,0,1,2021-05-18,Female,54,45-54,6
21,2,0,0,2,2021-05-19,Male,70,70-74,12
21,0,0,0,0,2021-05-13,Male,25,25-34,13
21,1,1,0,2,2021-05-19,Male,54,45-54,1
21,1,0,0,1,2021-05-14,Male,65,65-69,19
21,0,2,0,2,2021-05-18,Female,65,65-69,1
21,2,0,0,2,2021-05-18,Female,60,55-64,1
21,0,2,0,2,2021-05-17,Female,69,65-69,5
21,3,0,0,3,2021-05-19,Female,18,15-19,1
21,1,6,0,7,2021-05-20,Male,39,35-44,1
21,3,13,0,16,2021-05-19,Female,3,1-4,1
21,3,1,0,4,2021-05-19,Female,18,15-19,1
21,1,1,0,2,2021-05-19,Male,73,70-74,1
21,0,1,0,1,2021-05-18,Male,41,35-44,2
21,1,2,0,3,2021-05-18,Female,54,45-54,1
21,1,0,0,1,2021-05-13,Female,25,25-34,6
21,1,4,0,5,2021-05-19,Female,73,70-74,4
21,1,1,0,2,2021-05-14,Female,79,75-79,16
21,1,0,0,1,2021-05-19,Male,49,45-54,2
21,1,0,0,1,2021-05-13,Male,57,55-64,15
21,1,0,0,1,2021-05-18,Male,33,25-34,1
21,1,0,0,1,2021-05-14,Female,29,25-34,17
21,1,0,0,1,2021-05-13,Male,52,45-54,4
21,1,0,0,1,2021-05-13,Female,67,65-69,15
21,0,0,0,0,2021-05-18,Female,57,55-64,15
21,1,0,0,1,2021-05-18,Female,64,55-64,1
21,0,0,0,0,2021-05-19,Female,51,45-54,4
21,0,25,0,25,2021-05-19,Female,42,35-44,1
21,1,0,0,1,2021-05-17,Male,53,45-54,15
21,0,0,0,0,2021-05-18,Male,52,45-54,11
21,0,3,0,3,2021-05-19,Female,81,80-84,1
21,2,4,0,6,2021-05-19,Female,27,25-34,1
21,0,0,4,4,2021-05-20,Male,27,25-34,1
21,1,0,0,1,2021-05-17,Male,71,70-74,18
21,1,2,0,3,2021-05-18,Female,68,65-69,21
21,0,0,0,0,2021-05-17,Female,52,45-54,19
21,1,0,0,1,2021-05-16,Male,29,25-34,16
21,1,0,0,1,2021-05-20,Male,31,25-34,1
21,3,0,0,3,2021-05-13,Male,7,5-9,16
21,1,0,0,1,2021-05-18,Male,54,45-54,1
21,0,0,0,0,2021-05-13,Female,32,25-34,6
21,3,2,0,5,2021-05-13,Male,66,65-69,17
21,0,3,0,3,2021-05-19,Male,45,45-54,1
21,1,0,0,1,2021-05-13,Female,59,55-64,18
21,1,3,0,4,2021-05-18,Female,20,20-24,1
21,1,2,0,3,2021-05-19,Female,49,45-54,1
21,1,0,0,1,2021-05-20,Female,28,25-34,1
21,0,0,0,0,2021-05-19,Male,72,70-74,1
21,0,0,0,0,2021-05-14,Female,66,65-69,19
21,1,0,0,1,2021-05-13,Female,42,35-44,11
21,1,1,0,2,2021-05-18,Female,59,55-64,17
21,1,0,0,1,2021-05-18,Male,63,55-64,1
21,0,0,0,0,2021-05-18,Female,66,65-69,9
21,0,0,0,0,2021-05-14,Male,71,70-74,21
21,1,0,0,1,2021-05-19,Male,44,35-44,1
21,0,0,0,0,2021-05-17,Female,71,70-74,16
21,1,1,3,5,2021-05-18,Female,60,55-64,1
21,1,0,0,1,2021-05-14,Male,74,70-74,19
21,1,0,0,1,2021-05-18,Female,67,65-69,1
21,0,0,0,0,2021-05-13,Male,51,45-54,14
21,2,0,0,2,2021-05-14,Female,31,25-34,16
21,0,0,0,0,2021-05-20,Female,31,25-34,1
21,0,0,0,0,2021-05-13,Male,38,35-44,8
21,0,0,0,0,2021-05-19,Female,64,55-64,1
21,1,0,0,1,2021-05-18,Female,57,55-64,1
21,0,4,0,4,2021-05-19,Male,51,45-54,1
21,2,0,0,2,2021-05-19,Female,21,20-24,11
21,0,2,0,2,2021-05-17,Female,45,45-54,2
21,0,0,0,0,2021-05-13,Male,54,45-54,17
21,0,0,0,0,2021-05-18,Female,65,65-69,3
21,0,0,0,0,2021-05-16,Female,25,25-34,8
21,2,1,0,3,2021-05-18,Male,68,65-69,6
21,0,0,2,2,2021-05-18,Female,30,25-34,1
21,1,0,0,1,2021-05-14,Female,50,45-54,16
21,1,0,0,1,2021-05-19,Male,54,45-54,1
21,1,2,0,3,2021-05-19,Female,61,55-64,5
21,2,2,0,4,2021-05-16,Male,16,15-19,17
21,1,0,0,1,2021-05-19,Female,52,45-54,1
21,3,1,0,4,2021-05-19,Female,19,15-19,1
21,0,0,0,0,2021-05-14,Male,65,65-69,15
21,1,1,0,2,2021-05-17,Male,68,65-69,18
21,0,0,0,0,2021-05-20,Male,23,20-24,1
21,1,0,0,1,2021-05-14,Female,58,55-64,18
21,1,1,0,2,2021-05-20,Female,0,<1,1
21,2,6,0,8,2021-05-19,Female,39,35-44,1
21,5,15,0,20,2021-05-19,Male,13,10-14,1
21,2,4,0,6,2021-05-18,Female,1,1-4,1
21,0,0,0,0,2021-05-18,Male,14,10-14,1
21,4,1,0,5,2021-05-19,Female,47,45-54,1
21,0,0,0,0,2021-05-17,Male,14,10-14,17
21,0,0,0,0,2021-05-17,Male,71,70-74,19
21,0,0,0,0,2021-05-17,Male,40,35-44,15
21,1,1,0,2,2021-05-19,Female,53,45-54,1
21,2,0,0,2,2021-05-17,Female,70,70-74,21
21,0,0,0,0,2021-05-14,Male,38,35-44,15
21,1,2,0,3,2021-05-18,Female,63,55-64,1
21,3,0,0,3,2021-05-19,Male,22,20-24,8
21,2,1,0,3,2021-05-14,Female,73,70-74,14
21,0,0,0,0,2021-05-13,Male,52,45-54,15
21,1,0,0,1,2021-05-18,Female,57,55-64,17
21,1,0,0,1,2021-05-13,Female,60,55-64,21
21,0,0,0,0,2021-05-13,Male,44,35-44,20
21,0,0,0,0,2021-05-17,Female,63,55-64,15
21,2,0,0,2,2021-05-18,Male,34,25-34,1
21,1,0,0,1,2021-05-12,Female,23,20-24,8
21,1,1,0,2,2021-05-18,Female,55,55-64,1
21,2,0,0,2,2021-05-13,Male,74,70-74,17
21,2,6,0,8,2021-05-13,Female,53,45-54,19
21,0,0,0,0,2021-05-12,Male,69,65-69,16
21,1,0,0,1,2021-05-19,Male,26,25-34,1
21,1,0,0,1,2021-05-18,Male,34,25-34,20
21,0,1,0,1,2021-05-20,Female,21,20-24,1
21,0,0,0,0,2021-05-14,Male,48,45-54,15
21,0,0,0,0,2021-05-19,Male,41,35-44,1
21,3,0,0,3,2021-05-18,Male,70,70-74,16
21,1,0,1,2,2021-05-18,Male,55,55-64,1
21,0,0,0,0,2021-05-13,Male,66,65-69,19
21,2,11,0,13,2021-05-19,Male,16,15-19,1
21,2,0,0,2,2021-05-19,Male,68,65-69,19
21,1,4,0,5,2021-05-19,Female,22,20-24,1
21,0,3,0,3,2021-05-19,Male,62,55-64,15
21,1,2,0,3,2021-05-17,Male,71,70-74,14
21,1,0,0,1,2021-05-20,Female,1,1-4,1
21,0,0,0,0,2021-05-18,Male,44,35-44,14
21,0,0,1,1,2021-05-19,Male,28,25-34,1
21,1,0,0,1,2021-05-17,Female,56,55-64,19
21,3,0,0,3,2021-05-17,Male,23,20-24,10
21,0,0,0,0,2021-05-18,Female,67,65-69,17
21,0,3,50,53,2021-05-13,Male,23,20-24,5
21,1,0,0,1,2021-05-18,Female,58,55-64,1
21,0,10,0,10,2021-05-19,Male,54,45-54,1
21,0,1,0,1,2021-05-19,Female,76,75-79,1
21,1,3,0,4,2021-05-18,Female,55,55-64,1
21,1,0,0,1,2021-05-21,Male,22,20-24,1
21,0,0,2,2,2021-05-19,Male,69,65-69,1
21,1,0,0,1,2021-05-18,Male,65,65-69,1
21,1,0,0,1,2021-05-20,Female,34,25-34,1
21,0,1,0,1,2021-05-17,Female,64,55-64,15
21,3,5,0,8,2021-05-19,Male,3,1-4,1
21,0,5,0,5,2021-05-19,Male,70,70-74,1
21,1,0,0,1,2021-05-19,Male,29,25-34,1
21,3,0,0,3,2021-05-20,Female,19,15-19,1
21,2,0,0,2,2021-05-14,Female,14,10-14,3
21,1,0,0,1,2021-05-13,Female,61,55-64,21
21,0,0,0,0,2021-05-17,Male,60,55-64,6
21,2,0,0,2,2021-05-16,Male,49,45-54,16
21,0,0,0,0,2021-05-19,Female,61,55-64,1
21,1,0,0,1,2021-05-14,Female,54,45-54,21
21,0,0,0,0,2021-05-13,Male,34,25-34,15
21,1,1,0,2,2021-05-18,Male,61,55-64,1
21,0,1,0,1,2021-05-19,Male,56,55-64,16
21,1,0,0,1,2021-05-13,Female,38,35-44,5
21,0,0,0,0,2021-05-13,Female,66,65-69,20
21,2,0,0,2,2021-05-13,Male,13,10-14,14
21,1,0,0,1,2021-05-17,Male,73,70-74,16
21,3,0,0,3,2021-05-18,Female,9,5-9,15
21,3,16,0,19,2021-05-13,Male,9,5-9,14
21,0,0,0,0,2021-05-20,Female,25,25-34,1
21,1,0,0,1,2021-05-13,Male,79,75-79,15
21,0,1,0,1,2021-05-12,Female,67,65-69,15
21,0,0,0,0,2021-05-14,Male,39,35-44,17
21,2,0,0,2,2021-05-14,Female,19,15-19,14
21,1,0,0,1,2021-05-13,Female,56,55-64,18
21,0,2,0,2,2021-05-19,Female,74,70-74,1
21,1,0,0,1,2021-05-19,Female,69,65-69,1
21,0,0,0,0,2021-05-13,Male,54,45-54,15
21,0,2,0,2,2021-05-19,Female,71,70-74,1
21,2,1,0,3,2021-05-19,Male,5,5-9,1
21,1,0,0,1,2021-05-14,Male,69,65-69,19
21,2,9,0,11,2021-05-13,Male,19,15-19,15
21,0,5,0,5,2021-05-18,Female,32,25-34,8
21,4,0,0,4,2021-05-18,Female,11,10-14,1
21,0,4,0,4,2021-05-13,Male,37,35-44,21
21,1,2,0,3,2021-05-20,Female,51,45-54,1
21,2,0,0,2,2021-05-18,Female,49,45-54,10
21,0,0,0,0,2021-05-17,Male,66,65-69,8
21,1,3,0,4,2021-05-13,Male,40,35-44,21
21,0,0,0,0,2021-05-13,Male,33,25-34,17
21,1,4,0,5,2021-05-19,Male,65,65-69,1
21,2,0,0,2,2021-05-14,Male,62,55-64,20
21,0,0,0,0,2021-05-13,Female,2,1-4,9
21,1,3,0,4,2021-05-17,Female,69,65-69,14
21,0,0,0,0,2021-05-19,Female,70,70-74,12
21,1,1,0,2,2021-05-13,Male,68,65-69,11
21,0,0,0,0,2021-05-17,Male,7,5-9,17
21,0,1,0,1,2021-05-19,Male,46,45-54,1
21,0,0,0,0,2021-05-19,Male,24,20-24,1
21,1,1,0,2,2021-05-19,Female,71,70-74,11
21,0,0,0,0,2021-05-17,Male,68,65-69,19
21,1,0,0,1,2021-05-19,Female,68,65-69,1
21,0,4,0,4,2021-05-16,Male,29,25-34,17
21,1,0,0,1,2021-05-18,Female,21,20-24,1
21,1,1,20,22,2021-05-18,Male,10,10-14,1
21,0,0,0,0,2021-05-14,Female,54,45-54,17
21,0,0,0,0,2021-05-14,Male,19,15-19,6
21,1,0,0,1,2021-05-19,Male,43,35-44,1
21,0,4,0,4,2021-05-19,Male,34,25-34,1
21,3,15,0,18,2021-05-12,Male,6,5-9,16
21,0,0,0,0,2021-05-13,Male,31,25-34,8
21,0,0,0,0,2021-05-12,Female,18,15-19,3
21,1,2,0,3,2021-05-18,Male,60,55-64,1
21,0,1,1,2,2021-05-17,Male,47,45-54,15
21,1,2,0,3,2021-05-18,Male,53,45-54,18
21,0,0,0,0,2021-05-19,Male,58,55-64,1
21,1,1,0,2,2021-05-13,Male,33,25-34,15
21,3,0,0,3,2021-05-14,Male,70,70-74,16
21,1,0,0,1,2021-05-19,Male,48,45-54,1
21,0,3,0,3,2021-05-20,Female,34,25-34,1
21,2,0,0,2,2021-05-17,Female,34,25-34,15
21,0,0,0,0,2021-05-13,Male,15,15-19,18
21,2,0,0,2,2021-05-18,Male,65,65-69,17
21,0,1,0,1,2021-05-18,Male,49,45-54,18
21,1,0,0,1,2021-05-18,Male,66,65-69,12
21,1,0,0,1,2021-05-18,Female,67,65-69,12
21,1,0,0,1,2021-05-19,Female,74,70-74,1
21,0,1,0,1,2021-05-19,Male,48,45-54,1
21,1,0,0,1,2021-05-13,Male,67,65-69,19
21,0,0,0,0,2021-05-17,Male,65,65-69,19
21,1,0,0,1,2021-05-18,Female,18,15-19,1
21,0,0,0,0,2021-05-18,Female,30,25-34,1
21,2,5,1,8,2021-05-13,Female,68,65-69,20
21,1,0,0,1,2021-05-13,Male,68,65-69,19
21,0,0,0,0,2021-05-22,Male,24,20-24,1
21,0,0,0,0,2021-05-18,Male,41,35-44,13
21,0,0,0,0,2021-05-19,Female,5,5-9,9
21,1,0,0,1,2021-05-19,Male,45,45-54,1
21,0,0,0,0,2021-05-19,Female,49,45-54,1
21,2,18,0,20,2021-05-19,Female,9,5-9,1
21,1,0,0,1,2021-05-13,Female,44,35-44,11
21,0,0,0,0,2021-05-19,Female,72,70-74,1
21,1,0,0,1,2021-05-19,Male,57,55-64,1
21,1,2,0,3,2021-05-18,Female,57,55-64,1
21,0,0,0,0,2021-05-19,Male,53,45-54,6
21,2,0,0,2,2021-05-18,Male,70,70-74,13
21,0,4,0,4,2021-05-19,Female,54,45-54,1
21,1,4,0,5,2021-05-20,Male,33,25-34,1
21,0,8,0,8,2021-05-20,Male,44,35-44,1
21,3,0,0,3,2021-05-13,Male,15,15-19,2
21,0,0,0,0,2021-05-18,Male,65,65-69,1
21,0,0,0,0,2021-05-17,Female,47,45-54,9
21,0,0,0,0,2021-05-13,Male,17,15-19,17
21,1,3,0,4,2021-05-18,Male,55,55-64,1
21,0,0,0,0,2021-05-17,Female,52,45-54,19
21,1,2,0,3,2021-05-18,Female,67,65-69,1
21,5,0,0,5,2021-05-16,Male,11,10-14,18
21,0,0,0,0,2021-05-18,Female,60,55-64,16
21,1,12,0,13,2021-05-18,Female,67,65-69,1
21,0,0,0,0,2021-05-14,Male,14,10-14,18
21,3,0,0,3,2021-05-19,Male,26,25-34,1
21,0,0,0,0,2021-05-13,Male,47,45-54,10
21,0,0,0,0,2021-05-18,Male,56,55-64,1
21,0,0,0,0,2021-05-19,Male,73,70-74,1
21,0,0,0,0,2021-05-13,Male,82,80-84,18
21,0,0,0,0,2021-05-18,Female,65,65-69,1
21,3,0,0,3,2021-05-13,Female,5,5-9,11
21,3,22,0,25,2021-05-19,Female,7,5-9,1
21,3,0,0,3,2021-05-13,Male,3,1-4,4
21,0,0,0,0,2021-05-19,Female,59,55-64,13
21,0,0,0,0,2021-05-17,Female,5,5-9,14
21,1,0,0,1,2021-05-18,Male,59,55-64,1
21,0,1,0,1,2021-05-17,Male,60,55-64,12
21,0,2,0,2,2021-05-17,Female,51,45-54,7
21,0,0,0,0,2021-05-14,Male,49,45-54,15
21,1,1,0,2,2021-05-13,Male,44,35-44,2
21,1,0,0,1,2021-05-13,Female,53,45-54,13
21,2,0,0,2,2021-05-19,Female,15,15-19,1
21,0,1,0,1,2021-05-13,Male,25,25-34,18
21,2,0,0,2,2021-05-17,Male,71,70-74,19
21,0,0,0,0,2021-05-19,Male,35,35-44,20
21,2,0,0,2,2021-05-20,Female,37,35-44,2
21,1,0,0,1,2021-05-18,Female,35,35-44,12
21,1,1,0,2,2021-05-19,Male,63,55-64,1
21,0,0,0,0,2021-05-18,Female,3,1-4,1
21,1,0,0,1,2021-05-19,Male,72,70-74,1
21,1,0,0,1,2021-05-20,Male,29,25-34,1
21,0,0,0,0,2021-05-14,Female,67,65-69,15
21,3,0,0,3,2021-05-13,Male,23,20-24,16
21,1,0,0,1,2021-05-17,Female,68,65-69,13
21,0,2,0,2,2021-05-19,Male,68,65-69,18
21,1,7,0,8,2021-05-19,Male,71,70-74,1
21,2,2,0,4,2021-05-19,Male,28,25-34,1
21,1,0,0,1,2021-05-12,Male,22,20-24,12
21,2,0,0,2,2021-05-12,Male,41,35-44,21
21,1,0,0,1,2021-05-12,Male,65,65-69,17
21,0,1,0,1,2021-05-20,Male,1,1-4,1
21,0,0,3,3,2021-05-18,Female,22,20-24,1
21,2,0,0,2,2021-05-18,Female,39,35-44,1
21,0,6,0,6,2021-05-18,Male,59,55-64,1
21,2,3,0,5,2021-05-14,Male,59,55-64,17
21,0,0,0,0,2021-05-19,Male,51,45-54,4
21,3,0,0,3,2021-05-18,Female,67,65-69,5
21,0,1,0,1,2021-05-18,Male,53,45-54,1
21,2,0,0,2,2021-05-13,Male,12,10-14,7
21,1,0,0,1,2021-05-13,Male,79,75-79,19
21,0,0,0,0,2021-05-12,Male,54,45-54,16
21,0,0,0,0,2021-05-20,Female,28,25-34,1
21,1,4,0,5,2021-05-18,Male,57,55-64,1
21,2,4,12,18,2021-05-19,Male,68,65-69,2
21,1,4,0,5,2021-05-18,Female,65,65-69,1
21,0,0,0,0,2021-05-17,Female,69,65-69,14
21,2,0,0,2,2021-05-18,Male,65,65-69,13
21,1,0,0,1,2021-05-14,Male,64,55-64,14
21,0,0,0,0,2021-05-18,Female,67,65-69,18
21,1,0,0,1,2021-05-19,Female,67,65-69,1
21,0,0,0,0,2021-05-21,Male,23,20-24,1
21,0,0,0,0,2021-05-18,Female,65,65-69,2
21,0,10,0,10,2021-05-19,Male,51,45-54,1
21,1,0,0,1,2021-05-13,Male,13,10-14,9
21,2,0,0,2,2021-05-14,Female,26,25-34,11
21,1,0,0,1,2021-05-19,Male,67,65-69,1
21,0,1,0,1,2021-05-17,Female,69,65-69,18
21,3,0,0,3,2021-05-24,Male,19,15-19,1
21,0,0,0,0,2021-05-17,Female,33,25-34,5
21,0,0,0,0,2021-05-13,Female,28,25-34,8
21,1,5,0,6,2021-05-20,Male,33,25-34,1
21,0,0,0,0,2021-05-18,Male,54,45-54,1
21,0,0,0,0,2021-05-18,Male,53,45-54,1
21,0,0,0,0,2021-05-14,Female,66,65-69,14
21,1,0,0,1,2021-05-19,Female,26,25-34,1
21,0,0,0,0,2021-05-17,Female,64,55-64,16
21,1,0,0,1,2021-05-14,Male,69,65-69,18
21,1,1,0,2,2021-05-19,Male,58,55-64,1
21,5,0,0,5,2021-05-13,Male,13,10-14,10
21,0,0,0,0,2021-05-13,Female,34,25-34,15
21,2,0,0,2,2021-05-13,Female,16,15-19,13
21,0,0,0,0,2021-05-13,Female,69,65-69,5
21,2,3,0,5,2021-05-20,Male,0,<1,1
21,0,0,0,0,2021-05-19,Male,53,45-54,1
21,0,2,0,2,2021-05-19,Female,72,70-74,12
21,0,0,0,0,2021-05-13,Female,9,5-9,18
21,1,0,0,1,2021-05-20,Female,38,35-44,1
21,0,7,0,7,2021-05-19,Female,51,45-54,1
21,3,5,0,8,2021-05-20,Female,24,20-24,1
21,3,0,0,3,2021-05-13,Female,53,45-54,16
21,2,2,0,4,2021-05-14,Male,61,55-64,17
21,0,0,4,4,2021-05-18,Female,28,25-34,10
21,2,0,0,2,2021-05-17,Female,66,65-69,14
21,0,0,0,0,2021-05-17,Female,22,20-24,5
21,1,0,0,1,2021-05-19,Male,57,55-64,1
21,0,0,0,0,2021-05-19,Female,19,15-19,1
21,0,0,0,0,2021-05-19,Female,71,70-74,1
21,0,0,0,0,2021-05-17,Male,54,45-54,13
21,2,6,0,8,2021-05-18,Male,66,65-69,1
21,2,0,0,2,2021-05-20,Male,10,10-14,1
21,1,0,0,1,2021-05-13,Male,31,25-34,2
21,0,2,0,2,2021-05-17,Male,66,65-69,20
21,1,0,0,1,2021-05-18,Male,65,65-69,1
21,1,0,0,1,2021-05-17,Female,70,70-74,17
21,0,0,0,0,2021-05-13,Female,76,75-79,19
21,2,0,0,2,2021-05-18,Male,61,55-64,1
21,0,0,0,0,2021-05-18,Male,33,25-34,1
21,2,17,0,19,2021-05-19,Female,15,15-19,1
21,3,0,0,3,2021-05-13,Male,37,35-44,16
21,0,0,0,0,2021-05-20,Male,26,25-34,6
21,1,0,0,1,2021-05-16,Female,49,45-54,16
21,1,1,0,2,2021-05-17,Male,61,55-64,15
21,1,0,0,1,2021-05-18,Female,66,65-69,1
21,1,0,0,1,2021-05-13,Male,32,25-34,2
21,1,11,10,22,2021-05-18,Male,55,55-64,1
21,1,1,0,2,2021-05-19,Female,51,45-54,14
21,0,0,0,0,2021-05-12,Male,14,10-14,8
21,1,0,0,1,2021-05-19,Female,71,70-74,2
21,3,0,0,3,2021-05-15,Female,18,15-19,10
21,0,0,0,0,2021-05-13,Male,57,55-64,12
21,1,0,1,2,2021-05-18,Female,62,55-64,1
21,2,0,0,2,2021-05-14,Female,54,45-54,16
21,0,0,0,0,2021-05-21,Male,19,15-19,1
21,0,0,0,0,2021-05-17,Male,62,55-64,16
21,0,0,0,0,2021-05-18,Male,61,55-64,1
21,0,0,0,0,2021-05-21,Male,19,15-19,1
21,0,0,0,0,2021-05-17,Female,66,65-69,13
21,0,0,0,0,2021-05-18,Female,33,25-34,6
21,0,0,0,0,2021-05-13,Male,33,25-34,11
21,2,0,0,2,2021-05-19,Male,16,15-19,1
21,3,0,0,3,2021-05-20,Female,44,35-44,1
21,0,4,0,4,2021-05-13,Female,61,55-64,11
21,1,0,0,1,2021-05-18,Male,52,45-54,1
21,1,5,0,6,2021-05-19,Female,61,55-64,16
21,0,3,0,3,2021-05-17,Male,52,45-54,16
21,0,0,0,0,2021-05-13,Female,50,45-54,17
21,0,3,0,3,2021-05-18,Female,63,55-64,1
21,1,0,0,1,2021-05-21,Male,16,15-19,1
21,1,10,2,13,2021-05-21,Female,22,20-24,1
21,0,0,0,0,2021-05-18,Male,74,70-74,19
21,0,0,0,0,2021-05-13,Male,64,55-64,3
21,0,3,0,3,2021-05-19,Female,66,65-69,1
21,2,0,21,23,2021-05-19,Male,51,45-54,1
21,3,0,0,3,2021-05-14,Female,11,10-14,19
21,1,0,0,1,2021-05-13,Male,6,5-9,19
21,1,1,0,2,2021-05-17,Female,70,70-74,17
21,2,0,0,2,2021-05-13,Female,11,10-14,17
21,3,2,0,5,2021-05-19,Female,49,45-54,1
21,0,0,0,0,2021-05-19,Male,77,75-79,1
21,0,0,0,0,2021-05-13,Female,66,65-69,16
21,1,0,0,1,2021-05-16,Female,27,25-34,18
21,0,0,0,0,2021-05-22,Male,21,20-24,1
21,1,0,0,1,2021-05-18,Female,62,55-64,1
21,2,0,0,2,2021-05-14,Male,76,75-79,19
21,1,0,0,1,2021-05-19,Male,68,65-69,1
21,0,1,0,1,2021-05-18,Male,64,55-64,1
21,0,1,0,1,2021-05-13,Female,29,25-34,3
21,1,2,0,3,2021-05-19,Male,74,70-74,16
21,0,0,0,0,2021-05-17,Male,31,25-34,15
21,1,0,4,5,2021-05-19,Female,14,10-14,1
21,1,0,4,5,2021-05-12,Female,26,25-34,19
21,1,0,0,1,2021-05-18,Female,23,20-24,9
21,0,0,0,0,2021-05-18,Female,65,65-69,1
21,0,0,2,2,2021-05-15,Female,43,35-44,7
21,1,0,0,1,2021-05-14,Male,63,55-64,18
21,4,0,0,4,2021-05-20,Female,12,10-14,1
21,0,2,0,2,2021-05-18,Female,33,25-34,1
21,3,0,0,3,2021-05-20,Female,30,25-34,1
21,0,0,0,0,2021-05-21,Female,20,20-24,1
21,0,2,0,2,2021-05-14,Male,64,55-64,17
21,3,1,0,4,2021-05-16,Male,17,15-19,16
21,1,0,2,3,2021-05-19,Male,51,45-54,1
21,0,1,0,1,2021-05-19,Male,54,45-54,1
21,0,0,0,0,2021-05-19,Female,24,20-24,1
21,3,3,0,6,2021-05-20,Female,21,20-24,1
21,2,0,0,2,2021-05-18,Male,55,55-64,20
21,1,10,0,11,2021-05-20,Male,35,35-44,1
21,0,0,0,0,2021-05-14,Male,61,55-64,13
21,0,0,0,0,2021-05-13,Female,5,5-9,18
21,0,0,0,0,2021-05-19,Female,66,65-69,6
21,2,1,0,3,2021-05-19,Male,73,70-74,14
21,2,0,0,2,2021-05-18,Male,73,70-74,14
21,0,8,0,8,2021-05-19,Female,41,35-44,1
21,1,0,0,1,2021-05-16,Female,53,45-54,19
21,0,0,0,0,2021-05-14,Male,33,25-34,13
21,0,0,0,0,2021-05-19,Female,49,45-54,1
21,1,0,0,1,2021-05-19,Female,72,70-74,1
21,0,0,0,0,2021-05-17,Female,71,70-74,16
21,1,2,0,3,2021-05-19,Male,69,65-69,1
21,0,0,0,0,2021-05-18,Female,31,25-34,1
21,0,3,0,3,2021-05-20,Female,28,25-34,1
21,0,0,0,0,2021-05-16,Male,30,25-34,18
21,2,0,0,2,2021-05-13,Female,17,15-19,13
21,0,1,0,1,2021-05-13,Female,57,55-64,20
21,0,0,0,0,2021-05-17,Male,68,65-69,16
21,0,3,0,3,2021-05-20,Male,51,45-54,1
21,0,0,0,0,2021-05-19,Male,52,45-54,18
21,1,1,0,2,2021-05-13,Male,5,5-9,2
21,2,0,0,2,2021-05-13,Male,67,65-69,20
21,1,0,0,1,2021-05-19,Female,35,35-44,1
21,2,0,0,2,2021-05-20,Male,5,5-9,1
21,0,0,0,0,2021-05-13,Female,69,65-69,13
21,2,0,0,2,2021-05-20,Female,50,45-54,1
21,1,0,0,1,2021-05-20,Female,23,20-24,1
21,0,0,0,0,2021-05-18,Female,30,25-34,16
21,0,1,0,1,2021-05-14,Male,46,45-54,18
21,1,0,0,1,2021-05-20,Female,42,35-44,1
21,1,0,0,1,2021-05-18,Female,63,55-64,1
21,0,0,0,0,2021-05-19,Male,57,55-64,1
21,2,0,0,2,2021-05-17,Female,69,65-69,16
21,1,6,20,27,2021-05-19,Male,50,45-54,2
21,2,2,0,4,2021-05-20,Male,37,35-44,2
21,1,0,0,1,2021-05-14,Male,55,55-64,14
21,1,2,0,3,2021-05-18,Male,2,1-4,1
21,1,0,0,1,2021-05-13,Female,25,25-34,13
21,1,3,0,4,2021-05-18,Female,48,45-54,14
21,0,0,0,0,2021-05-13,Female,42,35-44,8
21,1,0,0,1,2021-05-13,Male,64,55-64,19
21,1,2,0,3,2021-05-18,Male,66,65-69,18
21,2,8,10,20,2021-05-19,Female,2,1-4,1
21,2,1,0,3,2021-05-14,Male,9,5-9,20
21,2,4,0,6,2021-05-14,Female,18,15-19,2
21,1,0,0,1,2021-05-20,Female,18,15-19,1
21,0,0,0,0,2021-05-17,Male,58,55-64,20
21,1,0,0,1,2021-05-13,Female,66,65-69,21
21,1,0,0,1,2021-05-14,Male,52,45-54,13
21,2,0,0,2,2021-05-17,Female,53,45-54,7
21,3,0,0,3,2021-05-18,Female,6,5-9,11
21,2,0,0,2,2021-05-16,Female,12,10-14,16
21,2,2,0,4,2021-05-19,Male,4,1-4,1
21,4,0,0,4,2021-05-14,Male,11,10-14,21
21,2,7,0,9,2021-05-18,Male,51,45-54,19
21,2,6,0,8,2021-05-20,Female,1,1-4,1
21,0,0,0,0,2021-05-15,Male,74,70-74,20
21,0,0,0,0,2021-05-19,Female,30,25-34,2
21,3,0,0,3,2021-05-19,Female,9,5-9,1
21,0,0,0,0,2021-05-18,Female,67,65-69,13
21,1,0,0,1,2021-05-19,Male,55,55-64,18
21,0,1,0,1,2021-05-17,Female,69,65-69,20
21,0,1,0,1,2021-05-19,Female,79,75-79,6
21,2,0,0,2,2021-05-13,Male,68,65-69,9
21,0,12,0,12,2021-05-13,Male,78,75-79,16
21,0,2,0,2,2021-05-12,Female,32,25-34,7
21,0,1,0,1,2021-05-15,Male,85,85+,13
21,1,2,0,3,2021-05-19,Female,56,55-64,14
21,2,1,0,3,2021-05-18,Male,54,45-54,1
21,0,0,0,0,2021-05-19,Male,69,65-69,1
21,1,0,0,1,2021-05-18,Female,64,55-64,12
21,1,0,0,1,2021-05-18,Female,67,65-69,11
21,2,0,0,2,2021-05-18,Male,66,65-69,16
21,1,0,0,1,2021-05-14,Male,60,55-64,20
21,1,0,0,1,2021-05-17,Male,55,55-64,17
21,0,7,7,14,2021-05-19,Male,69,65-69,1
21,1,0,0,1,2021-05-18,Male,63,55-64,7
21,0,0,0,0,2021-05-19,Female,70,70-74,1
21,0,0,0,0,2021-05-13,Female,25,25-34,20
21,0,14,0,14,2021-05-19,Male,50,45-54,1
21,1,0,0,1,2021-05-13,Male,36,35-44,17
21,1,0,0,1,2021-05-17,Male,52,45-54,20
21,1,1,0,2,2021-05-19,Male,69,65-69,1
21,0,0,0,0,2021-05-12,Female,24,20-24,18
21,1,0,0,1,2021-05-13,Male,34,25-34,17
21,0,3,0,3,2021-05-13,Female,49,45-54,21
21,0,2,0,2,2021-05-18,Male,41,35-44,1
21,0,0,0,0,2021-05-13,Male,70,70-74,18
21,2,5,0,7,2021-05-18,Male,67,65-69,1
21,2,0,0,2,2021-05-13,Male,64,55-64,20
21,1,1,0,2,2021-05-19,Male,70,70-74,1
21,1,0,0,1,2021-05-18,Female,54,45-54,1
21,1,4,0,5,2021-05-14,Male,64,55-64,17
21,2,0,0,2,2021-05-17,Male,43,35-44,2
21,1,0,1,2,2021-05-12,Female,23,20-24,2
21,1,2,0,3,2021-05-18,Male,38,35-44,12
21,0,0,0,0,2021-05-13,Female,21,20-24,8
21,2,1,0,3,2021-05-13,Female,37,35-44,18
21,2,2,0,4,2021-05-12,Male,34,25-34,3
21,0,0,0,0,2021-05-12,Female,23,20-24,8
21,0,0,0,0,2021-05-19,Female,76,75-79,1
21,2,0,0,2,2021-05-17,Female,61,55-64,18
21,1,0,0,1,2021-05-20,Male,49,45-54,1
21,1,0,0,1,2021-05-13,Male,71,70-74,15
21,0,0,0,0,2021-05-19,Female,69,65-69,1
21,1,0,0,1,2021-05-17,Female,57,55-64,13
21,1,7,0,8,2021-05-19,Male,52,45-54,1
21,2,0,0,2,2021-05-20,Male,4,1-4,1
21,0,0,0,0,2021-05-14,Male,53,45-54,17
21,0,3,0,3,2021-05-13,Female,66,65-69,21
21,1,1,0,2,2021-05-20,Female,47,45-54,1
21,2,3,0,5,2021-05-18,Male,4,1-4,1
21,0,4,0,4,2021-05-19,Female,67,65-69,17
21,0,1,0,1,2021-05-19,Female,70,70-74,14
21,3,0,0,3,2021-05-15,Female,6,5-9,15
21,1,0,0,1,2021-05-20,Female,37,35-44,1
21,4,3,0,7,2021-05-16,Female,46,45-54,11
21,4,0,0,4,2021-05-19,Female,8,5-9,1
21,4,0,0,4,2021-05-13,Male,1,1-4,7
21,0,0,0,0,2021-05-21,Male,22,20-24,1
21,1,0,0,1,2021-05-19,Male,54,45-54,1
21,0,0,0,0,2021-05-19,Female,43,35-44,1
21,3,1,25,29,2021-05-22,Male,18,15-19,1
21,1,0,0,1,2021-05-14,Male,58,55-64,16
21,0,0,0,0,2021-05-17,Male,40,35-44,19
21,0,6,0,6,2021-05-14,Male,39,35-44,18
21,4,0,0,4,2021-05-16,Female,15,15-19,8
21,0,1,0,1,2021-05-13,Male,40,35-44,16
21,3,0,0,3,2021-05-19,Female,21,20-24,16
21,1,0,0,1,2021-05-18,Male,57,55-64,1
21,1,0,0,1,2021-05-18,Male,66,65-69,1
21,0,0,0,0,2021-05-15,Female,16,15-19,11
21,1,7,0,8,2021-05-18,Female,57,55-64,9
21,2,0,0,2,2021-05-20,Male,16,15-19,1
21,1,2,0,3,2021-05-19,Female,65,65-69,1
21,1,2,0,3,2021-05-20,Female,24,20-24,1
21,1,0,0,1,2021-05-13,Male,66,65-69,19
21,0,3,0,3,2021-05-19,Male,40,35-44,2
21,0,0,0,0,2021-05-17,Male,61,55-64,16
21,1,0,0,1,2021-05-18,Male,66,65-69,1
21,2,0,0,2,2021-05-18,Male,64,55-64,17
21,0,0,0,0,2021-05-13,Female,19,15-19,6
21,1,0,0,1,2021-05-18,Female,64,55-64,7
21,0,1,1,2,2021-05-13,Male,73,70-74,18
21,1,20,0,21,2021-05-18,Female,33,25-34,8
21,0,0,0,0,2021-05-18,Female,57,55-64,16
21,1,0,0,1,2021-05-20,Male,48,45-54,1
21,2,0,0,2,2021-05-16,Male,43,35-44,13
21,1,0,0,1,2021-05-12,Male,71,70-74,19
21,0,0,0,0,2021-05-12,Female,19,15-19,20
21,1,0,0,1,2021-05-13,Male,63,55-64,20
21,0,0,0,0,2021-05-19,Female,4,1-4,1
21,1,1,0,2,2021-05-13,Male,68,65-69,21
21,9,0,0,9,2021-05-18,Female,21,20-24,1
21,1,17,0,18,2021-05-19,Female,6,5-9,1
21,1,0,0,1,2021-05-21,Male,20,20-24,1
21,2,0,0,2,2021-05-13,Male,77,75-79,8
21,0,1,0,1,2021-05-18,Female,30,25-34,1
21,0,0,0,0,2021-05-18,Male,65,65-69,1
21,2,0,0,2,2021-05-19,Male,46,45-54,1
21,0,0,0,0,2021-05-17,Male,57,55-64,18
21,1,0,0,1,2021-05-19,Male,60,55-64,1
21,1,0,0,1,2021-05-14,Female,71,70-74,17
21,1,0,0,1,2021-05-19,Male,74,70-74,1
21,0,1,0,1,2021-05-17,Male,52,45-54,10
21,0,2,0,2,2021-05-18,Female,60,55-64,12
21,1,0,0,1,2021-05-19,Female,61,55-64,5
21,3,0,0,3,2021-05-14,Male,8,5-9,21
21,2,0,0,2,2021-05-18,Female,56,55-64,19
21,3,0,0,3,2021-05-17,Female,8,5-9,11
21,0,0,0,0,2021-05-18,Male,53,45-54,12
21,0,0,0,0,2021-05-18,Female,35,35-44,1
21,0,0,0,0,2021-05-18,Female,22,20-24,16
21,2,0,0,2,2021-05-18,Female,67,65-69,5
21,1,4,0,5,2021-05-19,Male,72,70-74,1
21,0,11,0,11,2021-05-19,Male,44,35-44,1
21,0,0,0,0,2021-05-12,Female,36,35-44,17
21,2,2,0,4,2021-05-17,Male,56,55-64,15
21,0,30,0,30,2021-05-19,Female,45,45-54,1
21,1,0,0,1,2021-05-14,Male,62,55-64,17
21,0,2,0,2,2021-05-18,Male,27,25-34,7
21,0,3,0,3,2021-05-18,Female,53,45-54,1
21,0,1,0,1,2021-05-18,Male,54,45-54,14
21,2,2,0,4,2021-05-18,Female,18,15-19,1
21,2,0,0,2,2021-05-18,Female,73,70-74,10
21,3,0,0,3,2021-05-14,Female,22,20-24,8
21,1,1,0,2,2021-05-20,Male,22,20-24,1
21,1,0,0,1,2021-05-19,Female,18,15-19,1
21,0,0,0,0,2021-05-12,Male,13,10-14,19
21,2,0,0,2,2021-05-18,Male,79,75-79,12
21,1,1,0,2,2021-05-17,Female,23,20-24,5
21,1,0,0,1,2021-05-13,Female,66,65-69,17
21,1,0,0,1,2021-05-19,Male,77,75-79,1
21,5,0,0,5,2021-05-16,Female,11,10-14,16
21,2,0,0,2,2021-05-19,Female,4,1-4,1
21,1,0,0,1,2021-05-14,Male,64,55-64,21
21,1,0,0,1,2021-05-20,Female,40,35-44,1
21,0,0,0,0,2021-05-19,Male,66,65-69,1
21,1,2,0,3,2021-05-18,Female,52,45-54,16
21,2,0,4,6,2021-05-17,Female,21,20-24,20
21,1,0,0,1,2021-05-20,Male,32,25-34,1
21,1,0,0,1,2021-05-19,Female,47,45-54,1
21,2,34,0,36,2021-05-19,Male,26,25-34,1
21,0,0,0,0,2021-05-14,Female,23,20-24,2
21,0,0,0,0,2021-05-17,Female,73,70-74,14
21,1,0,0,1,2021-05-18,Male,34,25-34,1
21,0,2,0,2,2021-05-18,Male,64,55-64,1
21,0,0,0,0,2021-05-19,Female,35,35-44,14
21,1,0,0,1,2021-05-18,Male,52,45-54,1
21,2,0,0,2,2021-05-19,Male,21,20-24,1
21,0,0,0,0,2021-05-20,Male,34,25-34,1
21,1,0,0,1,2021-05-19,Male,65,65-69,1
21,1,0,70,71,2021-05-19,Male,54,45-54,16
21,0,0,0,0,2021-05-18,Male,60,55-64,1
21,1,7,0,8,2021-05-19,Male,62,55-64,1
21,1,0,2,3,2021-05-19,Male,71,70-74,1
21,3,0,0,3,2021-05-20,Female,13,10-14,1
21,2,3,0,5,2021-05-13,Male,56,55-64,20
21,0,0,0,0,2021-05-12,Female,22,20-24,9
21,1,0,0,1,2021-05-17,Female,55,55-64,17
21,2,1,0,3,2021-05-20,Male,24,20-24,1
21,1,5,0,6,2021-05-18,Female,57,55-64,1
21,2,15,0,17,2021-05-19,Male,18,15-19,2
21,0,0,0,0,2021-05-17,Female,24,20-24,18
21,1,0,0,1,2021-05-18,Female,66,65-69,1
21,1,0,0,1,2021-05-17,Male,32,25-34,18
21,2,0,0,2,2021-05-22,Male,23,20-24,1
21,0,1,0,1,2021-05-13,Male,28,25-34,20
21,0,1,0,1,2021-05-14,Male,48,45-54,17
21,0,4,0,4,2021-05-19,Female,18,15-19,1
21,3,2,0,5,2021-05-20,Female,19,15-19,1
21,0,0,0,0,2021-05-17,Female,34,25-34,19
21,0,0,0,0,2021-05-13,Female,41,35-44,21
21,1,0,0,1,2021-05-17,Male,69,65-69,18
21,5,0,6,11,2021-05-19,Female,0,<1,1
21,0,0,0,0,2021-05-14,Male,73,70-74,10
21,2,0,0,2,2021-05-19,Female,74,70-74,14
21,2,0,0,2,2021-05-17,Female,2,1-4,3
21,0,0,0,0,2021-05-17,Male,66,65-69,18
21,0,1,0,1,2021-05-18,Female,49,45-54,6
21,1,1,0,2,2021-05-18,Female,63,55-64,1
21,1,2,0,3,2021-05-14,Male,33,25-34,17
21,1,0,0,1,2021-05-17,Female,52,45-54,16
21,0,0,0,0,2021-05-19,Male,77,75-79,1
21,2,0,0,2,2021-05-17,Female,66,65-69,14
21,0,0,0,0,2021-05-13,Male,69,65-69,18
21,1,0,0,1,2021-05-18,Female,21,20-24,1
21,0,0,0,0,2021-05-14,Female,31,25-34,19
21,1,3,0,4,2021-05-20,Female,28,25-34,1
21,1,0,0,1,2021-05-18,Female,58,55-64,1
21,2,0,0,2,2021-05-18,Female,0,<1,1
21,1,0,0,1,2021-05-19,Male,70,70-74,1
21,0,0,0,0,2021-05-18,Female,58,55-64,1
21,0,0,0,0,2021-05-17,Female,73,70-74,17
21,0,0,0,0,2021-05-13,Male,59,55-64,14
21,0,0,0,0,2021-05-16,Female,52,45-54,12
21,2,0,0,2,2021-05-20,Female,21,20-24,1
21,1,0,0,1,2021-05-13,Male,69,65-69,20
21,1,13,0,14,2021-05-19,Female,49,45-54,1
21,2,1,0,3,2021-05-19,Female,60,55-64,5
21,2,1,0,3,2021-05-18,Male,71,70-74,14
21,0,4,0,4,2021-05-18,Male,59,55-64,16
21,0,0,0,0,2021-05-19,Female,54,45-54,16
21,0,0,0,0,2021-05-14,Male,51,45-54,12
21,2,0,0,2,2021-05-14,Male,19,15-19,16
21,3,0,0,3,2021-05-17,Male,1,1-4,17
21,1,0,0,1,2021-05-17,Female,31,25-34,17
21,0,5,0,5,2021-05-18,Male,61,55-64,16
21,1,2,0,3,2021-05-18,Female,69,65-69,15
21,1,0,0,1,2021-05-20,Female,52,45-54,1
21,0,0,0,0,2021-05-17,Male,68,65-69,20
21,0,14,0,14,2021-05-18,Male,61,55-64,1
21,1,0,0,1,2021-05-13,Male,47,45-54,9
21,0,0,0,0,2021-05-19,Female,71,70-74,1
21,0,0,0,0,2021-05-13,Female,24,20-24,7
21,0,0,0,0,2021-05-19,Male,60,55-64,3
21,3,0,0,3,2021-05-13,Female,66,65-69,12
21,0,1,0,1,2021-05-20,Male,27,25-34,1
21,1,0,0,1,2021-05-19,Female,26,25-34,1
21,1,0,0,1,2021-05-18,Female,28,25-34,7
21,0,6,0,6,2021-05-19,Female,56,55-64,1
21,2,0,0,2,2021-05-14,Female,23,20-24,14
21,0,0,0,0,2021-05-18,Female,64,55-64,8
21,0,1,0,1,2021-05-17,Female,69,65-69,11
21,1,0,0,1,2021-05-14,Female,48,45-54,14
21,0,2,0,2,2021-05-13,Male,59,55-64,17
21,0,0,0,0,2021-05-17,Male,37,35-44,19
21,1,0,0,1,2021-05-14,Female,54,45-54,7
21,0,4,0,4,2021-05-13,Female,43,35-44,16
21,1,0,0,1,2021-05-14,Female,36,35-44,3
21,0,0,0,0,2021-05-13,Male,52,45-54,18
21,1,1,0,2,2021-05-19,Male,73,70-74,1
21,2,0,0,2,2021-05-17,Male,6,5-9,13
21,5,0,0,5,2021-05-19,Female,2,1-4,1
21,0,0,0,0,2021-05-19,Male,43,35-44,1
21,0,0,0,0,2021-05-14,Female,46,45-54,19
21,2,5,0,7,2021-05-17,Male,69,65-69,14
21,0,0,10,10,2021-05-13,Male,42,35-44,14
21,1,0,0,1,2021-05-19,Male,47,45-54,1
21,0,0,0,0,2021-05-14,Male,63,55-64,14
21,1,0,0,1,2021-05-18,Male,55,55-64,18
21,1,0,0,1,2021-05-13,Female,52,45-54,15
21,2,1,0,3,2021-05-18,Female,70,70-74,17
21,1,15,0,16,2021-05-18,Female,52,45-54,1
21,0,0,0,0,2021-05-18,Female,66,65-69,15
21,3,0,0,3,2021-05-17,Male,19,15-19,18
21,3,1,0,4,2021-05-19,Female,13,10-14,3
21,0,0,0,0,2021-05-18,Male,55,55-64,18
21,0,5,2,7,2021-05-21,Male,21,20-24,1
21,1,0,0,1,2021-05-17,Male,58,55-64,3
21,1,5,0,6,2021-05-20,Female,37,35-44,1
21,1,0,0,1,2021-05-18,Female,60,55-64,15
21,1,7,0,8,2021-05-20,Female,28,25-34,1
21,1,0,0,1,2021-05-19,Male,26,25-34,1
21,0,0,0,0,2021-05-19,Male,60,55-64,13
21,2,0,0,2,2021-05-18,Female,51,45-54,9
21,1,0,0,1,2021-05-18,Female,63,55-64,1
21,0,1,0,1,2021-05-18,Female,37,35-44,1
21,0,0,0,0,2021-05-14,Male,31,25-34,16
21,0,0,0,0,2021-05-19,Male,65,65-69,1
21,1,0,0,1,2021-05-13,Female,21,20-24,18
21,3,2,0,5,2021-05-18,Female,56,55-64,13
21,3,0,0,3,2021-05-19,Female,67,65-69,16
21,0,1,0,1,2021-05-19,Male,54,45-54,2
21,0,0,0,0,2021-05-18,Male,58,55-64,3
21,0,0,0,0,2021-05-19,Male,28,25-34,1
21,2,0,0,2,2021-05-18,Male,52,45-54,19
21,0,3,0,3,2021-05-18,Male,65,65-69,16
21,0,0,0,0,2021-05-19,Male,38,35-44,1
21,1,0,0,1,2021-05-13,Male,48,45-54,15
21,0,0,0,0,2021-05-13,Male,60,55-64,17
21,1,1,0,2,2021-05-14,Male,69,65-69,16
21,0,5,0,5,2021-05-13,Male,31,25-34,18
21,0,0,0,0,2021-05-13,Male,36,35-44,17
21,1,28,29,58,2021-05-19,Female,56,55-64,1
21,3,1,0,4,2021-05-17,Female,7,5-9,11
21,1,1,0,2,2021-05-18,Female,59,55-64,1
21,2,0,0,2,2021-05-17,Female,69,65-69,18
21,0,1,0,1,2021-05-17,Female,26,25-34,18
21,0,0,0,0,2021-05-14,Female,24,20-24,7
21,1,0,0,1,2021-05-13,Female,60,55-64,17
21,1,1,0,2,2021-05-18,Female,54,45-54,1
21,0,0,0,0,2021-05-17,Male,41,35-44,14
21,1,0,0,1,2021-05-19,Female,73,70-74,1
21,0,0,0,0,2021-05-17,Male,66,65-69,21
21,1,3,0,4,2021-05-13,Male,53,45-54,13
21,0,1,0,1,2021-05-17,Male,70,70-74,14
21,0,10,0,10,2021-05-12,Female,24,20-24,5
21,2,0,0,2,2021-05-20,Male,35,35-44,2
21,0,4,0,4,2021-05-18,Female,22,20-24,1
21,0,53,0,53,2021-05-19,Female,40,35-44,7
21,2,0,0,2,2021-05-17,Female,66,65-69,21
21,1,0,0,1,2021-05-17,Male,70,70-74,18
21,0,7,0,7,2021-05-18,Female,65,65-69,1
21,1,2,0,3,2021-05-17,Male,62,55-64,14
21,0,0,0,0,2021-05-18,Male,65,65-69,1
21,0,0,0,0,2021-05-15,Male,46,45-54,11
21,0,1,0,1,2021-05-18,Female,66,65-69,17
21,0,1,0,1,2021-05-19,Female,69,65-69,1
21,1,0,0,1,2021-05-17,Female,56,55-64,4
21,1,2,0,3,2021-05-13,Male,79,75-79,16
21,1,0,0,1,2021-05-17,Male,72,70-74,13
21,0,0,0,0,2021-05-17,Male,68,65-69,15
21,1,0,0,1,2021-05-19,Male,1,1-4,1
21,2,0,0,2,2021-05-14,Female,26,25-34,8
21,1,0,0,1,2021-05-17,Female,68,65-69,15
21,0,0,0,0,2021-05-19,Female,65,65-69,17
21,0,3,0,3,2021-05-19,Female,41,35-44,1
21,1,0,0,1,2021-05-12,Male,59,55-64,21
21,3,0,0,3,2021-05-18,Male,12,10-14,1
21,2,0,0,2,2021-05-17,Male,70,70-74,20
21,2,0,0,2,2021-05-19,Male,45,45-54,1
21,2,47,0,49,2021-05-18,Female,53,45-54,1
21,1,0,0,1,2021-05-19,Male,48,45-54,1
21,1,0,2,3,2021-05-12,Male,39,35-44,8
21,1,1,0,2,2021-05-14,Male,51,45-54,20
21,1,0,0,1,2021-05-13,Female,27,25-34,7
21,0,0,0,0,2021-05-20,Female,43,35-44,1
21,3,0,0,3,2021-05-18,Female,20,20-24,1
21,3,0,0,3,2021-05-18,Male,5,5-9,10
21,1,0,0,1,2021-05-13,Male,72,70-74,17
21,0,3,0,3,2021-05-19,Female,73,70-74,2
21,3,0,13,16,2021-05-18,Male,10,10-14,1
21,1,0,0,1,2021-05-14,Female,78,75-79,13
21,2,0,0,2,2021-05-18,Male,72,70-74,17
21,0,4,0,4,2021-05-16,Female,53,45-54,11
21,1,1,0,2,2021-05-14,Female,64,55-64,16
21,2,0,0,2,2021-05-13,Female,16,15-19,19
21,2,0,0,2,2021-05-16,Male,4,1-4,12
21,1,7,0,8,2021-05-13,Female,39,35-44,19
21,1,0,0,1,2021-05-17,Female,58,55-64,19
21,0,1,1,2,2021-05-18,Female,65,65-69,1
21,3,0,0,3,2021-05-16,Male,21,20-24,19
21,0,0,0,0,2021-05-20,Male,1,1-4,1
21,0,3,0,3,2021-05-13,Male,40,35-44,18
21,0,0,0,0,2021-05-13,Male,67,65-69,16
21,2,0,0,2,2021-05-20,Male,9,5-9,1
21,5,0,0,5,2021-05-14,Male,32,25-34,5
21,1,0,0,1,2021-05-18,Female,67,65-69,16
21,2,3,0,5,2021-05-20,Male,17,15-19,1
21,1,3,0,4,2021-05-14,Female,69,65-69,20
21,0,0,0,0,2021-05-17,Male,67,65-69,7
21,0,1,0,1,2021-05-13,Female,29,25-34,19
21,4,0,0,4,2021-05-14,Female,32,25-34,17
21,1,0,0,1,2021-05-17,Female,64,55-64,14
21,0,0,0,0,2021-05-20,Female,0,<1,1
21,0,0,0,0,2021-05-17,Male,16,15-19,10
21,1,2,0,3,2021-05-20,Female,49,45-54,9
21,0,0,0,0,2021-05-17,Female,47,45-54,16
21,1,0,0,1,2021-05-13,Male,65,65-69,14
21,0,1,0,1,2021-05-17,Female,68,65-69,18
21,1,6,0,7,2021-05-19,Female,17,15-19,16
21,2,0,0,2,2021-05-12,Female,50,45-54,14
21,1,0,0,1,2021-05-13,Male,62,55-64,10
21,0,0,0,0,2021-05-13,Male,23,20-24,15
21,2,16,0,18,2021-05-19,Female,16,15-19,1
21,0,0,0,0,2021-05-17,Male,59,55-64,16
21,1,0,0,1,2021-05-19,Male,67,65-69,1
21,1,0,0,1,2021-05-12,Male,2,1-4,11
21,0,0,0,0,2021-05-19,Female,32,25-34,1
21,1,0,0,1,2021-05-17,Male,60,55-64,17
21,0,2,0,2,2021-05-17,Female,60,55-64,6
21,1,2,0,3,2021-05-20,Female,50,45-54,1
21,0,11,0,11,2021-05-21,Male,24,20-24,1
21,2,0,0,2,2021-05-16,Male,26,25-34,18
21,2,0,0,2,2021-05-18,Female,19,15-19,1
21,1,0,0,1,2021-05-14,Female,68,65-69,15
21,1,2,0,3,2021-05-20,Female,43,35-44,1
21,0,0,0,0,2021-05-15,Female,23,20-24,6
21,2,10,0,12,2021-05-19,Male,57,55-64,15
21,0,1,0,1,2021-05-19,Female,41,35-44,1
21,2,1,0,3,2021-05-17,Male,70,70-74,16
21,2,2,0,4,2021-05-18,Male,0,<1,1
21,1,0,0,1,2021-05-18,Male,70,70-74,19
21,1,0,0,1,2021-05-18,Male,64,55-64,1
21,1,0,0,1,2021-05-20,Female,46,45-54,1
21,1,0,0,1,2021-05-17,Male,60,55-64,17
21,1,0,0,1,2021-05-19,Female,52,45-54,1
21,0,1,0,1,2021-05-13,Male,52,45-54,13
21,2,11,0,13,2021-05-20,Male,31,25-34,17
21,1,0,0,1,2021-05-18,Female,66,65-69,1
21,3,0,0,3,2021-05-19,Female,4,1-4,18
21,0,0,0,0,2021-05-19,Female,35,35-44,1
21,1,0,0,1,2021-05-18,Female,63,55-64,15
21,0,0,0,0,2021-05-17,Male,43,35-44,18
21,0,1,0,1,2021-05-19,Female,70,70-74,1
21,1,1,10,12,2021-05-22,Male,21,20-24,1
21,2,0,0,2,2021-05-13,Male,35,35-44,3
21,0,3,0,3,2021-05-20,Female,48,45-54,1
21,2,0,0,2,2021-05-18,Female,57,55-64,1
21,1,0,0,1,2021-05-22,Male,19,15-19,1
21,3,0,0,3,2021-05-19,Female,6,5-9,1
21,2,0,0,2,2021-05-17,Female,67,65-69,3
21,1,0,0,1,2021-05-18,Male,37,35-44,16
21,0,0,0,0,2021-05-19,Female,48,45-54,1
21,3,0,0,3,2021-05-17,Male,10,10-14,15
21,2,4,0,6,2021-05-18,Female,19,15-19,1
21,1,10,0,11,2021-05-19,Female,29,25-34,1
21,0,0,0,0,2021-05-14,Male,61,55-64,3
21,0,2,0,2,2021-05-20,Male,41,35-44,1
21,0,0,0,0,2021-05-17,Male,25,25-34,12
21,2,0,0,2,2021-05-18,Female,68,65-69,16
21,1,0,0,1,2021-05-17,Male,50,45-54,18
21,1,0,0,1,2021-05-17,Male,32,25-34,11
21,2,0,0,2,2021-05-13,Male,70,70-74,18
21,0,0,0,0,2021-05-19,Female,65,65-69,1
21,0,0,0,0,2021-05-20,Male,37,35-44,1
21,1,4,0,5,2021-05-19,Male,70,70-74,1
21,2,0,0,2,2021-05-13,Female,60,55-64,18
21,0,0,0,0,2021-05-18,Male,34,25-34,1
21,1,0,0,1,2021-05-17,Male,41,35-44,16
21,0,0,0,0,2021-05-13,Female,46,45-54,8
21,0,0,0,0,2021-05-18,Male,39,35-44,5
21,0,0,0,0,2021-05-13,Male,54,45-54,16
21,0,2,0,2,2021-05-13,Female,31,25-34,19
21,4,1,0,5,2021-05-17,Female,4,1-4,10
21,0,10,0,10,2021-05-18,Female,34,25-34,1
21,0,0,0,0,2021-05-13,Male,33,25-34,20
21,1,0,0,1,2021-05-18,Male,56,55-64,1
21,0,2,0,2,2021-05-18,Male,47,45-54,15
21,0,2,0,2,2021-05-12,Female,66,65-69,19
21,2,0,0,2,2021-05-16,Female,13,10-14,13
21,0,0,0,0,2021-05-13,Female,68,65-69,16
21,1,0,0,1,2021-05-21,Male,20,20-24,1
21,0,0,0,0,2021-05-12,Female,23,20-24,7
21,0,0,0,0,2021-05-13,Female,70,70-74,17
21,2,0,0,2,2021-05-14,Male,46,45-54,21
21,0,1,0,1,2021-05-18,Female,60,55-64,8
21,0,0,0,0,2021-05-18,Female,37,35-44,1
21,0,0,0,0,2021-05-12,Female,56,55-64,19
21,3,0,0,3,2021-05-13,Male,1,1-4,11
21,0,0,0,0,2021-05-19,Male,85,85+,1
21,0,1,0,1,2021-05-12,Male,30,25-34,16
21,0,1,0,1,2021-05-17,Male,23,20-24,4
21,0,2,0,2,2021-05-19,Female,47,45-54,1
21,0,0,0,0,2021-05-17,Male,17,15-19,8
21,0,0,0,0,2021-05-13,Male,40,35-44,13
21,1,3,3,7,2021-05-18,Male,68,65-69,18
21,0,0,0,0,2021-05-13,Male,14,10-14,14
21,1,0,0,1,2021-05-12,Female,23,20-24,2
21,2,0,0,2,2021-05-14,Female,55,55-64,8
21,2,0,0,2,2021-05-20,Male,14,10-14,1
21,1,0,0,1,2021-05-13,Male,79,75-79,13
21,1,0,0,1,2021-05-18,Male,65,65-69,1
21,0,0,0,0,2021-05-16,Male,47,45-54,12
21,1,1,0,2,2021-05-14,Male,74,70-74,13
21,0,0,0,0,2021-05-13,Female,40,35-44,3
21,0,0,0,0,2021-05-19,Female,16,15-19,1
21,2,0,4,6,2021-05-14,Female,30,25-34,8
21,0,4,0,4,2021-05-19,Male,19,15-19,1
21,5,0,0,5,2021-05-17,Male,15,15-19,15
21,1,0,0,1,2021-05-18,Male,30,25-34,1
21,1,2,0,3,2021-05-16,Male,32,25-34,16
21,1,0,0,1,2021-05-13,Male,15,15-19,12
21,0,0,0,0,2021-05-19,Male,76,75-79,1
21,1,0,0,1,2021-05-19,Female,54,45-54,1
21,1,2,0,3,2021-05-19,Male,75,75-79,1
21,1,0,0,1,2021-05-19,Female,68,65-69,11
21,0,5,0,5,2021-05-19,Male,47,45-54,1
21,1,10,0,11,2021-05-13,Male,58,55-64,18
21,0,3,0,3,2021-05-13,Male,42,35-44,17
21,1,0,0,1,2021-05-18,Male,53,45-54,1
21,1,0,0,1,2021-05-19,Male,48,45-54,1
21,3,1,0,4,2021-05-17,Male,12,10-14,18
21,3,0,0,3,2021-05-13,Male,13,10-14,15
21,3,1,0,4,2021-05-18,Male,13,10-14,1
21,0,0,0,0,2021-05-13,Male,65,65-69,17
21,1,1,0,2,2021-05-17,Female,67,65-69,17
21,1,1,0,2,2021-05-18,Female,68,65-69,17
21,1,3,0,4,2021-05-19,Male,55,55-64,1
21,2,5,0,7,2021-05-13,Male,81,80-84,14
21,0,0,0,0,2021-05-14,Male,51,45-54,16
21,0,3,0,3,2021-05-18,Male,51,45-54,1
21,1,15,0,16,2021-05-19,Female,49,45-54,1
21,0,0,0,0,2021-05-13,Female,21,20-24,13
21,0,2,0,2,2021-05-19,Female,54,45-54,11
21,4,21,0,25,2021-05-18,Female,11,10-14,1
21,0,3,0,3,2021-05-13,Female,48,45-54,16
21,1,0,0,1,2021-05-17,Male,72,70-74,17
21,0,0,0,0,2021-05-12,Male,23,20-24,18
21,0,0,0,0,2021-05-19,Female,66,65-69,1
21,0,0,0,0,2021-05-20,Male,41,35-44,1
21,0,0,0,0,2021-05-13,Male,28,25-34,16
21,2,1,0,3,2021-05-17,Female,11,10-14,7
21,1,0,0,1,2021-05-12,Female,63,55-64,19
21,1,0,0,1,2021-05-18,Female,53,45-54,13
21,0,0,0,0,2021-05-13,Male,66,65-69,20
21,3,0,0,3,2021-05-20,Female,19,15-19,1
21,0,0,0,0,2021-05-18,Male,66,65-69,19
21,1,0,0,1,2021-05-17,Male,63,55-64,20
21,0,0,0,0,2021-05-14,Female,69,65-69,15
21,1,4,0,5,2021-05-19,Female,62,55-64,1
21,2,0,0,2,2021-05-18,Female,69,65-69,14
21,1,0,0,1,2021-05-16,Male,31,25-34,11
21,0,0,0,0,2021-05-20,Male,34,25-34,1
21,3,4,0,7,2021-05-19,Male,26,25-34,1
21,0,0,0,0,2021-05-13,Female,28,25-34,16
21,1,0,0,1,2021-05-14,Male,72,70-74,19
21,2,2,0,4,2021-05-19,Female,46,45-54,9
21,0,0,0,0,2021-05-13,Female,63,55-64,18
21,0,7,0,7,2021-05-17,Female,36,35-44,19
21,0,5,0,5,2021-05-19,Male,45,45-54,6
21,2,0,0,2,2021-05-17,Male,71,70-74,16
21,1,0,0,1,2021-05-14,Female,23,20-24,7
21,1,0,0,1,2021-05-18,Female,56,55-64,1
21,0,0,0,0,2021-05-20,Female,22,20-24,1
21,5,2,0,7,2021-05-19,Female,19,15-19,18
21,2,0,0,2,2021-05-13,Female,65,65-69,20
21,0,1,0,1,2021-05-14,Female,62,55-64,17
21,0,0,0,0,2021-05-14,Female,32,25-34,15
21,1,0,0,1,2021-05-18,Female,60,55-64,1
21,0,0,0,0,2021-05-18,Male,58,55-64,1
21,0,0,0,0,2021-05-13,Male,26,25-34,13
21,2,0,0,2,2021-05-13,Male,55,55-64,18
21,0,1,1,2,2021-05-19,Male,64,55-64,1
21,2,1,0,3,2021-05-13,Male,55,55-64,10
21,0,5,0,5,2021-05-20,Male,53,45-54,1
21,0,0,0,0,2021-05-17,Female,43,35-44,13
21,3,7,0,10,2021-05-18,Female,18,15-19,1
21,1,1,0,2,2021-05-18,Female,58,55-64,1
21,2,0,0,2,2021-05-18,Male,37,35-44,1
21,0,0,0,0,2021-05-19,Female,32,25-34,1
21,0,0,0,0,2021-05-18,Male,55,55-64,1
21,3,10,0,13,2021-05-19,Male,32,25-34,1
21,3,0,4,7,2021-05-18,Female,18,15-19,1
21,2,0,0,2,2021-05-20,Female,13,10-14,1
21,1,0,0,1,2021-05-13,Male,56,55-64,14
21,0,0,0,0,2021-05-19,Male,65,65-69,1
21,0,2,0,2,2021-05-19,Female,25,25-34,8
21,0,1,0,1,2021-05-18,Male,66,65-69,1
21,0,0,0,0,2021-05-14,Male,54,45-54,18
21,1,0,0,1,2021-05-19,Female,53,45-54,1
21,0,2,0,2,2021-05-13,Male,40,35-44,17
21,1,10,0,11,2021-05-18,Male,60,55-64,1
21,1,0,4,5,2021-05-19,Male,85,85+,1
21,0,0,0,0,2021-05-19,Male,42,35-44,1
21,1,0,0,1,2021-05-19,Female,69,65-69,1
21,1,1,0,2,2021-05-17,Male,43,35-44,18
21,0,1,0,1,2021-05-19,Male,28,25-34,1
21,3,0,0,3,2021-05-19,Male,67,65-69,1
21,0,0,0,0,2021-05-13,Female,19,15-19,5
21,3,13,0,16,2021-05-13,Male,16,15-19,13
21,2,0,1,3,2021-05-19,Male,66,65-69,9
21,0,0,0,0,2021-05-18,Male,39,35-44,1
21,0,0,0,0,2021-05-18,Female,64,55-64,20
21,0,0,0,0,2021-05-12,Male,20,20-24,20
21,1,0,0,1,2021-05-17,Female,67,65-69,18
21,2,6,2,10,2021-05-18,Female,61,55-64,16
21,0,2,0,2,2021-05-18,Male,31,25-34,1
21,0,12,0,12,2021-05-14,Male,19,15-19,6
21,1,0,0,1,2021-05-21,Female,21,20-24,1
21,1,0,13,14,2021-05-19,Male,54,45-54,1
21,0,0,0,0,2021-05-13,Male,61,55-64,12
21,1,3,0,4,2021-05-20,Female,30,25-34,1
21,1,0,0,1,2021-05-19,Female,64,55-64,1
21,0,2,0,2,2021-05-14,Female,62,55-64,19
21,0,0,0,0,2021-05-14,Male,51,45-54,17
21,1,0,0,1,2021-05-18,Female,55,55-64,1
21,1,0,0,1,2021-05-21,Male,16,15-19,1
21,0,5,0,5,2021-05-24,Male,24,20-24,1
21,2,1,0,3,2021-05-18,Female,54,45-54,1
21,0,0,0,0,2021-05-18,Female,34,25-34,1
21,0,0,0,0,2021-05-21,Male,21,20-24,1
21,0,0,0,0,2021-05-15,Male,44,35-44,19
21,0,1,0,1,2021-05-18,Female,55,55-64,1
21,2,1,0,3,2021-05-18,Male,33,25-34,1
21,2,3,0,5,2021-05-13,Male,15,15-19,16
21,3,0,0,3,2021-05-20,Female,53,45-54,1
21,1,1,0,2,2021-05-13,Male,71,70-74,16
21,3,0,0,3,2021-05-18,Female,18,15-19,1
21,0,0,0,0,2021-05-17,Female,68,65-69,14
21,0,1,0,1,2021-05-19,Female,68,65-69,15
21,1,0,0,1,2021-05-14,Male,70,70-74,17
21,2,1,0,3,2021-05-18,Male,51,45-54,1
21,1,0,0,1,2021-05-19,Male,68,65-69,1
21,1,0,0,1,2021-05-12,Male,23,20-24,12
21,0,0,0,0,2021-05-14,Male,19,15-19,10
21,1,0,0,1,2021-05-19,Female,67,65-69,1
21,2,0,0,2,2021-05-16,Male,8,5-9,15
21,0,0,0,0,2021-05-13,Female,71,70-74,19
21,0,0,0,0,2021-05-16,Female,26,25-34,5
21,1,0,0,1,2021-05-18,Female,65,65-69,1
21,2,0,0,2,2021-05-17,Male,67,65-69,15
21,1,0,0,1,2021-05-18,Male,67,65-69,18
21,0,0,0,0,2021-05-13,Female,33,25-34,6
21,1,0,0,1,2021-05-19,Male,45,45-54,1
21,0,0,0,0,2021-05-18,Female,26,25-34,3
21,0,0,0,0,2021-05-17,Male,70,70-74,17
21,0,0,0,0,2021-05-18,Female,65,65-69,1
21,1,4,0,5,2021-05-14,Male,50,45-54,2
21,0,0,0,0,2021-05-14,Female,34,25-34,20
21,0,0,0,0,2021-05-13,Male,53,45-54,20
21,1,0,0,1,2021-05-13,Male,68,65-69,21
21,1,0,0,1,2021-05-19,Male,31,25-34,1
21,1,9,0,10,2021-05-14,Male,53,45-54,3
21,0,0,0,0,2021-05-13,Male,34,25-34,15
21,1,2,0,3,2021-05-18,Male,53,45-54,2
21,0,2,0,2,2021-05-13,Female,38,35-44,7
21,1,0,0,1,2021-05-13,Male,79,75-79,15
21,4,0,0,4,2021-05-17,Female,11,10-14,12
21,1,0,0,1,2021-05-18,Male,69,65-69,10
21,0,0,0,0,2021-05-14,Male,24,20-24,15
21,0,0,0,0,2021-05-14,Male,19,15-19,18
21,3,0,0,3,2021-05-18,Female,13,10-14,12
21,1,0,0,1,2021-05-18,Female,30,25-34,4
21,1,1,0,2,2021-05-13,Female,58,55-64,8
21,1,0,0,1,2021-05-19,Female,73,70-74,1
21,0,0,0,0,2021-05-14,Male,42,35-44,12
21,1,0,0,1,2021-05-18,Female,52,45-54,1
21,1,0,0,1,2021-05-19,Female,75,75-79,1
21,1,5,0,6,2021-05-18,Male,65,65-69,1
21,3,7,0,10,2021-05-18,Male,11,10-14,17
21,2,1,0,3,2021-05-18,Female,62,55-64,14
21,0,1,0,1,2021-05-18,Female,66,65-69,1
21,0,2,0,2,2021-05-19,Female,57,55-64,1
21,2,3,0,5,2021-05-20,Male,18,15-19,1
21,0,0,0,0,2021-05-15,Female,23,20-24,15
21,2,5,0,7,2021-05-13,Male,79,75-79,16
21,3,2,2,7,2021-05-19,Female,2,1-4,1
21,1,0,0,1,2021-05-19,Female,62,55-64,1
21,2,2,0,4,2021-05-18,Female,61,55-64,1
21,2,0,0,2,2021-05-13,Male,53,45-54,18
21,1,0,0,1,2021-05-17,Female,34,25-34,11
21,1,2,0,3,2021-05-18,Male,67,65-69,12
21,1,0,0,1,2021-05-14,Male,52,45-54,16
21,2,4,0,6,2021-05-21,Male,21,20-24,1
21,0,0,0,0,2021-05-13,Male,62,55-64,14
21,3,0,0,3,2021-05-14,Female,43,35-44,20
21,2,0,0,2,2021-05-19,Male,0,<1,1
21,2,0,0,2,2021-05-19,Female,71,70-74,16
21,1,0,0,1,2021-05-13,Female,24,20-24,19
21,0,0,0,0,2021-05-14,Female,72,70-74,14
21,0,3,0,3,2021-05-13,Male,32,25-34,15
21,0,0,0,0,2021-05-13,Female,69,65-69,21
21,0,0,0,0,2021-05-19,Male,60,55-64,14
21,3,0,0,3,2021-05-18,Male,7,5-9,1
21,0,6,5,11,2021-05-18,Female,58,55-64,1
21,3,0,2,5,2021-05-13,Female,37,35-44,10
21,2,0,0,2,2021-05-14,Male,11,10-14,17
21,2,0,0,2,2021-05-18,Male,18,15-19,1
21,2,0,0,2,2021-05-17,Male,25,25-34,10
21,2,0,0,2,2021-05-13,Male,70,70-74,13
21,3,0,0,3,2021-05-19,Male,11,10-14,1
21,2,0,0,2,2021-05-19,Male,52,45-54,1
21,2,1,0,3,2021-05-18,Female,51,45-54,17
21,2,1,0,3,2021-05-18,Male,66,65-69,1
21,0,0,0,0,2021-05-19,Female,5,5-9,1
21,0,0,0,0,2021-05-17,Female,70,70-74,15
21,1,0,0,1,2021-05-18,Male,26,25-34,8
21,2,0,0,2,2021-05-17,Male,33,25-34,17
21,4,7,0,11,2021-05-18,Female,13,10-14,16
21,3,0,0,3,2021-05-13,Female,1,1-4,18
21,1,15,10,26,2021-05-12,Male,60,55-64,12
21,1,0,0,1,2021-05-18,Male,39,35-44,12
21,0,2,0,2,2021-05-18,Female,65,65-69,1
21,0,0,0,0,2021-05-14,Male,45,45-54,16
21,0,0,0,0,2021-05-12,Male,8,5-9,8
21,0,0,0,0,2021-05-18,Female,68,65-69,17
21,0,0,0,0,2021-05-17,Female,54,45-54,19
21,3,0,0,3,2021-05-18,Male,70,70-74,11
21,0,0,0,0,2021-05-13,Female,41,35-44,20
21,0,0,0,0,2021-05-12,Male,20,20-24,2
21,0,3,0,3,2021-05-20,Female,24,20-24,3
21,0,5,0,5,2021-05-18,Female,32,25-34,1
21,1,16,0,17,2021-05-19,Female,49,45-54,1
21,2,0,0,2,2021-05-14,Female,14,10-14,5
21,1,1,0,2,2021-05-19,Male,67,65-69,1
21,2,8,0,10,2021-05-20,Female,15,15-19,1
21,0,0,0,0,2021-05-17,Female,64,55-64,18
21,0,0,0,0,2021-05-13,Male,40,35-44,13
21,3,2,0,5,2021-05-12,Female,13,10-14,15
21,0,0,0,0,2021-05-22,Male,21,20-24,1
21,0,0,0,0,2021-05-19,Male,82,80-84,6
21,1,0,0,1,2021-05-17,Female,53,45-54,21
21,1,0,0,1,2021-05-19,Male,51,45-54,1
21,0,1,0,1,2021-05-18,Male,62,55-64,1
21,0,0,0,0,2021-05-19,Female,72,70-74,1
21,1,1,0,2,2021-05-19,Female,49,45-54,1
21,1,0,0,1,2021-05-15,Male,79,75-79,7
21,1,5,0,6,2021-05-18,Male,64,55-64,1
21,0,0,0,0,2021-05-15,Female,43,35-44,8
21,0,0,0,0,2021-05-17,Male,36,35-44,6
21,3,0,0,3,2021-05-18,Female,33,25-34,1
21,4,3,0,7,2021-05-22,Male,17,15-19,1
21,3,0,0,3,2021-05-13,Male,16,15-19,17
21,0,2,0,2,2021-05-13,Male,78,75-79,20
21,0,1,0,1,2021-05-13,Female,29,25-34,2
21,0,0,0,0,2021-05-13,Male,44,35-44,14
21,1,0,0,1,2021-05-12,Female,22,20-24,7
21,2,0,0,2,2021-05-14,Female,67,65-69,20
21,0,0,0,0,2021-05-17,Female,66,65-69,14
21,1,0,0,1,2021-05-19,Female,52,45-54,3
21,2,2,0,4,2021-05-19,Female,11,10-14,1
21,0,0,0,0,2021-05-18,Female,36,35-44,1
21,0,4,0,4,2021-05-20,Male,29,25-34,1
21,0,0,0,0,2021-05-19,Female,29,25-34,1
21,3,1,0,4,2021-05-20,Female,8,5-9,1
21,1,16,0,17,2021-05-20,Male,52,45-54,1
21,0,0,0,0,2021-05-14,Male,40,35-44,18
21,0,2,0,2,2021-05-19,Male,63,55-64,1
21,1,6,0,7,2021-05-13,Female,66,65-69,21
21,1,2,0,3,2021-05-18,Female,63,55-64,1
21,0,40,0,40,2021-05-13,Male,38,35-44,18
21,1,0,0,1,2021-05-19,Male,60,55-64,1
21,2,0,20,22,2021-05-19,Male,10,10-14,1
21,0,0,0,0,2021-05-13,Male,31,25-34,18
21,0,12,0,12,2021-05-20,Female,23,20-24,1
21,0,0,0,0,2021-05-13,Male,16,15-19,15
21,0,1,0,1,2021-05-13,Female,54,45-54,17
21,2,0,0,2,2021-05-17,Male,58,55-64,11
21,1,0,0,1,2021-05-13,Female,68,65-69,19
21,3,0,0,3,2021-05-19,Female,9,5-9,11
21,1,1,0,2,2021-05-13,Male,49,45-54,14
21,2,0,0,2,2021-05-13,Female,44,35-44,13
21,0,0,0,0,2021-05-13,Male,40,35-44,20
21,1,0,0,1,2021-05-14,Male,64,55-64,18
21,0,0,0,0,2021-05-18,Male,58,55-64,6
21,0,0,0,0,2021-05-13,Male,41,35-44,19
21,0,0,0,0,2021-05-20,Male,11,10-14,1
21,0,0,0,0,2021-05-13,Female,12,10-14,13
21,0,0,0,0,2021-05-18,Male,35,35-44,13
21,0,4,0,4,2021-05-19,Female,50,45-54,1
21,1,0,0,1,2021-05-19,Male,67,65-69,1
21,2,0,0,2,2021-05-19,Male,69,65-69,12
21,0,0,0,0,2021-05-13,Female,14,10-14,21
21,1,0,0,1,2021-05-19,Female,64,55-64,1
21,0,3,0,3,2021-05-20,Female,31,25-34,1
21,1,0,0,1,2021-05-17,Male,67,65-69,9
21,0,0,0,0,2021-05-18,Female,59,55-64,18
21,2,0,0,2,2021-05-14,Female,52,45-54,17
21,2,0,0,2,2021-05-17,Female,58,55-64,13
21,0,0,0,0,2021-05-17,Male,56,55-64,5
21,2,0,0,2,2021-05-21,Female,1,1-4,1
21,2,3,0,5,2021-05-18,Male,58,55-64,1
21,1,0,0,1,2021-05-13,Female,60,55-64,19
21,0,0,0,0,2021-05-12,Male,14,10-14,18
21,1,0,0,1,2021-05-13,Male,18,15-19,17
21,1,0,0,1,2021-05-17,Male,66,65-69,17
21,4,0,0,4,2021-05-19,Female,0,<1,1
21,2,0,0,2,2021-05-13,Female,16,15-19,19
21,2,3,0,5,2021-05-20,Male,27,25-34,1
21,1,0,0,1,2021-05-16,Male,55,55-64,10
21,1,0,0,1,2021-05-19,Female,72,70-74,1
21,0,10,0,10,2021-05-18,Male,60,55-64,1
21,1,0,0,1,2021-05-19,Female,60,55-64,1
21,0,0,0,0,2021-05-16,Female,50,45-54,16
21,0,0,0,0,2021-05-17,Female,55,55-64,12
21,0,0,0,0,2021-05-19,Female,24,20-24,12
21,0,0,0,0,2021-05-18,Male,66,65-69,1
21,1,1,0,2,2021-05-21,Female,21,20-24,1
21,1,10,0,11,2021-05-18,Male,23,20-24,5
21,0,29,16,45,2021-05-20,Female,21,20-24,1
21,0,0,0,0,2021-05-12,Female,22,20-24,16
21,2,0,0,2,2021-05-20,Male,18,15-19,1
21,0,2,0,2,2021-05-17,Male,43,35-44,14
21,1,0,0,1,2021-05-18,Male,65,65-69,1
21,1,0,0,1,2021-05-18,Female,21,20-24,1
21,0,2,0,2,2021-05-19,Female,77,75-79,1
21,1,0,0,1,2021-05-13,Female,70,70-74,11
21,0,2,0,2,2021-05-19,Male,70,70-74,1
21,0,0,0,0,2021-05-19,Male,39,35-44,1
21,3,0,0,3,2021-05-20,Female,0,<1,1
21,2,0,0,2,2021-05-19,Male,65,65-69,1
21,1,0,0,1,2021-05-19,Female,7,5-9,11
21,1,3,0,4,2021-05-19,Male,78,75-79,1
21,0,1,0,1,2021-05-19,Female,68,65-69,13
21,1,0,0,1,2021-05-18,Male,62,55-64,1
21,0,1,0,1,2021-05-16,Female,54,45-54,18
21,2,0,0,2,2021-05-18,Female,13,10-14,1
21,0,0,0,0,2021-05-19,Female,66,65-69,1
21,0,0,0,0,2021-05-13,Male,39,35-44,18
21,0,0,0,0,2021-05-12,Male,36,35-44,11
21,2,0,0,2,2021-05-17,Male,16,15-19,14
21,0,0,0,0,2021-05-12,Male,36,35-44,15
21,2,1,0,3,2021-05-17,Male,35,35-44,16
21,3,0,0,3,2021-05-13,Female,0,<1,12
21,0,0,0,0,2021-05-17,Female,25,25-34,8
21,0,0,0,0,2021-05-14,Female,66,65-69,16
21,0,0,0,0,2021-05-17,Female,66,65-69,15
21,1,12,0,13,2021-05-13,Female,38,35-44,2
21,3,0,0,3,2021-05-18,Male,2,1-4,1
21,0,0,0,0,2021-05-19,Female,5,5-9,1
21,0,2,0,2,2021-05-19,Female,81,80-84,1
21,0,0,0,0,2021-05-19,Female,69,65-69,1
21,2,0,0,2,2021-05-18,Male,33,25-34,9
21,0,0,0,0,2021-05-18,Female,34,25-34,1
21,1,0,0,1,2021-05-13,Male,53,45-54,12
21,1,4,0,5,2021-05-18,Female,67,65-69,1
21,0,3,0,3,2021-05-13,Male,53,45-54,20
21,0,15,0,15,2021-05-18,Female,53,45-54,1
21,1,0,0,1,2021-05-14,Female,41,35-44,13
21,0,0,0,0,2021-05-13,Female,31,25-34,17
21,1,0,0,1,2021-05-18,Male,57,55-64,15
21,1,6,0,7,2021-05-19,Male,66,65-69,15
21,2,6,0,8,2021-05-17,Male,67,65-69,18
21,0,1,0,1,2021-05-14,Female,59,55-64,8
21,1,0,0,1,2021-05-17,Female,76,75-79,13
21,2,0,0,2,2021-05-16,Female,8,5-9,17
21,3,16,15,34,2021-05-20,Male,1,1-4,1
21,0,0,0,0,2021-05-18,Male,20,20-24,6
21,3,2,0,5,2021-05-15,Male,9,5-9,4
21,1,0,0,1,2021-05-13,Female,29,25-34,13
21,2,0,0,2,2021-05-18,Male,12,10-14,16
21,1,32,100,133,2021-05-18,Female,22,20-24,1
21,1,3,0,4,2021-05-18,Female,18,15-19,1
21,1,0,0,1,2021-05-19,Male,68,65-69,1
21,0,0,0,0,2021-05-19,Male,27,25-34,1
21,2,1,0,3,2021-05-19,Female,68,65-69,1
21,0,3,0,3,2021-05-19,Female,71,70-74,8
21,0,1,0,1,2021-05-17,Female,69,65-69,18
21,0,0,0,0,2021-05-18,Female,56,55-64,7
21,0,0,0,0,2021-05-21,Male,24,20-24,1
21,0,0,0,0,2021-05-13,Male,73,70-74,17
21,1,0,0,1,2021-05-19,Male,62,55-64,11
21,0,0,0,0,2021-05-12,Female,21,20-24,10
21,1,1,0,2,2021-05-19,Male,68,65-69,3
21,0,0,0,0,2021-05-13,Male,6,5-9,7
21,0,0,0,0,2021-05-17,Male,63,55-64,15
21,0,0,3,3,2021-05-20,Male,31,25-34,3
21,1,0,0,1,2021-05-19,Female,51,45-54,1
21,0,0,0,0,2021-05-19,Female,29,25-34,8
21,0,0,0,0,2021-05-14,Male,45,45-54,17
21,0,4,0,4,2021-05-16,Female,30,25-34,13
21,2,0,0,2,2021-05-21,Male,12,10-14,1
21,1,0,0,1,2021-05-14,Male,55,55-64,15
21,1,0,2,3,2021-05-18,Female,66,65-69,1
21,0,0,2,2,2021-05-21,Male,20,20-24,1
21,2,0,0,2,2021-05-13,Male,17,15-19,19
21,1,0,20,21,2021-05-18,Male,56,55-64,1
21,3,0,0,3,2021-05-18,Male,18,15-19,1
21,1,0,0,1,2021-05-17,Female,69,65-69,15
21,1,0,0,1,2021-05-19,Female,81,80-84,1
21,2,0,0,2,2021-05-18,Female,63,55-64,14
21,2,0,0,2,2021-05-19,Female,65,65-69,1
21,0,0,0,0,2021-05-20,Male,26,25-34,1
21,2,0,0,2,2021-05-13,Female,74,70-74,10
21,1,0,0,1,2021-05-18,Female,68,65-69,18
21,0,0,0,0,2021-05-20,Male,42,35-44,1
21,3,1,0,4,2021-05-18,Female,65,65-69,1
21,1,0,0,1,2021-05-14,Male,55,55-64,21
21,1,0,0,1,2021-05-17,Female,62,55-64,20
21,0,0,0,0,2021-05-14,Male,67,65-69,15
21,2,0,0,2,2021-05-13,Female,62,55-64,20
21,1,0,0,1,2021-05-20,Male,53,45-54,20
21,1,4,0,5,2021-05-19,Male,69,65-69,1
21,0,3,0,3,2021-05-14,Female,66,65-69,19
21,0,0,0,0,2021-05-12,Male,66,65-69,18
21,0,5,0,5,2021-05-13,Female,60,55-64,17
21,1,0,0,1,2021-05-17,Male,66,65-69,15
21,1,0,0,1,2021-05-17,Female,24,20-24,6
21,0,0,0,0,2021-05-13,Female,68,65-69,16
21,1,1,0,2,2021-05-19,Female,65,65-69,1
21,3,0,0,3,2021-05-14,Female,14,10-14,16
21,2,0,0,2,2021-05-13,Male,12,10-14,15
21,1,0,0,1,2021-05-18,Female,63,55-64,19
21,0,7,0,7,2021-05-13,Female,52,45-54,19
21,1,6,0,7,2021-05-19,Male,85,85+,1
21,1,0,0,1,2021-05-18,Female,61,55-64,1
21,0,0,0,0,2021-05-17,Female,17,15-19,13
21,3,0,0,3,2021-05-20,Male,0,<1,1
21,0,2,0,2,2021-05-18,Female,56,55-64,17
21,2,0,0,2,2021-05-18,Female,53,45-54,17
21,2,0,0,2,2021-05-14,Female,48,45-54,18
21,1,0,0,1,2021-05-17,Male,67,65-69,17
21,0,0,0,0,2021-05-19,Female,67,65-69,6
21,2,1,5,8,2021-05-19,Male,7,5-9,1
21,0,0,0,0,2021-05-12,Female,31,25-34,8
21,0,0,0,0,2021-05-18,Male,29,25-34,14
21,1,1,0,2,2021-05-13,Male,58,55-64,12
21,0,0,0,0,2021-05-17,Female,44,35-44,20
21,2,0,0,2,2021-05-14,Male,22,20-24,13
21,1,0,0,1,2021-05-14,Male,72,70-74,16
21,2,0,0,2,2021-05-17,Female,68,65-69,15
21,2,4,0,6,2021-05-18,Male,70,70-74,12
21,2,1,0,3,2021-05-17,Male,21,20-24,18
21,1,0,0,1,2021-05-17,Female,67,65-69,13
21,1,2,0,3,2021-05-13,Male,58,55-64,20
21,0,0,0,0,2021-05-12,Male,52,45-54,3
21,2,0,0,2,2021-05-21,Male,20,20-24,1
21,1,4,0,5,2021-05-19,Female,66,65-69,1
21,0,0,0,0,2021-05-19,Male,50,45-54,1
21,1,0,0,1,2021-05-13,Male,67,65-69,15
21,0,3,0,3,2021-05-19,Female,71,70-74,1
21,3,0,0,3,2021-05-14,Male,3,1-4,17
21,0,4,0,4,2021-05-14,Male,35,35-44,12
21,2,0,0,2,2021-05-19,Female,85,85+,1
21,0,2,0,2,2021-05-18,Male,53,45-54,1
21,1,1,0,2,2021-05-19,Male,63,55-64,1
21,0,0,0,0,2021-05-19,Female,51,45-54,1
21,0,1,0,1,2021-05-18,Female,65,65-69,1
21,2,0,0,2,2021-05-17,Female,59,55-64,9
21,1,0,0,1,2021-05-18,Female,63,55-64,1
21,0,0,0,0,2021-05-14,Male,44,35-44,17
21,0,0,0,0,2021-05-18,Male,50,45-54,16
21,4,0,0,4,2021-05-19,Female,18,15-19,1
21,1,0,0,1,2021-05-17,Male,70,70-74,7
21,1,0,0,1,2021-05-18,Female,67,65-69,1
21,0,1,0,1,2021-05-17,Female,21,20-24,5
21,2,0,0,2,2021-05-21,Male,21,20-24,1
21,2,1,12,15,2021-05-13,Female,26,25-34,20
21,2,0,0,2,2021-05-16,Male,30,25-34,19
21,0,0,0,0,2021-05-13,Male,34,25-34,15
21,2,2,0,4,2021-05-15,Female,12,10-14,16
21,1,0,0,1,2021-05-17,Female,70,70-74,18
21,1,14,0,15,2021-05-18,Female,36,35-44,1
21,1,0,0,1,2021-05-17,Male,67,65-69,13
21,1,0,0,1,2021-05-18,Male,52,45-54,1
21,0,1,0,1,2021-05-14,Male,67,65-69,17
21,0,0,0,0,2021-05-16,Female,49,45-54,11
21,2,1,0,3,2021-05-20,Male,10,10-14,1
21,2,0,0,2,2021-05-19,Female,68,65-69,13
21,2,0,0,2,2021-05-21,Female,20,20-24,1
21,0,0,0,0,2021-05-18,Male,36,35-44,16
21,2,0,0,2,2021-05-13,Female,7,5-9,18
21,0,0,0,0,2021-05-17,Female,50,45-54,13
21,0,3,0,3,2021-05-15,Female,77,75-79,11
21,1,0,0,1,2021-05-19,Female,72,70-74,1
21,2,0,0,2,2021-05-20,Male,0,<1,1
21,1,0,0,1,2021-05-17,Female,62,55-64,13
21,0,10,1,11,2021-05-18,Female,61,55-64,1
21,0,7,0,7,2021-05-19,Female,54,45-54,1
21,2,0,0,2,2021-05-18,Male,54,45-54,9
21,1,0,0,1,2021-05-17,Male,68,65-69,18
21,6,0,0,6,2021-05-20,Female,20,20-24,1
21,4,0,0,4,2021-05-13,Male,5,5-9,21
21,0,11,10,21,2021-05-18,Male,65,65-69,1
21,1,3,0,4,2021-05-13,Female,0,<1,2
21,2,0,0,2,2021-05-19,Female,1,1-4,1
21,4,15,0,19,2021-05-19,Male,77,75-79,2
21,0,0,0,0,2021-05-13,Male,24,20-24,2
21,1,0,0,1,2021-05-13,Male,30,25-34,3
21,2,0,0,2,2021-05-19,Female,73,70-74,1
21,0,1,0,1,2021-05-18,Female,51,45-54,1
21,2,10,0,12,2021-05-17,Female,46,45-54,4
21,1,2,0,3,2021-05-18,Male,56,55-64,1
21,1,0,0,1,2021-05-20,Female,52,45-54,1
21,2,2,0,4,2021-05-13,Female,1,1-4,16
21,3,0,0,3,2021-05-12,Male,32,25-34,15
21,0,0,0,0,2021-05-18,Male,57,55-64,1
21,2,0,0,2,2021-05-13,Male,52,45-54,16
21,1,0,0,1,2021-05-19,Female,69,65-69,13
21,0,0,0,0,2021-05-18,Male,66,65-69,1
21,2,0,0,2,2021-05-18,Male,61,55-64,17
21,0,2,0,2,2021-05-19,Male,51,45-54,1
21,1,0,0,1,2021-05-18,Female,65,65-69,1
21,0,0,0,0,2021-05-16,Male,52,45-54,12
21,0,0,0,0,2021-05-17,Male,62,55-64,3
21,1,0,0,1,2021-05-18,Female,65,65-69,1
21,1,1,0,2,2021-05-17,Male,66,65-69,19
21,3,0,0,3,2021-05-18,Female,22,20-24,1
21,3,36,0,39,2021-05-20,Male,2,1-4,1
21,1,0,0,1,2021-05-14,Female,40,35-44,15
21,0,1,0,1,2021-05-19,Male,50,45-54,1
21,0,0,0,0,2021-05-19,Male,46,45-54,1
21,0,1,0,1,2021-05-18,Female,22,20-24,1
21,3,4,0,7,2021-05-18,Male,53,45-54,20
21,0,30,0,30,2021-05-19,Male,57,55-64,1
21,0,0,0,0,2021-05-14,Male,51,45-54,15
21,0,2,0,2,2021-05-18,Female,62,55-64,1
21,1,10,0,11,2021-05-17,Male,54,45-54,16
21,1,0,0,1,2021-05-19,Male,68,65-69,1
21,0,0,0,0,2021-05-14,Female,61,55-64,15
21,1,3,0,4,2021-05-19,Female,70,70-74,1
21,1,0,0,1,2021-05-14,Female,54,45-54,20
21,0,1,0,1,2021-05-19,Female,76,75-79,1
21,1,0,0,1,2021-05-13,Male,32,25-34,17
21,0,0,0,0,2021-05-18,Male,66,65-69,13
21,1,0,0,1,2021-05-14,Male,67,65-69,18
21,0,0,0,0,2021-05-13,Male,41,35-44,18
21,0,0,0,0,2021-05-17,Male,59,55-64,17
21,0,0,0,0,2021-05-15,Male,42,35-44,21
21,0,1,0,1,2021-05-14,Male,67,65-69,20
21,3,2,1,6,2021-05-18,Female,30,25-34,1
21,0,0,0,0,2021-05-19,Male,34,25-34,8
21,0,0,0,0,2021-05-13,Female,35,35-44,17
21,2,4,0,6,2021-05-14,Female,4,1-4,2
21,1,0,0,1,2021-05-18,Male,63,55-64,16
21,0,0,0,0,2021-05-19,Female,69,65-69,17
21,2,23,0,25,2021-05-18,Male,51,45-54,11
21,4,2,0,6,2021-05-14,Male,2,1-4,18
21,0,6,2,8,2021-05-18,Female,23,20-24,1
21,4,3,0,7,2021-05-19,Female,50,45-54,1
21,0,0,0,0,2021-05-17,Male,55,55-64,15
21,0,1,0,1,2021-05-13,Male,58,55-64,19
21,1,1,0,2,2021-05-14,Male,48,45-54,16
21,3,0,0,3,2021-05-13,Male,14,10-14,7
21,0,1,0,1,2021-05-19,Female,47,45-54,1
21,0,0,0,0,2021-05-20,Female,26,25-34,1
21,2,0,0,2,2021-05-19,Female,24,20-24,10
21,0,0,0,0,2021-05-17,Female,67,65-69,21
21,3,0,0,3,2021-05-14,Female,13,10-14,19
21,3,0,0,3,2021-05-15,Female,39,35-44,16
21,0,0,0,0,2021-05-19,Male,65,65-69,1
21,2,0,0,2,2021-05-19,Male,78,75-79,15
21,0,0,0,0,2021-05-15,Female,37,35-44,17
21,0,0,0,0,2021-05-20,Male,49,45-54,1
21,0,0,0,0,2021-05-18,Female,57,55-64,1
21,1,10,0,11,2021-05-19,Female,53,45-54,1
21,0,0,0,0,2021-05-19,Female,16,15-19,15
21,0,0,0,0,2021-05-19,Male,14,10-14,1
21,0,0,0,0,2021-05-19,Male,34,25-34,1
21,1,0,0,1,2021-05-18,Male,65,65-69,1
21,1,0,0,1,2021-05-19,Male,70,70-74,1
21,1,12,0,13,2021-05-19,Female,18,15-19,1
21,0,0,0,0,2021-05-19,Male,44,35-44,1
21,1,0,0,1,2021-05-17,Male,67,65-69,16
21,4,0,0,4,2021-05-17,Female,16,15-19,11
21,2,0,0,2,2021-05-14,Male,51,45-54,13
21,2,1,0,3,2021-05-19,Female,2,1-4,1
21,2,6,0,8,2021-05-19,Female,66,65-69,15
21,0,0,0,0,2021-05-19,Male,68,65-69,1
21,0,2,0,2,2021-05-19,Female,50,45-54,1
21,0,0,0,0,2021-05-13,Male,27,25-34,17
21,1,2,0,3,2021-05-19,Female,72,70-74,1
21,0,1,0,1,2021-05-17,Male,48,45-54,18
21,3,0,0,3,2021-05-18,Male,3,1-4,2
21,1,0,0,1,2021-05-19,Male,69,65-69,1
21,0,2,2,4,2021-05-18,Male,34,25-34,1
21,1,0,0,1,2021-05-14,Male,49,45-54,12
21,3,0,6,9,2021-05-20,Female,18,15-19,1
21,0,0,0,0,2021-05-13,Male,52,45-54,18
21,0,0,0,0,2021-05-14,Male,72,70-74,8
21,1,0,0,1,2021-05-19,Male,75,75-79,1
21,2,0,0,2,2021-05-13,Male,23,20-24,14
21,0,7,0,7,2021-05-19,Female,38,35-44,1
21,0,5,1,6,2021-05-19,Female,56,55-64,1
21,0,5,0,5,2021-05-19,Female,56,55-64,1
21,0,2,0,2,2021-05-14,Male,29,25-34,7
21,4,0,0,4,2021-05-17,Female,4,1-4,12
21,1,0,0,1,2021-05-18,Female,55,55-64,1
21,2,0,0,2,2021-05-17,Female,12,10-14,14
21,0,0,0,0,2021-05-18,Male,62,55-64,16
21,0,0,0,0,2021-05-19,Female,31,25-34,7
21,2,0,0,2,2021-05-13,Male,10,10-14,20
21,1,0,0,1,2021-05-17,Male,71,70-74,5
21,3,2,0,5,2021-05-19,Male,16,15-19,1
21,2,0,0,2,2021-05-13,Female,63,55-64,17
21,3,0,0,3,2021-05-21,Female,20,20-24,1
21,1,0,0,1,2021-05-14,Male,45,45-54,12
21,0,0,0,0,2021-05-13,Female,64,55-64,21
21,1,0,0,1,2021-05-13,Female,74,70-74,19
21,0,1,0,1,2021-05-12,Male,54,45-54,13
21,1,0,0,1,2021-05-18,Female,65,65-69,1
21,3,15,0,18,2021-05-19,Female,14,10-14,1
21,0,1,0,1,2021-05-18,Male,52,45-54,1
21,0,2,0,2,2021-05-20,Female,50,45-54,1
21,0,4,0,4,2021-05-13,Male,72,70-74,11
21,3,0,0,3,2021-05-17,Male,4,1-4,6
21,0,0,0,0,2021-05-13,Female,54,45-54,16
21,2,1,0,3,2021-05-20,Male,2,1-4,1
21,1,0,0,1,2021-05-19,Male,28,25-34,1
21,1,3,0,4,2021-05-13,Female,54,45-54,2
21,1,0,0,1,2021-05-13,Female,34,25-34,14
21,1,0,0,1,2021-05-18,Male,30,25-34,1
21,2,0,0,2,2021-05-13,Female,12,10-14,17
21,1,0,0,1,2021-05-12,Female,51,45-54,17
21,0,0,0,0,2021-05-18,Male,57,55-64,17
21,0,3,2,5,2021-05-18,Male,51,45-54,3
21,0,6,0,6,2021-05-13,Female,43,35-44,8
21,0,2,0,2,2021-05-13,Female,62,55-64,13
21,3,22,0,25,2021-05-20,Female,13,10-14,1
21,0,2,0,2,2021-05-14,Female,42,35-44,5
21,0,0,0,0,2021-05-14,Female,59,55-64,16
21,2,1,0,3,2021-05-17,Male,66,65-69,20
21,1,0,0,1,2021-05-13,Female,34,25-34,10
21,5,1,0,6,2021-05-18,Female,9,5-9,11
21,3,0,0,3,2021-05-18,Female,4,1-4,1
21,0,0,0,0,2021-05-13,Female,36,35-44,6
21,2,0,0,2,2021-05-18,Male,71,70-74,11
21,1,0,0,1,2021-05-13,Male,61,55-64,20
21,1,0,0,1,2021-05-17,Male,66,65-69,20
21,1,0,1,2,2021-05-13,Female,56,55-64,12
21,0,0,0,0,2021-05-18,Male,60,55-64,1
21,0,0,0,0,2021-05-20,Female,15,15-19,1
21,0,0,0,0,2021-05-18,Male,34,25-34,16
21,1,0,0,1,2021-05-13,Female,59,55-64,19
21,0,0,0,0,2021-05-18,Male,54,45-54,1
21,2,1,0,3,2021-05-13,Male,73,70-74,16
21,1,0,0,1,2021-05-19,Female,67,65-69,1
21,2,0,0,2,2021-05-20,Female,2,1-4,1
21,2,0,0,2,2021-05-18,Male,73,70-74,12
21,1,0,0,1,2021-05-18,Female,30,25-34,1
21,0,0,0,0,2021-05-14,Male,34,25-34,15
21,0,0,0,0,2021-05-13,Female,37,35-44,14
21,1,0,0,1,2021-05-19,Male,63,55-64,12
21,1,0,0,1,2021-05-14,Female,47,45-54,12
21,3,0,1,4,2021-05-12,Female,22,20-24,12
21,0,1,0,1,2021-05-18,Male,63,55-64,16
21,0,0,0,0,2021-05-14,Male,38,35-44,10
21,0,3,0,3,2021-05-20,Female,21,20-24,1
21,0,0,0,0,2021-05-17,Female,69,65-69,16
21,2,0,0,2,2021-05-12,Female,66,65-69,16
21,0,0,0,0,2021-05-17,Male,54,45-54,18
21,0,3,0,3,2021-05-19,Female,35,35-44,13
21,0,1,0,1,2021-05-14,Male,56,55-64,18
21,1,0,0,1,2021-05-18,Male,63,55-64,1
21,1,1,0,2,2021-05-18,Female,56,55-64,19
21,0,0,0,0,2021-05-14,Female,67,65-69,20
21,2,0,0,2,2021-05-20,Female,11,10-14,1
21,3,17,0,20,2021-05-19,Female,17,15-19,1
21,0,0,0,0,2021-05-16,Male,42,35-44,12
21,1,0,0,1,2021-05-17,Male,72,70-74,15
21,1,0,0,1,2021-05-17,Male,67,65-69,15
21,1,0,0,1,2021-05-12,Female,24,20-24,7
21,1,0,0,1,2021-05-17,Female,73,70-74,13
21,0,0,0,0,2021-05-14,Male,31,25-34,14
21,0,0,0,0,2021-05-20,Female,50,45-54,1
21,0,0,0,0,2021-05-18,Male,72,70-74,16
21,3,17,0,20,2021-05-20,Male,9,5-9,1
21,1,2,0,3,2021-05-18,Female,56,55-64,9
21,2,0,0,2,2021-05-17,Female,70,70-74,17
21,0,0,0,0,2021-05-17,Female,71,70-74,16
21,0,0,0,0,2021-05-18,Male,32,25-34,1
21,0,3,0,3,2021-05-19,Female,60,55-64,1
21,0,0,0,0,2021-05-17,Male,67,65-69,21
21,2,0,0,2,2021-05-19,Male,1,1-4,1
21,0,0,0,0,2021-05-13,Female,26,25-34,16
21,1,0,0,1,2021-05-17,Female,56,55-64,12
21,0,0,0,0,2021-05-18,Female,74,70-74,14
21,2,0,0,2,2021-05-18,Male,81,80-84,16
21,0,0,0,0,2021-05-14,Male,61,55-64,15
21,1,0,0,1,2021-05-13,Female,53,45-54,18
21,0,4,0,4,2021-05-18,Female,58,55-64,1
21,1,0,0,1,2021-05-13,Male,63,55-64,19
21,3,0,0,3,2021-05-19,Male,19,15-19,1
21,0,1,0,1,2021-05-18,Female,67,65-69,1
21,0,0,0,0,2021-05-17,Male,38,35-44,20
21,0,0,0,0,2021-05-18,Female,68,65-69,13
21,1,0,0,1,2021-05-19,Female,68,65-69,1
21,1,2,0,3,2021-05-13,Female,28,25-34,19
21,0,0,0,0,2021-05-14,Male,27,25-34,2
21,4,0,0,4,2021-05-19,Female,48,45-54,9
21,0,0,0,0,2021-05-18,Female,17,15-19,17
21,0,0,0,0,2021-05-16,Male,54,45-54,17
21,2,0,0,2,2021-05-16,Female,31,25-34,21
21,3,0,0,3,2021-05-13,Male,1,1-4,3
21,2,1,0,3,2021-05-19,Male,1,1-4,1
21,2,0,0,2,2021-05-13,Male,9,5-9,2
21,2,6,0,8,2021-05-20,Female,2,1-4,1
21,1,0,0,1,2021-05-18,Female,64,55-64,1
21,2,0,0,2,2021-05-21,Male,18,15-19,1
21,2,0,0,2,2021-05-14,Male,16,15-19,12
21,3,0,0,3,2021-05-13,Female,13,10-14,3
21,1,0,0,1,2021-05-12,Male,35,35-44,20
21,3,2,0,5,2021-05-18,Male,64,55-64,1
21,0,1,0,1,2021-05-18,Female,35,35-44,3
21,0,0,0,0,2021-05-17,Female,72,70-74,19
21,1,0,0,1,2021-05-20,Female,54,45-54,1
21,0,0,0,0,2021-05-14,Female,26,25-34,13
21,3,0,0,3,2021-05-13,Female,9,5-9,15
21,3,3,0,6,2021-05-13,Male,41,35-44,18
21,0,0,0,0,2021-05-13,Female,63,55-64,8
21,1,0,0,1,2021-05-19,Male,21,20-24,1
21,5,1,0,6,2021-05-20,Female,7,5-9,1
21,3,0,0,3,2021-05-18,Male,15,15-19,1
21,1,0,0,1,2021-05-18,Male,32,25-34,16
21,0,2,0,2,2021-05-13,Female,43,35-44,18
21,2,2,0,4,2021-05-17,Female,72,70-74,14
21,0,1,0,1,2021-05-19,Male,59,55-64,15
21,1,0,0,1,2021-05-18,Female,54,45-54,1
21,1,0,0,1,2021-05-18,Male,32,25-34,8
21,1,0,0,1,2021-05-14,Male,55,55-64,16
21,3,4,0,7,2021-05-14,Male,6,5-9,17
21,3,0,0,3,2021-05-12,Female,36,35-44,20
21,1,0,0,1,2021-05-13,Female,59,55-64,19
21,0,0,0,0,2021-05-20,Female,7,5-9,2
21,1,0,0,1,2021-05-17,Male,70,70-74,13
21,1,0,0,1,2021-05-12,Male,67,65-69,19
21,0,5,0,5,2021-05-20,Male,43,35-44,1
21,2,16,0,18,2021-05-20,Male,9,5-9,1
21,0,9,0,9,2021-05-18,Male,60,55-64,1
21,1,1,0,2,2021-05-14,Male,28,25-34,7
21,3,0,0,3,2021-05-18,Male,49,45-54,12
21,0,0,0,0,2021-05-17,Female,58,55-64,17
21,0,0,0,0,2021-05-13,Male,76,75-79,15
21,0,0,0,0,2021-05-17,Female,49,45-54,7
21,2,0,0,2,2021-05-18,Female,54,45-54,1
21,0,0,0,0,2021-05-19,Female,48,45-54,1
21,0,0,0,0,2021-05-14,Male,52,45-54,19
21,1,0,0,1,2021-05-13,Female,76,75-79,13
21,3,0,0,3,2021-05-18,Male,34,25-34,1
21,2,0,0,2,2021-05-18,Male,9,5-9,1
21,0,0,0,0,2021-05-19,Male,31,25-34,2
21,0,0,0,0,2021-05-13,Male,25,25-34,10
21,0,0,0,0,2021-05-17,Male,67,65-69,7
21,3,0,0,3,2021-05-20,Female,3,1-4,1
21,1,0,0,1,2021-05-19,Female,64,55-64,12
21,2,0,0,2,2021-05-19,Male,65,65-69,17
21,4,0,0,4,2021-05-19,Female,24,20-24,1
21,3,0,0,3,2021-05-17,Male,18,15-19,11
21,0,1,0,1,2021-05-13,Male,48,45-54,5
21,0,2,0,2,2021-05-18,Male,59,55-64,1
21,0,0,0,0,2021-05-15,Male,75,75-79,15
21,2,0,0,2,2021-05-19,Male,17,15-19,1
21,0,0,0,0,2021-05-13,Male,29,25-34,8
21,0,1,0,1,2021-05-17,Male,36,35-44,7
21,0,7,0,7,2021-05-19,Male,74,70-74,6
21,0,1,0,1,2021-05-14,Female,66,65-69,20
21,3,2,0,5,2021-05-18,Female,17,15-19,10
21,0,0,0,0,2021-05-13,Female,54,45-54,16
21,1,0,0,1,2021-05-14,Female,46,45-54,18
21,1,0,0,1,2021-05-19,Female,68,65-69,1
21,1,0,0,1,2021-05-20,Female,21,20-24,1
21,1,0,0,1,2021-05-19,Male,54,45-54,16
21,0,1,0,1,2021-05-17,Male,19,15-19,9
21,0,0,0,0,2021-05-19,Male,71,70-74,1
21,0,0,0,0,2021-05-14,Female,63,55-64,18
21,0,0,0,0,2021-05-13,Female,23,20-24,11
21,1,1,0,2,2021-05-19,Female,26,25-34,6
21,2,2,0,4,2021-05-18,Male,74,70-74,14
21,1,0,0,1,2021-05-13,Female,71,70-74,20
21,1,1,0,2,2021-05-14,Female,54,45-54,8
21,2,0,0,2,2021-05-18,Male,14,10-14,1
21,1,1,0,2,2021-05-13,Male,74,70-74,13
21,3,3,0,6,2021-05-18,Male,61,55-64,1
21,0,0,0,0,2021-05-13,Male,27,25-34,19
21,1,0,0,1,2021-05-14,Female,78,75-79,7
21,1,0,0,1,2021-05-13,Male,28,25-34,21
21,1,0,0,1,2021-05-12,Female,31,25-34,15
21,0,0,0,0,2021-05-17,Female,65,65-69,15
21,1,0,0,1,2021-05-14,Male,42,35-44,18
21,3,1,0,4,2021-05-17,Female,3,1-4,2
21,0,0,0,0,2021-05-13,Male,71,70-74,19
21,2,16,10,28,2021-05-20,Male,52,45-54,1
21,1,0,0,1,2021-05-19,Male,51,45-54,1
21,0,0,0,0,2021-05-13,Female,69,65-69,21
21,1,1,72,74,2021-05-18,Male,67,65-69,1
21,0,2,0,2,2021-05-17,Female,63,55-64,18
21,0,0,0,0,2021-05-19,Female,80,80-84,1
21,2,0,0,2,2021-05-18,Male,16,15-19,1
21,2,0,0,2,2021-05-19,Male,26,25-34,1
21,0,0,0,0,2021-05-18,Male,61,55-64,16
21,2,0,0,2,2021-05-14,Male,27,25-34,15
21,0,0,0,0,2021-05-19,Female,40,35-44,1
21,0,0,0,0,2021-05-15,Male,6,5-9,16
21,0,0,0,0,2021-05-16,Female,34,25-34,17
21,1,0,0,1,2021-05-17,Male,69,65-69,20
21,2,0,0,2,2021-05-14,Male,68,65-69,10
21,2,0,0,2,2021-05-18,Female,67,65-69,15
21,0,0,0,0,2021-05-13,Female,40,35-44,8
21,1,0,0,1,2021-05-19,Male,66,65-69,1
21,1,4,0,5,2021-05-13,Male,69,65-69,19
21,3,0,0,3,2021-05-17,Male,19,15-19,8
21,0,0,0,0,2021-05-14,Male,34,25-34,17
21,2,1,0,3,2021-05-13,Male,15,15-19,14
21,1,0,0,1,2021-05-19,Female,46,45-54,1
21,0,2,0,2,2021-05-14,Female,56,55-64,20
21,1,4,0,5,2021-05-18,Male,10,10-14,1
21,1,0,0,1,2021-05-13,Female,53,45-54,16
21,1,1,0,2,2021-05-12,Male,67,65-69,16
21,1,5,0,6,2021-05-19,Female,67,65-69,1
21,1,0,0,1,2021-05-18,Male,56,55-64,15
21,3,0,0,3,2021-05-17,Male,7,5-9,15
21,1,0,0,1,2021-05-15,Male,42,35-44,14
21,0,1,0,1,2021-05-18,Female,54,45-54,13
21,1,1,0,2,2021-05-19,Male,72,70-74,1
21,0,0,0,0,2021-05-19,Female,55,55-64,13
21,0,0,0,0,2021-05-13,Male,60,55-64,21
21,3,0,0,3,2021-05-13,Female,4,1-4,17
21,1,3,0,4,2021-05-19,Female,33,25-34,1
21,1,0,0,1,2021-05-17,Female,60,55-64,15
21,3,15,0,18,2021-05-20,Male,3,1-4,1
21,1,4,0,5,2021-05-18,Male,63,55-64,1
21,3,1,0,4,2021-05-17,Male,9,5-9,12
21,4,0,0,4,2021-05-14,Female,55,55-64,15
21,1,1,0,2,2021-05-20,Male,35,35-44,1
21,0,1,0,1,2021-05-18,Male,66,65-69,1
21,2,0,0,2,2021-05-18,Female,56,55-64,17
21,0,0,0,0,2021-05-19,Female,21,20-24,1
21,1,1,0,2,2021-05-13,Female,60,55-64,20
21,0,0,0,0,2021-05-20,Female,41,35-44,1
21,2,1,0,3,2021-05-13,Male,60,55-64,16
21,4,0,0,4,2021-05-19,Male,15,15-19,1
21,0,0,0,0,2021-05-18,Male,70,70-74,20
21,3,0,0,3,2021-05-13,Male,48,45-54,12
21,0,2,0,2,2021-05-13,Female,55,55-64,16
21,2,0,5,7,2021-05-19,Male,33,25-34,5
21,2,1,0,3,2021-05-20,Female,14,10-14,1
21,3,20,18,41,2021-05-19,Female,10,10-14,1
21,1,0,0,1,2021-05-18,Male,61,55-64,13
21,2,5,45,52,2021-05-20,Male,1,1-4,1
21,2,0,0,2,2021-05-19,Male,1,1-4,1
21,1,0,0,1,2021-05-17,Female,52,45-54,19
21,3,0,0,3,2021-05-19,Female,12,10-14,1
21,1,0,0,1,2021-05-17,Male,69,65-69,15
21,4,4,0,8,2021-05-18,Male,17,15-19,1
21,2,0,0,2,2021-05-17,Male,72,70-74,16
21,0,0,0,0,2021-05-18,Female,62,55-64,1
21,1,0,0,1,2021-05-19,Male,66,65-69,1
21,2,1,0,3,2021-05-13,Male,78,75-79,15
21,0,0,0,0,2021-05-19,Female,67,65-69,1
21,2,0,0,2,2021-05-18,Male,11,10-14,1
21,4,0,0,4,2021-05-19,Male,53,45-54,1
21,2,6,0,8,2021-05-17,Female,67,65-69,11
21,0,4,0,4,2021-05-18,Female,62,55-64,1
21,2,1,0,3,2021-05-18,Male,52,45-54,14
21,0,2,0,2,2021-05-18,Male,56,55-64,1
21,1,1,0,2,2021-05-17,Male,70,70-74,17
21,2,2,0,4,2021-05-20,Male,12,10-14,1
21,3,0,0,3,2021-05-14,Female,19,15-19,17
21,1,6,0,7,2021-05-19,Female,40,35-44,1
21,0,0,0,0,2021-05-14,Female,42,35-44,6
21,0,0,0,0,2021-05-19,Female,70,70-74,1
21,1,0,0,1,2021-05-13,Female,65,65-69,20
21,0,0,0,0,2021-05-19,Female,38,35-44,17
21,3,0,0,3,2021-05-17,Female,14,10-14,7
21,0,0,0,0,2021-05-19,Female,43,35-44,1
21,2,0,1,3,2021-05-20,Female,9,5-9,1
21,0,0,0,0,2021-05-17,Male,58,55-64,13
21,1,0,3,4,2021-05-17,Female,28,25-34,6
21,3,7,0,10,2021-05-20,Female,4,1-4,1
21,2,2,40,44,2021-05-18,Male,12,10-14,1
21,1,1,0,2,2021-05-18,Female,52,45-54,1
21,2,0,0,2,2021-05-19,Male,11,10-14,7
21,0,0,0,0,2021-05-14,Female,59,55-64,7
21,0,0,0,0,2021-05-17,Male,60,55-64,14
21,0,0,0,0,2021-05-13,Female,56,55-64,18
21,3,0,0,3,2021-05-21,Male,19,15-19,1
21,0,0,0,0,2021-05-17,Male,55,55-64,17
21,0,0,0,0,2021-05-12,Male,36,35-44,14
21,1,2,0,3,2021-05-19,Female,36,35-44,1
21,0,0,0,0,2021-05-19,Male,37,35-44,16
21,1,0,0,1,2021-05-16,Male,16,15-19,8
21,2,0,0,2,2021-05-13,Male,64,55-64,15
21,0,0,0,0,2021-05-14,Male,74,70-74,13
21,0,3,0,3,2021-05-18,Male,18,15-19,1
21,4,0,0,4,2021-05-19,Female,18,15-19,1
21,1,0,0,1,2021-05-19,Male,41,35-44,1
21,1,5,0,6,2021-05-18,Male,62,55-64,1
21,0,0,0,0,2021-05-19,Male,56,55-64,1
21,2,0,0,2,2021-05-13,Male,13,10-14,12
21,2,0,0,2,2021-05-20,Female,18,15-19,1
21,1,0,0,1,2021-05-19,Female,15,15-19,17
21,0,4,0,4,2021-05-18,Male,62,55-64,17
21,0,0,0,0,2021-05-21,Male,19,15-19,1
21,0,0,0,0,2021-05-19,Male,32,25-34,1
21,2,0,0,2,2021-05-15,Male,16,15-19,8
21,1,0,0,1,2021-05-13,Male,51,45-54,8
21,3,0,0,3,2021-05-18,Male,31,25-34,1
21,0,0,0,0,2021-05-13,Male,54,45-54,12
21,1,0,0,1,2021-05-17,Male,52,45-54,7
21,1,1,0,2,2021-05-18,Male,64,55-64,1
21,1,0,0,1,2021-05-14,Male,54,45-54,16
21,2,1,0,3,2021-05-14,Female,65,65-69,19
21,1,0,0,1,2021-05-19,Male,70,70-74,1
21,3,0,0,3,2021-05-19,Female,3,1-4,1
21,0,0,0,0,2021-05-13,Male,79,75-79,11
21,1,0,0,1,2021-05-12,Male,62,55-64,18
21,0,0,0,0,2021-05-20,Male,42,35-44,1
21,0,0,0,0,2021-05-18,Male,63,55-64,1
21,2,0,0,2,2021-05-13,Male,38,35-44,17
21,0,0,0,0,2021-05-14,Male,16,15-19,10
21,0,0,0,0,2021-05-13,Male,53,45-54,16
21,1,4,0,5,2021-05-19,Female,61,55-64,1
21,1,0,0,1,2021-05-13,Female,51,45-54,14
21,3,2,0,5,2021-05-18,Male,5,5-9,1
21,0,0,0,0,2021-05-17,Female,61,55-64,17
21,1,0,0,1,2021-05-16,Male,11,10-14,20
21,3,0,0,3,2021-05-18,Female,4,1-4,1
21,1,0,0,1,2021-05-13,Female,27,25-34,8
21,0,0,0,0,2021-05-17,Male,41,35-44,14
21,0,1,0,1,2021-05-19,Male,40,35-44,1
21,3,2,0,5,2021-05-18,Female,60,55-64,6
21,1,0,0,1,2021-05-19,Female,50,45-54,1
21,2,0,0,2,2021-05-17,Female,68,65-69,9
21,3,0,0,3,2021-05-19,Female,7,5-9,1
21,0,0,0,0,2021-05-19,Female,27,25-34,1
21,3,0,0,3,2021-05-12,Female,1,1-4,6
21,0,1,0,1,2021-05-19,Male,68,65-69,1
21,1,0,0,1,2021-05-20,Male,39,35-44,1
21,4,18,0,22,2021-05-20,Female,3,1-4,1
21,0,0,0,0,2021-05-18,Female,37,35-44,1
21,0,0,0,0,2021-05-18,Female,66,65-69,19
21,0,0,0,0,2021-05-13,Male,64,55-64,11
21,1,0,0,1,2021-05-19,Male,68,65-69,11
21,1,1,0,2,2021-05-17,Male,38,35-44,17
21,1,0,0,1,2021-05-19,Male,70,70-74,2
21,0,1,0,1,2021-05-18,Female,24,20-24,12
21,0,0,0,0,2021-05-17,Female,66,65-69,6
21,0,0,0,0,2021-05-17,Female,68,65-69,20
21,0,0,0,0,2021-05-18,Male,61,55-64,1
21,1,0,0,1,2021-05-18,Male,59,55-64,1
21,0,0,0,0,2021-05-16,Female,44,35-44,12
21,0,0,0,0,2021-05-18,Male,65,65-69,1
21,1,0,0,1,2021-05-14,Female,40,35-44,15
21,1,0,0,1,2021-05-19,Male,46,45-54,1
21,0,1,0,1,2021-05-13,Female,68,65-69,18
21,0,4,0,4,2021-05-18,Female,56,55-64,1
21,0,0,6,6,2021-05-18,Male,67,65-69,14
21,1,0,0,1,2021-05-14,Female,52,45-54,20
21,0,0,0,0,2021-05-19,Female,24,20-24,18
21,3,0,0,3,2021-05-18,Female,23,20-24,1
21,1,0,0,1,2021-05-18,Female,18,15-19,16
21,0,0,0,0,2021-05-17,Female,44,35-44,16
21,1,0,0,1,2021-05-18,Male,67,65-69,12
21,2,0,0,2,2021-05-14,Female,63,55-64,18
21,0,6,0,6,2021-05-18,Female,51,45-54,14
21,1,0,0,1,2021-05-19,Male,61,55-64,1
21,0,3,0,3,2021-05-17,Male,42,35-44,5
21,0,0,0,0,2021-05-14,Female,67,65-69,18
21,0,0,0,0,2021-05-19,Male,6,5-9,1
21,1,0,0,1,2021-05-18,Male,30,25-34,2
21,1,0,0,1,2021-05-19,Male,36,35-44,12
21,0,0,0,0,2021-05-17,Male,59,55-64,20
21,0,0,0,0,2021-05-19,Male,26,25-34,1
21,1,4,0,5,2021-05-14,Male,79,75-79,16
21,0,0,0,0,2021-05-22,Male,22,20-24,1
21,4,23,5,32,2021-05-20,Female,12,10-14,1
21,2,2,0,4,2021-05-13,Female,6,5-9,16
21,1,4,0,5,2021-05-17,Male,44,35-44,13
21,1,1,0,2,2021-05-17,Female,63,55-64,15
21,1,0,0,1,2021-05-19,Male,31,25-34,1
21,0,0,0,0,2021-05-17,Female,53,45-54,14
21,2,0,0,2,2021-05-17,Male,69,65-69,18
21,1,0,0,1,2021-05-13,Female,56,55-64,18
21,2,1,0,3,2021-05-18,Female,61,55-64,12
21,3,2,0,5,2021-05-19,Male,17,15-19,1
21,3,0,0,3,2021-05-20,Male,8,5-9,1
21,1,0,0,1,2021-05-14,Female,62,55-64,16
21,1,0,0,1,2021-05-13,Male,68,65-69,15
21,1,1,0,2,2021-05-18,Male,60,55-64,1
21,0,3,0,3,2021-05-19,Male,49,45-54,1
21,1,0,0,1,2021-05-19,Female,47,45-54,1
21,1,1,0,2,2021-05-14,Male,64,55-64,21
21,0,0,0,0,2021-05-20,Female,30,25-34,1
21,2,2,0,4,2021-05-17,Male,73,70-74,18
21,1,0,0,1,2021-05-17,Female,65,65-69,17
21,2,0,0,2,2021-05-14,Male,54,45-54,16
21,0,0,0,0,2021-05-18,Female,67,65-69,16
21,1,0,0,1,2021-05-20,Male,53,45-54,1
21,1,0,2,3,2021-05-18,Male,66,65-69,1
21,0,0,0,0,2021-05-12,Male,12,10-14,6
21,1,0,0,1,2021-05-20,Female,24,20-24,2
21,0,0,0,0,2021-05-18,Female,38,35-44,5
21,0,0,0,0,2021-05-20,Male,46,45-54,1
21,0,2,0,2,2021-05-18,Female,72,70-74,18
21,2,0,0,2,2021-05-17,Female,72,70-74,17
21,1,0,0,1,2021-05-14,Female,50,45-54,20
21,3,0,0,3,2021-05-13,Female,59,55-64,17
21,0,0,0,0,2021-05-17,Female,34,25-34,16
21,2,2,0,4,2021-05-17,Female,2,1-4,12
21,1,0,0,1,2021-05-17,Female,51,45-54,14
21,0,0,0,0,2021-05-13,Female,41,35-44,20
21,0,10,0,10,2021-05-18,Female,53,45-54,1
21,0,0,0,0,2021-05-12,Male,22,20-24,20
21,0,0,0,0,2021-05-14,Male,55,55-64,20
21,0,0,0,0,2021-05-14,Male,23,20-24,14
21,0,7,0,7,2021-05-12,Female,37,35-44,19
21,3,8,0,11,2021-05-13,Female,8,5-9,17
21,2,6,0,8,2021-05-19,Female,85,85+,1
21,1,0,0,1,2021-05-18,Male,55,55-64,17
21,1,0,0,1,2021-05-18,Male,63,55-64,1
21,2,3,0,5,2021-05-17,Male,62,55-64,18
21,0,10,0,10,2021-05-14,Female,20,20-24,7
21,5,0,0,5,2021-05-12,Male,15,15-19,17
21,0,7,0,7,2021-05-19,Male,40,35-44,6
21,2,0,0,2,2021-05-17,Male,70,70-74,3
21,1,2,0,3,2021-05-13,Female,57,55-64,16
21,1,0,0,1,2021-05-19,Female,68,65-69,16
21,0,0,0,0,2021-05-13,Female,85,85+,9
21,0,0,0,0,2021-05-17,Female,71,70-74,19
21,1,0,0,1,2021-05-14,Male,74,70-74,21
21,1,0,0,1,2021-05-17,Female,66,65-69,16
21,3,0,0,3,2021-05-14,Male,11,10-14,8
21,0,4,0,4,2021-05-19,Male,73,70-74,18
21,1,6,0,7,2021-05-18,Female,40,35-44,6
21,0,2,0,2,2021-05-20,Male,39,35-44,1
21,0,12,0,12,2021-05-20,Female,20,20-24,1
21,1,0,0,1,2021-05-18,Male,54,45-54,1
21,0,0,0,0,2021-05-18,Female,37,35-44,11
21,0,0,0,0,2021-05-19,Male,67,65-69,8
21,0,0,0,0,2021-05-13,Female,38,35-44,18
21,2,0,0,2,2021-05-18,Male,58,55-64,1
21,1,2,0,3,2021-05-20,Female,28,25-34,1
21,2,0,0,2,2021-05-14,Female,11,10-14,12
21,1,0,0,1,2021-05-17,Male,67,65-69,14
21,1,0,0,1,2021-05-13,Female,61,55-64,18
21,0,1,0,1,2021-05-20,Male,33,25-34,1
21,1,0,0,1,2021-05-18,Female,66,65-69,14
21,1,0,7,8,2021-05-18,Male,32,25-34,1
21,1,0,0,1,2021-05-18,Male,67,65-69,16
21,1,0,0,1,2021-05-21,Male,24,20-24,1
21,3,0,0,3,2021-05-14,Female,12,10-14,18
21,1,4,0,5,2021-05-19,Male,71,70-74,9
21,0,0,0,0,2021-05-17,Female,51,45-54,15
21,4,2,0,6,2021-05-17,Female,11,10-14,8
21,1,0,0,1,2021-05-18,Male,39,35-44,1
21,0,1,0,1,2021-05-14,Female,51,45-54,10
21,3,0,0,3,2021-05-18,Male,52,45-54,1
21,0,0,0,0,2021-05-17,Male,22,20-24,16
21,0,0,0,0,2021-05-19,Female,66,65-69,1
21,0,0,13,13,2021-05-14,Male,39,35-44,3
21,1,0,0,1,2021-05-19,Female,67,65-69,1
21,1,31,0,32,2021-05-17,Male,66,65-69,20
21,2,16,0,18,2021-05-22,Male,18,15-19,1
21,0,0,0,0,2021-05-17,Male,32,25-34,15
21,1,1,0,2,2021-05-18,Female,65,65-69,1
21,0,2,0,2,2021-05-19,Female,71,70-74,1
21,1,0,0,1,2021-05-19,Male,74,70-74,1
21,1,0,0,1,2021-05-14,Female,10,10-14,14
21,0,0,0,0,2021-05-19,Female,25,25-34,13
21,3,0,0,3,2021-05-18,Female,65,65-69,20
21,2,0,0,2,2021-05-19,Female,67,65-69,18
21,0,0,0,0,2021-05-14,Female,75,75-79,19
21,2,3,0,5,2021-05-18,Female,10,10-14,1
21,0,0,0,0,2021-05-17,Female,45,45-54,13
21,0,0,0,0,2021-05-19,Male,32,25-34,16
21,3,0,0,3,2021-05-13,Male,23,20-24,18
21,0,0,0,0,2021-05-13,Male,37,35-44,14
21,2,1,0,3,2021-05-18,Female,23,20-24,17
21,0,0,0,0,2021-05-14,Male,35,35-44,12
21,0,0,0,0,2021-05-24,Male,24,20-24,1
21,0,0,0,0,2021-05-13,Male,15,15-19,18
21,0,1,0,1,2021-05-18,Female,69,65-69,5
21,1,1,0,2,2021-05-12,Male,66,65-69,19
21,1,0,4,5,2021-05-18,Female,60,55-64,1
21,1,0,0,1,2021-05-19,Male,56,55-64,10
21,3,0,0,3,2021-05-16,Female,14,10-14,21
21,3,0,0,3,2021-05-19,Female,0,<1,1
21,0,3,0,3,2021-05-19,Female,66,65-69,15
21,3,2,0,5,2021-05-19,Female,13,10-14,1
21,1,0,0,1,2021-05-14,Male,76,75-79,16
21,0,0,0,0,2021-05-19,Male,45,45-54,1
21,2,0,0,2,2021-05-20,Male,0,<1,2
21,0,0,0,0,2021-05-20,Male,54,45-54,1
21,2,4,0,6,2021-05-19,Male,42,35-44,1
21,0,0,0,0,2021-05-13,Male,22,20-24,10
21,3,15,0,18,2021-05-19,Female,9,5-9,1
21,1,0,0,1,2021-05-17,Male,59,55-64,14
21,1,0,0,1,2021-05-17,Male,63,55-64,20
21,0,0,0,0,2021-05-14,Male,30,25-34,3
21,0,6,8,14,2021-05-21,Male,18,15-19,1
21,2,0,0,2,2021-05-13,Male,66,65-69,18
21,0,0,0,0,2021-05-19,Female,38,35-44,8
21,2,1,0,3,2021-05-12,Female,22,20-24,6
21,0,0,0,0,2021-05-18,Male,38,35-44,15
21,1,0,0,1,2021-05-19,Female,67,65-69,14
21,3,0,0,3,2021-05-14,Male,16,15-19,2
21,1,0,0,1,2021-05-19,Female,66,65-69,1
21,0,0,0,0,2021-05-14,Male,30,25-34,9
21,0,2,0,2,2021-05-19,Male,54,45-54,1
21,0,0,0,0,2021-05-13,Male,28,25-34,14
21,1,3,0,4,2021-05-20,Male,29,25-34,1
21,1,0,64,65,2021-05-17,Male,68,65-69,9
21,1,0,0,1,2021-05-14,Female,62,55-64,15
21,1,0,0,1,2021-05-17,Female,53,45-54,18
21,0,0,0,0,2021-05-13,Male,75,75-79,7
21,1,0,0,1,2021-05-14,Female,49,45-54,19
21,3,0,0,3,2021-05-18,Female,5,5-9,1
21,1,3,0,4,2021-05-19,Female,40,35-44,1
21,0,0,0,0,2021-05-18,Female,73,70-74,12
21,0,0,0,0,2021-05-17,Female,13,10-14,11
21,0,1,0,1,2021-05-18,Female,66,65-69,1
21,1,0,0,1,2021-05-18,Male,65,65-69,14
21,3,0,0,3,2021-05-16,Male,30,25-34,10
21,0,4,0,4,2021-05-19,Female,67,65-69,1
21,0,0,0,0,2021-05-18,Male,54,45-54,1
21,0,0,0,0,2021-05-17,Female,25,25-34,20
21,0,4,0,4,2021-05-18,Female,31,25-34,3
21,1,0,0,1,2021-05-14,Male,40,35-44,18
21,0,6,0,6,2021-05-20,Female,44,35-44,1
21,1,0,0,1,2021-05-17,Male,62,55-64,17
21,2,0,0,2,2021-05-19,Female,18,15-19,1
21,0,0,0,0,2021-05-14,Female,69,65-69,16
21,0,0,0,0,2021-05-20,Female,32,25-34,1
21,1,2,0,3,2021-05-18,Male,51,45-54,1
21,1,0,0,1,2021-05-14,Male,68,65-69,19
21,3,0,17,20,2021-05-21,Male,19,15-19,1
21,2,1,0,3,2021-05-13,Female,36,35-44,2
21,2,0,0,2,2021-05-13,Male,13,10-14,21
21,4,0,0,4,2021-05-16,Female,13,10-14,15
21,0,0,0,0,2021-05-18,Male,56,55-64,16
21,1,1,0,2,2021-05-17,Male,71,70-74,16
21,2,0,0,2,2021-05-21,Male,21,20-24,1
21,1,0,0,1,2021-05-18,Male,56,55-64,1
21,2,0,0,2,2021-05-17,Female,60,55-64,17
21,0,0,0,0,2021-05-17,Male,46,45-54,13
21,1,0,0,1,2021-05-19,Female,58,55-64,1
21,1,0,0,1,2021-05-13,Male,3,1-4,11
21,2,0,0,2,2021-05-17,Male,58,55-64,18
21,2,0,0,2,2021-05-18,Female,67,65-69,10
21,0,0,0,0,2021-05-21,Male,19,15-19,1
21,0,1,0,1,2021-05-19,Female,67,65-69,1
21,1,0,0,1,2021-05-18,Female,51,45-54,1
21,0,0,0,0,2021-05-14,Female,34,25-34,17
21,3,1,0,4,2021-05-13,Female,33,25-34,18
21,1,0,0,1,2021-05-14,Male,58,55-64,19
21,2,0,0,2,2021-05-17,Male,64,55-64,20
21,1,0,6,7,2021-05-17,Female,63,55-64,19
21,2,0,0,2,2021-05-14,Male,2,1-4,2
21,1,0,0,1,2021-05-18,Female,64,55-64,18
21,0,0,0,0,2021-05-18,Female,66,65-69,1
21,1,1,0,2,2021-05-19,Female,57,55-64,1
21,0,0,0,0,2021-05-12,Female,44,35-44,17
21,2,0,0,2,2021-05-17,Female,69,65-69,19
21,1,0,0,1,2021-05-13,Male,53,45-54,17
21,2,0,0,2,2021-05-12,Male,50,45-54,19
21,1,1,0,2,2021-05-20,Male,36,35-44,1
21,1,0,0,1,2021-05-19,Female,64,55-64,13
21,1,3,0,4,2021-05-13,Female,68,65-69,19
21,1,0,0,1,2021-05-19,Male,59,55-64,18
21,1,4,0,5,2021-05-18,Female,64,55-64,1
21,0,0,0,0,2021-05-14,Male,33,25-34,18
21,2,0,0,2,2021-05-18,Male,11,10-14,1
21,0,6,0,6,2021-05-19,Male,32,25-34,1
21,2,0,0,2,2021-05-18,Female,19,15-19,1
21,1,0,0,1,2021-05-19,Female,65,65-69,15
21,1,6,0,7,2021-05-14,Male,68,65-69,21
21,0,0,0,0,2021-05-13,Male,13,10-14,18
21,0,0,0,0,2021-05-19,Female,39,35-44,1
21,2,0,0,2,2021-05-16,Male,77,75-79,14
21,0,0,0,0,2021-05-18,Male,67,65-69,1
21,0,0,1,1,2021-05-20,Male,36,35-44,1
21,1,0,0,1,2021-05-14,Female,59,55-64,20
21,0,0,0,0,2021-05-15,Female,25,25-34,11
21,1,2,0,3,2021-05-19,Male,42,35-44,1
21,1,0,0,1,2021-05-20,Male,32,25-34,1
21,6,0,0,6,2021-05-15,Female,26,25-34,20
21,1,0,0,1,2021-05-18,Male,67,65-69,9
21,1,0,0,1,2021-05-13,Female,66,65-69,10
21,0,0,0,0,2021-05-13,Female,68,65-69,13
21,1,0,0,1,2021-05-21,Male,20,20-24,1
21,3,1,0,4,2021-05-12,Male,10,10-14,17
21,1,0,0,1,2021-05-19,Male,47,45-54,1
21,0,0,0,0,2021-05-18,Male,36,35-44,1
21,1,1,0,2,2021-05-19,Male,77,75-79,1
21,0,0,0,0,2021-05-12,Female,19,15-19,9
21,2,0,0,2,2021-05-14,Male,24,20-24,13
21,2,0,1,3,2021-05-13,Male,11,10-14,16
21,0,1,0,1,2021-05-17,Female,40,35-44,12
21,0,0,0,0,2021-05-18,Male,15,15-19,15
21,0,0,0,0,2021-05-18,Female,56,55-64,1
21,2,2,0,4,2021-05-20,Male,53,45-54,1
21,2,2,0,4,2021-05-13,Male,51,45-54,17
21,1,0,0,1,2021-05-12,Male,47,45-54,10
21,0,3,0,3,2021-05-19,Female,68,65-69,1
21,0,0,0,0,2021-05-19,Male,51,45-54,1
21,2,0,0,2,2021-05-19,Male,64,55-64,1
21,0,0,0,0,2021-05-13,Male,40,35-44,17
21,0,0,0,0,2021-05-14,Female,34,25-34,19
21,0,0,0,0,2021-05-20,Female,19,15-19,3
21,0,0,0,0,2021-05-17,Female,68,65-69,9
21,5,0,0,5,2021-05-13,Female,19,15-19,8
21,2,0,0,2,2021-05-19,Male,0,<1,1
21,0,2,0,2,2021-05-15,Male,46,45-54,17
21,0,7,0,7,2021-05-18,Female,66,65-69,17
21,0,0,0,0,2021-05-19,Female,76,75-79,10
21,3,2,7,12,2021-05-19,Male,5,5-9,1
21,2,0,0,2,2021-05-19,Female,71,70-74,4
21,0,0,0,0,2021-05-19,Female,19,15-19,2
21,5,0,0,5,2021-05-12,Female,20,20-24,12
21,0,0,0,0,2021-05-13,Female,53,45-54,17
21,0,1,0,1,2021-05-14,Female,28,25-34,8
21,0,0,0,0,2021-05-13,Male,71,70-74,7
21,2,0,0,2,2021-05-13,Male,26,25-34,15
21,1,0,0,1,2021-05-19,Female,55,55-64,1
21,2,0,0,2,2021-05-19,Male,26,25-34,3
21,0,3,0,3,2021-05-19,Female,28,25-34,16
21,0,3,0,3,2021-05-14,Male,44,35-44,8
21,1,2,0,3,2021-05-20,Female,32,25-34,1
21,0,0,0,0,2021-05-13,Male,16,15-19,12
21,0,0,0,0,2021-05-14,Female,67,65-69,17
21,0,0,0,0,2021-05-13,Female,68,65-69,13
21,0,0,0,0,2021-05-13,Female,69,65-69,19
21,0,0,0,0,2021-05-12,Male,25,25-34,7
21,1,15,0,16,2021-05-19,Male,19,15-19,1
21,0,0,0,0,2021-05-24,Male,32,25-34,1
21,1,0,0,1,2021-05-19,Male,76,75-79,1
21,1,4,0,5,2021-05-18,Male,65,65-69,1
21,1,0,0,1,2021-05-13,Female,31,25-34,10
21,1,9,0,10,2021-05-18,Female,19,15-19,1
21,5,0,0,5,2021-05-14,Male,11,10-14,18
21,1,3,0,4,2021-05-19,Male,70,70-74,1
21,3,0,0,3,2021-05-18,Female,4,1-4,1
21,2,2,0,4,2021-05-13,Female,55,55-64,17
21,0,4,0,4,2021-05-14,Female,28,25-34,13
21,2,0,0,2,2021-05-14,Male,48,45-54,20
21,3,2,2,7,2021-05-18,Male,9,5-9,1
21,0,0,0,0,2021-05-18,Female,53,45-54,20
21,0,0,0,0,2021-05-18,Male,60,55-64,1
21,3,0,0,3,2021-05-13,Female,21,20-24,9
21,0,0,0,0,2021-05-17,Female,38,35-44,14
21,1,0,0,1,2021-05-19,Female,68,65-69,1
21,0,1,0,1,2021-05-19,Female,79,75-79,1
21,1,0,0,1,2021-05-19,Female,65,65-69,1
21,0,0,0,0,2021-05-16,Male,54,45-54,14
21,2,0,0,2,2021-05-17,Male,68,65-69,10
21,1,0,0,1,2021-05-13,Female,40,35-44,8
21,0,0,0,0,2021-05-19,Female,70,70-74,1
21,2,0,0,2,2021-05-18,Female,20,20-24,1
21,1,9,0,10,2021-05-19,Female,69,65-69,1
21,0,0,0,0,2021-05-17,Male,49,45-54,17
21,2,0,0,2,2021-05-17,Female,73,70-74,5
21,1,0,0,1,2021-05-17,Male,64,55-64,16
21,0,6,0,6,2021-05-19,Male,40,35-44,1
21,0,0,0,0,2021-05-13,Male,62,55-64,3
21,1,0,0,1,2021-05-12,Male,36,35-44,17
21,1,0,0,1,2021-05-18,Female,33,25-34,1
21,1,0,0,1,2021-05-19,Male,50,45-54,18
21,0,0,0,0,2021-05-14,Male,53,45-54,3
21,0,5,0,5,2021-05-18,Female,51,45-54,1
21,1,9,0,10,2021-05-20,Male,53,45-54,1
21,1,0,0,1,2021-05-18,Female,66,65-69,1
21,3,0,0,3,2021-05-20,Female,48,45-54,1
21,0,0,0,0,2021-05-14,Female,53,45-54,16
21,2,0,0,2,2021-05-13,Male,69,65-69,19
21,0,1,0,1,2021-05-20,Female,34,25-34,1
21,0,0,9,9,2021-05-19,Male,44,35-44,1
21,1,24,17,42,2021-05-13,Female,48,45-54,17
21,2,0,0,2,2021-05-14,Male,21,20-24,18
21,3,2,0,5,2021-05-18,Male,85,85+,15
21,2,3,0,5,2021-05-20,Male,1,1-4,1
21,1,0,0,1,2021-05-21,Male,23,20-24,1
21,1,0,0,1,2021-05-18,Male,56,55-64,1
21,1,2,0,3,2021-05-18,Female,32,25-34,11
21,2,0,0,2,2021-05-14,Male,12,10-14,13
21,1,0,0,1,2021-05-19,Male,67,65-69,1
21,2,0,0,2,2021-05-17,Female,71,70-74,9
21,2,1,0,3,2021-05-14,Female,20,20-24,10
21,2,2,0,4,2021-05-19,Female,67,65-69,15
21,0,0,0,0,2021-05-13,Male,50,45-54,21
21,0,0,1,1,2021-05-13,Male,0,<1,11
21,1,0,0,1,2021-05-19,Male,1,1-4,2
21,0,0,0,0,2021-05-20,Male,34,25-34,1
21,1,0,0,1,2021-05-19,Female,45,45-54,1
21,0,0,0,0,2021-05-16,Male,29,25-34,15
21,0,0,0,0,2021-05-18,Male,38,35-44,1
21,0,0,0,0,2021-05-18,Female,38,35-44,3
21,2,0,0,2,2021-05-14,Female,19,15-19,7
21,2,0,0,2,2021-05-17,Male,55,55-64,18
21,2,3,0,5,2021-05-18,Male,62,55-64,1
21,0,0,0,0,2021-05-17,Male,31,25-34,16
21,2,0,0,2,2021-05-19,Male,66,65-69,13
21,0,0,0,0,2021-05-19,Female,31,25-34,6
21,0,1,0,1,2021-05-19,Female,66,65-69,1
21,2,0,0,2,2021-05-14,Female,80,80-84,16
21,2,1,18,21,2021-05-20,Female,18,15-19,1
21,1,0,0,1,2021-05-14,Female,70,70-74,19
21,0,0,0,0,2021-05-17,Female,70,70-74,21
21,1,1,0,2,2021-05-14,Male,71,70-74,19
21,3,6,0,9,2021-05-19,Female,65,65-69,1
21,1,0,0,1,2021-05-18,Female,57,55-64,1
21,0,1,0,1,2021-05-18,Female,60,55-64,1
21,3,0,0,3,2021-05-17,Male,10,10-14,13
21,0,4,0,4,2021-05-13,Male,61,55-64,20
21,1,0,0,1,2021-05-19,Female,70,70-74,1
21,0,0,0,0,2021-05-17,Male,67,65-69,9
21,1,3,0,4,2021-05-15,Female,30,25-34,16
21,3,0,0,3,2021-05-17,Female,14,10-14,17
21,3,0,0,3,2021-05-19,Male,0,<1,1
21,0,0,0,0,2021-05-19,Male,10,10-14,17
21,0,0,0,0,2021-05-14,Male,34,25-34,19
21,0,0,0,0,2021-05-20,Female,10,10-14,1
21,2,0,0,2,2021-05-17,Male,15,15-19,13
21,3,1,0,4,2021-05-17,Male,6,5-9,11
21,2,0,0,2,2021-05-13,Male,20,20-24,17
22,0,0,0,0,2021-05-31,Male,60,55-64,15
22,0,0,0,0,2021-06-03,Male,65,65-69,1
22,3,0,0,3,2021-06-02,Male,1,1-4,1
22,0,0,0,0,2021-05-30,Male,65,65-69,2
22,0,2,0,2,2021-05-31,Female,49,45-54,2
22,0,0,0,0,2021-06-02,Female,30,25-34,1
22,0,0,0,0,2021-05-27,Male,30,25-34,2
22,2,0,0,2,2021-05-30,Female,66,65-69,21
22,1,2,0,3,2021-06-02,Female,55,55-64,1
22,0,1,0,1,2021-05-27,Female,72,70-74,18
22,2,0,0,2,2021-05-31,Female,4,1-4,7
22,1,4,23,28,2021-06-02,Female,9,5-9,1
22,1,0,0,1,2021-06-02,Female,58,55-64,1
22,1,4,0,5,2021-06-02,Female,21,20-24,1
22,1,0,0,1,2021-05-27,Female,72,70-74,22
22,1,1,0,2,2021-05-28,Male,70,70-74,2
22,0,0,0,0,2021-05-29,Female,53,45-54,12
22,2,0,0,2,2021-05-29,Male,18,15-19,2
22,0,0,0,0,2021-05-30,Female,68,65-69,15
22,2,0,0,2,2021-06-02,Female,57,55-64,1
22,1,0,0,1,2021-05-30,Female,68,65-69,2
22,0,0,0,0,2021-05-28,Female,34,25-34,9
22,0,0,0,0,2021-06-02,Female,6,5-9,1
22,0,0,0,0,2021-05-30,Female,59,55-64,17
22,0,1,0,1,2021-05-29,Male,52,45-54,2
22,1,0,0,1,2021-06-01,Female,61,55-64,12
22,0,0,0,0,2021-05-29,Male,51,45-54,18
22,0,1,0,1,2021-05-30,Male,68,65-69,7
22,1,0,0,1,2021-05-29,Male,51,45-54,17
22,2,0,0,2,2021-05-29,Female,45,45-54,2
22,3,2,0,5,2021-05-30,Female,58,55-64,18
22,3,0,0,3,2021-05-29,Male,5,5-9,2
22,0,0,0,0,2021-05-30,Female,66,65-69,2
22,0,0,0,0,2021-06-02,Male,33,25-34,1
22,1,0,0,1,2021-05-31,Male,34,25-34,3
22,0,3,0,3,2021-05-29,Male,50,45-54,2
22,2,2,0,4,2021-05-31,Female,19,15-19,2
22,0,0,0,0,2021-05-30,Male,43,35-44,15
22,3,1,0,4,2021-05-29,Female,54,45-54,2
22,2,0,6,8,2021-06-02,Male,21,20-24,1
22,1,3,0,4,2021-05-31,Male,67,65-69,14
22,1,1,0,2,2021-05-30,Male,67,65-69,17
22,1,0,0,1,2021-05-30,Female,56,55-64,2
22,1,1,0,2,2021-05-30,Male,63,55-64,22
22,0,0,0,0,2021-06-03,Female,50,45-54,2
22,1,6,0,7,2021-05-31,Male,59,55-64,2
22,1,1,0,2,2021-05-30,Male,65,65-69,2
22,0,2,1,3,2021-05-29,Male,48,45-54,2
22,1,0,0,1,2021-06-01,Male,16,15-19,19
22,0,0,0,0,2021-06-01,Male,49,45-54,19
22,0,6,0,6,2021-05-29,Male,42,35-44,2
22,2,0,0,2,2021-05-31,Male,59,55-64,16
22,2,0,0,2,2021-05-29,Male,52,45-54,9
22,1,1,0,2,2021-05-28,Male,34,25-34,2
22,0,11,0,11,2021-05-29,Male,53,45-54,15
22,1,0,0,1,2021-05-27,Male,76,75-79,2
22,0,0,0,0,2021-06-02,Male,27,25-34,2
22,0,0,0,0,2021-05-27,Female,71,70-74,21
22,1,0,0,1,2021-05-31,Male,68,65-69,18
22,1,0,0,1,2021-05-29,Female,53,45-54,18
22,1,0,0,1,2021-05-27,Female,69,65-69,16
22,0,0,0,0,2021-05-29,Male,42,35-44,22
22,0,0,0,0,2021-05-27,Female,78,75-79,2
22,3,0,0,3,2021-05-31,Female,56,55-64,2
22,4,0,0,4,2021-05-26,Male,19,15-19,8
22,1,0,0,1,2021-05-30,Male,59,55-64,13
22,1,1,0,2,2021-05-30,Female,57,55-64,22
22,2,0,0,2,2021-05-26,Female,22,20-24,20
22,1,0,0,1,2021-05-30,Male,52,45-54,20
22,1,0,0,1,2021-05-31,Male,43,35-44,4
22,0,0,0,0,2021-05-27,Male,85,85+,19
22,2,0,0,2,2021-05-30,Male,16,15-19,2
22,1,0,0,1,2021-06-01,Female,69,65-69,17
22,0,5,0,5,2021-06-01,Female,66,65-69,9
22,3,3,0,6,2021-05-31,Female,14,10-14,7
22,3,0,0,3,2021-05-28,Male,4,1-4,9
22,0,1,0,1,2021-05-31,Male,54,45-54,7
22,1,0,0,1,2021-05-29,Male,16,15-19,15
22,1,2,0,3,2021-05-30,Male,33,25-34,2
22,0,0,0,0,2021-05-27,Female,70,70-74,2
22,1,0,0,1,2021-05-30,Male,58,55-64,20
22,0,0,0,0,2021-05-30,Male,68,65-69,20
22,0,0,0,0,2021-05-28,Male,35,35-44,2
22,2,0,0,2,2021-06-02,Female,19,15-19,1
22,1,0,0,1,2021-05-28,Male,72,70-74,15
22,0,0,0,0,2021-05-27,Male,77,75-79,17
22,0,0,0,0,2021-05-27,Male,27,25-34,9
22,0,5,0,5,2021-06-02,Female,53,45-54,1
22,1,0,0,1,2021-05-27,Male,72,70-74,19
22,0,0,0,0,2021-05-29,Male,44,35-44,12
22,0,0,0,0,2021-05-27,Male,28,25-34,2
22,1,0,0,1,2021-06-02,Female,14,10-14,1
22,0,0,0,0,2021-05-30,Male,52,45-54,19
22,1,0,1,2,2021-06-02,Female,38,35-44,1
22,0,1,0,1,2021-05-28,Female,38,35-44,2
22,0,0,0,0,2021-05-30,Male,60,55-64,2
22,0,0,0,0,2021-05-29,Male,53,45-54,14
22,3,0,0,3,2021-06-03,Female,18,15-19,1
22,1,0,0,1,2021-05-29,Male,44,35-44,13
22,0,1,0,1,2021-06-01,Female,56,55-64,2
22,0,0,0,0,2021-05-29,Male,43,35-44,2
22,1,3,0,4,2021-05-28,Male,39,35-44,2
22,1,0,0,1,2021-05-31,Female,71,70-74,2
22,1,4,0,5,2021-05-30,Male,67,65-69,2
22,2,0,0,2,2021-05-28,Male,35,35-44,11
22,1,1,0,2,2021-05-28,Male,39,35-44,19
22,0,0,0,0,2021-05-27,Female,77,75-79,16
22,2,0,0,2,2021-05-31,Male,66,65-69,2
22,1,0,0,1,2021-05-30,Female,68,65-69,19
22,0,4,0,4,2021-05-29,Female,52,45-54,11
22,3,0,0,3,2021-05-31,Female,43,35-44,15
22,0,3,0,3,2021-05-27,Male,72,70-74,15
22,0,0,0,0,2021-05-26,Female,20,20-24,8
22,0,0,0,0,2021-06-02,Male,56,55-64,2
22,1,0,0,1,2021-06-01,Female,28,25-34,2
22,0,0,0,0,2021-05-27,Male,85,85+,16
22,2,0,0,2,2021-05-27,Female,72,70-74,17
22,0,1,1,2,2021-06-01,Male,72,70-74,2
22,0,0,0,0,2021-05-26,Female,22,20-24,8
22,1,0,0,1,2021-06-01,Female,28,25-34,2
22,0,1,0,1,2021-06-03,Female,35,35-44,1
22,1,0,0,1,2021-05-29,Male,45,45-54,9
22,2,2,0,4,2021-05-31,Male,55,55-64,21
22,1,0,0,1,2021-05-27,Male,70,70-74,19
22,1,0,0,1,2021-05-27,Female,69,65-69,18
22,1,0,0,1,2021-05-30,Male,67,65-69,13
22,1,2,0,3,2021-05-30,Female,66,65-69,21
22,3,16,0,19,2021-05-29,Male,13,10-14,13
22,2,0,0,2,2021-05-27,Male,66,65-69,20
22,2,0,0,2,2021-06-02,Male,65,65-69,2
22,4,0,0,4,2021-05-31,Female,3,1-4,3
22,0,0,0,0,2021-05-31,Female,54,45-54,2
22,1,0,0,1,2021-05-30,Male,68,65-69,17
22,1,0,0,1,2021-05-28,Male,32,25-34,2
22,2,7,0,9,2021-05-27,Male,70,70-74,12
22,2,2,0,4,2021-05-27,Male,4,1-4,2
22,1,0,0,1,2021-05-30,Female,58,55-64,2
22,0,0,0,0,2021-05-28,Female,12,10-14,8
22,0,0,0,0,2021-05-31,Female,23,20-24,13
22,0,0,0,0,2021-05-29,Male,43,35-44,18
22,3,0,0,3,2021-05-28,Female,8,5-9,16
22,2,0,0,2,2021-06-01,Male,13,10-14,2
22,0,0,0,0,2021-05-28,Female,75,75-79,2
22,1,17,44,62,2021-06-02,Male,9,5-9,1
22,0,0,0,0,2021-06-02,Male,69,65-69,2
22,0,0,0,0,2021-06-02,Female,27,25-34,2
22,0,0,0,0,2021-05-27,Male,71,70-74,17
22,1,1,0,2,2021-05-27,Male,69,65-69,22
22,4,0,0,4,2021-05-27,Female,3,1-4,16
22,2,0,0,2,2021-05-30,Female,60,55-64,20
22,3,0,0,3,2021-05-29,Male,19,15-19,18
22,1,2,0,3,2021-05-31,Male,31,25-34,16
22,0,1,0,1,2021-05-30,Female,53,45-54,19
22,0,0,0,0,2021-05-29,Male,49,45-54,20
22,0,1,0,1,2021-05-28,Male,70,70-74,15
22,1,19,0,20,2021-06-03,Female,18,15-19,2
22,1,0,0,1,2021-06-01,Male,60,55-64,2
22,1,1,0,2,2021-05-30,Female,61,55-64,3
22,2,0,0,2,2021-05-31,Male,63,55-64,2
22,3,0,0,3,2021-05-26,Male,19,15-19,2
22,1,2,0,3,2021-06-02,Male,21,20-24,1
22,1,1,0,2,2021-06-01,Female,67,65-69,12
22,2,0,0,2,2021-06-02,Male,34,25-34,1
22,0,0,0,0,2021-05-30,Female,63,55-64,20
22,0,0,0,0,2021-05-27,Female,42,35-44,15
22,0,0,0,0,2021-05-30,Male,75,75-79,6
22,0,3,0,3,2021-05-27,Female,31,25-34,21
22,1,0,0,1,2021-05-29,Male,52,45-54,2
22,1,0,0,1,2021-05-29,Male,17,15-19,12
22,1,0,0,1,2021-05-30,Female,63,55-64,20
22,1,5,0,6,2021-06-02,Male,31,25-34,1
22,0,0,0,0,2021-05-29,Male,17,15-19,10
22,2,0,0,2,2021-05-27,Female,27,25-34,2
22,0,0,0,0,2021-05-30,Male,68,65-69,11
22,2,0,0,2,2021-06-03,Male,20,20-24,1
22,0,0,0,0,2021-05-31,Male,55,55-64,19
22,0,0,0,0,2021-05-27,Male,34,25-34,14
22,0,0,0,0,2021-05-29,Male,30,25-34,12
22,2,0,0,2,2021-05-29,Male,4,1-4,7
22,1,0,0,1,2021-06-02,Female,73,70-74,14
22,0,1,0,1,2021-05-27,Male,33,25-34,22
22,0,0,0,0,2021-05-30,Male,66,65-69,15
22,0,0,0,0,2021-05-30,Male,68,65-69,2
22,2,0,0,2,2021-05-30,Female,0,<1,2
22,2,0,0,2,2021-06-02,Male,28,25-34,8
22,0,0,0,0,2021-05-28,Female,31,25-34,2
22,1,0,0,1,2021-05-27,Female,71,70-74,3
22,1,0,0,1,2021-05-30,Female,44,35-44,2
22,2,0,0,2,2021-05-27,Female,31,25-34,16
22,0,0,0,0,2021-05-30,Female,67,65-69,8
22,0,3,6,9,2021-05-30,Male,47,45-54,2
22,1,0,0,1,2021-06-03,Female,13,10-14,1
22,1,0,0,1,2021-05-30,Female,67,65-69,2
22,2,0,0,2,2021-05-31,Male,13,10-14,2
22,1,1,0,2,2021-05-28,Female,23,20-24,9
22,1,0,0,1,2021-05-30,Male,66,65-69,17
22,1,1,0,2,2021-05-27,Female,27,25-34,2
22,0,0,0,0,2021-05-30,Male,64,55-64,19
22,3,0,0,3,2021-05-30,Male,6,5-9,13
22,1,0,0,1,2021-06-01,Male,69,65-69,2
22,2,0,0,2,2021-05-27,Female,25,25-34,17
22,0,0,0,0,2021-05-29,Female,44,35-44,2
22,0,0,0,0,2021-05-30,Male,69,65-69,17
22,0,0,0,0,2021-05-30,Male,52,45-54,2
22,2,0,0,2,2021-05-29,Male,42,35-44,16
22,2,0,0,2,2021-05-30,Male,59,55-64,21
22,0,0,0,0,2021-05-31,Female,63,55-64,18
22,1,0,0,1,2021-05-30,Male,61,55-64,2
22,4,0,0,4,2021-05-30,Male,10,10-14,9
22,1,0,0,1,2021-05-29,Male,54,45-54,2
22,0,0,0,0,2021-05-27,Male,69,65-69,17
22,1,0,0,1,2021-06-02,Male,65,65-69,2
22,2,0,0,2,2021-05-27,Male,70,70-74,13
22,0,0,2,2,2021-05-27,Male,25,25-34,14
22,1,0,0,1,2021-05-29,Male,54,45-54,2
22,3,0,0,3,2021-05-31,Female,19,15-19,16
22,2,0,0,2,2021-06-02,Female,3,1-4,3
22,1,0,0,1,2021-05-30,Male,65,65-69,20
22,2,0,2,4,2021-05-30,Female,61,55-64,2
22,1,3,0,4,2021-05-28,Female,69,65-69,6
22,3,0,0,3,2021-05-26,Female,20,20-24,2
22,1,5,0,6,2021-05-28,Male,39,35-44,2
22,0,0,0,0,2021-06-02,Male,60,55-64,1
22,3,14,0,17,2021-05-28,Female,4,1-4,2
22,1,0,0,1,2021-05-27,Male,73,70-74,2
22,0,1,0,1,2021-06-02,Male,42,35-44,3
22,1,0,0,1,2021-05-29,Female,54,45-54,2
22,0,0,0,0,2021-06-03,Female,69,65-69,1
22,1,1,0,2,2021-06-03,Male,74,70-74,1
22,1,0,0,1,2021-06-02,Male,43,35-44,1
22,1,0,1,2,2021-05-27,Female,79,75-79,17
22,0,0,0,0,2021-06-02,Female,34,25-34,1
22,1,4,0,5,2021-05-29,Male,49,45-54,3
22,1,0,0,1,2021-05-31,Male,33,25-34,2
22,1,0,0,1,2021-05-28,Female,29,25-34,18
22,3,3,0,6,2021-06-02,Male,8,5-9,1
22,1,0,0,1,2021-06-01,Male,52,45-54,5
22,0,0,0,0,2021-06-02,Male,23,20-24,8
22,0,0,0,0,2021-05-31,Female,57,55-64,16
22,1,3,1,5,2021-05-30,Male,62,55-64,2
22,0,2,0,2,2021-05-29,Female,51,45-54,5
22,0,0,12,12,2021-05-29,Female,42,35-44,2
22,0,1,0,1,2021-06-03,Male,67,65-69,1
22,1,0,0,1,2021-05-29,Male,53,45-54,16
22,0,0,0,0,2021-06-01,Male,53,45-54,12
22,0,0,0,0,2021-05-28,Female,81,80-84,2
22,2,0,0,2,2021-05-27,Female,27,25-34,2
22,0,0,0,0,2021-05-27,Male,27,25-34,2
22,1,1,0,2,2021-06-02,Male,39,35-44,1
22,1,2,0,3,2021-05-27,Male,71,70-74,19
22,1,3,0,4,2021-05-30,Female,68,65-69,22
22,0,0,0,0,2021-05-30,Female,52,45-54,20
22,1,0,0,1,2021-06-02,Male,34,25-34,1
22,1,0,0,1,2021-05-27,Male,29,25-34,17
22,3,0,0,3,2021-06-03,Female,18,15-19,1
22,1,0,0,1,2021-06-01,Male,31,25-34,2
22,3,0,0,3,2021-05-29,Male,7,5-9,17
22,1,0,0,1,2021-05-30,Male,54,45-54,2
22,0,0,0,0,2021-05-28,Female,32,25-34,7
22,3,0,0,3,2021-05-30,Male,66,65-69,18
22,2,0,0,2,2021-06-03,Male,58,55-64,1
22,0,3,0,3,2021-05-30,Male,45,45-54,2
22,1,0,0,1,2021-05-31,Female,59,55-64,19
22,1,2,0,3,2021-06-02,Male,64,55-64,1
22,1,7,0,8,2021-06-01,Female,49,45-54,2
22,0,1,0,1,2021-05-27,Male,72,70-74,2
22,0,0,0,0,2021-06-01,Female,66,65-69,20
22,1,0,0,1,2021-05-31,Female,42,35-44,12
22,1,0,0,1,2021-05-30,Female,60,55-64,18
22,1,0,0,1,2021-05-30,Male,63,55-64,2
22,0,0,0,0,2021-05-30,Female,66,65-69,10
22,0,0,0,0,2021-05-27,Male,71,70-74,22
22,1,0,0,1,2021-06-01,Male,44,35-44,2
22,0,3,0,3,2021-05-29,Female,71,70-74,17
22,1,19,0,20,2021-06-03,Female,60,55-64,2
22,1,0,0,1,2021-05-27,Male,74,70-74,20
22,1,2,0,3,2021-05-30,Female,67,65-69,2
22,0,0,0,0,2021-06-02,Male,59,55-64,1
22,2,0,0,2,2021-06-01,Female,65,65-69,13
22,0,0,0,0,2021-05-29,Male,51,45-54,15
22,1,0,0,1,2021-06-03,Female,31,25-34,17
22,0,0,0,0,2021-05-28,Female,58,55-64,2
22,0,0,0,0,2021-05-28,Male,38,35-44,9
22,1,0,0,1,2021-05-31,Female,64,55-64,2
22,1,0,0,1,2021-05-31,Female,57,55-64,2
22,2,0,0,2,2021-06-02,Male,13,10-14,1
22,1,6,3,10,2021-06-03,Male,64,55-64,1
22,0,0,0,0,2021-05-29,Male,54,45-54,18
22,0,1,0,1,2021-05-30,Female,65,65-69,4
22,2,0,24,26,2021-06-03,Male,6,5-9,1
22,0,0,1,1,2021-05-27,Female,30,25-34,2
22,1,0,0,1,2021-05-29,Female,50,45-54,17
22,3,11,17,31,2021-06-02,Female,2,1-4,1
22,0,3,0,3,2021-06-03,Male,21,20-24,1
22,1,1,0,2,2021-06-01,Female,61,55-64,6
22,0,0,0,0,2021-05-29,Male,10,10-14,16
22,2,4,100,106,2021-05-30,Male,16,15-19,18
22,1,0,0,1,2021-05-29,Female,52,45-54,2
22,3,1,0,4,2021-05-31,Female,19,15-19,2
22,0,0,0,0,2021-05-31,Male,65,65-69,16
22,1,1,0,2,2021-05-30,Male,68,65-69,19
22,0,0,0,0,2021-05-27,Male,23,20-24,2
22,1,1,0,2,2021-06-01,Female,58,55-64,19
22,0,0,0,0,2021-06-02,Male,34,25-34,1
22,0,0,0,0,2021-06-03,Female,50,45-54,1
22,2,2,0,4,2021-06-03,Female,39,35-44,2
22,2,0,0,2,2021-05-30,Female,2,1-4,2
22,0,0,0,0,2021-05-31,Male,50,45-54,19
22,2,1,0,3,2021-05-29,Male,16,15-19,2
22,3,0,0,3,2021-05-29,Female,47,45-54,2
22,0,0,0,0,2021-05-29,Male,14,10-14,18
22,1,0,0,1,2021-06-01,Female,59,55-64,11
22,0,1,0,1,2021-05-31,Male,71,70-74,20
22,0,0,0,0,2021-06-02,Male,40,35-44,16
22,1,1,0,2,2021-05-30,Female,53,45-54,2
22,0,0,0,0,2021-06-02,Female,58,55-64,1
22,2,0,0,2,2021-05-27,Female,70,70-74,22
22,0,0,0,0,2021-06-01,Male,38,35-44,16
22,1,4,0,5,2021-05-30,Female,63,55-64,2
22,3,0,0,3,2021-05-31,Male,22,20-24,9
22,2,0,0,2,2021-05-28,Female,73,70-74,15
22,0,1,0,1,2021-05-30,Male,52,45-54,16
22,1,0,0,1,2021-05-30,Female,60,55-64,22
22,0,0,0,0,2021-05-29,Male,44,35-44,21
22,2,0,0,2,2021-05-31,Male,63,55-64,9
22,2,0,0,2,2021-05-31,Female,63,55-64,16
22,2,0,0,2,2021-05-27,Male,34,25-34,2
22,2,0,0,2,2021-05-28,Male,74,70-74,18
22,1,1,0,2,2021-05-27,Female,32,25-34,6
22,2,3,0,5,2021-06-01,Female,53,45-54,20
22,0,0,0,0,2021-06-02,Male,43,35-44,1
22,2,1,0,3,2021-05-30,Male,69,65-69,17
22,1,0,0,1,2021-05-27,Male,26,25-34,2
22,1,0,0,1,2021-05-27,Male,34,25-34,21
22,0,0,0,0,2021-05-30,Male,48,45-54,16
22,3,0,0,3,2021-05-27,Male,70,70-74,17
22,2,0,0,2,2021-05-31,Male,55,55-64,2
22,2,0,0,2,2021-05-31,Male,19,15-19,2
22,1,2,0,3,2021-06-02,Male,50,45-54,1
22,2,0,0,2,2021-05-31,Male,68,65-69,20
22,1,1,0,2,2021-06-01,Female,22,20-24,2
22,3,1,0,4,2021-06-02,Female,14,10-14,1
22,0,3,0,3,2021-06-01,Male,62,55-64,16
22,1,0,0,1,2021-06-03,Male,69,65-69,1
22,1,0,0,1,2021-05-31,Female,2,1-4,2
22,0,0,0,0,2021-05-30,Male,44,35-44,15
22,0,3,0,3,2021-05-27,Male,28,25-34,2
22,1,0,0,1,2021-05-30,Female,56,55-64,20
22,0,0,0,0,2021-05-30,Female,58,55-64,17
22,0,0,0,0,2021-05-30,Female,67,65-69,18
22,1,0,0,1,2021-06-03,Female,83,80-84,1
22,0,4,0,4,2021-06-02,Male,23,20-24,6
22,1,0,0,1,2021-05-31,Female,58,55-64,2
22,0,0,0,0,2021-05-30,Male,54,45-54,2
22,0,1,0,1,2021-05-27,Female,76,75-79,2
22,1,1,0,2,2021-05-29,Female,55,55-64,2
22,0,0,0,0,2021-05-29,Male,45,45-54,13
22,0,4,0,4,2021-05-30,Female,64,55-64,16
22,0,2,0,2,2021-05-27,Male,70,70-74,2
22,1,0,0,1,2021-05-31,Male,29,25-34,2
22,0,0,0,0,2021-05-31,Female,19,15-19,2
22,1,2,0,3,2021-06-02,Male,70,70-74,3
22,2,0,0,2,2021-05-27,Female,14,10-14,4
22,1,2,0,3,2021-05-30,Female,61,55-64,22
22,1,0,0,1,2021-06-03,Male,61,55-64,7
22,2,1,0,3,2021-05-29,Male,49,45-54,17
22,0,0,0,0,2021-05-30,Female,61,55-64,2
22,1,1,0,2,2021-05-29,Female,54,45-54,22
22,0,1,0,1,2021-05-30,Male,56,55-64,17
22,0,0,0,0,2021-05-30,Female,66,65-69,21
22,1,0,0,1,2021-05-29,Male,73,70-74,17
22,3,0,0,3,2021-05-30,Female,5,5-9,16
22,4,0,0,4,2021-05-31,Male,8,5-9,15
22,0,1,0,1,2021-06-02,Female,25,25-34,2
22,1,0,0,1,2021-05-27,Male,79,75-79,16
22,0,2,0,2,2021-05-30,Female,67,65-69,16
22,0,0,0,0,2021-05-28,Male,39,35-44,18
22,2,10,0,12,2021-05-30,Female,17,15-19,15
22,0,0,0,0,2021-05-27,Female,74,70-74,2
22,0,0,0,0,2021-05-31,Male,54,45-54,16
22,1,0,0,1,2021-05-27,Female,71,70-74,2
22,1,1,0,2,2021-05-27,Male,69,65-69,20
22,2,1,0,3,2021-05-29,Male,15,15-19,16
22,4,0,0,4,2021-05-30,Female,11,10-14,2
22,0,3,0,3,2021-05-28,Male,37,35-44,22
22,1,1,0,2,2021-05-30,Female,51,45-54,2
22,2,2,0,4,2021-05-30,Female,49,45-54,11
22,1,0,0,1,2021-05-28,Male,40,35-44,22
22,0,0,0,0,2021-05-29,Male,33,25-34,18
22,1,8,0,9,2021-05-31,Male,65,65-69,2
22,2,0,0,2,2021-05-31,Male,62,55-64,21
22,2,0,0,2,2021-05-27,Female,3,1-4,10
22,1,1,0,2,2021-05-31,Female,69,65-69,15
22,0,3,0,3,2021-06-01,Female,70,70-74,13
22,1,0,0,1,2021-05-31,Male,68,65-69,12
22,0,0,2,2,2021-05-27,Male,7,5-9,18
22,0,0,0,0,2021-05-29,Male,46,45-54,2
22,1,3,0,4,2021-05-29,Female,34,25-34,15
22,1,0,0,1,2021-05-31,Male,39,35-44,2
22,1,0,0,1,2021-05-27,Male,73,70-74,12
22,0,0,0,0,2021-05-30,Male,68,65-69,20
22,0,2,0,2,2021-05-27,Male,29,25-34,18
22,1,0,0,1,2021-05-26,Female,21,20-24,2
22,1,19,0,20,2021-05-29,Male,12,10-14,2
22,0,0,0,0,2021-05-30,Female,54,45-54,18
22,1,0,0,1,2021-05-29,Male,43,35-44,2
22,0,0,0,0,2021-06-02,Male,34,25-34,2
22,0,0,0,0,2021-06-02,Male,31,25-34,9
22,2,17,22,41,2021-06-02,Female,10,10-14,1
22,0,0,0,0,2021-06-03,Male,51,45-54,1
22,0,0,0,0,2021-05-31,Male,77,75-79,13
22,1,2,0,3,2021-05-31,Male,60,55-64,2
22,0,2,0,2,2021-05-30,Male,47,45-54,16
22,2,15,0,17,2021-06-03,Female,3,1-4,1
22,1,2,0,3,2021-05-29,Male,53,45-54,19
22,0,0,0,0,2021-05-31,Female,71,70-74,12
22,1,1,0,2,2021-05-27,Female,69,65-69,9
22,5,0,0,5,2021-05-30,Male,58,55-64,2
22,1,10,0,11,2021-05-27,Male,33,25-34,16
22,3,0,0,3,2021-05-27,Male,70,70-74,17
22,3,0,0,3,2021-05-30,Male,18,15-19,19
22,2,0,0,2,2021-05-30,Male,65,65-69,18
22,0,1,0,1,2021-05-29,Male,49,45-54,19
22,1,14,0,15,2021-06-02,Male,66,65-69,1
22,1,0,0,1,2021-06-03,Male,66,65-69,13
22,1,0,0,1,2021-05-29,Female,74,70-74,2
22,0,0,0,0,2021-05-29,Male,48,45-54,2
22,0,0,0,0,2021-05-30,Male,67,65-69,20
22,0,0,0,0,2021-05-30,Male,65,65-69,20
22,1,0,0,1,2021-05-29,Female,18,15-19,2
22,0,0,0,0,2021-05-27,Female,30,25-34,2
22,1,1,0,2,2021-06-02,Male,34,25-34,1
22,2,0,0,2,2021-05-31,Female,68,65-69,21
22,1,0,0,1,2021-05-30,Male,68,65-69,20
22,0,0,0,0,2021-05-29,Male,41,35-44,14
22,1,0,0,1,2021-06-01,Male,75,75-79,13
22,3,0,0,3,2021-06-03,Male,16,15-19,1
22,1,0,0,1,2021-06-01,Male,45,45-54,2
22,0,0,0,0,2021-05-31,Female,49,45-54,2
22,2,1,0,3,2021-05-31,Female,6,5-9,2
22,1,1,0,2,2021-05-29,Female,44,35-44,12
22,0,0,0,0,2021-05-27,Female,72,70-74,2
22,1,0,0,1,2021-05-31,Male,57,55-64,2
22,0,0,0,0,2021-05-30,Male,53,45-54,7
22,2,0,0,2,2021-05-28,Male,70,70-74,14
22,0,2,0,2,2021-05-29,Female,57,55-64,2
22,1,3,0,4,2021-05-28,Male,33,25-34,2
22,0,0,0,0,2021-05-30,Male,65,65-69,2
22,0,0,0,0,2021-05-30,Female,47,45-54,10
22,1,3,0,4,2021-05-30,Female,61,55-64,10
22,1,0,0,1,2021-06-02,Female,42,35-44,1
22,1,0,0,1,2021-05-31,Male,17,15-19,18
22,1,4,0,5,2021-05-29,Male,55,55-64,2
22,0,0,0,0,2021-05-29,Female,52,45-54,20
22,1,1,0,2,2021-06-03,Female,67,65-69,2
22,5,0,0,5,2021-05-30,Male,13,10-14,19
22,0,0,0,0,2021-05-31,Female,60,55-64,17
22,1,4,0,5,2021-05-30,Female,67,65-69,2
22,0,0,7,7,2021-05-31,Male,14,10-14,19
22,2,0,3,5,2021-05-27,Male,26,25-34,2
22,0,0,0,0,2021-05-30,Male,56,55-64,2
22,0,0,0,0,2021-05-27,Male,74,70-74,2
22,1,0,0,1,2021-05-28,Male,82,80-84,19
22,2,1,0,3,2021-06-02,Female,40,35-44,1
22,1,1,0,2,2021-06-03,Female,71,70-74,1
22,3,0,0,3,2021-05-26,Female,7,5-9,12
22,3,12,0,15,2021-06-01,Female,7,5-9,2
22,3,0,0,3,2021-05-27,Male,2,1-4,5
22,0,0,0,0,2021-05-31,Female,59,55-64,14
22,0,0,0,0,2021-05-29,Female,5,5-9,15
22,1,0,0,1,2021-05-30,Male,59,55-64,2
22,0,3,0,3,2021-05-30,Female,51,45-54,8
22,0,0,0,0,2021-05-31,Male,49,45-54,16
22,1,0,0,1,2021-05-31,Male,44,35-44,3
22,2,2,0,4,2021-05-30,Female,18,15-19,2
22,0,0,0,0,2021-05-28,Male,25,25-34,19
22,0,0,0,0,2021-05-30,Male,24,20-24,14
22,0,2,0,2,2021-06-03,Female,44,35-44,1
22,2,0,0,2,2021-05-31,Female,66,65-69,20
22,0,0,0,0,2021-05-28,Male,35,35-44,21
22,0,0,0,0,2021-05-28,Female,35,35-44,13
22,1,0,1,2,2021-05-31,Male,63,55-64,2
22,3,0,0,3,2021-06-03,Male,17,15-19,1
22,0,0,0,0,2021-06-01,Female,46,45-54,7
22,2,0,0,2,2021-05-31,Female,5,5-9,2
22,1,0,0,1,2021-05-27,Male,72,70-74,2
22,1,0,4,5,2021-05-28,Male,29,25-34,2
22,1,2,0,3,2021-06-02,Female,67,65-69,1
22,1,0,0,1,2021-05-31,Female,24,20-24,20
22,0,0,0,0,2021-05-30,Female,67,65-69,16
22,3,0,0,3,2021-05-27,Male,23,20-24,17
22,1,0,0,1,2021-05-30,Female,68,65-69,14
22,0,0,0,0,2021-05-31,Male,68,65-69,19
22,1,2,0,3,2021-05-28,Male,64,55-64,2
22,0,0,0,0,2021-05-28,Male,28,25-34,2
22,2,0,2,4,2021-06-02,Female,0,<1,1
22,1,0,0,1,2021-05-27,Male,22,20-24,13
22,2,0,0,2,2021-05-29,Male,41,35-44,22
22,1,0,0,1,2021-05-31,Male,65,65-69,18
22,2,10,0,12,2021-06-02,Male,2,1-4,2
22,3,1,0,4,2021-05-26,Female,22,20-24,2
22,0,0,0,0,2021-05-27,Male,71,70-74,14
22,2,0,0,2,2021-05-28,Female,39,35-44,2
22,0,4,0,4,2021-05-30,Male,59,55-64,2
22,2,10,0,12,2021-06-02,Female,40,35-44,3
22,2,0,0,2,2021-05-30,Male,59,55-64,18
22,1,1,0,2,2021-06-02,Female,54,45-54,1
22,0,0,0,0,2021-05-29,Male,53,45-54,2
22,3,0,0,3,2021-05-27,Male,14,10-14,8
22,1,0,0,1,2021-05-27,Male,79,75-79,20
22,0,0,0,0,2021-05-27,Male,54,45-54,17
22,0,2,0,2,2021-05-31,Female,57,55-64,2
22,2,0,0,2,2021-05-30,Male,57,55-64,2
22,2,5,10,17,2021-05-30,Male,68,65-69,3
22,0,2,0,2,2021-06-03,Male,79,75-79,1
22,1,5,0,6,2021-06-01,Female,65,65-69,2
22,1,6,0,7,2021-06-01,Female,69,65-69,15
22,2,0,0,2,2021-05-30,Male,65,65-69,14
22,1,0,0,1,2021-06-01,Male,64,55-64,15
22,0,2,0,2,2021-05-30,Female,67,65-69,19
22,1,1,0,2,2021-06-01,Female,68,65-69,2
22,3,0,0,3,2021-06-03,Male,20,20-24,4
22,0,0,0,0,2021-05-27,Male,23,20-24,2
22,0,0,0,0,2021-06-01,Female,65,65-69,3
22,0,0,0,0,2021-05-29,Male,51,45-54,2
22,2,1,0,3,2021-05-31,Female,25,25-34,9
22,2,0,0,2,2021-06-01,Female,26,25-34,12
22,1,0,0,1,2021-05-30,Male,67,65-69,2
22,0,1,0,1,2021-05-27,Female,69,65-69,19
22,3,0,0,3,2021-05-26,Male,19,15-19,2
22,0,0,0,0,2021-05-27,Female,23,20-24,6
22,0,1,0,1,2021-05-27,Female,28,25-34,9
22,1,0,0,1,2021-05-30,Male,33,25-34,2
22,2,0,0,2,2021-05-31,Female,66,65-69,15
22,1,0,0,1,2021-05-27,Female,26,25-34,2
22,0,0,0,0,2021-05-30,Female,64,55-64,17
22,1,3,0,4,2021-05-27,Male,69,65-69,19
22,1,0,0,1,2021-05-30,Male,58,55-64,2
22,0,1,0,1,2021-06-01,Female,34,25-34,16
22,1,75,0,76,2021-06-02,Female,50,45-54,1
22,2,0,0,2,2021-05-28,Female,19,15-19,14
22,2,0,0,2,2021-05-28,Male,0,<1,2
22,0,0,0,0,2021-05-28,Male,30,25-34,18
22,1,0,0,1,2021-06-03,Female,66,65-69,1
22,0,0,0,0,2021-05-30,Male,53,45-54,2
22,0,3,0,3,2021-05-28,Female,72,70-74,13
22,0,0,0,0,2021-05-27,Female,9,5-9,19
22,1,0,0,1,2021-05-28,Female,38,35-44,2
22,4,4,0,8,2021-05-28,Female,24,20-24,2
22,3,0,0,3,2021-05-30,Female,53,45-54,17
22,2,0,0,2,2021-06-03,Male,61,55-64,18
22,2,0,0,2,2021-05-30,Female,79,75-79,16
22,1,0,0,1,2021-05-29,Female,16,15-19,2
22,0,0,0,0,2021-05-27,Female,71,70-74,2
22,0,0,0,0,2021-05-30,Male,54,45-54,14
22,2,0,0,2,2021-05-31,Male,66,65-69,2
22,2,0,0,2,2021-05-28,Male,14,10-14,2
22,0,0,0,0,2021-06-02,Male,58,55-64,1
22,1,0,0,1,2021-06-02,Male,31,25-34,3
22,0,0,0,0,2021-05-30,Male,66,65-69,21
22,1,0,6,7,2021-05-31,Male,65,65-69,2
22,1,0,0,1,2021-05-31,Male,42,35-44,14
22,1,1,0,2,2021-05-27,Female,70,70-74,18
22,0,0,0,0,2021-05-27,Female,76,75-79,20
22,2,0,0,2,2021-05-30,Male,61,55-64,2
22,1,0,0,1,2021-05-29,Male,33,25-34,2
22,2,3,0,5,2021-05-27,Female,19,15-19,2
22,0,0,0,0,2021-05-28,Male,37,35-44,17
22,1,0,0,1,2021-06-02,Female,65,65-69,1
22,1,0,0,1,2021-05-29,Female,49,45-54,17
22,1,3,0,4,2021-05-30,Male,61,55-64,16
22,1,0,0,1,2021-05-30,Female,66,65-69,2
22,1,0,0,1,2021-05-27,Male,32,25-34,3
22,1,0,0,1,2021-05-31,Male,55,55-64,2
22,1,0,0,1,2021-05-30,Female,51,45-54,15
22,1,0,0,1,2021-05-27,Female,71,70-74,3
22,3,0,0,3,2021-05-26,Female,18,15-19,11
22,6,0,0,6,2021-06-02,Female,4,1-4,1
22,1,0,0,1,2021-05-27,Male,69,65-69,19
22,2,0,0,2,2021-05-30,Male,57,55-64,13
22,1,0,0,1,2021-05-30,Female,62,55-64,2
22,0,0,0,0,2021-05-30,Male,62,55-64,17
22,3,1,0,4,2021-05-31,Male,48,45-54,8
22,0,1,0,1,2021-05-30,Male,61,55-64,2
22,0,0,0,0,2021-05-31,Female,66,65-69,14
22,0,1,0,1,2021-05-31,Female,33,25-34,7
22,0,0,0,0,2021-05-27,Female,33,25-34,12
22,2,0,0,2,2021-05-29,Male,15,15-19,2
22,3,0,0,3,2021-05-30,Female,44,35-44,2
22,0,1,0,1,2021-06-02,Female,61,55-64,12
22,1,0,0,1,2021-05-29,Male,52,45-54,2
22,3,0,0,3,2021-06-02,Male,18,15-19,1
22,1,2,0,3,2021-05-27,Female,71,70-74,17
22,0,1,0,1,2021-05-31,Male,52,45-54,17
22,0,0,0,0,2021-05-29,Female,50,45-54,18
22,1,5,0,6,2021-06-02,Female,60,55-64,1
22,0,2,0,2,2021-05-31,Female,63,55-64,2
22,0,1,3,4,2021-06-03,Male,47,45-54,1
22,1,0,0,1,2021-05-26,Male,17,15-19,2
22,0,0,0,0,2021-05-27,Male,74,70-74,20
22,1,1,0,2,2021-06-02,Female,19,15-19,19
22,0,0,0,0,2021-05-30,Male,64,55-64,4
22,0,0,0,0,2021-05-31,Female,66,65-69,2
22,1,1,0,2,2021-05-29,Male,51,45-54,2
22,1,0,0,1,2021-06-01,Female,11,10-14,20
22,1,0,0,1,2021-06-02,Male,26,25-34,20
22,1,2,0,3,2021-05-27,Female,70,70-74,18
22,0,2,0,2,2021-05-28,Female,81,80-84,8
22,0,1,0,1,2021-05-29,Female,14,10-14,18
22,3,4,0,7,2021-05-29,Female,49,45-54,2
22,1,0,0,1,2021-05-31,Male,77,75-79,2
22,1,0,0,1,2021-06-02,Female,40,35-44,1
22,0,0,0,0,2021-05-30,Female,66,65-69,17
22,1,0,1,2,2021-06-01,Female,27,25-34,19
22,2,1,0,3,2021-05-28,Male,76,75-79,20
22,1,0,0,1,2021-05-30,Male,68,65-69,2
22,0,0,0,0,2021-05-30,Male,64,55-64,2
22,0,1,0,1,2021-05-27,Female,29,25-34,4
22,0,0,0,0,2021-06-02,Male,25,25-34,1
22,1,1,0,2,2021-05-28,Male,74,70-74,17
22,0,0,0,0,2021-05-28,Male,31,25-34,16
22,0,0,0,0,2021-06-03,Female,0,<1,2
22,0,0,2,2,2021-05-29,Female,11,10-14,2
22,0,0,0,0,2021-05-31,Female,24,20-24,20
22,1,0,0,1,2021-05-28,Female,23,20-24,10
22,0,0,0,0,2021-05-29,Female,43,35-44,8
22,1,1,0,2,2021-05-30,Male,63,55-64,19
22,1,0,0,1,2021-05-30,Male,20,20-24,2
22,0,0,0,0,2021-05-27,Female,33,25-34,2
22,0,0,0,0,2021-05-26,Female,20,20-24,2
22,0,1,0,1,2021-05-30,Male,64,55-64,18
22,0,0,0,0,2021-05-29,Male,51,45-54,2
22,0,0,0,0,2021-05-29,Male,54,45-54,2
22,5,0,0,5,2021-05-31,Male,20,20-24,3
22,0,0,13,13,2021-05-27,Female,24,20-24,2
22,4,0,0,4,2021-06-02,Female,21,20-24,2
22,2,0,0,2,2021-05-29,Male,55,55-64,21
22,1,0,0,1,2021-05-31,Male,35,35-44,2
22,0,0,0,0,2021-06-02,Male,61,55-64,14
22,3,0,11,14,2021-06-02,Female,8,5-9,19
22,0,1,0,1,2021-05-30,Female,66,65-69,7
22,2,0,0,2,2021-05-27,Male,73,70-74,15
22,2,0,0,2,2021-05-28,Male,73,70-74,15
22,0,2,0,2,2021-05-31,Female,41,35-44,2
22,1,0,0,1,2021-05-29,Female,53,45-54,20
22,0,0,0,0,2021-05-26,Male,33,25-34,14
22,0,2,0,2,2021-05-30,Female,49,45-54,2
22,0,0,0,0,2021-06-03,Male,32,25-34,1
22,1,0,0,1,2021-05-27,Female,72,70-74,2
22,0,1,0,1,2021-05-27,Female,71,70-74,17
22,1,1,0,2,2021-05-30,Male,69,65-69,2
22,0,0,0,0,2021-05-31,Female,28,25-34,2
22,4,9,0,13,2021-06-02,Male,20,20-24,1
22,0,0,0,0,2021-05-28,Male,30,25-34,19
22,2,0,0,2,2021-06-01,Female,18,15-19,14
22,0,3,0,3,2021-05-30,Female,57,55-64,21
22,0,1,0,1,2021-05-31,Male,51,45-54,2
22,0,0,0,0,2021-05-31,Male,52,45-54,19
22,0,2,0,2,2021-06-01,Male,55,55-64,17
22,2,2,0,4,2021-06-03,Female,48,45-54,1
22,1,0,0,1,2021-05-28,Male,7,5-9,3
22,2,0,0,2,2021-06-02,Male,27,25-34,1
22,0,5,0,5,2021-06-03,Female,51,45-54,1
22,2,0,0,2,2021-05-30,Male,67,65-69,21
22,1,0,0,1,2021-05-31,Female,38,35-44,2
22,2,0,0,2,2021-05-28,Male,7,5-9,2
22,0,1,0,1,2021-06-03,Female,69,65-69,14
22,1,1,0,2,2021-05-29,Female,50,45-54,2
22,0,0,0,0,2021-06-02,Male,29,25-34,1
22,0,0,0,0,2021-05-27,Female,30,25-34,17
22,0,1,0,1,2021-06-01,Male,46,45-54,19
22,1,0,0,1,2021-05-31,Female,42,35-44,2
22,0,0,0,0,2021-05-30,Male,57,55-64,2
22,2,0,0,2,2021-05-27,Female,69,65-69,17
22,1,0,0,1,2021-06-02,Male,45,45-54,1
22,1,0,0,1,2021-05-29,Male,50,45-54,3
22,2,3,0,5,2021-06-01,Male,37,35-44,3
22,1,0,0,1,2021-05-28,Female,25,25-34,14
22,1,0,0,1,2021-05-29,Male,48,45-54,15
22,0,1,0,1,2021-05-30,Female,42,35-44,9
22,1,0,0,1,2021-05-30,Male,64,55-64,20
22,0,0,0,0,2021-06-02,Female,53,45-54,5
22,1,0,0,1,2021-05-31,Male,66,65-69,19
22,2,6,13,21,2021-05-29,Female,4,1-4,2
22,2,0,0,2,2021-06-01,Male,8,5-9,21
22,1,0,0,1,2021-06-02,Male,28,25-34,1
22,2,1,0,3,2021-06-02,Female,18,15-19,3
22,1,0,0,1,2021-05-29,Female,18,15-19,2
22,0,0,0,0,2021-06-02,Female,50,45-54,6
22,0,0,0,0,2021-05-27,Male,58,55-64,21
22,1,0,0,1,2021-05-31,Female,66,65-69,22
22,2,0,0,2,2021-06-01,Male,9,5-9,9
22,1,0,0,1,2021-05-29,Male,52,45-54,14
22,1,0,0,1,2021-06-02,Female,68,65-69,1
22,2,2,0,4,2021-05-28,Female,12,10-14,17
22,2,0,0,2,2021-05-28,Male,2,1-4,2
22,1,0,0,1,2021-05-29,Female,25,25-34,16
22,4,4,1,9,2021-05-29,Male,11,10-14,22
22,2,3,0,5,2021-05-30,Male,51,45-54,20
22,5,1,0,6,2021-06-02,Female,21,20-24,1
22,0,0,0,0,2021-05-27,Male,74,70-74,21
22,0,0,0,0,2021-05-26,Male,19,15-19,10
22,0,2,0,2,2021-06-01,Female,30,25-34,3
22,3,0,0,3,2021-05-30,Female,8,5-9,2
22,0,0,0,0,2021-05-30,Female,67,65-69,14
22,1,1,0,2,2021-05-30,Male,55,55-64,19
22,0,5,0,5,2021-05-27,Female,69,65-69,21
22,0,2,0,2,2021-05-28,Female,79,75-79,7
22,2,0,0,2,2021-05-30,Male,68,65-69,10
22,0,0,0,0,2021-06-02,Male,41,35-44,1
22,0,0,0,0,2021-05-27,Male,78,75-79,17
22,0,1,0,1,2021-05-28,Female,32,25-34,8
22,0,0,0,0,2021-05-27,Male,85,85+,14
22,3,0,0,3,2021-06-02,Female,3,1-4,1
22,1,1,0,2,2021-05-30,Female,56,55-64,15
22,2,0,0,2,2021-06-01,Male,54,45-54,2
22,0,0,0,0,2021-05-27,Male,69,65-69,2
22,1,0,0,1,2021-05-31,Female,64,55-64,13
22,1,0,0,1,2021-05-31,Female,67,65-69,12
22,2,0,0,2,2021-05-30,Male,66,65-69,17
22,1,12,0,13,2021-05-30,Male,60,55-64,21
22,1,0,0,1,2021-06-01,Male,55,55-64,18
22,0,0,0,0,2021-05-27,Female,25,25-34,21
22,0,10,0,10,2021-05-29,Male,50,45-54,2
22,0,0,0,0,2021-05-28,Male,36,35-44,18
22,1,0,0,1,2021-05-30,Male,52,45-54,21
22,1,0,0,1,2021-05-28,Male,69,65-69,2
22,0,2,0,2,2021-05-31,Female,66,65-69,8
22,0,0,0,0,2021-05-27,Female,24,20-24,19
22,0,1,0,1,2021-05-29,Female,49,45-54,22
22,0,1,0,1,2021-05-28,Male,41,35-44,2
22,0,11,0,11,2021-05-31,Male,40,35-44,14
22,1,0,0,1,2021-06-03,Female,21,20-24,1
22,0,1,0,1,2021-05-27,Male,70,70-74,19
22,2,2,0,4,2021-05-30,Male,67,65-69,2
22,2,2,0,4,2021-05-30,Female,64,55-64,21
22,1,1,0,2,2021-05-27,Male,70,70-74,2
22,1,1,0,2,2021-05-29,Female,54,45-54,2
22,0,0,0,0,2021-06-02,Male,58,55-64,1
22,1,2,0,3,2021-05-31,Male,64,55-64,18
22,2,0,0,2,2021-05-30,Male,43,35-44,3
22,1,0,0,1,2021-06-01,Female,23,20-24,3
22,0,0,0,0,2021-05-29,Male,37,35-44,13
22,0,0,0,0,2021-05-27,Female,21,20-24,9
22,2,0,0,2,2021-06-02,Male,23,20-24,1
22,2,1,0,3,2021-05-28,Female,37,35-44,19
22,2,2,0,4,2021-05-28,Male,34,25-34,4
22,0,0,0,0,2021-05-27,Female,23,20-24,9
22,0,0,0,0,2021-05-31,Female,76,75-79,2
22,1,0,0,1,2021-06-02,Male,54,45-54,1
22,2,2,0,4,2021-06-01,Female,61,55-64,19
22,1,2,0,3,2021-05-29,Male,49,45-54,2
22,0,0,0,0,2021-05-27,Female,58,55-64,2
22,1,0,0,1,2021-05-30,Female,57,55-64,14
22,0,1,0,1,2021-06-02,Female,65,65-69,1
22,1,2,0,3,2021-05-31,Male,52,45-54,2
22,2,0,0,2,2021-05-28,Male,1,1-4,2
22,0,0,0,0,2021-05-30,Female,66,65-69,22
22,0,0,0,0,2021-06-02,Female,27,25-34,1
22,2,0,2,4,2021-05-28,Male,2,1-4,2
22,0,0,0,0,2021-05-31,Female,67,65-69,18
22,0,2,0,2,2021-05-27,Female,70,70-74,15
22,3,0,0,3,2021-06-01,Female,6,5-9,16
22,1,30,0,31,2021-05-28,Female,37,35-44,2
22,1,0,0,1,2021-06-02,Female,3,1-4,1
22,4,0,0,4,2021-05-29,Female,8,5-9,2
22,0,5,0,5,2021-06-03,Male,73,70-74,1
22,2,1,0,3,2021-05-26,Male,18,15-19,2
22,0,0,0,0,2021-06-02,Male,61,55-64,1
22,1,0,0,1,2021-05-31,Male,58,55-64,17
22,2,0,0,2,2021-05-28,Male,40,35-44,20
22,0,1,0,1,2021-06-01,Male,39,35-44,19
22,3,0,0,3,2021-05-30,Female,17,15-19,9
22,0,1,0,1,2021-05-28,Male,40,35-44,17
22,3,0,0,3,2021-05-31,Female,21,20-24,17
22,1,2,0,3,2021-05-30,Male,57,55-64,2
22,1,0,0,1,2021-05-30,Male,66,65-69,2
22,0,0,0,0,2021-05-29,Female,16,15-19,12
22,1,0,0,1,2021-05-29,Male,5,5-9,2
22,0,0,15,15,2021-06-02,Female,49,45-54,1
22,1,11,0,12,2021-05-30,Female,65,65-69,2
22,0,0,2,2,2021-06-02,Male,31,25-34,1
22,0,0,0,0,2021-05-30,Male,66,65-69,20
22,0,4,0,4,2021-06-02,Male,40,35-44,3
22,0,0,0,0,2021-05-31,Male,61,55-64,17
22,1,1,0,2,2021-06-01,Male,66,65-69,2
22,0,0,0,0,2021-05-27,Female,19,15-19,7
22,0,0,0,0,2021-06-02,Female,39,35-44,1
22,1,0,0,1,2021-05-28,Female,33,25-34,9
22,0,0,0,0,2021-05-30,Female,57,55-64,17
22,1,2,0,3,2021-06-01,Male,48,45-54,2
22,0,0,0,0,2021-06-02,Female,24,20-24,1
22,1,0,0,1,2021-05-27,Male,71,70-74,20
22,0,0,0,0,2021-06-02,Female,15,15-19,21
22,1,0,0,1,2021-05-30,Male,63,55-64,21
22,2,0,3,5,2021-05-31,Female,3,1-4,2
22,1,0,0,1,2021-05-31,Male,68,65-69,22
22,8,0,0,8,2021-05-26,Female,21,20-24,2
22,1,0,0,1,2021-06-03,Female,48,45-54,1
22,1,6,0,7,2021-06-01,Female,9,5-9,2
22,2,0,0,2,2021-05-27,Male,20,20-24,2
22,0,0,0,0,2021-06-03,Female,22,20-24,1
22,2,0,0,2,2021-05-28,Male,77,75-79,9
22,0,5,0,5,2021-05-31,Female,30,25-34,2
22,1,1,0,2,2021-06-02,Female,28,25-34,1
22,0,0,0,0,2021-05-29,Male,46,45-54,2
22,3,2,0,5,2021-06-02,Female,4,1-4,1
22,0,0,0,0,2021-05-30,Male,57,55-64,19
22,1,0,0,1,2021-05-27,Female,71,70-74,18
22,1,0,0,1,2021-05-27,Male,74,70-74,2
22,0,1,0,1,2021-06-01,Male,52,45-54,11
22,0,2,0,2,2021-05-30,Female,60,55-64,13
22,0,1,0,1,2021-05-30,Female,61,55-64,6
22,3,0,0,3,2021-05-31,Male,9,5-9,22
22,2,0,0,2,2021-06-01,Female,56,55-64,20
22,0,0,0,0,2021-05-26,Female,22,20-24,17
22,1,3,0,4,2021-05-27,Male,72,70-74,2
22,0,4,0,4,2021-05-29,Male,44,35-44,2
22,2,3,0,5,2021-05-30,Male,56,55-64,16
22,0,0,0,0,2021-05-31,Female,45,45-54,2
22,1,2,0,3,2021-05-30,Male,62,55-64,18
22,0,3,0,3,2021-06-03,Female,61,55-64,1
22,0,40,0,40,2021-06-02,Male,58,55-64,1
22,0,0,0,0,2021-06-01,Male,66,65-69,11
22,1,5,0,6,2021-06-03,Male,68,65-69,1
22,0,0,0,0,2021-06-02,Male,47,45-54,1
22,0,1,0,1,2021-05-30,Male,54,45-54,15
22,2,0,0,2,2021-05-30,Female,73,70-74,11
22,1,0,0,1,2021-06-01,Female,18,15-19,2
22,2,0,0,2,2021-05-28,Male,79,75-79,13
22,0,0,0,0,2021-05-30,Female,20,20-24,7
22,1,0,0,1,2021-06-03,Male,69,65-69,1
22,1,0,0,1,2021-05-30,Female,66,65-69,18
22,1,0,0,1,2021-05-27,Male,77,75-79,2
22,5,0,0,5,2021-05-27,Female,13,10-14,17
22,2,0,0,2,2021-05-27,Female,1,1-4,2
22,1,0,0,1,2021-05-30,Male,64,55-64,22
22,1,2,0,3,2021-06-02,Male,28,25-34,1
22,1,0,0,1,2021-06-01,Female,40,35-44,2
22,1,0,0,1,2021-05-29,Female,52,45-54,17
22,2,0,0,2,2021-05-29,Female,23,20-24,21
22,1,0,0,1,2021-06-03,Female,56,55-64,1
22,1,6,0,7,2021-05-30,Male,32,25-34,2
22,0,0,0,0,2021-05-27,Female,73,70-74,15
22,1,11,0,12,2021-05-29,Male,34,25-34,2
22,0,2,0,2,2021-05-31,Male,64,55-64,2
22,1,0,0,1,2021-05-30,Male,52,45-54,2
22,1,1,0,2,2021-05-30,Male,65,65-69,2
22,1,0,90,91,2021-05-30,Male,54,45-54,17
22,1,2,0,3,2021-05-30,Male,60,55-64,2
22,1,0,30,31,2021-05-31,Male,62,55-64,2
22,1,0,0,1,2021-05-27,Male,70,70-74,2
22,3,30,0,33,2021-05-29,Female,12,10-14,2
22,2,3,0,5,2021-05-30,Male,56,55-64,21
22,1,0,0,1,2021-05-29,Female,55,55-64,18
22,2,0,0,2,2021-06-01,Male,25,25-34,2
22,1,0,0,1,2021-05-30,Female,57,55-64,2
22,2,2,0,4,2021-05-31,Male,17,15-19,3
22,0,0,0,0,2021-05-30,Male,60,55-64,19
22,1,0,0,1,2021-06-03,Female,29,25-34,1
22,3,0,0,3,2021-06-03,Female,0,<1,1
22,1,0,0,1,2021-05-30,Female,66,65-69,2
22,1,0,0,1,2021-05-27,Male,32,25-34,19
22,0,0,0,0,2021-05-27,Male,28,25-34,21
22,1,0,0,1,2021-06-03,Female,76,75-79,1
22,0,0,0,0,2021-06-01,Male,48,45-54,18
22,2,1,2,5,2021-05-27,Female,18,15-19,2
22,0,0,0,0,2021-06-02,Male,1,1-4,10
22,0,12,0,12,2021-05-29,Female,41,35-44,22
22,1,1,0,2,2021-05-27,Male,69,65-69,19
22,0,3,0,3,2021-05-30,Male,73,70-74,11
22,2,1,0,3,2021-05-27,Female,74,70-74,15
22,0,0,0,0,2021-05-30,Male,66,65-69,19
22,3,30,0,33,2021-06-02,Female,23,20-24,1
22,0,1,0,1,2021-05-29,Female,49,45-54,7
22,1,1,0,2,2021-06-01,Female,63,55-64,2
22,1,0,0,1,2021-05-31,Male,33,25-34,18
22,1,1,0,2,2021-05-31,Female,50,45-54,17
22,0,0,0,0,2021-05-28,Male,77,75-79,2
22,1,1,0,2,2021-06-03,Male,49,45-54,1
22,2,4,0,6,2021-05-30,Female,66,65-69,15
22,0,3,0,3,2021-06-03,Male,23,20-24,1
22,0,0,0,0,2021-05-27,Male,69,65-69,19
22,2,0,0,2,2021-05-28,Female,21,20-24,2
22,1,1,0,2,2021-05-30,Female,58,55-64,2
22,2,0,0,2,2021-05-27,Female,0,<1,2
22,0,0,0,0,2021-05-30,Female,58,55-64,2
22,0,0,0,0,2021-06-01,Female,73,70-74,18
22,0,0,0,0,2021-06-02,Male,57,55-64,1
22,0,0,0,0,2021-05-30,Male,59,55-64,15
22,0,0,0,0,2021-06-02,Female,42,35-44,13
22,1,1,0,2,2021-05-30,Male,69,65-69,21
22,1,0,0,1,2021-05-30,Female,49,45-54,2
22,0,0,0,0,2021-05-31,Male,79,75-79,8
22,2,0,0,2,2021-05-27,Male,71,70-74,15
22,0,4,0,4,2021-05-30,Male,59,55-64,17
22,1,0,0,1,2021-05-30,Male,59,55-64,17
22,1,0,0,1,2021-05-31,Male,67,65-69,16
22,0,3,0,3,2021-05-29,Female,54,45-54,17
22,0,0,0,0,2021-05-31,Male,51,45-54,13
22,2,1,0,3,2021-06-01,Male,17,15-19,17
22,2,0,0,2,2021-06-02,Male,2,1-4,18
22,1,2,0,3,2021-05-30,Female,31,25-34,18
22,0,2,0,2,2021-05-30,Male,61,55-64,17
22,1,0,0,1,2021-06-03,Female,70,70-74,16
22,1,0,0,1,2021-05-31,Female,52,45-54,2
22,1,0,0,1,2021-05-30,Male,68,65-69,21
22,0,0,0,0,2021-06-02,Male,28,25-34,1
22,0,2,100,102,2021-05-30,Male,61,55-64,2
22,0,0,0,0,2021-06-02,Male,59,55-64,1
22,0,0,0,0,2021-05-27,Female,71,70-74,2
22,0,2,0,2,2021-05-31,Male,60,55-64,4
22,3,1,0,4,2021-05-30,Female,66,65-69,13
22,0,2,0,2,2021-05-27,Male,27,25-34,2
22,2,1,0,3,2021-05-27,Female,26,25-34,2
22,2,0,0,2,2021-05-27,Male,76,75-79,8
22,0,0,1,1,2021-06-02,Male,51,45-54,1
22,1,0,0,1,2021-06-02,Female,28,25-34,8
22,0,0,0,0,2021-05-30,Female,56,55-64,2
22,1,0,0,1,2021-05-30,Female,23,20-24,15
22,0,0,0,0,2021-05-30,Female,64,55-64,9
22,0,2,0,2,2021-05-27,Female,69,65-69,12
22,1,0,0,1,2021-05-31,Female,48,45-54,15
22,0,1,0,1,2021-05-30,Male,59,55-64,18
22,0,0,0,0,2021-05-28,Male,37,35-44,20
22,1,0,0,1,2021-06-01,Female,55,55-64,8
22,0,1,0,1,2021-05-31,Female,43,35-44,17
22,1,0,0,1,2021-05-28,Female,36,35-44,4
22,0,0,0,0,2021-05-29,Male,52,45-54,19
22,3,10,0,13,2021-06-02,Male,7,5-9,1
22,1,6,0,7,2021-05-27,Male,73,70-74,2
22,2,0,0,2,2021-05-27,Male,7,5-9,14
22,2,0,0,2,2021-06-02,Male,25,25-34,1
22,1,0,0,1,2021-06-02,Female,22,20-24,1
22,5,0,0,5,2021-05-31,Female,2,1-4,2
22,0,0,0,0,2021-05-29,Male,43,35-44,2
22,0,0,0,0,2021-05-29,Female,46,45-54,20
22,2,0,0,2,2021-06-01,Male,68,65-69,4
22,3,9,0,12,2021-05-31,Male,69,65-69,15
22,0,0,0,0,2021-05-29,Male,42,35-44,15
22,0,7,0,7,2021-06-02,Female,42,35-44,1
22,0,0,0,0,2021-05-31,Male,63,55-64,15
22,1,0,0,1,2021-05-29,Male,55,55-64,19
22,1,0,0,1,2021-05-31,Female,52,45-54,16
22,1,18,0,19,2021-06-02,Female,52,45-54,2
22,0,0,0,0,2021-05-31,Female,66,65-69,16
22,3,0,0,3,2021-05-31,Male,18,15-19,19
22,3,9,0,12,2021-05-27,Female,12,10-14,4
22,0,0,0,0,2021-05-30,Male,55,55-64,19
22,1,0,0,1,2021-05-30,Male,58,55-64,4
22,1,3,0,4,2021-06-02,Female,37,35-44,2
22,2,0,0,2,2021-05-30,Female,60,55-64,16
22,2,3,0,5,2021-05-27,Female,28,25-34,2
22,0,0,0,0,2021-05-30,Male,60,55-64,14
22,2,0,0,2,2021-05-31,Female,51,45-54,10
22,1,1,0,2,2021-05-31,Female,63,55-64,2
22,1,0,0,1,2021-05-28,Female,37,35-44,2
22,0,0,0,0,2021-05-27,Male,31,25-34,17
22,0,3,0,3,2021-05-31,Male,65,65-69,2
22,1,0,0,1,2021-05-27,Female,21,20-24,19
22,1,1,0,2,2021-06-02,Male,32,25-34,1
22,3,0,0,3,2021-05-31,Female,56,55-64,14
22,3,0,0,3,2021-05-30,Female,67,65-69,17
22,0,1,0,1,2021-05-29,Male,54,45-54,3
22,0,0,0,0,2021-05-30,Male,58,55-64,4
22,0,0,5,5,2021-05-27,Male,28,25-34,2
22,2,0,0,2,2021-05-29,Male,52,45-54,20
22,1,0,0,1,2021-05-31,Female,59,55-64,7
22,0,2,0,2,2021-05-30,Male,65,65-69,17
22,0,0,0,0,2021-05-28,Male,38,35-44,2
22,1,0,0,1,2021-05-29,Male,48,45-54,16
22,0,0,0,0,2021-05-30,Male,60,55-64,18
22,1,0,0,1,2021-06-02,Female,28,25-34,1
22,1,0,0,1,2021-05-27,Male,69,65-69,17
22,0,3,0,3,2021-05-27,Male,31,25-34,19
22,0,0,0,0,2021-05-28,Male,36,35-44,18
22,1,9,0,10,2021-05-30,Female,57,55-64,2
22,1,4,0,5,2021-05-30,Female,30,25-34,8
22,2,0,0,2,2021-05-27,Female,69,65-69,19
22,0,1,0,1,2021-06-02,Female,26,25-34,19
22,0,1,0,1,2021-06-02,Female,24,20-24,8
22,1,0,0,1,2021-05-30,Female,60,55-64,18
22,1,1,0,2,2021-05-29,Female,54,45-54,2
22,0,0,20,20,2021-05-31,Male,41,35-44,15
22,1,0,0,1,2021-05-27,Female,73,70-74,2
22,0,2,0,2,2021-05-30,Male,66,65-69,22
22,1,0,0,1,2021-05-31,Male,53,45-54,14
22,1,0,0,1,2021-06-03,Female,42,35-44,1
22,0,1,1,2,2021-05-27,Male,70,70-74,15
22,3,0,0,3,2021-06-02,Female,2,1-4,1
22,0,5,0,5,2021-05-29,Female,24,20-24,6
22,2,0,0,2,2021-05-28,Male,35,35-44,3
22,0,6,0,6,2021-06-01,Female,22,20-24,2
22,1,0,0,1,2021-05-30,Female,66,65-69,22
22,1,0,0,1,2021-05-27,Male,70,70-74,19
22,1,0,0,1,2021-06-02,Male,34,25-34,10
22,2,1,0,3,2021-05-28,Female,71,70-74,8
22,0,0,0,0,2021-05-30,Female,65,65-69,2
22,1,0,0,1,2021-05-31,Male,62,55-64,15
22,0,3,0,3,2021-05-30,Female,60,55-64,4
22,0,0,0,0,2021-06-02,Female,26,25-34,1
22,0,0,0,0,2021-05-29,Male,46,45-54,12
22,0,0,0,0,2021-05-30,Female,66,65-69,18
22,0,0,0,0,2021-05-27,Female,69,65-69,2
22,1,0,0,1,2021-05-27,Male,79,75-79,17
22,2,10,0,12,2021-05-27,Male,72,70-74,14
22,0,0,0,0,2021-05-30,Male,68,65-69,16
22,1,0,0,1,2021-05-31,Female,68,65-69,16
22,0,0,0,0,2021-05-30,Female,65,65-69,18
22,0,2,2,4,2021-06-02,Female,56,55-64,1
22,1,0,0,1,2021-06-01,Male,59,55-64,22
22,0,0,0,0,2021-05-28,Male,14,10-14,2
22,2,0,0,2,2021-05-27,Male,70,70-74,21
22,2,0,0,2,2021-05-29,Male,45,45-54,2
22,2,0,0,2,2021-05-29,Female,53,45-54,2
22,1,10,0,11,2021-06-02,Female,46,45-54,1
22,0,0,0,0,2021-05-31,Male,39,35-44,9
22,1,2,0,3,2021-05-29,Male,51,45-54,21
22,1,0,1,2,2021-06-01,Female,27,25-34,8
22,3,0,0,3,2021-05-28,Male,6,5-9,11
22,1,2,0,3,2021-06-03,Female,38,35-44,1
22,1,0,0,1,2021-05-27,Male,72,70-74,18
22,2,0,0,2,2021-05-26,Male,12,10-14,2
22,0,0,0,0,2021-05-29,Female,78,75-79,14
22,1,1,0,2,2021-05-30,Female,64,55-64,17
22,2,0,0,2,2021-05-27,Female,16,15-19,20
22,1,6,0,7,2021-05-28,Female,39,35-44,20
22,1,2,0,3,2021-06-01,Female,58,55-64,20
22,3,18,0,21,2021-06-03,Male,18,15-19,1
22,0,0,0,0,2021-06-02,Female,71,70-74,1
22,0,0,6,6,2021-05-30,Female,65,65-69,2
22,2,0,0,2,2021-05-31,Male,78,75-79,14
22,2,0,0,2,2021-05-29,Male,23,20-24,20
22,0,1,0,1,2021-05-29,Male,40,35-44,19
22,1,0,0,1,2021-05-31,Male,78,75-79,7
22,0,0,0,0,2021-05-30,Male,67,65-69,17
22,0,1,0,1,2021-06-01,Male,29,25-34,2
22,1,1,0,2,2021-06-03,Female,67,65-69,17
22,1,1,0,2,2021-05-31,Female,69,65-69,21
22,3,0,0,3,2021-05-26,Female,17,15-19,16
22,0,0,0,0,2021-05-27,Female,29,25-34,20
22,1,0,0,1,2021-05-30,Female,64,55-64,15
22,3,0,0,3,2021-05-28,Female,0,<1,2
22,0,0,0,0,2021-05-27,Female,21,20-24,8
22,1,0,0,1,2021-06-02,Female,49,45-54,10
22,0,0,0,0,2021-05-29,Female,47,45-54,17
22,1,0,0,1,2021-05-30,Male,65,65-69,15
22,0,0,0,0,2021-05-31,Female,68,65-69,19
22,2,0,0,2,2021-05-26,Female,17,15-19,17
22,2,0,0,2,2021-06-01,Female,50,45-54,15
22,1,0,0,1,2021-06-02,Female,72,70-74,1
22,1,1,0,2,2021-05-30,Male,62,55-64,11
22,2,0,0,2,2021-05-29,Female,15,15-19,2
22,0,5,0,5,2021-05-30,Male,59,55-64,17
22,1,0,0,1,2021-05-30,Male,67,65-69,2
22,1,0,0,1,2021-05-26,Male,4,1-4,12
22,0,0,0,0,2021-05-27,Female,32,25-34,2
22,1,0,0,1,2021-05-30,Male,60,55-64,18
22,2,0,0,2,2021-06-01,Female,50,45-54,2
22,0,0,0,0,2021-06-02,Male,34,25-34,1
22,2,0,0,2,2021-05-28,Male,26,25-34,19
22,2,0,0,2,2021-06-01,Female,15,15-19,2
22,1,0,0,1,2021-05-31,Female,68,65-69,16
22,0,3,9,12,2021-05-29,Female,43,35-44,2
22,1,5,0,6,2021-05-30,Male,57,55-64,16
22,0,0,0,0,2021-05-29,Female,41,35-44,2
22,0,0,0,0,2021-06-02,Male,43,35-44,1
22,2,0,0,2,2021-05-27,Male,70,70-74,17
22,1,0,0,1,2021-06-02,Female,20,20-24,1
22,1,0,0,1,2021-05-27,Male,70,70-74,20
22,1,0,0,1,2021-05-30,Male,64,55-64,2
22,1,2,0,3,2021-05-30,Female,46,45-54,2
22,1,1,0,2,2021-06-01,Male,60,55-64,18
22,1,0,0,1,2021-05-31,Female,52,45-54,2
22,0,0,0,0,2021-05-29,Male,52,45-54,14
22,2,11,0,13,2021-05-28,Male,31,25-34,18
22,1,0,0,1,2021-05-31,Female,66,65-69,2
22,4,0,0,4,2021-05-28,Female,3,1-4,6
22,2,0,0,2,2021-06-02,Male,0,<1,1
22,1,0,0,1,2021-06-02,Female,35,35-44,2
22,3,0,0,3,2021-05-28,Female,3,1-4,19
22,2,2,0,4,2021-06-02,Male,53,45-54,1
22,0,0,0,0,2021-05-28,Female,35,35-44,2
22,1,0,0,1,2021-05-30,Female,63,55-64,16
22,0,1,0,1,2021-05-30,Male,43,35-44,19
22,0,0,0,0,2021-06-02,Male,51,45-54,1
22,1,0,0,1,2021-05-31,Male,35,35-44,4
22,2,0,0,2,2021-05-30,Female,57,55-64,2
22,2,0,0,2,2021-06-02,Male,6,5-9,1
22,2,0,0,2,2021-05-29,Female,7,5-9,2
22,2,0,0,2,2021-05-31,Female,67,65-69,4
22,0,0,0,0,2021-06-02,Female,56,55-64,1
22,0,0,0,0,2021-05-29,Female,48,45-54,2
22,3,0,0,3,2021-05-31,Male,13,10-14,16
22,1,6,0,7,2021-05-27,Female,29,25-34,2
22,0,0,0,0,2021-05-30,Male,61,55-64,4
22,0,46,0,46,2021-06-02,Male,41,35-44,2
22,0,0,0,0,2021-06-01,Male,25,25-34,13
22,2,1,0,3,2021-05-31,Female,51,45-54,15
22,2,2,0,4,2021-05-30,Female,68,65-69,17
22,1,0,0,1,2021-05-30,Male,50,45-54,19
22,0,0,0,0,2021-06-01,Female,31,25-34,12
22,0,0,0,0,2021-06-03,Female,25,25-34,13
22,1,0,0,1,2021-05-30,Male,52,45-54,20
22,2,0,0,2,2021-06-03,Male,25,25-34,1
22,1,2,0,3,2021-06-02,Female,31,25-34,1
22,0,1,0,1,2021-05-30,Female,56,55-64,15
22,2,0,0,2,2021-05-31,Male,70,70-74,19
22,0,0,0,0,2021-05-30,Female,65,65-69,2
22,0,0,0,0,2021-06-01,Male,37,35-44,2
22,1,4,0,5,2021-05-27,Male,70,70-74,2
22,2,0,0,2,2021-05-30,Female,60,55-64,19
22,0,0,0,0,2021-05-27,Male,34,25-34,2
22,4,5,0,9,2021-06-02,Female,24,20-24,1
22,0,0,0,0,2021-05-30,Male,41,35-44,17
22,0,1,0,1,2021-05-31,Female,46,45-54,9
22,0,0,0,0,2021-05-29,Male,54,45-54,17
22,0,0,0,0,2021-05-27,Female,31,25-34,20
22,0,5,0,5,2021-06-02,Female,34,25-34,2
22,0,0,0,0,2021-05-28,Male,33,25-34,21
22,1,0,0,1,2021-05-30,Male,56,55-64,2
22,0,0,0,0,2021-05-30,Male,47,45-54,16
22,1,0,0,1,2021-05-31,Female,55,55-64,13
22,0,1,0,1,2021-05-30,Female,66,65-69,20
22,2,0,0,2,2021-05-28,Female,11,10-14,14
22,0,0,0,0,2021-05-30,Female,68,65-69,17
22,0,0,0,0,2021-06-02,Male,32,25-34,1
22,1,1,0,2,2021-06-03,Male,60,55-64,1
22,0,0,0,0,2021-05-27,Female,23,20-24,8
22,2,0,0,2,2021-05-29,Male,46,45-54,22
22,0,1,0,1,2021-06-01,Female,60,55-64,9
22,0,0,0,0,2021-05-28,Female,37,35-44,2
22,0,0,0,0,2021-05-30,Female,56,55-64,20
22,1,3,0,4,2021-06-02,Female,61,55-64,1
22,3,0,0,3,2021-05-27,Female,5,5-9,12
22,1,0,0,1,2021-05-27,Male,85,85+,2
22,0,0,0,0,2021-05-27,Male,30,25-34,17
22,0,2,0,2,2021-05-31,Female,47,45-54,2
22,0,0,0,0,2021-06-02,Male,19,15-19,9
22,0,0,0,0,2021-05-28,Male,39,35-44,14
22,1,4,0,5,2021-05-31,Male,68,65-69,19
22,1,0,0,1,2021-05-29,Male,13,10-14,15
22,0,0,0,0,2021-06-02,Female,34,25-34,1
22,2,2,0,4,2021-05-30,Female,55,55-64,9
22,2,15,30,47,2021-06-03,Male,12,10-14,2
22,2,14,0,16,2021-06-02,Female,19,15-19,12
22,0,0,0,0,2021-05-27,Male,79,75-79,14
22,1,0,0,1,2021-05-30,Male,65,65-69,2
22,0,0,0,0,2021-05-30,Male,47,45-54,13
22,4,0,0,4,2021-05-27,Female,17,15-19,2
22,0,3,0,3,2021-06-02,Female,27,25-34,1
22,2,0,0,2,2021-05-27,Female,30,25-34,9
22,0,1,0,1,2021-05-26,Male,19,15-19,2
22,2,0,0,2,2021-06-03,Female,7,5-9,1
22,1,3,0,4,2021-05-28,Male,30,25-34,2
22,3,0,0,3,2021-05-30,Male,18,15-19,13
22,0,0,0,0,2021-05-27,Male,76,75-79,2
22,1,0,0,1,2021-05-31,Female,54,45-54,2
22,1,1,0,2,2021-05-31,Male,75,75-79,2
22,1,0,0,1,2021-05-30,Female,68,65-69,12
22,0,0,0,0,2021-05-31,Male,47,45-54,2
22,1,0,0,1,2021-05-30,Male,58,55-64,19
22,0,4,0,4,2021-05-27,Male,42,35-44,18
22,1,0,0,1,2021-05-29,Male,53,45-54,2
22,1,0,0,1,2021-06-02,Male,48,45-54,2
22,3,1,0,4,2021-05-27,Male,11,10-14,19
22,3,1,0,4,2021-05-29,Male,11,10-14,16
22,3,0,0,3,2021-05-31,Male,13,10-14,2
22,0,0,0,0,2021-05-30,Male,65,65-69,18
22,1,1,0,2,2021-05-30,Female,67,65-69,18
22,1,0,0,1,2021-05-30,Female,68,65-69,18
22,1,0,0,1,2021-05-29,Male,55,55-64,2
22,2,1,2,5,2021-05-27,Male,81,80-84,15
22,0,0,0,0,2021-05-29,Male,51,45-54,17
22,0,3,0,3,2021-05-29,Male,51,45-54,2
22,0,0,0,0,2021-05-26,Female,21,20-24,14
22,4,19,0,23,2021-05-29,Female,10,10-14,2
22,0,0,1,1,2021-05-29,Female,48,45-54,17
22,1,0,0,1,2021-05-27,Male,72,70-74,18
22,0,0,0,0,2021-05-26,Male,21,20-24,19
22,0,3,0,3,2021-05-31,Female,66,65-69,2
22,0,0,0,0,2021-05-30,Male,41,35-44,2
22,0,0,0,0,2021-05-27,Male,28,25-34,17
22,1,0,0,1,2021-06-03,Female,32,25-34,1
22,2,1,0,3,2021-05-31,Female,13,10-14,8
22,1,0,0,1,2021-05-30,Female,63,55-64,20
22,1,0,0,1,2021-05-29,Female,53,45-54,14
22,0,0,0,0,2021-05-30,Male,66,65-69,21
22,0,0,0,0,2021-05-27,Male,57,55-64,13
22,0,1,0,1,2021-05-30,Male,66,65-69,20
22,1,0,0,1,2021-05-30,Male,63,55-64,21
22,0,0,0,0,2021-05-28,Female,69,65-69,16
22,1,7,0,8,2021-05-30,Female,62,55-64,2
22,1,0,0,1,2021-05-31,Male,31,25-34,12
22,0,0,0,0,2021-05-28,Male,34,25-34,2
22,5,5,0,10,2021-05-27,Male,26,25-34,2
22,0,0,0,0,2021-05-28,Female,30,25-34,17
22,1,0,0,1,2021-05-27,Male,72,70-74,20
22,0,0,0,0,2021-06-01,Female,63,55-64,19
22,0,0,0,0,2021-05-28,Female,36,35-44,20
22,0,3,0,3,2021-05-29,Male,45,45-54,7
22,2,0,0,2,2021-05-27,Male,71,70-74,17
22,0,0,0,0,2021-05-28,Female,23,20-24,8
22,1,0,0,1,2021-05-30,Female,56,55-64,2
22,5,0,0,5,2021-05-29,Female,18,15-19,19
22,3,2,0,5,2021-05-30,Male,65,65-69,21
22,0,1,0,1,2021-05-30,Female,62,55-64,18
22,0,0,0,0,2021-05-30,Female,32,25-34,16
22,1,0,0,1,2021-05-30,Female,60,55-64,2
22,0,1,0,1,2021-05-30,Male,58,55-64,2
22,2,0,0,2,2021-05-29,Male,55,55-64,19
22,0,3,0,3,2021-05-29,Male,53,45-54,2
22,0,1,0,1,2021-05-30,Female,67,65-69,16
22,2,1,0,3,2021-05-30,Female,58,55-64,2
22,2,0,0,2,2021-05-28,Male,37,35-44,2
22,2,0,0,2,2021-06-02,Female,60,55-64,17
22,0,1,0,1,2021-05-27,Female,32,25-34,2
22,3,1,0,4,2021-06-02,Female,3,1-4,1
22,1,0,0,1,2021-05-30,Male,55,55-64,2
22,1,1,0,2,2021-05-29,Male,32,25-34,2
22,1,9,0,10,2021-06-02,Female,26,25-34,2
22,1,1,6,8,2021-06-02,Female,23,20-24,16
22,1,0,0,1,2021-05-26,Female,19,15-19,8
22,1,4,0,5,2021-05-26,Female,18,15-19,2
22,1,0,0,1,2021-06-02,Male,7,5-9,1
22,2,0,0,2,2021-05-27,Female,14,10-14,2
22,1,1,0,2,2021-05-31,Male,56,55-64,15
22,0,0,0,0,2021-05-31,Male,65,65-69,2
22,0,0,0,0,2021-05-28,Female,25,25-34,9
22,0,3,0,3,2021-05-31,Male,66,65-69,2
22,0,0,0,0,2021-05-29,Male,54,45-54,19
22,0,4,0,4,2021-05-28,Male,40,35-44,18
22,1,3,0,4,2021-06-01,Male,60,55-64,2
22,2,3,0,5,2021-06-03,Female,49,45-54,1
22,1,1,0,2,2021-06-01,Male,85,85+,2
22,0,3,0,3,2021-05-30,Male,42,35-44,2
22,0,0,0,0,2021-06-02,Male,36,35-44,1
22,1,1,0,2,2021-05-27,Female,69,65-69,2
22,1,1,0,2,2021-05-29,Male,43,35-44,19
22,0,0,0,0,2021-05-29,Male,28,25-34,2
22,3,0,0,3,2021-05-30,Male,15,15-19,14
22,2,0,0,2,2021-05-30,Male,66,65-69,10
22,0,1,0,1,2021-05-29,Male,39,35-44,2
22,0,0,0,0,2021-06-03,Male,52,45-54,1
22,0,0,0,0,2021-05-30,Female,64,55-64,21
22,1,0,0,1,2021-05-30,Female,67,65-69,19
22,2,0,0,2,2021-05-30,Female,61,55-64,17
22,0,0,0,0,2021-05-27,Male,19,15-19,7
22,1,0,0,1,2021-05-29,Male,54,45-54,2
22,0,0,0,0,2021-05-30,Male,61,55-64,13
22,0,3,0,3,2021-05-30,Female,62,55-64,20
22,0,0,7,7,2021-05-28,Male,24,20-24,2
22,2,2,0,4,2021-05-29,Female,54,45-54,2
22,0,0,5,5,2021-05-27,Female,34,25-34,2
22,0,7,0,7,2021-05-29,Female,55,55-64,2
22,1,0,0,1,2021-06-03,Female,70,70-74,1
22,0,0,0,0,2021-05-31,Male,33,25-34,2
22,2,24,0,26,2021-05-28,Male,18,15-19,17
22,1,1,0,2,2021-05-27,Male,71,70-74,17
22,1,2,0,3,2021-05-29,Male,16,15-19,2
22,0,2,0,2,2021-06-01,Female,68,65-69,15
22,1,4,0,5,2021-06-02,Male,28,25-34,1
22,0,0,0,0,2021-06-02,Female,68,65-69,16
22,1,0,0,1,2021-05-27,Male,70,70-74,18
22,2,0,0,2,2021-05-31,Male,51,45-54,2
22,1,0,0,1,2021-05-31,Male,68,65-69,2
22,0,3,0,3,2021-06-01,Male,23,20-24,13
22,1,0,0,1,2021-06-01,Female,67,65-69,2
22,2,1,0,3,2021-05-29,Male,7,5-9,16
22,1,0,0,1,2021-06-03,Male,42,35-44,1
22,0,0,0,0,2021-06-01,Female,71,70-74,20
22,1,0,0,1,2021-05-30,Female,65,65-69,2
22,2,0,0,2,2021-05-31,Male,67,65-69,16
22,0,1,0,1,2021-06-03,Female,65,65-69,1
22,1,0,0,1,2021-05-30,Male,67,65-69,19
22,0,0,0,0,2021-05-31,Female,33,25-34,7
22,0,2,0,2,2021-06-02,Female,74,70-74,1
22,1,4,0,5,2021-05-31,Male,45,45-54,2
22,1,0,0,1,2021-05-31,Female,26,25-34,4
22,0,0,0,0,2021-05-27,Male,70,70-74,18
22,0,10,0,10,2021-06-02,Male,53,45-54,1
22,3,0,0,3,2021-06-03,Female,49,45-54,1
22,0,4,0,4,2021-06-01,Female,65,65-69,2
22,1,1,0,2,2021-06-01,Male,50,45-54,3
22,0,0,0,0,2021-05-31,Female,34,25-34,21
22,2,0,0,2,2021-05-29,Male,53,45-54,21
22,1,0,0,1,2021-05-30,Male,68,65-69,22
22,1,0,0,1,2021-05-27,Male,31,25-34,2
22,1,0,0,1,2021-05-31,Male,53,45-54,4
22,1,0,1,2,2021-06-01,Male,53,45-54,3
22,0,0,0,0,2021-05-31,Female,38,35-44,8
22,0,0,0,0,2021-06-02,Male,30,25-34,9
22,1,0,0,1,2021-05-27,Male,79,75-79,16
22,0,0,0,0,2021-05-29,Female,47,45-54,2
22,2,2,0,4,2021-05-31,Female,14,10-14,13
22,1,0,0,1,2021-05-31,Male,69,65-69,11
22,0,0,0,0,2021-05-31,Male,24,20-24,16
22,0,0,0,0,2021-05-30,Male,16,15-19,19
22,3,2,0,5,2021-06-01,Female,11,10-14,13
22,1,0,0,1,2021-06-01,Male,30,25-34,5
22,1,0,0,1,2021-05-30,Female,58,55-64,9
22,1,0,0,1,2021-05-27,Female,73,70-74,2
22,1,3,1,5,2021-06-01,Female,57,55-64,5
22,1,20,0,21,2021-06-02,Female,52,45-54,2
22,1,0,0,1,2021-05-27,Female,75,75-79,2
22,0,2,0,2,2021-06-02,Female,22,20-24,1
22,1,7,0,8,2021-05-30,Male,65,65-69,2
22,3,0,0,3,2021-05-31,Male,13,10-14,18
22,1,0,0,1,2021-05-30,Female,62,55-64,15
22,0,0,1,1,2021-05-30,Female,66,65-69,2
22,2,0,0,2,2021-05-29,Female,36,35-44,11
22,2,7,0,9,2021-06-02,Female,18,15-19,1
22,0,0,0,0,2021-05-28,Female,23,20-24,16
22,1,1,0,2,2021-05-27,Male,79,75-79,17
22,2,3,0,5,2021-05-30,Female,61,55-64,2
22,2,0,0,2,2021-05-29,Male,53,45-54,19
22,1,0,0,1,2021-06-01,Female,34,25-34,12
22,2,0,0,2,2021-06-01,Female,48,45-54,5
22,1,1,0,2,2021-05-30,Male,67,65-69,13
22,1,0,0,1,2021-05-29,Male,52,45-54,17
22,2,0,0,2,2021-05-26,Male,21,20-24,2
22,0,0,0,0,2021-05-29,Male,52,45-54,15
22,3,0,0,3,2021-05-29,Female,43,35-44,21
22,2,0,0,2,2021-05-28,Female,71,70-74,17
22,1,1,0,2,2021-05-31,Female,66,65-69,10
22,1,5,0,6,2021-06-03,Male,67,65-69,1
22,1,0,0,1,2021-05-27,Female,24,20-24,20
22,0,0,0,0,2021-06-02,Male,33,25-34,1
22,0,0,0,0,2021-05-27,Female,72,70-74,15
22,1,0,0,1,2021-05-27,Male,32,25-34,16
22,0,0,0,0,2021-05-27,Female,69,65-69,22
22,0,0,0,0,2021-05-31,Male,60,55-64,15
22,3,0,0,3,2021-05-28,Male,7,5-9,2
22,0,0,0,0,2021-05-31,Female,58,55-64,2
22,3,0,0,3,2021-05-31,Female,37,35-44,11
22,2,0,0,2,2021-06-01,Male,12,10-14,18
22,2,0,0,2,2021-05-26,Male,18,15-19,2
22,2,0,0,2,2021-05-27,Male,25,25-34,11
22,2,0,0,2,2021-06-01,Male,70,70-74,14
22,1,0,0,1,2021-06-03,Female,67,65-69,1
22,1,0,0,1,2021-06-02,Male,64,55-64,1
22,2,0,0,2,2021-05-31,Female,51,45-54,18
22,2,6,0,8,2021-05-30,Male,66,65-69,2
22,0,3,0,3,2021-05-27,Female,70,70-74,16
22,2,0,0,2,2021-05-31,Male,33,25-34,18
22,4,2,0,6,2021-05-30,Female,12,10-14,17
22,3,0,0,3,2021-06-03,Female,4,1-4,19
22,1,15,0,16,2021-05-30,Male,60,55-64,13
22,0,0,0,0,2021-05-31,Male,45,45-54,17
22,2,0,0,2,2021-05-27,Male,6,5-9,9
22,0,0,0,0,2021-05-30,Female,68,65-69,18
22,0,0,0,0,2021-05-29,Female,54,45-54,20
22,3,0,0,3,2021-05-31,Male,70,70-74,12
22,0,0,0,0,2021-05-29,Female,41,35-44,21
22,0,0,4,4,2021-05-26,Male,20,20-24,3
22,0,0,0,0,2021-05-27,Female,24,20-24,4
22,1,3,0,4,2021-05-30,Female,49,45-54,2
22,0,0,0,0,2021-06-02,Female,13,10-14,6
22,1,2,0,3,2021-06-01,Male,67,65-69,2
22,0,0,0,0,2021-06-02,Male,34,25-34,3
22,2,0,0,2,2021-05-31,Female,17,15-19,2
22,0,0,0,0,2021-05-30,Female,64,55-64,19
22,0,0,0,0,2021-06-03,Female,29,25-34,1
22,2,0,0,2,2021-05-31,Female,12,10-14,16
22,0,0,0,0,2021-05-27,Male,23,20-24,12
22,0,0,0,0,2021-06-02,Male,21,20-24,2
22,0,0,0,0,2021-05-27,Male,82,80-84,7
22,1,2,1,4,2021-06-02,Female,65,65-69,1
22,1,0,0,1,2021-05-29,Female,53,45-54,22
22,1,0,0,1,2021-05-29,Male,51,45-54,2
22,0,2,0,2,2021-05-30,Male,62,55-64,2
22,0,0,0,0,2021-05-27,Female,72,70-74,2
22,1,1,0,2,2021-05-27,Male,79,75-79,8
22,3,0,0,3,2021-06-01,Male,10,10-14,3
22,1,4,0,5,2021-05-30,Male,63,55-64,2
22,1,0,0,1,2021-06-02,Female,62,55-64,1
22,1,0,0,1,2021-05-28,Male,36,35-44,7
22,3,0,0,3,2021-05-31,Female,33,25-34,2
22,5,0,0,5,2021-05-27,Male,16,15-19,2
22,3,0,0,3,2021-05-29,Male,17,15-19,18
22,0,2,0,2,2021-05-27,Male,78,75-79,21
22,0,0,0,0,2021-05-27,Female,29,25-34,3
22,0,0,0,0,2021-05-31,Male,44,35-44,15
22,2,2,0,4,2021-05-30,Female,57,55-64,21
22,0,0,0,0,2021-05-30,Female,66,65-69,15
22,0,0,0,0,2021-05-29,Female,52,45-54,4
22,2,0,0,2,2021-05-29,Female,10,10-14,11
22,0,3,0,3,2021-06-02,Female,28,25-34,1
22,3,0,0,3,2021-06-01,Male,4,1-4,13
22,2,0,0,2,2021-05-30,Female,10,10-14,2
22,0,1,0,1,2021-05-28,Female,36,35-44,2
22,0,0,0,0,2021-05-28,Male,29,25-34,2
22,0,0,0,0,2021-05-27,Female,29,25-34,2
22,3,0,0,3,2021-05-30,Female,8,5-9,2
22,0,0,0,0,2021-06-02,Male,43,35-44,1
22,1,0,0,1,2021-05-31,Male,52,45-54,2
22,0,0,0,0,2021-05-28,Male,40,35-44,19
22,1,8,0,9,2021-05-30,Female,66,65-69,22
22,1,2,0,3,2021-05-30,Female,63,55-64,2
22,0,6,0,6,2021-05-28,Male,38,35-44,19
22,1,0,0,1,2021-05-30,Male,60,55-64,2
22,2,0,0,2,2021-05-29,Male,13,10-14,2
22,0,0,0,0,2021-05-28,Male,31,25-34,19
22,2,1,0,3,2021-06-02,Female,62,55-64,16
22,0,0,0,0,2021-05-28,Female,23,20-24,2
22,0,1,0,1,2021-05-29,Female,54,45-54,18
22,0,0,0,0,2021-06-01,Male,58,55-64,12
22,1,0,0,1,2021-05-30,Female,68,65-69,20
22,3,0,0,3,2021-05-31,Female,9,5-9,12
22,0,2,0,2,2021-06-02,Male,49,45-54,15
22,2,0,0,2,2021-05-30,Female,44,35-44,14
22,1,0,0,1,2021-05-30,Male,64,55-64,19
22,0,0,0,0,2021-05-30,Male,58,55-64,7
22,0,0,0,0,2021-05-31,Male,41,35-44,20
22,0,0,0,0,2021-05-27,Male,11,10-14,2
22,0,2,0,2,2021-05-29,Female,50,45-54,2
22,1,0,0,1,2021-05-30,Male,67,65-69,2
22,2,0,0,2,2021-05-28,Male,69,65-69,13
22,1,0,0,1,2021-06-01,Female,64,55-64,2
22,1,1,0,2,2021-05-30,Male,67,65-69,10
22,0,0,0,0,2021-05-30,Female,59,55-64,19
22,1,0,0,1,2021-05-28,Female,35,35-44,15
22,0,0,0,0,2021-06-03,Female,70,70-74,1
22,1,0,2,3,2021-06-03,Female,52,45-54,1
22,0,0,0,0,2021-05-30,Male,56,55-64,6
22,2,0,0,2,2021-05-26,Female,1,1-4,2
22,1,1,0,2,2021-06-02,Male,40,35-44,2
22,1,1,0,2,2021-05-30,Female,60,55-64,20
22,0,0,0,0,2021-05-31,Male,10,10-14,19
22,1,0,0,1,2021-05-29,Male,16,15-19,18
22,1,0,0,1,2021-05-30,Male,66,65-69,18
22,4,0,0,4,2021-05-29,Female,0,<1,2
22,2,0,0,2,2021-05-29,Female,15,15-19,20
22,1,0,0,1,2021-06-03,Female,38,35-44,1
22,1,0,0,1,2021-05-27,Female,72,70-74,2
22,0,0,0,0,2021-05-30,Male,60,55-64,2
22,0,0,0,0,2021-05-29,Female,50,45-54,17
22,0,0,0,0,2021-05-29,Female,55,55-64,13
22,0,0,0,0,2021-05-29,Female,24,20-24,13
22,0,0,0,0,2021-05-30,Male,66,65-69,2
22,1,0,0,1,2021-06-02,Female,33,25-34,1
22,4,2,0,6,2021-05-27,Male,23,20-24,6
22,0,27,0,27,2021-05-26,Female,21,20-24,2
22,0,0,0,0,2021-05-26,Female,22,20-24,17
22,2,17,11,30,2021-05-28,Female,18,15-19,14
22,0,0,0,0,2021-05-27,Female,20,20-24,2
22,1,0,0,1,2021-06-03,Male,68,65-69,1
22,0,0,0,0,2021-05-27,Female,77,75-79,2
22,3,1,0,4,2021-05-31,Female,18,15-19,13
22,2,0,0,2,2021-05-27,Female,70,70-74,12
22,1,3,0,4,2021-05-27,Male,70,70-74,2
22,0,0,0,0,2021-05-28,Male,39,35-44,2
22,1,1,0,2,2021-05-27,Male,78,75-79,2
22,0,10,0,10,2021-06-02,Male,57,55-64,1
22,0,2,0,2,2021-05-31,Female,68,65-69,14
22,1,2,0,3,2021-05-30,Male,62,55-64,2
22,0,0,0,0,2021-05-29,Female,54,45-54,19
22,1,0,0,1,2021-05-27,Male,75,75-79,13
22,0,0,0,0,2021-05-31,Female,66,65-69,2
22,0,0,0,0,2021-05-28,Male,39,35-44,19
22,0,3,0,3,2021-06-02,Male,36,35-44,16
22,0,0,0,0,2021-05-30,Female,16,15-19,17
22,3,0,0,3,2021-06-01,Female,0,<1,13
22,0,0,0,0,2021-05-31,Female,66,65-69,17
22,0,0,0,0,2021-05-30,Female,66,65-69,16
22,2,0,0,2,2021-06-01,Male,43,35-44,7
22,0,1,0,1,2021-05-31,Female,39,35-44,2
22,0,2,0,2,2021-05-27,Female,81,80-84,2
22,0,0,0,0,2021-05-27,Female,69,65-69,2
22,4,0,0,4,2021-05-27,Male,33,25-34,10
22,1,0,0,1,2021-05-29,Male,53,45-54,13
22,0,0,0,0,2021-06-02,Female,65,65-69,1
22,1,6,0,7,2021-06-01,Female,67,65-69,2
22,0,2,0,2,2021-05-30,Male,53,45-54,21
22,0,2,0,2,2021-05-29,Female,53,45-54,2
22,0,0,3,3,2021-06-03,Male,18,15-19,1
22,1,0,0,1,2021-06-02,Female,25,25-34,1
22,0,2,0,2,2021-05-28,Female,31,25-34,18
22,1,0,0,1,2021-05-31,Male,57,55-64,16
22,1,0,1,2,2021-06-02,Female,33,25-34,1
22,1,5,0,6,2021-05-30,Male,66,65-69,16
22,2,4,0,6,2021-05-31,Male,67,65-69,19
22,0,0,0,0,2021-06-02,Female,59,55-64,9
22,1,0,0,1,2021-06-01,Female,76,75-79,14
22,1,0,0,1,2021-06-02,Male,29,25-34,1
22,2,2,0,4,2021-05-29,Female,9,5-9,18
22,1,0,0,1,2021-06-03,Male,77,75-79,1
22,2,0,0,2,2021-05-31,Male,63,55-64,9
22,0,0,4,4,2021-06-02,Female,24,20-24,1
22,0,2,0,2,2021-05-29,Male,22,20-24,7
22,1,7,0,8,2021-06-03,Female,15,15-19,1
22,1,4,0,5,2021-05-28,Female,18,15-19,2
22,0,0,0,0,2021-05-30,Male,68,65-69,2
22,0,0,0,0,2021-05-27,Male,27,25-34,2
22,2,2,0,4,2021-06-03,Female,68,65-69,2
22,1,0,0,1,2021-06-02,Female,31,25-34,1
22,0,1,0,1,2021-05-29,Female,71,70-74,9
22,0,1,0,1,2021-06-02,Female,59,55-64,1
22,0,1,0,1,2021-05-27,Female,69,65-69,19
22,0,0,0,0,2021-06-02,Male,24,20-24,2
22,2,0,0,2,2021-05-27,Male,73,70-74,18
22,1,1,0,2,2021-05-31,Male,62,55-64,12
22,4,2,0,6,2021-05-30,Female,9,5-9,11
22,1,0,0,1,2021-06-02,Male,69,65-69,4
22,2,0,0,2,2021-05-29,Male,7,5-9,8
22,0,1,0,1,2021-06-02,Male,63,55-64,16
22,1,0,0,1,2021-05-29,Female,51,45-54,2
22,0,0,0,0,2021-06-02,Male,14,10-14,1
22,0,0,0,0,2021-06-01,Female,29,25-34,9
22,0,7,0,7,2021-06-02,Male,45,45-54,18
22,1,0,0,1,2021-05-30,Male,55,55-64,16
22,0,0,0,0,2021-06-03,Male,17,15-19,20
22,0,0,0,0,2021-05-30,Male,56,55-64,2
22,1,0,0,1,2021-05-28,Female,69,65-69,16
22,1,0,0,1,2021-05-27,Female,81,80-84,2
22,0,0,0,0,2021-06-02,Female,37,35-44,1
22,1,14,0,15,2021-06-02,Female,59,55-64,1
22,2,0,0,2,2021-05-30,Female,63,55-64,15
22,2,3,0,5,2021-05-30,Female,65,65-69,2
22,0,0,0,0,2021-05-27,Male,26,25-34,2
22,2,0,0,2,2021-05-31,Female,74,70-74,11
22,1,0,0,1,2021-05-30,Female,68,65-69,19
22,0,0,0,0,2021-05-29,Male,42,35-44,2
22,3,1,0,4,2021-05-30,Female,65,65-69,2
22,1,0,0,1,2021-05-29,Male,55,55-64,22
22,1,0,0,1,2021-05-30,Female,62,55-64,21
22,0,0,0,0,2021-05-31,Male,67,65-69,16
22,2,0,0,2,2021-05-30,Female,62,55-64,21
22,2,0,4,6,2021-05-31,Female,18,15-19,1
22,0,0,0,0,2021-05-31,Male,53,45-54,21
22,1,4,0,5,2021-05-27,Male,69,65-69,2
22,0,0,0,0,2021-05-31,Female,66,65-69,20
22,0,0,0,0,2021-06-02,Male,44,35-44,3
22,4,0,0,4,2021-05-31,Female,46,45-54,12
22,0,0,0,0,2021-05-30,Male,66,65-69,19
22,1,0,0,1,2021-05-30,Female,60,55-64,18
22,0,0,0,0,2021-05-30,Female,68,65-69,17
22,1,4,0,5,2021-05-30,Female,65,65-69,2
22,3,0,0,3,2021-05-31,Female,12,10-14,17
22,2,0,0,2,2021-05-29,Male,13,10-14,16
22,1,2,0,3,2021-05-30,Female,63,55-64,20
22,2,6,0,8,2021-05-30,Male,51,45-54,4
22,0,10,0,10,2021-05-31,Female,52,45-54,20
22,1,1,0,2,2021-05-27,Male,85,85+,2
22,0,1,0,1,2021-06-01,Female,66,65-69,18
22,1,1,0,2,2021-06-02,Male,27,25-34,1
22,2,0,0,2,2021-05-30,Female,53,45-54,18
22,2,1,0,3,2021-05-31,Female,48,45-54,19
22,1,0,0,1,2021-05-30,Male,67,65-69,18
22,0,0,0,0,2021-05-30,Female,67,65-69,7
22,2,0,0,2,2021-05-28,Male,8,5-9,2
22,0,0,0,0,2021-05-27,Female,31,25-34,9
22,2,0,0,2,2021-06-02,Male,22,20-24,14
22,1,0,0,1,2021-05-27,Male,72,70-74,17
22,2,0,0,2,2021-05-30,Female,68,65-69,16
22,0,3,0,3,2021-06-02,Female,64,55-64,12
22,1,6,0,7,2021-05-27,Male,70,70-74,13
22,2,1,0,3,2021-05-31,Male,23,20-24,19
22,1,0,0,1,2021-05-31,Female,67,65-69,14
22,1,2,0,3,2021-05-30,Male,58,55-64,21
22,0,0,0,0,2021-06-01,Male,52,45-54,4
22,1,0,0,1,2021-05-30,Male,66,65-69,2
22,0,0,0,0,2021-05-29,Male,50,45-54,2
22,1,0,0,1,2021-05-31,Male,67,65-69,16
22,0,3,0,3,2021-05-27,Female,71,70-74,2
22,0,0,0,0,2021-05-29,Male,17,15-19,17
22,3,1,0,4,2021-06-03,Male,8,5-9,1
22,3,0,0,3,2021-05-30,Male,1,1-4,18
22,1,0,0,1,2021-05-30,Male,63,55-64,2
22,0,0,0,0,2021-05-30,Female,51,45-54,2
22,0,1,0,1,2021-05-30,Female,65,65-69,2
22,1,0,0,1,2021-06-01,Female,59,55-64,10
22,1,0,0,1,2021-05-30,Female,63,55-64,2
22,1,0,0,1,2021-05-31,Male,23,20-24,18
22,0,0,0,0,2021-05-29,Male,50,45-54,17
22,4,0,0,4,2021-05-29,Female,18,15-19,2
22,0,0,0,0,2021-06-01,Male,70,70-74,8
22,1,0,0,1,2021-05-31,Female,67,65-69,2
22,0,1,0,1,2021-06-02,Female,21,20-24,6
22,2,2,0,4,2021-05-27,Female,26,25-34,21
22,3,0,0,3,2021-05-31,Male,30,25-34,20
22,2,2,0,4,2021-05-29,Female,11,10-14,17
22,1,0,0,1,2021-05-27,Female,70,70-74,19
22,1,0,0,1,2021-05-30,Male,67,65-69,14
22,0,3,0,3,2021-05-30,Male,67,65-69,18
22,0,0,0,0,2021-05-30,Female,49,45-54,12
22,2,0,0,2,2021-05-31,Male,11,10-14,2
22,1,0,0,1,2021-05-31,Female,68,65-69,14
22,2,0,0,2,2021-05-31,Female,9,5-9,19
22,0,0,0,0,2021-05-29,Female,50,45-54,14
22,2,0,0,2,2021-05-29,Male,42,35-44,18
22,0,8,6,14,2021-05-31,Female,77,75-79,12
22,1,0,0,1,2021-05-27,Female,72,70-74,2
22,2,2,0,4,2021-05-28,Male,0,<1,2
22,0,0,0,0,2021-06-02,Male,41,35-44,13
22,1,0,0,1,2021-05-30,Female,62,55-64,14
22,0,2,0,2,2021-05-30,Female,61,55-64,2
22,0,2,0,2,2021-05-30,Female,54,45-54,2
22,1,0,0,1,2021-05-29,Male,55,55-64,10
22,1,0,0,1,2021-05-31,Male,68,65-69,19
22,6,0,0,6,2021-06-02,Female,20,20-24,2
22,0,0,0,0,2021-05-31,Male,65,65-69,2
22,3,1,0,4,2021-05-27,Female,2,1-4,3
22,2,0,0,2,2021-05-31,Female,3,1-4,2
22,0,0,0,0,2021-06-02,Male,32,25-34,1
22,4,0,0,4,2021-05-27,Male,77,75-79,3
22,0,0,0,0,2021-05-27,Male,24,20-24,3
22,1,0,0,1,2021-05-29,Male,30,25-34,4
22,1,0,0,1,2021-05-31,Female,73,70-74,2
22,4,0,0,4,2021-05-30,Female,4,1-4,5
22,1,0,0,1,2021-05-31,Female,51,45-54,2
22,1,0,0,1,2021-05-30,Male,56,55-64,2
22,1,4,4,9,2021-05-29,Female,52,45-54,2
22,2,0,0,2,2021-05-28,Female,4,1-4,17
22,3,0,0,3,2021-05-28,Female,26,25-34,16
22,0,0,0,0,2021-06-02,Male,57,55-64,1
22,2,0,0,2,2021-05-31,Male,52,45-54,17
22,1,0,0,1,2021-05-30,Female,69,65-69,14
22,0,0,0,0,2021-05-30,Male,66,65-69,2
22,0,0,0,0,2021-05-29,Male,43,35-44,2
22,2,2,0,4,2021-05-30,Male,61,55-64,18
22,0,6,0,6,2021-05-29,Male,51,45-54,2
22,1,0,0,1,2021-05-30,Female,65,65-69,2
22,0,0,0,0,2021-06-03,Male,1,1-4,1
22,2,4,0,6,2021-05-31,Female,62,55-64,17
22,0,1,0,1,2021-05-29,Male,52,45-54,13
22,0,0,0,0,2021-06-02,Male,63,55-64,4
22,1,1,0,2,2021-06-02,Female,65,65-69,2
22,1,2,0,3,2021-05-31,Male,66,65-69,20
22,3,18,0,21,2021-06-02,Male,4,1-4,2
22,1,0,0,1,2021-05-31,Female,40,35-44,16
22,0,16,0,16,2021-05-29,Male,50,45-54,2
22,1,9,0,10,2021-06-01,Male,46,45-54,2
22,3,0,0,3,2021-05-30,Male,53,45-54,21
22,0,2,0,2,2021-05-31,Male,57,55-64,2
22,0,0,0,0,2021-05-29,Male,51,45-54,16
22,1,0,0,1,2021-05-29,Female,27,25-34,7
22,0,0,0,0,2021-05-30,Female,62,55-64,2
22,1,10,0,11,2021-05-30,Male,54,45-54,17
22,1,0,0,1,2021-05-30,Male,68,65-69,2
22,0,3,0,3,2021-06-01,Female,61,55-64,16
22,1,0,0,1,2021-06-03,Female,70,70-74,2
22,1,1,0,2,2021-05-30,Female,16,15-19,12
22,1,1,0,2,2021-05-30,Female,54,45-54,21
22,0,0,0,0,2021-05-27,Female,76,75-79,2
22,1,0,0,1,2021-05-27,Male,32,25-34,18
22,0,0,0,0,2021-06-02,Female,49,45-54,17
22,4,0,0,4,2021-06-02,Female,42,35-44,11
22,0,6,0,6,2021-06-02,Male,43,35-44,1
22,0,0,0,0,2021-05-31,Male,66,65-69,14
22,1,0,0,1,2021-05-30,Male,67,65-69,19
22,3,0,0,3,2021-06-03,Male,17,15-19,1
22,0,0,0,0,2021-05-29,Male,41,35-44,19
22,0,0,0,0,2021-05-30,Male,59,55-64,18
22,0,0,0,0,2021-05-29,Male,42,35-44,22
22,0,0,0,0,2021-05-30,Male,67,65-69,21
22,3,0,1,4,2021-05-27,Female,30,25-34,2
22,0,2,0,2,2021-05-30,Male,34,25-34,9
22,2,0,0,2,2021-05-31,Female,1,1-4,3
22,1,0,0,1,2021-05-30,Male,63,55-64,17
22,0,0,0,0,2021-05-27,Female,69,65-69,18
22,0,0,1,1,2021-06-02,Male,27,25-34,1
22,2,0,0,2,2021-05-31,Male,51,45-54,12
22,0,0,0,0,2021-06-02,Male,18,15-19,1
22,0,0,0,0,2021-06-03,Male,49,45-54,1
22,4,0,0,4,2021-05-29,Male,1,1-4,19
22,4,1,0,5,2021-05-31,Female,50,45-54,2
22,0,0,0,0,2021-05-29,Male,55,55-64,16
22,1,2,0,3,2021-05-31,Male,58,55-64,20
22,1,1,0,2,2021-05-29,Male,48,45-54,17
22,3,0,0,3,2021-05-27,Male,12,10-14,8
22,0,1,0,1,2021-06-02,Female,35,35-44,16
22,0,0,0,0,2021-06-02,Male,34,25-34,1
22,0,1,0,1,2021-05-31,Female,47,45-54,2
22,1,2,0,3,2021-05-30,Male,62,55-64,9
22,0,1,0,1,2021-05-27,Female,26,25-34,2
22,1,2,0,3,2021-05-30,Male,62,55-64,21
22,0,3,0,3,2021-05-30,Female,67,65-69,22
22,2,0,0,2,2021-05-30,Male,58,55-64,9
22,3,18,0,21,2021-05-29,Male,11,10-14,20
22,3,0,0,3,2021-05-29,Female,39,35-44,17
22,1,32,0,33,2021-06-03,Female,37,35-44,1
22,0,0,0,0,2021-05-31,Male,65,65-69,2
22,2,0,1,3,2021-05-27,Male,78,75-79,16
22,1,0,0,1,2021-05-29,Female,38,35-44,18
22,0,0,0,0,2021-06-03,Male,22,20-24,1
22,0,0,0,0,2021-05-29,Male,49,45-54,2
22,0,0,0,0,2021-05-30,Female,57,55-64,2
22,0,0,0,0,2021-05-28,Male,34,25-34,2
22,0,2,0,2,2021-05-29,Male,47,45-54,18
22,1,0,0,1,2021-05-27,Male,70,70-74,2
22,0,0,0,0,2021-06-03,Male,34,25-34,1
22,1,0,0,1,2021-05-26,Female,18,15-19,2
22,1,0,0,1,2021-05-30,Male,67,65-69,17
22,4,0,0,4,2021-05-30,Female,19,15-19,12
22,2,1,0,3,2021-05-31,Female,3,1-4,2
22,2,0,0,2,2021-05-31,Female,66,65-69,16
22,1,0,0,1,2021-05-31,Male,68,65-69,2
22,0,0,0,0,2021-05-31,Male,27,25-34,18
22,0,0,0,0,2021-05-27,Female,72,70-74,2
22,3,0,0,3,2021-05-27,Male,4,1-4,3
22,1,0,0,1,2021-05-27,Male,69,65-69,2
22,0,3,0,3,2021-05-27,Male,34,25-34,2
22,3,0,2,5,2021-05-31,Female,18,15-19,2
22,0,1,0,1,2021-05-30,Male,52,45-54,19
22,1,0,0,1,2021-05-27,Male,75,75-79,2
22,2,0,0,2,2021-05-29,Male,21,20-24,15
22,0,3,1,4,2021-05-28,Female,38,35-44,2
22,0,11,1,12,2021-05-31,Female,56,55-64,2
22,0,0,0,0,2021-05-31,Female,56,55-64,2
22,0,0,0,0,2021-05-28,Male,29,25-34,8
22,4,6,0,10,2021-05-28,Female,1,1-4,13
22,1,1,0,2,2021-05-30,Female,55,55-64,2
22,2,0,0,2,2021-05-29,Female,12,10-14,15
22,0,0,0,0,2021-05-30,Male,62,55-64,17
22,0,0,0,0,2021-05-28,Female,31,25-34,8
22,2,0,0,2,2021-05-31,Male,10,10-14,21
22,1,0,0,1,2021-05-27,Male,71,70-74,6
22,3,0,0,3,2021-05-30,Male,15,15-19,2
22,0,0,0,0,2021-06-02,Male,31,25-34,1
22,2,0,0,2,2021-05-30,Female,63,55-64,18
22,0,0,0,0,2021-05-27,Female,79,75-79,5
22,1,0,0,1,2021-05-31,Male,45,45-54,13
22,0,0,0,0,2021-05-30,Female,64,55-64,22
22,1,0,0,1,2021-06-02,Female,74,70-74,20
22,0,0,0,0,2021-06-02,Male,40,35-44,1
22,1,1,0,2,2021-06-02,Male,5,5-9,1
22,0,1,0,1,2021-05-31,Male,54,45-54,14
22,1,2,0,3,2021-05-30,Female,65,65-69,2
22,3,0,0,3,2021-05-27,Female,11,10-14,2
22,0,3,0,3,2021-05-29,Female,50,45-54,2
22,0,2,0,2,2021-05-28,Male,72,70-74,12
22,1,0,0,1,2021-05-27,Male,28,25-34,2
22,0,1,0,1,2021-05-29,Female,54,45-54,3
22,1,1,0,2,2021-05-27,Female,34,25-34,15
22,2,0,0,2,2021-05-28,Male,9,5-9,14
22,1,0,0,1,2021-06-02,Male,30,25-34,2
22,2,0,0,2,2021-05-29,Female,11,10-14,18
22,1,0,0,1,2021-05-29,Female,51,45-54,18
22,2,0,0,2,2021-05-30,Male,57,55-64,18
22,0,0,0,0,2021-05-29,Male,51,45-54,4
22,0,1,0,1,2021-05-29,Female,43,35-44,9
22,0,0,0,0,2021-05-30,Female,62,55-64,14
22,0,0,0,0,2021-05-30,Female,59,55-64,17
22,1,0,0,1,2021-05-31,Male,57,55-64,14
22,2,0,0,2,2021-05-31,Male,66,65-69,21
22,1,1,0,2,2021-06-02,Female,54,45-54,10
22,4,3,0,7,2021-05-30,Female,6,5-9,12
22,3,0,0,3,2021-05-28,Female,3,1-4,2
22,0,0,0,0,2021-05-28,Female,36,35-44,7
22,2,0,0,2,2021-05-28,Male,71,70-74,12
22,1,2,0,3,2021-06-01,Male,61,55-64,21
22,1,0,0,1,2021-05-30,Male,66,65-69,21
22,1,0,0,1,2021-05-30,Female,56,55-64,13
22,0,0,0,0,2021-05-30,Male,60,55-64,2
22,2,0,0,2,2021-06-02,Female,8,5-9,3
22,1,1,0,2,2021-06-01,Female,53,45-54,7
22,1,0,0,1,2021-05-30,Female,59,55-64,20
22,0,0,0,0,2021-05-29,Male,54,45-54,2
22,2,0,0,2,2021-05-27,Male,73,70-74,17
22,0,0,0,0,2021-05-31,Female,67,65-69,2
22,2,0,0,2,2021-06-02,Male,48,45-54,1
22,2,0,0,2,2021-05-31,Female,2,1-4,2
22,1,0,0,1,2021-06-02,Female,30,25-34,2
22,0,0,0,0,2021-05-29,Male,34,25-34,16
22,0,0,0,0,2021-05-28,Female,37,35-44,15
22,1,0,0,1,2021-05-31,Male,63,55-64,13
22,1,0,0,1,2021-05-31,Female,47,45-54,13
22,4,0,0,4,2021-06-02,Female,22,20-24,13
22,0,0,0,0,2021-05-30,Male,63,55-64,17
22,0,0,0,0,2021-06-01,Male,38,35-44,11
22,0,0,0,0,2021-05-26,Female,21,20-24,2
22,0,0,0,0,2021-05-28,Female,69,65-69,17
22,2,0,0,2,2021-05-30,Female,66,65-69,17
22,1,0,0,1,2021-06-01,Male,54,45-54,19
22,0,0,0,0,2021-06-02,Male,32,25-34,1
22,0,3,0,3,2021-05-28,Female,35,35-44,14
22,0,0,0,0,2021-05-30,Male,56,55-64,19
22,1,0,0,1,2021-05-30,Male,63,55-64,2
22,0,5,0,5,2021-06-01,Female,56,55-64,20
22,0,0,0,0,2021-06-02,Female,27,25-34,1
22,0,1,0,1,2021-05-30,Female,67,65-69,21
22,1,0,0,1,2021-06-02,Female,10,10-14,2
22,3,0,0,3,2021-05-30,Female,19,15-19,2
22,1,0,0,1,2021-05-30,Male,42,35-44,13
22,1,1,0,2,2021-05-27,Male,72,70-74,16
22,1,0,0,1,2021-05-31,Female,53,45-54,11
22,1,3,0,4,2021-05-31,Male,67,65-69,16
22,1,0,0,1,2021-05-27,Female,24,20-24,8
22,1,0,0,1,2021-05-27,Female,73,70-74,14
22,0,0,0,0,2021-05-27,Male,31,25-34,15
22,0,0,0,0,2021-05-26,Female,50,45-54,2
22,0,0,0,0,2021-05-27,Male,72,70-74,17
22,3,3,0,6,2021-05-31,Male,9,5-9,2
22,1,0,0,1,2021-05-31,Female,56,55-64,10
22,2,0,0,2,2021-05-27,Female,70,70-74,18
22,0,0,0,0,2021-05-27,Female,71,70-74,17
22,0,0,0,0,2021-05-27,Male,32,25-34,2
22,0,5,0,5,2021-05-30,Female,60,55-64,2
22,0,4,0,4,2021-05-30,Male,67,65-69,22
22,2,0,0,2,2021-05-28,Male,1,1-4,2
22,0,0,0,0,2021-05-27,Female,26,25-34,17
22,1,0,0,1,2021-05-30,Female,26,25-34,13
22,0,1,0,1,2021-06-03,Female,74,70-74,15
22,1,0,0,1,2021-05-28,Male,81,80-84,17
22,0,0,0,0,2021-05-31,Male,61,55-64,16
22,1,5,0,6,2021-05-29,Female,53,45-54,19
22,0,2,0,2,2021-06-01,Female,67,65-69,7
22,0,1,0,1,2021-05-31,Female,58,55-64,2
22,1,1,0,2,2021-05-30,Male,63,55-64,20
22,3,0,0,3,2021-05-27,Male,19,15-19,2
22,1,0,0,1,2021-05-30,Female,67,65-69,2
22,0,0,0,0,2021-05-28,Male,37,35-44,21
22,0,1,0,1,2021-05-31,Female,68,65-69,14
22,1,0,0,1,2021-05-31,Female,68,65-69,2
22,1,0,5,6,2021-05-28,Female,28,25-34,20
22,0,0,0,0,2021-05-27,Male,27,25-34,3
22,0,0,0,0,2021-05-29,Male,54,45-54,18
22,3,0,0,3,2021-05-27,Male,2,1-4,4
22,2,0,0,2,2021-05-28,Male,2,1-4,2
22,2,0,0,2,2021-05-28,Male,9,5-9,3
22,0,0,0,0,2021-06-02,Female,54,45-54,1
22,1,0,0,1,2021-05-30,Female,64,55-64,2
22,2,0,0,2,2021-05-28,Male,17,15-19,13
22,1,4,0,5,2021-06-02,Male,71,70-74,1
22,1,0,0,1,2021-05-28,Male,35,35-44,21
22,3,6,0,9,2021-05-30,Male,64,55-64,2
22,0,1,0,1,2021-05-28,Female,35,35-44,4
22,0,0,0,0,2021-05-27,Female,72,70-74,20
22,1,0,0,1,2021-05-31,Female,54,45-54,2
22,3,4,0,7,2021-05-29,Male,41,35-44,19
22,0,0,0,0,2021-06-01,Female,63,55-64,9
22,2,0,0,2,2021-05-28,Male,21,20-24,2
22,1,2,0,3,2021-05-27,Female,25,25-34,18
22,0,0,0,0,2021-05-29,Male,15,15-19,2
22,1,11,0,12,2021-05-31,Female,35,35-44,13
22,1,0,0,1,2021-05-28,Male,32,25-34,17
22,0,0,0,0,2021-05-31,Female,43,35-44,19
22,2,0,0,2,2021-05-29,Female,72,70-74,15
22,0,1,0,1,2021-06-01,Male,59,55-64,16
22,1,1,0,2,2021-06-01,Female,54,45-54,2
22,1,2,0,3,2021-06-03,Male,55,55-64,17
22,3,0,0,3,2021-05-31,Female,36,35-44,21
22,1,0,0,1,2021-05-30,Female,59,55-64,20
22,0,0,0,0,2021-05-27,Female,8,5-9,3
22,1,2,0,3,2021-05-27,Male,70,70-74,14
22,1,0,0,1,2021-05-30,Male,67,65-69,20
22,0,3,0,3,2021-05-31,Male,43,35-44,2
22,2,0,0,2,2021-05-28,Male,5,5-9,2
22,0,0,0,0,2021-05-31,Male,60,55-64,2
22,3,0,0,3,2021-05-29,Male,49,45-54,13
22,0,0,0,0,2021-06-02,Female,58,55-64,18
22,0,0,0,0,2021-05-27,Male,76,75-79,16
22,0,0,0,0,2021-05-30,Female,48,45-54,2
22,0,0,0,0,2021-05-29,Male,52,45-54,20
22,1,1,0,2,2021-05-27,Female,76,75-79,14
22,3,0,0,3,2021-06-02,Male,34,25-34,2
22,2,0,0,2,2021-06-02,Male,5,5-9,2
22,0,0,0,0,2021-05-27,Male,25,25-34,11
22,3,0,0,3,2021-06-01,Female,4,1-4,2
22,1,0,0,1,2021-05-30,Female,64,55-64,13
22,0,0,0,0,2021-06-01,Male,15,15-19,12
22,1,0,0,1,2021-06-03,Female,43,35-44,1
22,1,11,0,12,2021-06-02,Male,27,25-34,1
22,0,0,0,0,2021-05-31,Male,48,45-54,6
22,0,4,0,4,2021-06-02,Male,40,35-44,1
22,3,0,0,3,2021-05-29,Female,16,15-19,15
22,0,3,0,3,2021-05-27,Male,75,75-79,16
22,2,0,0,2,2021-05-30,Male,15,15-19,2
22,0,0,0,0,2021-05-27,Male,36,35-44,9
22,0,0,0,0,2021-06-03,Female,28,25-34,1
22,0,0,0,0,2021-05-28,Male,36,35-44,8
22,0,2,0,2,2021-05-27,Male,74,70-74,7
22,0,1,0,1,2021-05-30,Female,66,65-69,21
22,2,2,0,4,2021-05-28,Female,17,15-19,11
22,0,1,0,1,2021-05-30,Female,54,45-54,17
22,1,0,0,1,2021-05-29,Female,46,45-54,19
22,1,1,0,2,2021-05-30,Female,48,45-54,2
22,1,1,0,2,2021-05-26,Female,21,20-24,2
22,1,0,0,1,2021-06-02,Female,33,25-34,1
22,0,0,0,0,2021-05-29,Male,54,45-54,17
22,5,0,0,5,2021-05-30,Male,17,15-19,10
22,0,0,0,0,2021-05-27,Male,71,70-74,2
22,0,0,0,0,2021-06-01,Female,63,55-64,19
22,2,3,0,5,2021-05-27,Male,74,70-74,15
22,1,0,0,1,2021-05-27,Female,71,70-74,21
22,1,1,0,2,2021-05-29,Female,54,45-54,9
22,2,0,0,2,2021-05-31,Male,12,10-14,2
22,1,0,0,1,2021-06-02,Female,33,25-34,1
22,1,0,0,1,2021-05-31,Male,74,70-74,14
22,3,1,0,4,2021-05-30,Male,61,55-64,2
22,0,0,0,0,2021-05-27,Male,27,25-34,20
22,1,0,0,1,2021-05-27,Female,78,75-79,8
22,1,0,0,1,2021-05-27,Male,28,25-34,22
22,1,0,0,1,2021-05-31,Female,31,25-34,16
22,0,0,0,0,2021-05-30,Female,65,65-69,16
22,2,0,0,2,2021-05-29,Male,42,35-44,19
22,2,0,0,2,2021-06-02,Female,4,1-4,3
22,0,0,0,0,2021-05-27,Male,71,70-74,20
22,2,1,0,3,2021-06-02,Male,52,45-54,2
22,1,0,0,1,2021-06-01,Male,40,35-44,9
22,0,0,0,0,2021-05-30,Female,69,65-69,22
22,1,2,0,3,2021-05-30,Male,67,65-69,2
22,0,1,0,1,2021-06-01,Female,63,55-64,19
22,1,1,1,3,2021-05-27,Female,80,80-84,2
22,2,0,0,2,2021-05-27,Male,26,25-34,2
22,1,2,0,3,2021-05-27,Male,73,70-74,8
22,1,0,0,1,2021-06-03,Male,76,75-79,1
22,0,0,0,0,2021-05-30,Male,61,55-64,17
22,0,0,0,0,2021-06-01,Female,40,35-44,2
22,0,0,0,0,2021-05-29,Female,34,25-34,18
22,1,1,0,2,2021-05-27,Male,69,65-69,21
22,1,0,0,1,2021-06-02,Male,68,65-69,11
22,0,0,0,0,2021-05-29,Female,40,35-44,9
22,1,0,0,1,2021-05-31,Male,66,65-69,2
22,1,2,0,3,2021-05-27,Male,69,65-69,20
22,0,0,0,0,2021-05-29,Male,34,25-34,18
22,3,15,0,18,2021-05-29,Male,18,15-19,15
22,0,0,0,0,2021-06-02,Male,21,20-24,1
22,0,2,0,2,2021-05-30,Female,56,55-64,21
22,1,4,0,5,2021-05-27,Male,31,25-34,2
22,2,1,0,3,2021-05-29,Female,53,45-54,17
22,1,1,0,2,2021-05-30,Male,67,65-69,17
22,1,1,0,2,2021-05-30,Female,67,65-69,2
22,1,0,0,1,2021-05-31,Male,56,55-64,16
22,3,0,0,3,2021-05-31,Male,6,5-9,16
22,1,1,0,2,2021-06-02,Male,43,35-44,1
22,1,0,0,1,2021-05-29,Male,42,35-44,15
22,3,0,0,3,2021-06-02,Female,23,20-24,1
22,1,0,1,2,2021-06-02,Male,38,35-44,1
22,0,0,0,0,2021-05-31,Female,54,45-54,14
22,1,1,0,2,2021-05-27,Male,72,70-74,2
22,0,0,0,0,2021-06-01,Female,55,55-64,14
22,0,0,0,0,2021-05-30,Female,60,55-64,22
22,3,0,0,3,2021-05-30,Female,2,1-4,18
22,1,0,0,1,2021-05-31,Female,60,55-64,16
22,3,1,0,4,2021-05-29,Male,4,1-4,2
22,3,3,2,8,2021-05-31,Male,9,5-9,13
22,2,0,0,2,2021-06-03,Male,72,70-74,1
22,3,5,0,8,2021-06-02,Female,33,25-34,1
22,0,3,0,3,2021-06-02,Male,58,55-64,1
22,4,0,0,4,2021-05-30,Female,55,55-64,16
22,0,1,0,1,2021-05-30,Male,66,65-69,2
22,2,0,0,2,2021-05-30,Female,56,55-64,18
22,1,1,0,2,2021-06-02,Male,59,55-64,1
22,0,0,0,0,2021-05-27,Female,21,20-24,2
22,1,1,0,2,2021-05-31,Female,60,55-64,21
22,0,0,0,0,2021-05-29,Female,41,35-44,2
22,4,1,0,5,2021-05-29,Male,19,15-19,2
22,0,1,0,1,2021-05-27,Male,70,70-74,21
22,3,0,0,3,2021-05-29,Male,48,45-54,13
22,0,1,0,1,2021-05-30,Female,55,55-64,17
22,2,0,0,2,2021-05-27,Male,33,25-34,6
22,1,0,0,1,2021-05-31,Male,61,55-64,14
22,1,30,65,96,2021-06-03,Female,67,65-69,1
22,2,0,0,2,2021-05-29,Male,1,1-4,2
22,2,0,0,2,2021-06-01,Male,1,1-4,2
22,1,0,0,1,2021-05-29,Female,52,45-54,20
22,1,0,0,1,2021-06-03,Male,65,65-69,1
22,2,0,0,2,2021-05-30,Female,13,10-14,2
22,1,0,0,1,2021-05-27,Male,69,65-69,16
22,1,3,0,4,2021-05-28,Male,16,15-19,2
22,2,6,0,8,2021-05-27,Male,72,70-74,17
22,0,0,0,0,2021-05-30,Female,62,55-64,2
22,1,0,0,1,2021-05-30,Male,67,65-69,2
22,2,1,0,3,2021-05-27,Male,78,75-79,16
22,0,1,0,1,2021-05-30,Female,67,65-69,2
22,2,0,0,2,2021-05-31,Male,11,10-14,2
22,4,0,0,4,2021-06-01,Male,53,45-54,2
22,3,0,0,3,2021-05-31,Male,11,10-14,8
22,2,1,0,3,2021-06-02,Female,67,65-69,12
22,0,2,0,2,2021-05-30,Female,62,55-64,2
22,2,0,0,2,2021-05-29,Male,52,45-54,15
22,0,3,0,3,2021-05-30,Male,56,55-64,2
22,1,1,0,2,2021-05-27,Male,70,70-74,18
22,1,3,0,4,2021-06-03,Male,81,80-84,1
22,2,0,0,2,2021-05-31,Male,10,10-14,2
22,0,0,0,0,2021-05-30,Male,52,45-54,18
22,3,0,0,3,2021-05-30,Female,15,15-19,18
22,1,3,0,4,2021-05-28,Female,40,35-44,2
22,0,0,0,0,2021-05-27,Female,70,70-74,2
22,1,0,0,1,2021-05-30,Female,65,65-69,21
22,5,0,0,5,2021-05-29,Female,52,45-54,14
22,3,0,0,3,2021-05-30,Female,12,10-14,8
22,0,0,0,0,2021-05-29,Female,43,35-44,2
22,4,1,0,5,2021-05-29,Male,10,10-14,9
22,0,1,0,1,2021-05-30,Male,58,55-64,14
22,1,0,0,1,2021-06-01,Female,28,25-34,7
22,0,0,0,0,2021-06-03,Female,27,25-34,1
22,2,17,30,49,2021-05-29,Male,13,10-14,2
22,1,1,0,2,2021-05-29,Female,52,45-54,2
22,1,0,5,6,2021-05-29,Female,48,45-54,13
22,0,1,0,1,2021-05-31,Female,59,55-64,8
22,0,0,0,0,2021-05-30,Male,60,55-64,15
22,0,0,0,0,2021-05-27,Female,56,55-64,19
22,0,0,0,0,2021-05-30,Male,64,55-64,18
22,1,0,0,1,2021-05-28,Female,36,35-44,2
22,0,0,0,0,2021-05-28,Male,37,35-44,17
22,2,0,0,2,2021-06-02,Male,4,1-4,1
22,2,30,0,32,2021-06-02,Female,48,45-54,1
22,3,0,0,3,2021-05-27,Female,2,1-4,13
22,1,10,0,11,2021-05-29,Male,18,15-19,9
22,2,0,0,2,2021-05-30,Male,64,55-64,16
22,2,0,0,2,2021-05-30,Male,51,45-54,13
22,0,0,0,0,2021-05-29,Male,74,70-74,14
22,2,1,0,3,2021-05-29,Female,52,45-54,15
22,0,2,0,2,2021-05-26,Male,18,15-19,2
22,1,0,0,1,2021-06-02,Male,41,35-44,2
22,1,6,0,7,2021-05-30,Male,62,55-64,2
22,2,0,0,2,2021-05-27,Female,74,70-74,13
22,2,0,0,2,2021-05-30,Male,13,10-14,13
22,2,0,0,2,2021-05-29,Female,18,15-19,2
22,1,2,0,3,2021-05-31,Female,15,15-19,18
22,0,3,0,3,2021-05-30,Male,62,55-64,18
22,1,6,0,7,2021-05-29,Female,55,55-64,14
22,2,0,0,2,2021-05-29,Male,17,15-19,9
22,1,1,0,2,2021-05-29,Male,51,45-54,9
22,3,0,0,3,2021-05-27,Male,31,25-34,2
22,0,5,0,5,2021-06-02,Female,41,35-44,1
22,0,0,0,0,2021-05-30,Male,54,45-54,13
22,1,0,0,1,2021-05-31,Male,52,45-54,8
22,1,0,0,1,2021-05-30,Male,64,55-64,2
22,1,0,0,1,2021-05-31,Male,54,45-54,17
22,2,0,0,2,2021-05-30,Female,65,65-69,20
22,1,2,0,3,2021-06-03,Male,29,25-34,1
22,1,1,0,2,2021-05-31,Male,70,70-74,2
22,3,0,0,3,2021-05-31,Female,3,1-4,2
22,0,0,0,0,2021-05-27,Male,79,75-79,12
22,1,0,0,1,2021-05-30,Male,62,55-64,19
22,0,0,0,0,2021-05-29,Male,42,35-44,2
22,0,1,0,1,2021-05-30,Male,63,55-64,2
22,4,1,0,5,2021-05-26,Male,15,15-19,11
22,0,2,0,2,2021-05-29,Male,53,45-54,17
22,1,0,0,1,2021-05-30,Female,61,55-64,2
22,1,0,0,1,2021-05-30,Female,51,45-54,15
22,3,15,0,18,2021-05-29,Male,5,5-9,2
22,0,0,0,0,2021-05-31,Female,61,55-64,18
22,3,0,0,3,2021-05-29,Male,13,10-14,21
22,0,0,0,0,2021-05-28,Female,27,25-34,9
22,0,30,0,30,2021-05-28,Male,41,35-44,15
22,0,0,0,0,2021-05-29,Male,40,35-44,2
22,2,0,0,2,2021-06-03,Female,60,55-64,7
22,1,1,2,4,2021-05-29,Female,50,45-54,2
22,2,0,0,2,2021-06-03,Female,68,65-69,10
22,3,0,0,3,2021-05-29,Female,7,5-9,2
22,3,0,0,3,2021-05-27,Female,2,1-4,7
22,0,0,0,0,2021-05-30,Male,68,65-69,2
22,1,0,0,1,2021-05-29,Male,39,35-44,2
22,4,3,0,7,2021-05-31,Female,3,1-4,2
22,0,0,0,0,2021-06-01,Female,39,35-44,2
22,0,0,0,0,2021-05-30,Female,66,65-69,20
22,0,0,0,0,2021-06-02,Female,39,35-44,1
22,0,0,0,0,2021-05-28,Male,38,35-44,18
22,2,1,0,3,2021-06-03,Female,4,1-4,1
22,1,0,0,1,2021-05-27,Male,56,55-64,3
22,1,1,0,2,2021-05-30,Female,64,55-64,15
22,0,1,0,1,2021-05-31,Female,66,65-69,7
22,0,0,0,0,2021-05-31,Female,68,65-69,21
22,0,0,0,0,2021-05-30,Male,61,55-64,2
22,1,3,0,4,2021-05-30,Male,59,55-64,2
22,0,0,0,0,2021-05-29,Female,44,35-44,13
22,0,1,0,1,2021-05-30,Male,65,65-69,2
22,1,1,0,2,2021-05-31,Female,40,35-44,16
22,1,0,0,1,2021-05-29,Male,46,45-54,2
22,0,1,0,1,2021-05-30,Female,68,65-69,19
22,5,15,25,45,2021-06-02,Female,10,10-14,1
22,1,0,0,1,2021-05-28,Female,38,35-44,12
22,0,0,0,0,2021-05-27,Female,9,5-9,8
22,0,0,0,0,2021-05-30,Female,47,45-54,11
22,1,0,0,1,2021-05-30,Female,52,45-54,21
22,0,0,0,0,2021-05-28,Female,24,20-24,19
22,3,0,0,3,2021-05-27,Female,23,20-24,2
22,1,1,0,2,2021-05-30,Female,17,15-19,17
22,0,0,0,0,2021-06-01,Female,44,35-44,17
22,1,0,0,1,2021-05-30,Male,67,65-69,13
22,2,0,0,2,2021-05-30,Female,63,55-64,19
22,0,3,0,3,2021-05-29,Female,51,45-54,15
22,1,2,0,3,2021-06-03,Male,78,75-79,1
22,1,0,0,1,2021-05-30,Male,61,55-64,2
22,0,1,0,1,2021-06-01,Male,43,35-44,6
22,0,0,0,0,2021-05-30,Female,67,65-69,19
22,1,0,0,1,2021-05-29,Female,73,70-74,16
22,1,0,0,1,2021-05-29,Male,36,35-44,13
22,0,0,0,0,2021-05-27,Male,26,25-34,2
22,2,16,0,18,2021-06-01,Female,5,5-9,4
22,1,0,0,1,2021-05-27,Male,79,75-79,17
22,4,1,0,5,2021-05-31,Female,11,10-14,2
22,2,0,0,2,2021-05-31,Female,11,10-14,17
22,1,3,0,4,2021-05-28,Male,31,25-34,2
22,0,0,0,0,2021-06-02,Female,53,45-54,15
22,2,2,0,4,2021-05-31,Male,69,65-69,19
22,1,0,0,1,2021-05-30,Female,56,55-64,19
22,2,0,0,2,2021-05-30,Female,61,55-64,13
22,0,0,0,0,2021-06-02,Male,54,45-54,1
22,1,0,0,1,2021-05-30,Female,62,55-64,17
22,1,0,0,1,2021-06-01,Male,68,65-69,16
22,0,4,0,4,2021-05-31,Male,49,45-54,2
22,1,0,0,1,2021-05-30,Female,47,45-54,2
22,1,0,0,1,2021-05-30,Male,64,55-64,22
22,1,0,0,1,2021-06-02,Male,65,65-69,1
22,0,0,0,0,2021-05-27,Female,30,25-34,2
22,2,1,0,3,2021-05-27,Male,73,70-74,19
22,1,1,0,2,2021-06-02,Female,31,25-34,1
22,1,0,0,1,2021-05-30,Female,65,65-69,18
22,2,0,0,2,2021-05-29,Male,54,45-54,17
22,0,2,0,2,2021-05-31,Female,67,65-69,17
22,1,1,0,2,2021-05-29,Male,47,45-54,2
22,1,0,0,1,2021-05-30,Male,66,65-69,2
22,0,0,0,0,2021-05-27,Male,12,10-14,7
22,0,0,0,0,2021-05-28,Female,38,35-44,6
22,0,0,0,0,2021-06-02,Male,46,45-54,2
22,0,1,0,1,2021-06-03,Female,72,70-74,19
22,2,1,0,3,2021-05-28,Female,72,70-74,18
22,0,0,0,0,2021-06-01,Female,66,65-69,10
22,3,4,0,7,2021-05-30,Female,59,55-64,18
22,0,0,0,0,2021-05-28,Female,34,25-34,17
22,2,0,0,2,2021-05-29,Female,2,1-4,13
22,1,0,0,1,2021-05-30,Female,51,45-54,15
22,0,0,0,0,2021-06-02,Male,57,55-64,1
22,0,1,0,1,2021-05-29,Female,41,35-44,21
22,0,0,0,0,2021-05-29,Female,53,45-54,2
22,0,0,0,0,2021-06-01,Male,22,20-24,21
22,0,0,0,0,2021-05-29,Male,55,55-64,21
22,0,0,0,0,2021-05-30,Female,44,35-44,1
22,0,0,0,0,2021-05-28,Male,53,45-54,15
22,0,1,0,1,2021-05-28,Female,37,35-44,20
22,3,0,0,3,2021-05-30,Female,5,5-9,18
22,2,6,1,9,2021-05-27,Female,85,85+,2
22,1,0,0,1,2021-05-30,Male,55,55-64,18
22,1,0,0,1,2021-05-30,Male,63,55-64,2
22,2,4,0,6,2021-05-31,Male,62,55-64,19
22,0,1,0,1,2021-06-03,Female,20,20-24,8
22,0,0,0,0,2021-05-28,Male,40,35-44,7
22,1,1,0,2,2021-05-31,Female,57,55-64,17
22,1,0,0,1,2021-05-31,Female,68,65-69,17
22,0,0,0,0,2021-05-28,Female,85,85+,10
22,0,0,0,0,2021-05-27,Female,71,70-74,20
22,1,4,0,5,2021-05-29,Male,74,70-74,22
22,2,0,0,2,2021-06-02,Female,29,25-34,1
22,3,20,0,23,2021-05-28,Male,12,10-14,9
22,0,6,0,6,2021-05-27,Male,73,70-74,19
22,1,0,0,1,2021-05-28,Female,40,35-44,7
22,1,0,0,1,2021-05-29,Male,54,45-54,2
22,0,0,0,0,2021-05-31,Female,37,35-44,12
22,0,0,0,0,2021-05-28,Female,38,35-44,19
22,2,0,0,2,2021-05-30,Male,58,55-64,2
22,1,0,0,1,2021-05-28,Female,28,25-34,2
22,2,0,0,2,2021-05-28,Female,12,10-14,13
22,1,1,0,2,2021-05-30,Male,67,65-69,15
22,1,1,0,2,2021-06-02,Female,40,35-44,1
22,1,0,0,1,2021-05-30,Female,61,55-64,19
22,0,2,0,2,2021-05-27,Male,33,25-34,2
22,1,2,0,3,2021-05-31,Female,66,65-69,15
22,1,0,1,2,2021-05-27,Male,32,25-34,2
22,1,0,0,1,2021-05-30,Male,67,65-69,17
22,1,0,0,1,2021-05-27,Male,29,25-34,2
22,1,2,0,3,2021-05-31,Male,71,70-74,10
22,0,0,0,0,2021-05-30,Female,51,45-54,16
22,3,3,0,6,2021-05-31,Female,12,10-14,9
22,2,2,0,4,2021-05-30,Female,51,45-54,11
22,2,4,0,6,2021-06-01,Male,52,45-54,2
22,0,2,0,2,2021-05-31,Female,66,65-69,2
22,1,0,0,1,2021-06-02,Female,67,65-69,2
22,1,1,0,2,2021-05-30,Male,66,65-69,21
22,1,2,0,3,2021-06-02,Female,29,25-34,16
22,0,0,0,0,2021-06-03,Male,32,25-34,16
22,1,0,0,1,2021-05-30,Female,65,65-69,2
22,0,0,0,0,2021-05-27,Female,71,70-74,2
22,1,0,0,1,2021-05-31,Female,14,10-14,15
22,0,0,0,0,2021-05-27,Female,25,25-34,14
22,1,0,0,1,2021-06-03,Male,78,75-79,1
22,3,0,0,3,2021-05-30,Female,65,65-69,21
22,2,0,0,2,2021-05-31,Female,67,65-69,19
22,0,0,0,0,2021-05-27,Female,75,75-79,20
22,0,40,0,40,2021-06-02,Male,60,55-64,1
22,2,2,0,4,2021-05-31,Female,14,10-14,2
22,0,0,0,0,2021-05-29,Female,45,45-54,14
22,2,0,0,2,2021-05-31,Male,61,55-64,17
22,3,0,0,3,2021-05-28,Male,0,<1,19
22,2,0,0,2,2021-05-28,Female,23,20-24,18
22,0,3,0,3,2021-06-01,Female,69,65-69,6
22,1,0,0,1,2021-05-30,Male,66,65-69,20
22,0,0,0,0,2021-06-02,Female,28,25-34,1
22,1,0,0,1,2021-06-03,Female,41,35-44,1
22,1,4,0,5,2021-05-30,Female,60,55-64,2
22,3,0,0,3,2021-05-31,Female,12,10-14,22
22,3,3,0,6,2021-05-27,Female,0,<1,2
22,0,2,0,2,2021-05-30,Female,66,65-69,16
22,3,15,0,18,2021-05-28,Female,14,10-14,2
22,1,0,0,1,2021-05-28,Male,54,45-54,17
22,0,0,0,0,2021-06-02,Female,27,25-34,1
22,0,0,0,0,2021-05-30,Male,45,45-54,2
22,0,1,0,1,2021-06-02,Male,9,5-9,1
22,0,0,0,0,2021-06-03,Male,43,35-44,1
22,2,0,0,2,2021-05-27,Male,0,<1,3
22,2,0,0,2,2021-05-29,Male,42,35-44,2
22,4,3,0,7,2021-06-03,Female,23,20-24,1
22,1,0,0,1,2021-05-27,Male,21,20-24,11
22,3,20,0,23,2021-05-29,Female,8,5-9,2
22,1,0,0,1,2021-05-30,Male,59,55-64,15
22,1,0,0,1,2021-05-30,Male,63,55-64,21
22,0,0,0,0,2021-05-27,Male,30,25-34,4
22,0,3,0,3,2021-06-03,Male,34,25-34,1
22,0,20,1,21,2021-05-26,Male,18,15-19,2
22,0,0,0,0,2021-05-28,Female,38,35-44,9
22,2,3,0,5,2021-05-26,Female,22,20-24,7
22,1,2,0,3,2021-05-30,Female,67,65-69,15
22,3,0,0,3,2021-05-30,Male,18,15-19,3
22,1,0,0,1,2021-05-31,Female,66,65-69,2
22,1,0,0,1,2021-06-02,Male,22,20-24,1
22,1,2,0,3,2021-06-01,Male,29,25-34,2
22,1,1,32,34,2021-06-01,Male,68,65-69,10
22,1,3,0,4,2021-05-30,Female,62,55-64,16
22,1,3,0,4,2021-05-29,Female,53,45-54,19
22,1,0,0,1,2021-05-28,Male,75,75-79,8
22,1,0,0,1,2021-06-01,Female,49,45-54,20
22,1,0,0,1,2021-05-29,Female,40,35-44,2
22,0,3,0,3,2021-06-01,Female,73,70-74,13
22,0,0,0,0,2021-06-01,Female,14,10-14,12
22,0,2,0,2,2021-05-30,Female,66,65-69,2
22,1,0,0,1,2021-06-02,Male,65,65-69,15
22,3,0,0,3,2021-05-27,Male,30,25-34,11
22,0,4,0,4,2021-05-30,Female,67,65-69,2
22,0,1,0,1,2021-06-02,Male,44,35-44,1
22,0,0,0,0,2021-05-28,Female,26,25-34,21
22,1,0,0,1,2021-05-28,Male,40,35-44,19
22,0,0,0,0,2021-05-29,Female,44,35-44,2
22,0,0,0,0,2021-05-27,Male,34,25-34,15
22,1,1,0,2,2021-05-31,Male,62,55-64,18
22,0,3,0,3,2021-05-30,Female,69,65-69,17
22,0,0,2,2,2021-06-02,Female,32,25-34,2
22,1,0,0,1,2021-06-01,Male,41,35-44,2
22,1,0,0,1,2021-05-30,Male,68,65-69,20
22,3,0,0,3,2021-06-02,Male,19,15-19,2
22,2,0,0,2,2021-05-28,Female,36,35-44,3
22,2,0,0,2,2021-05-28,Male,12,10-14,22
22,4,0,0,4,2021-05-29,Female,10,10-14,16
22,1,1,0,2,2021-05-27,Male,71,70-74,17
22,1,0,0,1,2021-05-26,Male,21,20-24,2
22,2,0,0,2,2021-05-28,Female,29,25-34,8
22,1,0,0,1,2021-05-30,Male,56,55-64,2
22,0,0,0,0,2021-06-02,Male,41,35-44,1
22,2,0,0,2,2021-05-30,Female,60,55-64,18
22,1,12,0,13,2021-06-02,Female,28,25-34,1
22,5,0,0,5,2021-05-28,Female,33,25-34,11
22,3,0,0,3,2021-05-29,Female,15,15-19,8
22,0,1,0,1,2021-05-31,Male,46,45-54,14
22,0,2,0,2,2021-06-03,Female,23,20-24,1
22,1,0,0,1,2021-05-27,Male,2,1-4,12
22,1,0,0,1,2021-05-31,Female,67,65-69,11
22,0,0,0,0,2021-06-01,Female,67,65-69,2
22,0,0,0,0,2021-05-28,Female,70,70-74,10
22,1,0,0,1,2021-05-31,Female,51,45-54,2
22,0,3,0,3,2021-06-02,Female,26,25-34,1
22,1,0,0,1,2021-05-30,Male,46,45-54,15
22,0,0,0,0,2021-06-02,Female,35,35-44,18
22,3,1,0,4,2021-05-27,Female,33,25-34,19
22,0,0,0,0,2021-05-31,Male,58,55-64,20
22,2,1,0,3,2021-05-30,Male,64,55-64,21
22,1,0,20,21,2021-05-30,Female,63,55-64,20
22,2,0,0,2,2021-05-31,Male,1,1-4,3
22,1,0,0,1,2021-05-31,Female,64,55-64,19
22,0,0,0,0,2021-05-30,Female,40,35-44,2
22,0,9,0,9,2021-06-02,Female,41,35-44,1
22,1,2,0,3,2021-05-30,Female,57,55-64,2
22,3,0,0,3,2021-05-31,Female,44,35-44,18
22,2,0,0,2,2021-05-27,Female,69,65-69,20
22,1,0,0,1,2021-05-31,Male,53,45-54,18
22,2,0,0,2,2021-05-30,Male,50,45-54,20
22,1,0,0,1,2021-05-28,Male,36,35-44,2
22,1,0,0,1,2021-05-31,Female,64,55-64,14
22,1,1,0,2,2021-05-30,Female,68,65-69,20
22,2,0,0,2,2021-05-28,Male,59,55-64,19
22,1,4,0,5,2021-05-30,Male,72,70-74,2
22,0,0,0,0,2021-05-28,Male,33,25-34,19
22,1,0,10,11,2021-06-02,Female,31,25-34,1
22,1,0,0,1,2021-06-02,Male,58,55-64,1
22,3,0,0,3,2021-06-02,Female,3,1-4,1
22,0,0,0,0,2021-06-03,Female,10,10-14,1
22,0,0,0,0,2021-06-01,Male,11,10-14,2
22,0,1,0,1,2021-05-27,Male,32,25-34,2
22,2,0,0,2,2021-05-30,Female,19,15-19,2
22,1,0,0,1,2021-05-30,Female,65,65-69,16
22,1,0,0,1,2021-06-02,Female,53,45-54,1
22,3,0,0,3,2021-06-03,Female,35,35-44,2
22,1,3,0,4,2021-05-30,Male,68,65-69,22
22,0,0,0,0,2021-05-31,Male,10,10-14,19
22,0,0,0,0,2021-05-28,Female,39,35-44,2
22,2,0,0,2,2021-05-27,Male,77,75-79,15
22,0,0,0,0,2021-05-30,Male,67,65-69,2
22,0,0,0,0,2021-05-28,Male,36,35-44,2
22,1,1,0,2,2021-05-29,Male,42,35-44,2
22,1,0,0,1,2021-06-02,Male,33,25-34,2
22,6,0,0,6,2021-05-31,Female,15,15-19,21
22,1,0,0,1,2021-06-03,Male,70,70-74,3
22,2,13,0,15,2021-06-02,Female,2,1-4,1
22,0,0,0,0,2021-06-02,Female,47,45-54,1
22,1,0,0,1,2021-05-30,Male,67,65-69,10
22,1,0,0,1,2021-05-31,Female,66,65-69,11
22,0,0,0,0,2021-06-01,Female,68,65-69,14
22,2,0,0,2,2021-05-30,Male,11,10-14,18
22,1,0,0,1,2021-05-30,Male,47,45-54,2
22,1,0,0,1,2021-06-02,Female,71,70-74,1
22,1,0,0,1,2021-06-01,Male,77,75-79,2
22,4,5,0,9,2021-06-02,Male,2,1-4,1
22,0,1,0,1,2021-05-29,Female,40,35-44,13
22,2,0,0,2,2021-05-29,Male,19,15-19,16
22,0,1,0,1,2021-05-30,Female,56,55-64,2
22,3,1,0,4,2021-05-30,Male,53,45-54,2
22,2,0,0,2,2021-05-31,Male,51,45-54,18
22,1,0,0,1,2021-05-30,Male,47,45-54,11
22,0,2,0,2,2021-05-29,Male,51,45-54,2
22,0,0,0,0,2021-06-02,Female,34,25-34,1
22,2,0,0,2,2021-05-30,Male,64,55-64,2
22,0,2,0,2,2021-05-29,Male,40,35-44,18
22,0,0,0,0,2021-05-28,Female,34,25-34,20
22,2,2,0,4,2021-06-02,Male,2,1-4,1
22,0,0,0,0,2021-05-31,Female,19,15-19,4
22,0,0,0,0,2021-05-31,Female,68,65-69,10
22,6,0,0,6,2021-05-26,Female,19,15-19,9
22,2,0,0,2,2021-05-27,Male,0,<1,2
22,0,2,0,2,2021-05-29,Male,46,45-54,18
22,0,3,0,3,2021-06-01,Female,66,65-69,18
22,0,0,0,0,2021-06-03,Male,69,65-69,1
22,3,4,21,28,2021-05-29,Male,9,5-9,2
22,2,4,4,10,2021-05-29,Female,71,70-74,5
22,0,0,0,0,2021-06-01,Female,19,15-19,3
22,9,0,0,9,2021-05-26,Female,52,45-54,13
22,0,0,0,0,2021-05-31,Female,53,45-54,18
22,0,1,0,1,2021-05-27,Female,28,25-34,9
22,2,0,2,4,2021-06-02,Male,39,35-44,1
22,0,0,0,0,2021-06-03,Male,71,70-74,8
22,2,0,0,2,2021-05-29,Male,26,25-34,16
22,3,0,0,3,2021-06-01,Female,14,10-14,11
22,2,0,0,2,2021-06-01,Male,26,25-34,4
22,0,13,0,13,2021-05-31,Male,44,35-44,9
22,1,0,0,1,2021-06-01,Female,74,70-74,12
22,0,0,0,0,2021-05-29,Male,17,15-19,13
22,0,2,0,2,2021-05-30,Female,67,65-69,18
22,0,0,0,0,2021-05-30,Female,68,65-69,14
22,0,0,0,0,2021-05-27,Female,69,65-69,20
22,0,0,3,3,2021-05-27,Male,35,35-44,8
22,3,0,0,3,2021-05-31,Female,52,45-54,4
22,1,0,0,1,2021-05-31,Male,19,15-19,2
22,0,1,0,1,2021-05-31,Female,28,25-34,8
22,0,0,0,0,2021-06-02,Female,42,35-44,1
22,1,0,0,1,2021-05-29,Male,76,75-79,2
22,0,0,0,0,2021-06-02,Male,53,45-54,1
22,1,0,0,1,2021-06-01,Male,65,65-69,2
22,1,2,0,3,2021-06-02,Male,30,25-34,1
22,5,2,0,7,2021-06-01,Male,12,10-14,19
22,1,3,0,4,2021-05-27,Male,70,70-74,2
22,3,0,0,3,2021-05-28,Female,2,1-4,2
22,2,2,0,4,2021-05-29,Female,55,55-64,18
22,3,15,0,18,2021-05-27,Male,4,1-4,2
22,0,0,0,0,2021-05-31,Female,53,45-54,21
22,0,0,0,0,2021-05-30,Male,60,55-64,2
22,0,1,0,1,2021-05-30,Female,38,35-44,15
22,1,0,0,1,2021-05-31,Female,63,55-64,2
22,0,0,0,0,2021-06-01,Female,79,75-79,2
22,1,0,0,1,2021-05-31,Female,65,65-69,2
22,1,0,0,1,2021-05-31,Male,54,45-54,15
22,2,0,0,2,2021-05-31,Male,68,65-69,11
22,1,0,0,1,2021-05-28,Female,40,35-44,9
22,0,4,0,4,2021-05-26,Female,70,70-74,2
22,1,3,0,4,2021-05-27,Female,69,65-69,2
22,0,1,0,1,2021-05-29,Male,49,45-54,18
22,1,0,0,1,2021-05-30,Male,64,55-64,17
22,0,2,0,2,2021-05-31,Male,40,35-44,2
22,0,0,0,0,2021-05-30,Male,62,55-64,4
22,1,0,0,1,2021-05-29,Male,36,35-44,18
22,1,0,0,1,2021-05-29,Male,50,45-54,19
22,0,0,0,0,2021-05-30,Male,53,45-54,4
22,0,0,0,0,2021-05-30,Female,51,45-54,2
22,1,0,0,1,2021-06-02,Female,53,45-54,1
22,1,0,0,1,2021-05-29,Male,53,45-54,2
22,1,0,0,1,2021-05-30,Female,66,65-69,2
22,1,2,0,3,2021-06-02,Male,77,75-79,1
22,0,0,0,0,2021-05-30,Female,53,45-54,17
22,2,0,0,2,2021-06-01,Male,69,65-69,20
22,0,0,8,8,2021-05-29,Male,47,45-54,2
22,2,0,0,2,2021-05-30,Female,48,45-54,18
22,3,10,0,13,2021-05-26,Male,21,20-24,19
22,1,0,0,1,2021-05-31,Female,66,65-69,5
22,3,0,0,3,2021-05-27,Male,85,85+,16
22,1,0,0,1,2021-05-30,Male,56,55-64,2
22,1,0,0,1,2021-06-02,Female,54,45-54,18
22,2,0,0,2,2021-05-31,Male,14,10-14,14
22,1,0,0,1,2021-05-30,Male,67,65-69,2
22,2,0,0,2,2021-05-27,Female,71,70-74,10
22,2,1,0,3,2021-06-01,Female,20,20-24,11
22,0,0,0,0,2021-06-01,Male,48,45-54,15
22,2,0,0,2,2021-05-31,Female,67,65-69,16
22,0,0,0,0,2021-05-29,Male,50,45-54,22
22,0,0,0,0,2021-06-02,Male,19,15-19,1
22,0,0,3,3,2021-06-01,Male,0,<1,12
22,1,16,0,17,2021-06-01,Male,1,1-4,3
22,0,1,0,1,2021-06-02,Male,23,20-24,13
22,0,0,0,0,2021-06-02,Male,45,45-54,2
22,1,2,0,3,2021-06-02,Male,8,5-9,1
22,1,0,0,1,2021-05-30,Female,45,45-54,2
22,0,0,0,0,2021-06-02,Female,9,5-9,1
22,0,0,0,0,2021-05-28,Male,32,25-34,16
22,0,0,0,0,2021-06-01,Male,51,45-54,11
22,3,0,0,3,2021-05-31,Male,38,35-44,2
22,2,0,0,2,2021-05-27,Male,75,75-79,19
22,2,1,0,3,2021-05-31,Male,62,55-64,2
22,2,1,0,3,2021-05-31,Female,12,10-14,10
22,0,0,0,0,2021-06-02,Male,31,25-34,17
22,0,0,0,0,2021-06-02,Female,31,25-34,1
22,2,0,0,2,2021-05-31,Male,66,65-69,14
22,0,0,0,0,2021-05-31,Male,43,35-44,19
22,0,0,0,0,2021-05-28,Female,31,25-34,7
22,0,1,0,1,2021-05-30,Female,66,65-69,2
22,2,0,0,2,2021-05-27,Female,80,80-84,17
22,2,1,0,3,2021-05-30,Female,16,15-19,2
22,1,0,0,1,2021-05-27,Female,70,70-74,20
22,0,0,0,0,2021-05-27,Female,70,70-74,22
22,1,1,0,2,2021-05-27,Male,71,70-74,20
22,3,0,0,3,2021-05-30,Female,65,65-69,2
22,0,0,0,0,2021-05-30,Female,60,55-64,2
22,1,2,0,3,2021-06-02,Female,53,45-54,1
22,0,0,0,0,2021-05-29,Male,13,10-14,14
22,0,1,0,1,2021-05-30,Male,61,55-64,21
22,1,0,0,1,2021-05-27,Female,70,70-74,2
22,0,12,0,12,2021-06-02,Male,36,35-44,1
22,0,0,28,28,2021-06-02,Male,20,20-24,1
22,0,1,0,1,2021-05-30,Male,67,65-69,10
22,2,0,0,2,2021-06-02,Male,54,45-54,1
22,1,0,0,1,2021-05-28,Female,13,10-14,18
22,3,0,0,3,2021-05-27,Male,0,<1,2
22,3,0,0,3,2021-05-29,Male,14,10-14,18
22,0,1,0,1,2021-05-31,Male,34,25-34,20
22,2,0,0,2,2021-05-31,Male,16,15-19,14
22,1,0,0,1,2021-06-02,Male,31,25-34,1
22,2,0,0,2,2021-05-26,Male,20,20-24,18
23,0,0,0,0,2021-06-15,Male,60,55-64,16
23,0,0,0,0,2021-06-15,Male,65,65-69,2
23,1,4,0,5,2021-06-22,Male,68,65-69,17
23,2,15,0,17,2021-06-09,Male,11,10-14,4
23,3,0,0,3,2021-06-09,Male,1,1-4,2
23,2,0,0,2,2021-06-15,Male,65,65-69,3
23,0,13,2,15,2021-06-11,Female,49,45-54,3
23,0,0,0,0,2021-06-10,Male,28,25-34,3
23,2,0,0,2,2021-06-14,Female,66,65-69,22
23,1,0,0,1,2021-06-10,Female,55,55-64,2
23,0,0,0,0,2021-06-14,Female,72,70-74,19
23,1,0,0,1,2021-06-10,Female,58,55-64,2
23,1,0,0,1,2021-06-14,Female,72,70-74,23
23,1,1,0,2,2021-06-14,Male,71,70-74,3
23,0,0,0,0,2021-06-14,Male,30,25-34,18
23,0,5,0,5,2021-06-13,Female,53,45-54,13
23,2,0,0,2,2021-06-15,Male,19,15-19,3
23,1,3,0,4,2021-06-18,Female,24,20-24,1
23,0,0,0,0,2021-06-14,Female,68,65-69,16
23,1,0,0,1,2021-06-10,Female,57,55-64,2
23,3,0,0,3,2021-06-14,Male,17,15-19,3
23,1,0,0,1,2021-06-14,Female,68,65-69,3
23,0,0,0,0,2021-06-09,Female,34,25-34,10
23,0,0,0,0,2021-06-09,Female,5,5-9,2
23,1,0,0,1,2021-06-13,Female,60,55-64,18
23,0,1,0,1,2021-06-11,Male,52,45-54,3
23,1,2,0,3,2021-06-13,Female,61,55-64,13
23,0,0,0,0,2021-06-16,Male,51,45-54,19
23,0,1,0,1,2021-06-14,Male,68,65-69,8
23,1,0,0,1,2021-06-11,Male,51,45-54,18
23,2,0,0,2,2021-06-09,Female,35,35-44,19
23,2,0,0,2,2021-06-09,Female,45,45-54,3
23,3,0,0,3,2021-06-09,Female,58,55-64,19
23,3,0,0,3,2021-06-12,Male,8,5-9,3
23,0,0,0,0,2021-06-15,Female,66,65-69,3
23,0,2,0,2,2021-06-09,Male,33,25-34,2
23,1,0,0,1,2021-06-12,Male,34,25-34,4
23,0,3,0,3,2021-06-09,Male,50,45-54,3
23,2,12,0,14,2021-06-12,Female,19,15-19,3
23,2,0,0,2,2021-06-09,Female,11,10-14,17
23,0,3,0,3,2021-06-17,Female,40,35-44,1
23,0,0,0,0,2021-06-10,Male,43,35-44,16
23,0,0,0,0,2021-06-10,Male,33,25-34,17
23,3,0,0,3,2021-06-12,Female,55,55-64,3
23,1,0,0,1,2021-06-11,Male,57,55-64,2
23,0,0,0,0,2021-06-09,Male,21,20-24,2
23,1,1,0,2,2021-06-14,Male,67,65-69,15
23,1,0,0,1,2021-06-14,Male,67,65-69,18
23,1,2,0,3,2021-06-15,Male,56,55-64,3
23,1,0,0,1,2021-06-10,Male,63,55-64,23
23,0,0,0,0,2021-06-11,Female,50,45-54,3
23,1,25,0,26,2021-06-14,Male,60,55-64,3
23,0,0,0,0,2021-06-17,Female,36,35-44,1
23,1,0,0,1,2021-06-14,Male,65,65-69,3
23,0,0,0,0,2021-06-13,Male,15,15-19,20
23,0,0,0,0,2021-06-09,Male,49,45-54,20
23,0,1,0,1,2021-06-09,Male,43,35-44,3
23,3,0,0,3,2021-06-13,Male,59,55-64,17
23,3,0,0,3,2021-06-09,Male,52,45-54,10
23,1,1,0,2,2021-06-15,Male,34,25-34,3
23,1,2,0,3,2021-06-11,Male,76,75-79,3
23,0,0,0,0,2021-06-10,Male,27,25-34,3
23,1,1,0,2,2021-06-15,Male,68,65-69,19
23,1,0,0,1,2021-06-12,Female,53,45-54,19
23,1,0,0,1,2021-06-14,Female,69,65-69,17
23,0,0,0,0,2021-06-09,Male,42,35-44,23
23,0,1,0,1,2021-06-12,Female,78,75-79,3
23,1,0,0,1,2021-06-15,Female,56,55-64,3
23,4,0,0,4,2021-06-12,Male,19,15-19,9
23,1,1,0,2,2021-06-13,Male,59,55-64,14
23,1,0,0,1,2021-06-14,Female,57,55-64,23
23,1,0,0,1,2021-06-10,Male,43,35-44,5
23,0,0,0,0,2021-06-15,Male,85,85+,20
23,0,0,0,0,2021-06-16,Female,69,65-69,18
23,0,7,0,7,2021-06-17,Female,66,65-69,10
23,3,0,0,3,2021-06-09,Male,4,1-4,10
23,0,1,0,1,2021-06-10,Male,54,45-54,8
23,1,0,0,1,2021-06-14,Male,33,25-34,3
23,0,1,0,1,2021-06-16,Female,70,70-74,3
23,1,0,0,1,2021-06-15,Male,58,55-64,21
23,0,0,0,0,2021-06-15,Male,68,65-69,21
23,0,0,0,0,2021-06-14,Male,35,35-44,3
23,2,0,0,2,2021-06-12,Female,16,15-19,2
23,1,2,0,3,2021-06-15,Male,72,70-74,16
23,0,0,0,0,2021-06-11,Male,77,75-79,18
23,0,0,0,0,2021-06-09,Male,27,25-34,10
23,0,7,0,7,2021-06-15,Female,53,45-54,2
23,1,1,0,2,2021-06-09,Male,72,70-74,20
23,0,0,0,0,2021-06-09,Male,44,35-44,13
23,2,0,0,2,2021-06-14,Male,28,25-34,3
23,0,0,0,0,2021-06-12,Male,52,45-54,20
23,1,0,0,1,2021-06-10,Female,38,35-44,2
23,0,1,0,1,2021-06-14,Female,38,35-44,3
23,0,0,0,0,2021-06-16,Male,37,35-44,9
23,0,0,0,0,2021-06-13,Male,60,55-64,3
23,0,0,0,0,2021-06-12,Male,53,45-54,15
23,1,0,0,1,2021-06-15,Male,44,35-44,14
23,3,3,0,6,2021-06-12,Male,44,35-44,14
23,1,2,0,3,2021-06-09,Male,39,35-44,3
23,2,1,0,3,2021-06-20,Male,12,10-14,1
23,1,0,0,1,2021-06-15,Female,71,70-74,3
23,1,1,0,2,2021-06-14,Male,67,65-69,3
23,1,0,0,1,2021-06-15,Male,39,35-44,20
23,0,1,1,2,2021-06-11,Female,77,75-79,17
23,3,3,0,6,2021-06-09,Male,3,1-4,7
23,2,0,0,2,2021-06-14,Male,66,65-69,3
23,1,0,0,1,2021-06-14,Female,68,65-69,20
23,0,1,0,1,2021-06-13,Female,52,45-54,12
23,1,1,0,2,2021-06-09,Male,62,55-64,19
23,0,0,0,0,2021-06-09,Male,38,35-44,3
23,0,0,0,0,2021-06-09,Female,20,20-24,9
23,0,2,0,2,2021-06-16,Male,56,55-64,3
23,1,0,0,1,2021-06-10,Female,60,55-64,3
23,0,0,0,0,2021-06-11,Male,85,85+,17
23,2,0,0,2,2021-06-14,Female,72,70-74,18
23,0,0,0,0,2021-06-15,Male,72,70-74,3
23,0,0,0,0,2021-06-12,Female,22,20-24,9
23,1,0,0,1,2021-06-14,Female,28,25-34,3
23,0,1,0,1,2021-06-09,Female,35,35-44,2
23,1,0,0,1,2021-06-16,Male,45,45-54,10
23,2,0,0,2,2021-06-09,Male,7,5-9,2
23,2,3,0,5,2021-06-13,Male,55,55-64,22
23,1,0,0,1,2021-06-09,Male,71,70-74,20
23,2,0,0,2,2021-06-15,Female,69,65-69,19
23,1,0,0,1,2021-06-14,Female,66,65-69,22
23,3,16,0,19,2021-06-09,Male,10,10-14,14
23,2,0,0,2,2021-06-14,Male,66,65-69,21
23,2,0,0,2,2021-06-15,Male,65,65-69,3
23,2,0,0,2,2021-06-11,Female,1,1-4,4
23,0,0,0,0,2021-06-14,Male,69,65-69,13
23,0,5,0,5,2021-06-10,Female,54,45-54,3
23,1,0,0,1,2021-06-10,Male,68,65-69,18
23,0,0,0,0,2021-06-14,Male,32,25-34,3
23,2,0,0,2,2021-06-14,Male,70,70-74,13
23,2,0,0,2,2021-06-09,Male,2,1-4,3
23,1,0,0,1,2021-06-13,Female,58,55-64,3
23,0,0,12,12,2021-06-09,Female,32,25-34,9
23,0,0,0,0,2021-06-10,Male,32,25-34,2
23,1,0,0,1,2021-06-17,Female,72,70-74,1
23,0,0,0,0,2021-06-09,Male,43,35-44,19
23,3,0,0,3,2021-06-14,Female,7,5-9,17
23,2,0,0,2,2021-06-09,Male,11,10-14,3
23,0,3,0,3,2021-06-11,Female,75,75-79,3
23,1,0,25,26,2021-06-15,Male,6,5-9,2
23,1,0,0,1,2021-06-09,Female,27,25-34,3
23,3,0,0,3,2021-06-15,Male,15,15-19,7
23,0,0,0,0,2021-06-14,Male,71,70-74,18
23,1,0,0,1,2021-06-15,Male,70,70-74,23
23,1,0,0,1,2021-06-10,Female,20,20-24,4
23,0,0,0,0,2021-06-09,Female,28,25-34,2
23,2,0,0,2,2021-06-10,Female,60,55-64,21
23,3,0,0,3,2021-06-10,Male,18,15-19,19
23,1,0,0,1,2021-06-09,Male,31,25-34,17
23,0,2,0,2,2021-06-15,Female,53,45-54,20
23,1,0,0,1,2021-06-11,Male,49,45-54,21
23,0,1,0,1,2021-06-15,Male,70,70-74,16
23,0,0,0,0,2021-06-10,Female,18,15-19,3
23,1,0,0,1,2021-06-10,Male,60,55-64,3
23,1,2,0,3,2021-06-13,Female,61,55-64,4
23,2,0,0,2,2021-06-18,Female,4,1-4,1
23,2,0,0,2,2021-06-14,Male,63,55-64,3
23,3,1,0,4,2021-06-10,Male,19,15-19,3
23,1,1,0,2,2021-06-15,Male,21,20-24,2
23,2,0,0,2,2021-06-15,Male,34,25-34,2
23,0,1,0,1,2021-06-15,Female,63,55-64,21
23,0,0,2,2,2021-06-14,Female,27,25-34,16
23,0,0,0,0,2021-06-11,Male,75,75-79,7
23,1,1,0,2,2021-06-14,Female,31,25-34,22
23,1,0,0,1,2021-06-13,Female,60,55-64,2
23,2,0,0,2,2021-06-15,Female,68,65-69,16
23,2,0,0,2,2021-06-10,Female,24,20-24,2
23,1,0,0,1,2021-06-10,Male,52,45-54,3
23,1,0,0,1,2021-06-12,Male,15,15-19,13
23,1,3,0,4,2021-06-09,Male,31,25-34,2
23,0,0,0,0,2021-06-10,Male,15,15-19,11
23,2,0,0,2,2021-06-09,Female,27,25-34,3
23,0,0,0,0,2021-06-22,Male,68,65-69,12
23,0,2,0,2,2021-06-13,Male,55,55-64,20
23,0,0,0,0,2021-06-09,Male,34,25-34,15
23,1,2,0,3,2021-06-14,Male,58,55-64,17
23,2,0,0,2,2021-06-09,Male,4,1-4,8
23,0,0,0,0,2021-06-11,Female,73,70-74,15
23,0,0,0,0,2021-06-15,Male,66,65-69,16
23,1,0,0,1,2021-06-14,Male,68,65-69,3
23,2,0,0,2,2021-06-14,Female,0,<1,3
23,0,0,0,0,2021-06-10,Female,31,25-34,3
23,1,0,0,1,2021-06-09,Female,44,35-44,3
23,0,0,0,0,2021-06-10,Female,31,25-34,17
23,0,0,0,0,2021-06-15,Male,35,35-44,9
23,0,0,0,0,2021-06-15,Female,23,20-24,4
23,0,0,0,0,2021-06-11,Male,47,45-54,3
23,1,1,0,2,2021-06-11,Female,67,65-69,3
23,1,6,0,7,2021-06-14,Female,62,55-64,17
23,1,0,0,1,2021-06-12,Male,12,10-14,3
23,1,2,0,3,2021-06-09,Female,23,20-24,10
23,1,0,0,1,2021-06-14,Male,66,65-69,18
23,1,2,0,3,2021-06-15,Female,27,25-34,3
23,0,0,0,0,2021-06-14,Male,64,55-64,20
23,3,0,0,3,2021-06-10,Male,8,5-9,14
23,1,0,2,3,2021-06-16,Male,69,65-69,3
23,2,0,0,2,2021-06-10,Female,26,25-34,18
23,0,5,0,5,2021-06-09,Female,44,35-44,3
23,0,1,2,3,2021-06-15,Male,69,65-69,18
23,0,0,0,0,2021-06-11,Male,53,45-54,3
23,2,0,0,2,2021-06-09,Male,42,35-44,17
23,2,0,0,2,2021-06-09,Male,59,55-64,22
23,1,0,2,3,2021-06-17,Male,65,65-69,1
23,4,6,17,27,2021-06-10,Male,22,20-24,3
23,0,0,0,0,2021-06-14,Female,63,55-64,19
23,1,0,0,1,2021-06-09,Male,61,55-64,3
23,1,0,0,1,2021-06-13,Female,30,25-34,2
23,1,1,0,2,2021-06-13,Male,54,45-54,3
23,0,0,0,0,2021-06-14,Male,70,70-74,18
23,3,0,0,3,2021-06-09,Male,32,25-34,14
23,1,0,0,1,2021-06-14,Male,65,65-69,3
23,0,0,0,0,2021-06-10,Female,54,45-54,7
23,2,0,0,2,2021-06-14,Male,70,70-74,14
23,0,0,0,0,2021-06-13,Male,25,25-34,15
23,1,0,0,1,2021-06-09,Male,55,55-64,3
23,2,0,0,2,2021-06-09,Female,3,1-4,4
23,1,0,0,1,2021-06-14,Male,66,65-69,21
23,2,0,0,2,2021-06-15,Female,60,55-64,3
23,2,0,0,2,2021-06-18,Female,21,20-24,1
23,0,1,0,1,2021-06-14,Female,70,70-74,7
23,3,0,0,3,2021-06-09,Female,20,20-24,3
23,1,1,0,2,2021-06-14,Male,39,35-44,3
23,0,0,0,0,2021-06-09,Male,32,25-34,2
23,3,5,0,8,2021-06-14,Male,0,<1,3
23,2,1,0,3,2021-06-15,Male,73,70-74,3
23,0,0,0,0,2021-06-10,Male,41,35-44,4
23,1,2,4,7,2021-06-13,Female,54,45-54,3
23,0,2,0,2,2021-06-14,Female,69,65-69,2
23,1,0,0,1,2021-06-11,Male,74,70-74,2
23,1,1,0,2,2021-06-11,Female,79,75-79,18
23,0,0,0,0,2021-06-14,Female,34,25-34,2
23,1,8,0,9,2021-06-10,Male,49,45-54,4
23,1,0,0,1,2021-06-09,Male,57,55-64,16
23,0,0,0,0,2021-06-17,Male,20,20-24,1
23,1,0,0,1,2021-06-15,Female,29,25-34,19
23,3,0,30,33,2021-06-10,Male,11,10-14,2
23,1,0,0,1,2021-06-11,Male,52,45-54,6
23,1,3,0,4,2021-06-09,Female,67,65-69,16
23,2,0,0,2,2021-06-14,Female,57,55-64,17
23,1,0,0,1,2021-06-10,Female,64,55-64,3
23,0,0,0,0,2021-06-11,Female,51,45-54,6
23,0,10,0,10,2021-06-09,Female,42,35-44,3
23,0,0,0,0,2021-06-17,Female,74,70-74,1
23,0,1,0,1,2021-06-14,Male,67,65-69,2
23,1,0,0,1,2021-06-15,Male,53,45-54,17
23,0,0,0,0,2021-06-15,Male,53,45-54,13
23,1,0,0,1,2021-06-14,Male,28,25-34,10
23,0,4,2,6,2021-06-12,Female,81,80-84,3
23,0,0,2,2,2021-06-09,Male,27,25-34,3
23,1,3,4,8,2021-06-10,Male,71,70-74,20
23,1,1,0,2,2021-06-14,Female,68,65-69,23
23,0,0,0,0,2021-06-14,Female,52,45-54,21
23,1,0,0,1,2021-06-09,Male,34,25-34,2
23,1,0,0,1,2021-06-10,Male,29,25-34,18
23,3,15,0,18,2021-06-11,Male,8,5-9,18
23,1,0,0,1,2021-06-13,Male,54,45-54,3
23,0,0,0,0,2021-06-10,Female,32,25-34,8
23,3,1,0,4,2021-06-10,Male,66,65-69,19
23,2,0,0,2,2021-06-10,Male,58,55-64,2
23,1,1,0,2,2021-06-16,Female,24,20-24,6
23,0,3,0,3,2021-06-10,Male,45,45-54,3
23,1,0,0,1,2021-06-13,Female,59,55-64,20
23,1,10,0,11,2021-06-11,Female,20,20-24,2
23,1,12,0,13,2021-06-09,Male,64,55-64,2
23,1,1,0,2,2021-06-11,Female,49,45-54,3
23,0,0,0,0,2021-06-15,Male,72,70-74,3
23,0,0,0,0,2021-06-15,Female,66,65-69,21
23,1,0,0,1,2021-06-14,Female,42,35-44,13
23,1,0,0,1,2021-06-11,Female,60,55-64,19
23,1,0,0,1,2021-06-15,Male,63,55-64,3
23,0,0,0,0,2021-06-14,Male,71,70-74,23
23,0,0,0,0,2021-06-09,Male,44,35-44,3
23,0,5,5,10,2021-06-16,Female,72,70-74,18
23,1,6,0,7,2021-06-13,Female,60,55-64,3
23,1,2,0,3,2021-06-11,Male,74,70-74,21
23,1,0,0,1,2021-06-09,Female,67,65-69,3
23,0,0,0,0,2021-06-14,Male,59,55-64,2
23,2,1,0,3,2021-06-22,Female,65,65-69,14
23,0,0,0,0,2021-06-09,Male,51,45-54,16
23,2,1,0,3,2021-06-09,Female,31,25-34,18
23,0,0,1,1,2021-06-15,Female,47,45-54,3
23,0,0,0,0,2021-06-14,Male,39,35-44,10
23,1,0,0,1,2021-06-10,Female,64,55-64,3
23,0,0,0,0,2021-06-15,Male,51,45-54,2
23,2,0,0,2,2021-06-11,Male,12,10-14,2
23,0,0,0,0,2021-06-12,Male,54,45-54,19
23,1,1,0,2,2021-06-17,Female,72,70-74,1
23,0,0,0,0,2021-06-14,Female,65,65-69,5
23,0,0,0,0,2021-06-13,Female,30,25-34,3
23,1,0,0,1,2021-06-14,Female,50,45-54,18
23,3,0,0,3,2021-06-18,Male,18,15-19,1
23,1,3,0,4,2021-06-11,Male,54,45-54,2
23,0,0,0,0,2021-06-14,Male,11,10-14,17
23,2,2,100,104,2021-06-11,Male,17,15-19,19
23,1,0,1,2,2021-06-11,Female,52,45-54,3
23,0,0,0,0,2021-06-11,Male,65,65-69,17
23,1,1,0,2,2021-06-09,Male,69,65-69,20
23,0,0,0,0,2021-06-13,Male,23,20-24,3
23,1,0,0,1,2021-06-10,Female,58,55-64,20
23,0,0,0,0,2021-06-09,Male,34,25-34,2
23,2,0,0,2,2021-06-14,Female,39,35-44,3
23,0,0,0,0,2021-06-09,Male,51,45-54,20
23,0,0,0,0,2021-06-14,Male,16,15-19,3
23,0,0,0,0,2021-06-09,Female,47,45-54,3
23,0,0,0,0,2021-06-09,Male,10,10-14,19
23,0,0,0,0,2021-06-10,Male,71,70-74,21
23,0,0,0,0,2021-06-09,Male,40,35-44,17
23,1,9,0,10,2021-06-11,Female,53,45-54,3
23,0,40,0,40,2021-06-10,Female,58,55-64,2
23,2,0,0,2,2021-06-11,Female,70,70-74,23
23,0,0,0,0,2021-06-15,Male,38,35-44,17
23,2,0,0,2,2021-06-14,Female,35,35-44,7
23,3,0,0,3,2021-06-15,Male,20,20-24,12
23,1,15,0,16,2021-06-15,Female,9,5-9,14
23,1,0,0,1,2021-06-09,Male,22,20-24,10
23,2,1,0,3,2021-06-11,Female,73,70-74,16
23,0,0,0,0,2021-06-09,Male,52,45-54,17
23,1,1,0,2,2021-06-11,Female,60,55-64,23
23,2,0,0,2,2021-06-15,Male,63,55-64,10
23,2,0,0,2,2021-06-11,Female,63,55-64,17
23,2,0,0,2,2021-06-10,Male,34,25-34,3
23,1,0,0,1,2021-06-09,Female,55,55-64,2
23,2,0,0,2,2021-06-11,Male,74,70-74,19
23,2,0,0,2,2021-06-15,Male,66,65-69,6
23,2,6,0,8,2021-06-12,Female,53,45-54,21
23,0,0,0,0,2021-06-09,Male,43,35-44,2
23,0,0,0,0,2021-06-10,Male,69,65-69,18
23,1,0,0,1,2021-06-09,Male,26,25-34,3
23,1,0,0,1,2021-06-09,Male,34,25-34,22
23,0,2,0,2,2021-06-10,Female,21,20-24,2
23,0,0,0,0,2021-06-11,Male,48,45-54,17
23,2,0,0,2,2021-06-14,Male,41,35-44,2
23,3,3,0,6,2021-06-14,Male,70,70-74,18
23,2,0,0,2,2021-06-09,Male,55,55-64,3
23,1,0,0,1,2021-06-14,Male,66,65-69,20
23,2,13,0,15,2021-06-09,Male,15,15-19,3
23,1,0,0,1,2021-06-22,Male,50,45-54,2
23,2,0,0,2,2021-06-15,Male,68,65-69,21
23,1,1,0,2,2021-06-09,Female,22,20-24,3
23,0,2,0,2,2021-06-14,Male,62,55-64,17
23,0,1,0,1,2021-06-15,Male,71,70-74,15
23,1,0,0,1,2021-06-09,Male,69,65-69,2
23,1,15,0,16,2021-06-14,Female,2,1-4,3
23,0,3,0,3,2021-06-09,Male,28,25-34,3
23,0,0,0,0,2021-06-09,Female,57,55-64,21
23,0,0,0,0,2021-06-10,Female,59,55-64,18
23,3,10,0,13,2021-06-15,Male,23,20-24,11
23,0,0,0,0,2021-06-14,Female,67,65-69,19
23,1,2,0,3,2021-06-11,Female,73,70-74,2
23,0,20,3,23,2021-06-12,Male,54,45-54,3
23,0,2,0,2,2021-06-11,Female,76,75-79,3
23,0,1,0,1,2021-06-17,Male,21,20-24,1
23,1,0,0,1,2021-06-10,Female,55,55-64,3
23,0,0,0,0,2021-06-09,Male,45,45-54,14
23,0,0,0,0,2021-06-17,Female,23,20-24,1
23,0,5,0,5,2021-06-16,Female,64,55-64,17
23,0,0,0,0,2021-06-14,Male,70,70-74,3
23,1,0,0,1,2021-06-09,Male,29,25-34,3
23,0,0,0,0,2021-06-12,Female,18,15-19,3
23,1,0,0,1,2021-06-15,Male,70,70-74,4
23,2,0,0,2,2021-06-09,Female,13,10-14,5
23,1,0,0,1,2021-06-09,Female,61,55-64,23
23,1,0,0,1,2021-06-15,Male,61,55-64,8
23,2,0,0,2,2021-06-09,Male,49,45-54,18
23,1,0,0,1,2021-06-11,Female,54,45-54,23
23,0,0,0,0,2021-06-09,Male,34,25-34,16
23,1,1,0,2,2021-06-15,Male,61,55-64,2
23,0,1,0,1,2021-06-13,Male,56,55-64,18
23,0,3,0,3,2021-06-09,Female,66,65-69,22
23,2,0,0,2,2021-06-14,Male,15,15-19,15
23,1,0,0,1,2021-06-11,Male,73,70-74,18
23,3,17,0,20,2021-06-11,Male,9,5-9,16
23,1,1,0,2,2021-06-11,Male,79,75-79,17
23,0,0,0,0,2021-06-14,Female,67,65-69,17
23,0,0,0,0,2021-06-15,Male,39,35-44,19
23,1,15,0,16,2021-06-11,Female,18,15-19,16
23,1,0,0,1,2021-06-09,Female,56,55-64,19
23,0,0,0,0,2021-06-15,Female,74,70-74,3
23,0,0,0,0,2021-06-15,Male,54,45-54,17
23,1,0,0,1,2021-06-14,Female,71,70-74,3
23,2,1,0,3,2021-06-10,Male,8,5-9,2
23,1,1,0,2,2021-06-09,Male,69,65-69,21
23,2,15,0,17,2021-06-11,Male,16,15-19,17
23,4,0,0,4,2021-06-13,Female,13,10-14,3
23,0,2,0,2,2021-06-14,Male,37,35-44,23
23,1,0,0,1,2021-06-14,Female,51,45-54,3
23,2,0,0,2,2021-06-12,Female,50,45-54,12
23,1,3,0,4,2021-06-14,Male,41,35-44,23
23,0,0,0,0,2021-06-14,Male,33,25-34,19
23,1,3,0,4,2021-06-11,Male,66,65-69,3
23,2,1,0,3,2021-06-10,Male,62,55-64,22
23,0,0,0,0,2021-06-09,Female,4,1-4,11
23,1,2,0,3,2021-06-14,Female,69,65-69,16
23,1,0,0,1,2021-06-15,Male,68,65-69,13
23,0,0,0,0,2021-06-10,Male,5,5-9,19
23,0,2,0,2,2021-06-11,Male,46,45-54,3
23,1,0,0,1,2021-06-10,Female,34,25-34,16
23,0,1,0,1,2021-06-14,Male,69,65-69,21
23,3,0,0,3,2021-06-16,Female,64,55-64,7
23,0,4,0,4,2021-06-13,Male,29,25-34,19
23,1,0,0,1,2021-06-09,Female,21,20-24,3
23,1,15,0,16,2021-06-10,Male,13,10-14,3
23,0,0,0,0,2021-06-10,Female,54,45-54,19
23,0,2,0,2,2021-06-14,Male,19,15-19,7
23,1,0,1,2,2021-06-10,Male,43,35-44,3
23,3,16,0,19,2021-06-22,Male,8,5-9,17
23,0,0,0,0,2021-06-09,Male,31,25-34,10
23,2,4,0,6,2021-06-14,Female,13,10-14,2
23,0,0,0,0,2021-06-11,Male,51,45-54,2
23,0,0,0,0,2021-06-11,Male,77,75-79,14
23,1,3,0,4,2021-06-13,Male,60,55-64,3
23,0,4,0,4,2021-06-10,Male,47,45-54,17
23,2,0,22,24,2021-06-14,Female,4,1-4,2
23,1,2,0,3,2021-06-11,Male,53,45-54,20
23,0,0,0,0,2021-06-10,Female,71,70-74,13
23,1,10,0,11,2021-06-09,Male,33,25-34,17
23,3,0,0,3,2021-06-14,Male,70,70-74,18
23,0,7,0,7,2021-06-09,Female,34,25-34,2
23,3,0,0,3,2021-06-14,Female,69,65-69,16
23,0,0,0,0,2021-06-09,Male,19,15-19,20
23,2,0,0,2,2021-06-14,Male,65,65-69,19
23,0,1,0,1,2021-06-11,Male,50,45-54,20
23,1,6,0,7,2021-06-16,Male,66,65-69,2
23,1,0,0,1,2021-06-14,Male,66,65-69,14
23,1,0,0,1,2021-06-14,Female,67,65-69,13
23,1,1,0,2,2021-06-17,Male,22,20-24,1
23,0,0,0,0,2021-06-17,Male,35,35-44,1
23,0,11,0,11,2021-06-17,Female,23,20-24,1
23,0,0,0,0,2021-06-09,Male,16,15-19,11
23,3,1,0,4,2021-06-15,Male,22,20-24,9
23,0,0,0,0,2021-06-09,Male,48,45-54,3
23,1,0,0,1,2021-06-09,Male,67,65-69,21
23,0,0,0,0,2021-06-14,Male,65,65-69,21
23,1,0,0,1,2021-06-10,Female,18,15-19,3
23,0,0,0,0,2021-06-13,Female,30,25-34,3
23,1,0,0,1,2021-06-10,Male,34,25-34,2
23,2,3,0,5,2021-06-09,Female,68,65-69,22
23,1,0,0,1,2021-06-10,Male,68,65-69,21
23,0,0,0,0,2021-06-11,Male,41,35-44,15
23,3,0,0,3,2021-06-09,Male,15,15-19,2
23,1,0,0,1,2021-06-09,Male,45,45-54,3
23,0,0,0,0,2021-06-11,Female,49,45-54,3
23,2,0,0,2,2021-06-09,Female,8,5-9,3
23,1,0,0,1,2021-06-09,Female,44,35-44,13
23,0,0,0,0,2021-06-14,Female,72,70-74,3
23,1,0,0,1,2021-06-13,Male,57,55-64,3
23,1,7,0,8,2021-06-14,Female,57,55-64,2
23,0,0,0,0,2021-06-11,Male,53,45-54,8
23,2,0,0,2,2021-06-14,Male,67,65-69,15
23,0,2,0,2,2021-06-12,Female,54,45-54,3
23,1,2,0,3,2021-06-09,Male,33,25-34,3
23,3,0,0,3,2021-06-09,Male,16,15-19,3
23,0,0,0,0,2021-06-09,Male,65,65-69,3
23,1,0,0,1,2021-06-14,Female,42,35-44,2
23,1,0,0,1,2021-06-16,Male,16,15-19,19
23,1,0,0,1,2021-06-13,Male,55,55-64,3
23,0,0,0,0,2021-06-12,Female,53,45-54,21
23,5,0,0,5,2021-06-09,Male,14,10-14,20
23,1,8,0,9,2021-06-15,Female,67,65-69,3
23,0,0,0,0,2021-06-15,Male,11,10-14,20
23,2,37,0,39,2021-06-10,Female,2,1-4,13
23,3,0,0,3,2021-06-13,Male,26,25-34,3
23,0,7,0,7,2021-06-12,Male,47,45-54,11
23,0,0,0,0,2021-06-13,Male,56,55-64,3
23,1,1,0,2,2021-06-11,Male,82,80-84,20
23,1,5,0,6,2021-06-14,Female,71,70-74,2
23,3,0,0,3,2021-06-12,Female,7,5-9,13
23,3,6,0,9,2021-06-10,Female,8,5-9,3
23,3,0,0,3,2021-06-15,Male,1,1-4,6
23,0,0,0,0,2021-06-12,Female,11,10-14,16
23,1,0,0,1,2021-06-11,Male,59,55-64,3
23,0,0,0,0,2021-06-11,Female,51,45-54,9
23,0,0,0,0,2021-06-09,Male,49,45-54,17
23,1,0,0,1,2021-06-09,Male,44,35-44,4
23,1,0,0,1,2021-06-14,Female,53,45-54,14
23,2,15,0,17,2021-06-11,Female,19,15-19,3
23,1,0,0,1,2021-06-17,Male,65,65-69,1
23,0,2,0,2,2021-06-09,Male,25,25-34,20
23,0,0,0,0,2021-06-14,Male,20,20-24,15
23,0,3,0,3,2021-06-10,Female,44,35-44,2
23,2,0,0,2,2021-06-15,Male,71,70-74,21
23,0,0,0,0,2021-06-10,Male,35,35-44,22
23,0,0,0,0,2021-06-15,Female,37,35-44,3
23,1,0,0,1,2021-06-16,Female,35,35-44,14
23,1,0,0,1,2021-06-15,Male,63,55-64,3
23,3,1,0,4,2021-06-14,Male,17,15-19,2
23,0,0,0,0,2021-06-15,Female,46,45-54,8
23,1,0,0,1,2021-06-09,Male,72,70-74,3
23,1,0,0,1,2021-06-15,Male,29,25-34,3
23,1,0,0,1,2021-06-16,Female,67,65-69,2
23,0,0,0,0,2021-06-13,Female,24,20-24,21
23,0,0,0,0,2021-06-14,Female,67,65-69,17
23,3,0,0,3,2021-06-09,Male,24,20-24,18
23,0,0,0,0,2021-06-14,Female,5,5-9,16
23,1,0,0,1,2021-06-14,Female,68,65-69,15
23,0,0,0,0,2021-06-14,Male,68,65-69,20
23,2,1,0,3,2021-06-16,Female,0,<1,2
23,1,0,0,1,2021-06-13,Male,22,20-24,14
23,2,0,0,2,2021-06-09,Male,42,35-44,23
23,1,0,0,1,2021-06-16,Male,66,65-69,19
23,2,0,0,2,2021-06-10,Male,3,1-4,3
23,0,0,0,0,2021-06-14,Male,71,70-74,15
23,2,0,0,2,2021-06-15,Female,39,35-44,3
23,0,1,0,1,2021-06-15,Male,59,55-64,3
23,2,3,0,5,2021-06-10,Female,40,35-44,4
23,2,0,0,2,2021-06-10,Male,59,55-64,19
23,3,0,0,3,2021-06-09,Female,62,55-64,6
23,1,10,0,11,2021-06-09,Female,54,45-54,2
23,0,2,0,2,2021-06-12,Male,53,45-54,3
23,3,0,0,3,2021-06-09,Male,11,10-14,9
23,1,0,0,1,2021-06-10,Male,80,80-84,21
23,0,0,0,0,2021-06-11,Male,54,45-54,18
23,0,0,0,0,2021-06-09,Female,28,25-34,3
23,2,0,0,2,2021-06-13,Male,57,55-64,3
23,2,0,29,31,2021-06-10,Male,68,65-69,4
23,0,0,0,0,2021-06-11,Male,79,75-79,2
23,1,3,0,4,2021-06-14,Female,65,65-69,3
23,0,1,0,1,2021-06-15,Female,69,65-69,16
23,3,0,0,3,2021-06-14,Male,65,65-69,15
23,1,0,1,2,2021-06-10,Male,64,55-64,16
23,0,3,0,3,2021-06-14,Female,67,65-69,20
23,1,1,0,2,2021-06-22,Female,67,65-69,3
23,0,0,0,0,2021-06-10,Male,24,20-24,3
23,0,2,0,2,2021-06-14,Female,65,65-69,4
23,1,0,0,1,2021-06-16,Male,14,10-14,10
23,2,1,0,3,2021-06-09,Female,25,25-34,10
23,2,0,0,2,2021-06-10,Female,26,25-34,13
23,1,0,0,1,2021-06-14,Male,67,65-69,3
23,0,7,0,7,2021-06-14,Female,69,65-69,20
23,3,0,5,8,2021-06-09,Male,19,15-19,3
23,0,2,0,2,2021-06-14,Female,33,25-34,7
23,0,2,0,2,2021-06-10,Female,29,25-34,10
23,1,0,0,1,2021-06-14,Male,31,25-34,6
23,1,0,0,1,2021-06-14,Male,33,25-34,3
23,0,1,0,1,2021-06-09,Male,54,45-54,2
23,0,0,0,0,2021-06-12,Female,52,45-54,2
23,0,0,0,0,2021-06-14,Female,67,65-69,16
23,0,0,0,0,2021-06-14,Female,64,55-64,18
23,1,1,0,2,2021-06-14,Male,69,65-69,20
23,0,0,0,0,2021-06-13,Male,59,55-64,3
23,0,0,0,0,2021-06-10,Female,34,25-34,17
23,2,0,0,2,2021-06-09,Female,18,15-19,15
23,0,0,0,0,2021-06-14,Female,69,65-69,6
23,2,3,0,5,2021-06-09,Male,0,<1,3
23,1,0,0,1,2021-06-15,Female,66,65-69,2
23,0,1,0,1,2021-06-12,Male,53,45-54,3
23,0,0,0,0,2021-06-14,Female,72,70-74,14
23,0,0,0,0,2021-06-14,Female,7,5-9,20
23,1,0,0,1,2021-06-10,Female,38,35-44,3
23,4,1,0,5,2021-06-10,Female,24,20-24,3
23,3,1,0,4,2021-06-12,Female,53,45-54,18
23,2,0,0,2,2021-06-16,Male,61,55-64,19
23,2,0,0,2,2021-06-17,Female,66,65-69,15
23,2,0,0,2,2021-06-15,Female,79,75-79,17
23,3,1,0,4,2021-06-18,Female,18,15-19,1
23,0,0,0,0,2021-06-10,Female,22,20-24,6
23,1,0,0,1,2021-06-09,Male,57,55-64,2
23,0,0,0,0,2021-06-14,Female,71,70-74,3
23,0,0,0,0,2021-06-15,Male,54,45-54,15
23,2,0,0,2,2021-06-14,Male,66,65-69,3
23,2,0,0,2,2021-06-09,Male,11,10-14,3
23,0,1,0,1,2021-06-14,Male,58,55-64,2
23,1,0,0,1,2021-06-15,Male,31,25-34,4
23,0,1,0,1,2021-06-10,Male,66,65-69,22
23,1,0,0,1,2021-06-14,Male,65,65-69,3
23,1,0,0,1,2021-06-14,Female,70,70-74,19
23,0,0,0,0,2021-06-11,Female,76,75-79,21
23,2,0,0,2,2021-06-14,Male,61,55-64,3
23,2,45,0,47,2021-06-15,Female,15,15-19,3
23,0,0,0,0,2021-06-11,Male,37,35-44,18
23,1,0,0,1,2021-06-09,Female,65,65-69,2
23,1,0,0,1,2021-06-15,Female,49,45-54,18
23,1,1,0,2,2021-06-11,Male,61,55-64,17
23,1,0,0,1,2021-06-14,Female,66,65-69,3
23,1,0,0,1,2021-06-09,Male,32,25-34,4
23,1,10,6,17,2021-06-10,Male,55,55-64,3
23,1,0,0,1,2021-06-13,Female,51,45-54,16
23,1,0,0,1,2021-06-14,Female,71,70-74,4
23,5,0,0,5,2021-06-15,Female,4,1-4,2
23,1,0,0,1,2021-06-15,Male,69,65-69,20
23,1,0,1,2,2021-06-14,Female,62,55-64,3
23,0,0,0,0,2021-06-22,Male,19,15-19,2
23,0,0,0,0,2021-06-10,Male,62,55-64,18
23,2,2,0,4,2021-06-09,Male,27,25-34,9
23,0,1,0,1,2021-06-09,Male,61,55-64,3
23,0,0,0,0,2021-06-09,Male,19,15-19,2
23,0,0,0,0,2021-06-17,Female,66,65-69,15
23,1,0,0,1,2021-06-09,Female,33,25-34,13
23,0,0,0,0,2021-06-09,Male,19,15-19,3
23,3,0,0,3,2021-06-09,Female,44,35-44,3
23,0,4,0,4,2021-06-10,Female,61,55-64,13
23,1,0,0,1,2021-06-12,Male,52,45-54,3
23,1,0,0,1,2021-06-11,Female,61,55-64,18
23,0,5,0,5,2021-06-11,Male,52,45-54,18
23,1,0,0,1,2021-06-10,Female,50,45-54,19
23,3,0,0,3,2021-06-18,Female,20,20-24,1
23,1,0,0,1,2021-06-15,Male,59,55-64,2
23,0,2,1,3,2021-06-14,Female,63,55-64,3
23,1,0,0,1,2021-06-09,Male,19,15-19,3
23,0,1,0,1,2021-06-11,Male,74,70-74,21
23,8,0,0,8,2021-06-14,Female,17,15-19,20
23,0,1,0,1,2021-06-11,Male,64,55-64,5
23,1,0,0,1,2021-06-09,Male,51,45-54,3
23,1,0,0,1,2021-06-10,Male,33,25-34,21
23,1,0,0,1,2021-06-14,Female,70,70-74,19
23,0,0,0,0,2021-06-15,Female,81,80-84,9
23,0,0,0,0,2021-06-10,Male,43,35-44,5
23,0,0,0,0,2021-06-10,Male,17,15-19,6
23,3,15,0,18,2021-06-12,Female,14,10-14,19
23,1,0,0,1,2021-06-11,Male,77,75-79,3
23,1,1,0,2,2021-06-14,Male,40,35-44,2
23,0,0,0,0,2021-06-14,Female,66,65-69,18
23,1,0,0,1,2021-06-15,Female,27,25-34,20
23,1,2,0,3,2021-06-17,Female,15,15-19,1
23,1,0,0,1,2021-06-16,Female,62,55-64,2
23,2,1,0,3,2021-06-12,Male,76,75-79,21
23,1,0,0,1,2021-06-10,Male,68,65-69,3
23,0,0,0,0,2021-06-14,Male,64,55-64,3
23,0,0,0,0,2021-06-09,Female,30,25-34,5
23,0,6,0,6,2021-06-09,Male,25,25-34,2
23,1,0,0,1,2021-06-11,Male,74,70-74,18
23,0,0,0,0,2021-06-10,Male,31,25-34,17
23,4,0,0,4,2021-06-15,Female,12,10-14,3
23,0,0,0,0,2021-06-09,Female,24,20-24,21
23,1,0,0,1,2021-06-10,Female,23,20-24,11
23,0,0,0,0,2021-06-09,Female,43,35-44,9
23,1,0,0,1,2021-06-14,Male,63,55-64,20
23,1,0,0,1,2021-06-14,Female,13,10-14,3
23,2,0,0,2,2021-06-09,Female,55,55-64,13
23,0,2,0,2,2021-06-22,Female,30,25-34,2
23,0,0,0,0,2021-06-09,Female,20,20-24,3
23,0,1,0,1,2021-06-10,Male,64,55-64,19
23,3,0,0,3,2021-06-10,Male,18,15-19,17
23,0,0,0,0,2021-06-15,Male,51,45-54,3
23,0,0,0,0,2021-06-12,Male,54,45-54,3
23,0,0,0,0,2021-06-09,Female,24,20-24,3
23,3,2,0,5,2021-06-11,Female,21,20-24,3
23,2,0,0,2,2021-06-14,Male,55,55-64,22
23,1,0,0,1,2021-06-10,Male,36,35-44,3
23,1,0,0,1,2021-06-17,Male,67,65-69,1
23,0,0,0,0,2021-06-15,Male,61,55-64,15
23,0,0,0,0,2021-06-15,Female,6,5-9,20
23,0,1,0,1,2021-06-14,Female,66,65-69,8
23,0,0,0,0,2021-06-11,Male,73,70-74,16
23,2,0,0,2,2021-06-11,Male,73,70-74,16
23,1,0,0,1,2021-06-09,Female,53,45-54,21
23,0,0,0,0,2021-06-09,Male,34,25-34,15
23,0,0,0,0,2021-06-11,Female,49,45-54,3
23,0,0,30,30,2021-06-11,Male,32,25-34,2
23,1,1,0,2,2021-06-14,Female,72,70-74,3
23,0,0,0,0,2021-06-14,Female,72,70-74,18
23,0,1,0,1,2021-06-14,Male,70,70-74,3
23,0,0,0,0,2021-06-15,Female,28,25-34,3
23,4,0,0,4,2021-06-10,Male,20,20-24,2
23,0,0,0,0,2021-06-14,Male,30,25-34,20
23,2,0,0,2,2021-06-09,Female,18,15-19,15
23,0,2,0,2,2021-06-10,Female,57,55-64,22
23,0,0,0,0,2021-06-14,Male,67,65-69,17
23,0,0,0,0,2021-06-09,Male,51,45-54,3
23,0,9,0,9,2021-06-17,Female,67,65-69,1
23,0,2,0,2,2021-06-16,Male,55,55-64,18
23,2,4,0,6,2021-06-15,Female,48,45-54,2
23,1,0,0,1,2021-06-09,Male,6,5-9,4
23,0,0,0,0,2021-06-16,Male,8,5-9,18
23,2,0,0,2,2021-06-11,Male,27,25-34,2
23,0,2,0,2,2021-06-11,Female,51,45-54,2
23,2,0,0,2,2021-06-09,Male,67,65-69,22
23,0,0,0,0,2021-06-10,Female,38,35-44,3
23,2,0,0,2,2021-06-15,Male,6,5-9,3
23,0,0,0,0,2021-06-15,Female,69,65-69,15
23,2,0,0,2,2021-06-10,Male,28,25-34,2
23,2,0,0,2,2021-06-14,Male,51,45-54,13
23,1,2,0,3,2021-06-15,Female,70,70-74,8
23,0,0,0,0,2021-06-09,Female,30,25-34,18
23,0,0,0,0,2021-06-12,Male,46,45-54,20
23,1,0,0,1,2021-06-15,Female,42,35-44,3
23,1,0,0,1,2021-06-09,Female,63,55-64,2
23,0,0,0,0,2021-06-09,Male,57,55-64,3
23,2,0,0,2,2021-06-14,Female,69,65-69,18
23,1,0,0,1,2021-06-10,Male,45,45-54,2
23,1,0,0,1,2021-06-09,Male,50,45-54,4
23,2,0,0,2,2021-06-14,Male,37,35-44,4
23,1,4,0,5,2021-06-09,Male,55,55-64,15
23,1,4,0,5,2021-06-11,Female,48,45-54,16
23,0,3,0,3,2021-06-10,Female,42,35-44,10
23,1,0,0,1,2021-06-11,Male,64,55-64,21
23,1,1,0,2,2021-06-14,Male,66,65-69,20
23,2,3,6,11,2021-06-10,Female,3,1-4,3
23,2,0,0,2,2021-06-15,Male,5,5-9,22
23,1,0,0,1,2021-06-13,Male,28,25-34,2
23,2,0,0,2,2021-06-09,Female,18,15-19,4
23,1,0,0,1,2021-06-14,Female,19,15-19,3
23,0,0,0,0,2021-06-09,Female,50,45-54,7
23,0,1,0,1,2021-06-11,Male,58,55-64,22
23,1,4,0,5,2021-06-10,Female,66,65-69,23
23,1,0,0,1,2021-06-12,Male,52,45-54,15
23,1,2,0,3,2021-06-10,Female,68,65-69,2
23,2,0,0,2,2021-06-16,Female,53,45-54,8
23,2,0,0,2,2021-06-14,Female,10,10-14,18
23,2,0,2,4,2021-06-14,Female,72,70-74,9
23,2,0,0,2,2021-06-14,Male,1,1-4,3
23,4,4,0,8,2021-06-13,Male,12,10-14,23
23,1,5,0,6,2021-06-09,Male,51,45-54,21
23,0,0,0,0,2021-06-16,Female,52,45-54,8
23,5,1,0,6,2021-06-10,Female,21,20-24,2
23,0,2,0,2,2021-06-11,Male,74,70-74,22
23,0,0,0,0,2021-06-09,Male,19,15-19,11
23,0,0,0,0,2021-06-14,Female,30,25-34,4
23,3,0,0,3,2021-06-11,Female,9,5-9,3
23,0,0,0,0,2021-06-14,Female,67,65-69,15
23,1,0,0,1,2021-06-13,Male,55,55-64,20
23,0,1,0,1,2021-06-14,Female,69,65-69,22
23,0,2,0,2,2021-06-13,Female,79,75-79,8
23,0,0,1,1,2021-06-09,Male,41,35-44,2
23,0,0,0,0,2021-06-11,Male,78,75-79,18
23,0,0,0,0,2021-06-09,Female,33,25-34,9
23,0,0,0,0,2021-06-11,Male,85,85+,15
23,0,0,0,0,2021-06-14,Female,4,1-4,2
23,2,3,0,5,2021-06-12,Male,54,45-54,3
23,0,0,0,0,2021-06-09,Male,69,65-69,3
23,0,0,0,0,2021-06-14,Male,32,25-34,12
23,1,1,0,2,2021-06-10,Female,64,55-64,14
23,1,0,0,1,2021-06-10,Female,67,65-69,13
23,2,0,0,2,2021-06-11,Male,66,65-69,18
23,1,4,0,5,2021-06-11,Male,60,55-64,22
23,1,0,0,1,2021-06-10,Male,55,55-64,19
23,0,0,0,0,2021-06-14,Male,69,65-69,2
23,0,1,0,1,2021-06-15,Female,70,70-74,2
23,0,0,0,0,2021-06-16,Female,25,25-34,22
23,0,0,0,0,2021-06-19,Female,23,20-24,1
23,0,6,0,6,2021-06-09,Male,50,45-54,3
23,1,0,0,1,2021-06-09,Male,36,35-44,19
23,1,0,0,1,2021-06-13,Male,52,45-54,22
23,1,1,0,2,2021-06-14,Male,69,65-69,3
23,0,1,0,1,2021-06-22,Female,66,65-69,9
23,0,1,0,1,2021-06-09,Female,24,20-24,20
23,0,0,0,0,2021-06-14,Female,49,45-54,23
23,0,1,0,1,2021-06-14,Male,41,35-44,3
23,0,11,0,11,2021-06-10,Male,40,35-44,15
23,1,0,0,1,2021-06-14,Female,21,20-24,2
23,0,1,0,1,2021-06-15,Male,70,70-74,20
23,2,0,0,2,2021-06-14,Male,67,65-69,3
23,2,1,0,3,2021-06-14,Female,64,55-64,22
23,1,0,0,1,2021-06-14,Male,70,70-74,3
23,1,0,0,1,2021-06-10,Female,54,45-54,3
23,1,0,0,1,2021-06-09,Male,58,55-64,2
23,1,1,0,2,2021-06-10,Male,64,55-64,19
23,1,0,0,1,2021-06-09,Female,23,20-24,4
23,0,0,0,0,2021-06-14,Male,38,35-44,14
23,0,0,0,0,2021-06-11,Female,21,20-24,10
23,2,0,0,2,2021-06-11,Male,23,20-24,2
23,2,2,0,4,2021-06-09,Male,34,25-34,5
23,0,0,0,0,2021-06-14,Female,23,20-24,10
23,1,0,0,1,2021-06-11,Female,76,75-79,3
23,1,0,0,1,2021-06-11,Male,54,45-54,2
23,2,0,0,2,2021-06-11,Female,61,55-64,20
23,1,0,0,1,2021-06-10,Male,49,45-54,3
23,0,0,0,0,2021-06-14,Female,58,55-64,3
23,1,4,0,5,2021-06-13,Female,57,55-64,15
23,0,1,0,1,2021-06-09,Female,65,65-69,2
23,1,2,0,3,2021-06-15,Male,52,45-54,3
23,2,0,0,2,2021-06-09,Male,4,1-4,3
23,1,0,0,1,2021-06-10,Male,53,45-54,18
23,0,3,0,3,2021-06-14,Female,66,65-69,23
23,1,0,0,1,2021-06-09,Female,27,25-34,2
23,1,3,0,4,2021-06-10,Male,3,1-4,3
23,0,4,0,4,2021-06-11,Female,67,65-69,19
23,0,1,0,1,2021-06-14,Female,70,70-74,16
23,3,0,0,3,2021-06-16,Female,8,5-9,17
23,1,0,0,1,2021-06-14,Female,37,35-44,3
23,0,1,0,1,2021-06-09,Male,54,45-54,17
23,4,4,0,8,2021-06-14,Female,46,45-54,12
23,0,3,0,3,2021-06-10,Male,55,55-64,16
23,0,1,0,1,2021-06-11,Male,73,70-74,2
23,1,1,0,2,2021-06-10,Male,54,45-54,2
23,0,0,0,0,2021-06-16,Female,43,35-44,2
23,3,3,0,6,2021-06-09,Male,18,15-19,3
23,0,0,0,0,2021-06-10,Male,61,55-64,2
23,1,28,0,29,2021-06-09,Male,58,55-64,18
23,2,0,0,2,2021-06-09,Male,40,35-44,21
23,3,0,0,3,2021-06-14,Female,21,20-24,18
23,1,0,0,1,2021-06-10,Male,57,55-64,3
23,1,0,0,1,2021-06-15,Male,66,65-69,3
23,0,0,0,0,2021-06-11,Female,49,45-54,2
23,1,0,0,1,2021-06-09,Female,65,65-69,3
23,0,0,0,0,2021-06-13,Male,31,25-34,2
23,2,0,0,2,2021-06-11,Female,9,5-9,19
23,1,0,0,1,2021-06-10,Male,66,65-69,21
23,0,1,0,1,2021-06-10,Male,61,55-64,18
23,1,0,0,1,2021-06-14,Male,66,65-69,3
23,0,0,0,0,2021-06-10,Female,19,15-19,8
23,0,0,0,0,2021-06-14,Female,39,35-44,2
23,1,0,0,1,2021-06-15,Female,33,25-34,10
23,0,0,0,0,2021-06-10,Female,57,55-64,18
23,1,2,0,3,2021-06-11,Male,48,45-54,3
23,0,0,0,0,2021-06-09,Female,23,20-24,2
23,1,0,0,1,2021-06-14,Male,71,70-74,21
23,5,0,0,5,2021-06-10,Female,18,15-19,22
23,1,0,0,1,2021-06-10,Male,63,55-64,22
23,2,0,0,2,2021-06-09,Male,28,25-34,3
23,1,2,0,3,2021-06-10,Male,68,65-69,23
23,0,0,0,0,2021-06-12,Female,21,20-24,3
23,1,0,0,1,2021-06-12,Female,48,45-54,2
23,0,0,0,0,2021-06-13,Male,20,20-24,3
23,2,4,0,6,2021-06-12,Male,77,75-79,10
23,0,0,0,0,2021-06-14,Male,65,65-69,2
23,2,0,0,2,2021-06-09,Male,46,45-54,3
23,3,2,0,5,2021-06-09,Female,4,1-4,2
23,1,0,0,1,2021-06-14,Male,60,55-64,2
23,1,0,0,1,2021-06-15,Female,71,70-74,19
23,1,9,0,10,2021-06-11,Male,74,70-74,3
23,0,1,0,1,2021-06-12,Male,52,45-54,12
23,0,1,0,1,2021-06-14,Female,60,55-64,14
23,1,0,0,1,2021-06-13,Female,61,55-64,7
23,3,0,0,3,2021-06-14,Male,5,5-9,23
23,2,0,0,2,2021-06-09,Female,56,55-64,21
23,0,0,0,0,2021-06-12,Male,53,45-54,13
23,1,1,0,2,2021-06-14,Male,72,70-74,3
23,0,5,0,5,2021-06-09,Male,44,35-44,3
23,0,0,0,0,2021-06-11,Female,36,35-44,18
23,2,2,0,4,2021-06-13,Male,56,55-64,17
23,1,1,0,2,2021-06-14,Male,63,55-64,19
23,0,0,0,0,2021-06-13,Female,61,55-64,2
23,0,0,0,0,2021-06-13,Male,58,55-64,2
23,0,0,0,0,2021-06-14,Male,66,65-69,12
23,1,0,0,1,2021-06-16,Male,68,65-69,2
23,0,0,0,0,2021-06-09,Male,47,45-54,2
23,0,0,0,0,2021-06-13,Male,54,45-54,16
23,2,0,0,2,2021-06-16,Female,73,70-74,12
23,2,0,0,2,2021-06-11,Female,22,20-24,9
23,0,0,0,0,2021-06-09,Male,12,10-14,20
23,2,0,0,2,2021-06-14,Male,79,75-79,14
23,1,0,0,1,2021-06-10,Male,69,65-69,2
23,1,0,3,4,2021-06-16,Female,24,20-24,6
23,1,2,0,3,2021-06-15,Female,66,65-69,19
23,1,0,0,1,2021-06-11,Male,77,75-79,3
23,5,0,0,5,2021-06-09,Female,14,10-14,18
23,2,0,0,2,2021-06-09,Female,2,1-4,3
23,1,0,0,1,2021-06-14,Male,65,65-69,23
23,1,0,0,1,2021-06-14,Female,40,35-44,3
23,1,0,0,1,2021-06-12,Female,52,45-54,18
23,2,0,0,2,2021-06-09,Female,20,20-24,22
23,1,0,0,1,2021-06-11,Female,56,55-64,2
23,1,1,0,2,2021-06-09,Male,32,25-34,3
23,1,2,2,5,2021-06-16,Female,47,45-54,2
23,0,0,0,0,2021-06-22,Female,73,70-74,16
23,1,0,0,1,2021-06-10,Male,34,25-34,3
23,0,2,0,2,2021-06-11,Male,64,55-64,3
23,0,2,0,2,2021-06-15,Female,56,55-64,14
23,1,0,0,1,2021-06-13,Male,52,45-54,3
23,2,0,0,2,2021-06-15,Male,21,20-24,2
23,1,4,0,5,2021-06-09,Male,65,65-69,3
23,1,30,30,61,2021-06-13,Male,54,45-54,18
23,0,0,0,0,2021-06-09,Male,61,55-64,3
23,0,0,0,0,2021-06-15,Female,60,55-64,7
23,1,0,0,1,2021-06-14,Male,62,55-64,3
23,1,1,0,2,2021-06-22,Male,70,70-74,3
23,3,0,0,3,2021-06-09,Female,13,10-14,3
23,2,1,0,3,2021-06-13,Male,56,55-64,22
23,1,0,0,1,2021-06-10,Female,55,55-64,19
23,0,0,0,0,2021-06-17,Male,66,65-69,1
23,2,1,3,6,2021-06-14,Male,25,25-34,3
23,1,0,0,1,2021-06-16,Female,57,55-64,3
23,2,1,0,3,2021-06-10,Male,15,15-19,4
23,0,0,0,0,2021-06-13,Male,60,55-64,20
23,1,0,0,1,2021-06-11,Female,29,25-34,2
23,0,1,0,1,2021-06-16,Female,67,65-69,11
23,3,3,0,6,2021-06-13,Female,0,<1,2
23,0,0,0,0,2021-06-10,Female,24,20-24,19
23,1,0,0,1,2021-06-15,Female,66,65-69,3
23,1,0,0,1,2021-06-09,Male,32,25-34,20
23,2,0,0,2,2021-06-17,Female,31,25-34,1
23,1,0,0,1,2021-06-12,Female,76,75-79,2
23,0,0,0,0,2021-06-12,Male,48,45-54,19
23,0,6,0,6,2021-06-16,Female,18,15-19,3
23,3,0,0,3,2021-06-09,Female,19,15-19,2
23,0,0,0,0,2021-06-22,Male,3,1-4,11
23,0,0,0,0,2021-06-11,Female,34,25-34,20
23,1,0,0,1,2021-06-09,Female,41,35-44,23
23,1,0,0,1,2021-06-14,Male,69,65-69,20
23,5,0,0,5,2021-06-14,Female,7,5-9,2
23,0,3,0,3,2021-06-16,Male,73,70-74,12
23,2,1,0,3,2021-06-11,Female,74,70-74,16
23,2,0,0,2,2021-06-10,Male,66,65-69,20
23,0,1,0,1,2021-06-11,Female,49,45-54,8
23,1,1,0,2,2021-06-14,Female,63,55-64,3
23,1,0,0,1,2021-06-09,Male,34,25-34,19
23,1,0,0,1,2021-06-14,Female,50,45-54,18
23,1,1,0,2,2021-06-11,Male,49,45-54,2
23,0,2,0,2,2021-06-14,Female,66,65-69,16
23,1,0,0,1,2021-06-09,Male,23,20-24,2
23,0,0,0,0,2021-06-14,Male,69,65-69,20
23,0,0,0,0,2021-06-22,Female,21,20-24,3
23,1,0,0,1,2021-06-09,Female,58,55-64,3
23,1,0,0,1,2021-06-22,Male,70,70-74,2
23,0,0,0,0,2021-06-10,Female,59,55-64,3
23,0,0,0,0,2021-06-12,Female,73,70-74,19
23,0,0,0,0,2021-06-13,Male,57,55-64,2
23,0,0,0,0,2021-06-13,Male,59,55-64,16
23,2,0,0,2,2021-06-18,Male,12,10-14,1
23,2,0,0,2,2021-06-09,Male,69,65-69,22
23,1,4,0,5,2021-06-15,Female,49,45-54,3
23,2,7,0,9,2021-06-16,Female,60,55-64,6
23,0,0,0,0,2021-06-15,Male,79,75-79,9
23,2,0,0,2,2021-06-14,Male,71,70-74,16
23,0,4,0,4,2021-06-14,Male,60,55-64,18
23,1,0,0,1,2021-06-10,Male,59,55-64,18
23,1,0,0,1,2021-06-14,Male,67,65-69,17
23,0,0,0,0,2021-06-12,Female,54,45-54,18
23,0,1,0,1,2021-06-11,Male,51,45-54,14
23,2,0,0,2,2021-06-15,Male,16,15-19,18
23,3,0,0,3,2021-06-09,Male,2,1-4,19
23,1,0,0,1,2021-06-14,Female,31,25-34,19
23,0,2,0,2,2021-06-15,Male,61,55-64,18
23,1,2,0,3,2021-06-15,Female,70,70-74,17
23,1,2,0,3,2021-06-14,Male,68,65-69,22
23,0,0,0,0,2021-06-13,Male,61,55-64,3
23,1,0,0,1,2021-06-09,Male,47,45-54,10
23,0,0,0,0,2021-06-13,Male,59,55-64,2
23,0,0,0,0,2021-06-14,Female,71,70-74,3
23,0,0,0,0,2021-06-16,Female,25,25-34,8
23,0,1,0,1,2021-06-13,Male,60,55-64,5
23,3,1,0,4,2021-06-15,Female,66,65-69,14
23,0,0,0,0,2021-06-09,Male,27,25-34,3
23,2,2,0,4,2021-06-10,Female,26,25-34,3
23,1,0,0,1,2021-06-11,Female,28,25-34,9
23,0,0,0,0,2021-06-13,Female,56,55-64,3
23,1,1,0,2,2021-06-13,Female,23,20-24,16
23,0,0,0,0,2021-06-14,Female,64,55-64,10
23,0,0,0,0,2021-06-22,Female,69,65-69,13
23,1,0,2,3,2021-06-12,Female,48,45-54,16
23,0,3,0,3,2021-06-14,Male,59,55-64,19
23,0,0,0,0,2021-06-11,Male,37,35-44,21
23,0,3,0,3,2021-06-09,Female,43,35-44,18
23,0,2,0,2,2021-06-12,Male,52,45-54,20
23,3,10,0,13,2021-06-10,Male,8,5-9,2
23,4,0,0,4,2021-06-09,Female,32,25-34,13
23,1,7,0,8,2021-06-11,Male,73,70-74,3
23,2,0,0,2,2021-06-13,Male,6,5-9,15
23,2,0,0,2,2021-06-09,Male,25,25-34,2
23,1,0,0,1,2021-06-09,Female,22,20-24,2
23,3,0,0,3,2021-06-14,Female,1,1-4,3
23,0,0,0,0,2021-06-09,Male,44,35-44,3
23,0,0,1,1,2021-06-09,Female,46,45-54,21
23,3,6,0,9,2021-06-14,Male,69,65-69,16
23,0,0,5,5,2021-06-10,Male,42,35-44,16
23,1,0,0,1,2021-06-17,Female,68,65-69,1
23,0,8,0,8,2021-06-09,Female,42,35-44,2
23,0,0,0,0,2021-06-10,Male,63,55-64,16
23,1,0,0,1,2021-06-13,Male,55,55-64,20
23,1,0,0,1,2021-06-11,Female,52,45-54,17
23,1,18,0,19,2021-06-12,Female,52,45-54,3
23,0,0,0,0,2021-06-14,Female,66,65-69,17
23,3,0,0,3,2021-06-12,Male,19,15-19,20
23,1,0,0,1,2021-06-17,Female,71,70-74,1
23,3,0,0,3,2021-06-14,Female,14,10-14,5
23,0,2,0,2,2021-06-14,Male,55,55-64,20
23,1,0,0,1,2021-06-13,Male,58,55-64,5
23,1,1,0,2,2021-06-09,Female,37,35-44,3
23,3,1,0,4,2021-06-13,Female,60,55-64,17
23,2,4,0,6,2021-06-13,Female,28,25-34,3
23,1,0,0,1,2021-06-17,Female,36,35-44,13
23,0,0,0,0,2021-06-13,Male,60,55-64,15
23,2,0,0,2,2021-06-11,Female,51,45-54,11
23,1,0,0,1,2021-06-14,Female,63,55-64,3
23,0,5,0,5,2021-06-15,Male,65,65-69,3
23,1,1,0,2,2021-06-13,Female,21,20-24,20
23,1,0,0,1,2021-06-15,Male,32,25-34,2
23,3,0,0,3,2021-06-15,Female,56,55-64,15
23,3,0,0,3,2021-06-14,Female,67,65-69,18
23,0,3,0,3,2021-06-12,Male,54,45-54,4
23,0,0,0,0,2021-06-13,Male,58,55-64,5
23,0,0,0,0,2021-06-15,Male,29,25-34,3
23,2,0,0,2,2021-06-11,Male,52,45-54,21
23,0,0,0,0,2021-06-15,Female,62,55-64,5
23,1,0,0,1,2021-06-14,Female,59,55-64,8
23,0,4,0,4,2021-06-16,Male,65,65-69,18
23,0,0,0,0,2021-06-14,Male,38,35-44,3
23,1,0,0,1,2021-06-09,Male,49,45-54,17
23,0,0,0,0,2021-06-09,Male,60,55-64,19
23,1,0,0,1,2021-06-11,Male,70,70-74,18
23,0,5,0,5,2021-06-09,Male,31,25-34,20
23,0,0,0,0,2021-06-15,Male,36,35-44,19
23,2,0,0,2,2021-06-14,Female,9,5-9,1
23,1,0,0,1,2021-06-14,Female,69,65-69,20
23,1,9,0,10,2021-06-13,Female,57,55-64,9
23,0,1,0,1,2021-06-09,Female,26,25-34,20
23,0,1,0,1,2021-06-10,Female,24,20-24,9
23,2,0,0,2,2021-06-14,Female,55,55-64,6
23,1,0,0,1,2021-06-13,Female,60,55-64,19
23,1,0,0,1,2021-06-13,Female,54,45-54,3
23,0,0,0,0,2021-06-09,Male,41,35-44,16
23,1,0,0,1,2021-06-11,Female,73,70-74,3
23,0,1,0,1,2021-06-14,Male,66,65-69,23
23,1,0,0,1,2021-06-09,Male,53,45-54,15
23,1,0,0,1,2021-06-15,Female,42,35-44,2
23,0,1,0,1,2021-06-09,Male,70,70-74,16
23,3,0,0,3,2021-06-09,Female,4,1-4,2
23,0,3,0,3,2021-06-09,Female,24,20-24,7
23,2,0,0,2,2021-06-09,Male,35,35-44,4
23,0,2,0,2,2021-06-14,Female,40,35-44,8
23,2,0,0,2,2021-06-10,Female,66,65-69,23
23,1,0,0,1,2021-06-14,Male,70,70-74,20
23,1,0,0,1,2021-06-14,Male,34,25-34,11
23,0,0,0,0,2021-06-15,Female,65,65-69,3
23,0,0,0,0,2021-06-14,Male,45,45-54,2
23,1,0,0,1,2021-06-10,Female,26,25-34,2
23,0,0,0,0,2021-06-11,Male,46,45-54,13
23,0,0,0,0,2021-06-14,Female,66,65-69,19
23,0,0,0,0,2021-06-16,Female,62,55-64,3
23,1,1,0,2,2021-06-11,Male,79,75-79,18
23,2,0,0,2,2021-06-14,Male,72,70-74,15
23,0,0,0,0,2021-06-15,Female,41,35-44,17
23,2,0,0,2,2021-06-10,Female,26,25-34,9
23,1,0,0,1,2021-06-14,Female,68,65-69,17
23,0,0,0,0,2021-06-14,Female,65,65-69,19
23,0,13,0,13,2021-06-09,Female,41,35-44,2
23,0,0,0,0,2021-06-13,Female,56,55-64,2
23,1,0,0,1,2021-06-10,Male,59,55-64,23
23,3,0,0,3,2021-06-09,Male,12,10-14,3
23,2,0,0,2,2021-06-14,Male,70,70-74,22
23,2,0,0,2,2021-06-09,Male,45,45-54,3
23,2,1,0,3,2021-06-09,Female,46,45-54,2
23,1,0,0,1,2021-06-09,Male,47,45-54,2
23,1,0,3,4,2021-06-09,Male,39,35-44,10
23,1,1,0,2,2021-06-10,Male,51,45-54,22
23,1,0,0,1,2021-06-09,Female,27,25-34,9
23,3,0,0,3,2021-06-09,Female,20,20-24,2
23,2,15,44,61,2021-06-15,Male,8,5-9,12
23,1,0,0,1,2021-06-14,Female,38,35-44,2
23,1,1,0,2,2021-06-16,Male,72,70-74,19
23,0,1,0,1,2021-06-16,Female,73,70-74,3
23,3,0,0,3,2021-06-11,Male,10,10-14,3
23,1,3,0,4,2021-06-17,Male,65,65-69,1
23,0,4,0,4,2021-06-15,Female,78,75-79,15
23,0,3,0,3,2021-06-12,Female,53,45-54,12
23,1,2,0,3,2021-06-14,Female,64,55-64,18
23,2,0,0,2,2021-06-15,Female,18,15-19,21
23,1,3,0,4,2021-06-15,Female,39,35-44,21
23,2,22,100,124,2021-06-11,Male,19,15-19,2
23,0,0,0,0,2021-06-10,Female,65,65-69,3
23,2,0,0,2,2021-06-11,Male,78,75-79,15
23,0,0,0,0,2021-06-15,Male,53,45-54,21
23,0,4,0,4,2021-06-10,Male,40,35-44,20
23,0,0,0,0,2021-06-14,Male,67,65-69,18
23,1,1,0,2,2021-06-14,Female,67,65-69,18
23,1,0,0,1,2021-06-09,Female,69,65-69,22
23,3,0,0,3,2021-06-09,Female,17,15-19,17
23,0,0,0,0,2021-06-13,Female,29,25-34,21
23,1,0,0,1,2021-06-14,Female,64,55-64,16
23,0,0,0,0,2021-06-10,Female,0,<1,3
23,0,0,0,0,2021-06-14,Female,33,25-34,16
23,1,2,0,3,2021-06-17,Female,49,45-54,11
23,0,0,0,0,2021-06-09,Female,47,45-54,18
23,1,0,0,1,2021-06-10,Male,66,65-69,16
23,0,0,0,0,2021-06-14,Female,68,65-69,20
23,2,2,0,4,2021-06-09,Female,50,45-54,16
23,1,0,0,1,2021-06-09,Female,72,70-74,2
23,1,0,0,1,2021-06-15,Male,62,55-64,12
23,2,25,0,27,2021-06-12,Female,16,15-19,3
23,0,0,0,0,2021-06-13,Male,60,55-64,18
23,1,0,0,1,2021-06-09,Male,67,65-69,3
23,0,1,0,1,2021-06-16,Female,32,25-34,3
23,1,0,0,1,2021-06-15,Male,60,55-64,19
23,1,2,0,3,2021-06-09,Female,50,45-54,3
23,0,0,0,0,2021-06-10,Male,34,25-34,2
23,2,0,0,2,2021-06-13,Male,26,25-34,20
23,1,2,0,3,2021-06-15,Female,68,65-69,17
23,0,2,0,2,2021-06-14,Female,43,35-44,3
23,1,1,0,2,2021-06-10,Male,57,55-64,17
23,0,0,0,0,2021-06-14,Male,48,45-54,6
23,2,0,0,2,2021-06-14,Male,70,70-74,18
23,1,0,0,1,2021-06-09,Female,20,20-24,2
23,2,0,0,2,2021-06-14,Male,70,70-74,21
23,1,0,0,1,2021-06-14,Male,64,55-64,3
23,1,0,0,1,2021-06-09,Female,46,45-54,3
23,0,0,0,0,2021-06-14,Male,60,55-64,19
23,0,1,0,1,2021-06-10,Female,52,45-54,3
23,0,0,0,0,2021-06-12,Male,52,45-54,15
23,2,11,3,16,2021-06-10,Male,31,25-34,19
23,1,0,0,1,2021-06-16,Female,67,65-69,3
23,0,0,0,0,2021-06-15,Male,22,20-24,10
23,1,0,0,1,2021-06-09,Female,36,35-44,3
23,2,0,0,2,2021-06-09,Female,1,1-4,20
23,2,0,0,2,2021-06-10,Male,53,45-54,2
23,0,0,0,0,2021-06-09,Female,35,35-44,3
23,1,0,0,1,2021-06-10,Female,64,55-64,17
23,0,0,0,0,2021-06-15,Male,43,35-44,20
23,0,1,0,1,2021-06-10,Male,51,45-54,2
23,2,0,0,2,2021-06-10,Male,35,35-44,5
23,0,0,0,0,2021-06-15,Female,48,45-54,2
23,2,0,0,2,2021-06-09,Female,58,55-64,3
23,1,8,0,9,2021-06-15,Male,5,5-9,9
23,3,0,0,3,2021-06-09,Male,5,5-9,2
23,3,0,0,3,2021-06-10,Female,7,5-9,3
23,1,0,0,1,2021-06-10,Male,37,35-44,17
23,0,0,0,0,2021-06-10,Female,48,45-54,3
23,3,0,0,3,2021-06-11,Male,11,10-14,17
23,0,0,0,0,2021-06-10,Male,61,55-64,5
23,0,1,0,1,2021-06-16,Female,52,45-54,9
23,0,36,0,36,2021-06-15,Male,41,35-44,3
23,0,0,0,0,2021-06-09,Male,25,25-34,14
23,2,0,3,5,2021-06-17,Female,51,45-54,16
23,2,0,0,2,2021-06-15,Female,68,65-69,18
23,1,0,0,1,2021-06-14,Male,63,55-64,20
23,1,0,0,1,2021-06-15,Male,32,25-34,13
23,1,0,0,1,2021-06-11,Male,52,45-54,21
23,2,0,0,2,2021-06-14,Male,25,25-34,2
23,1,0,0,1,2021-06-22,Male,43,35-44,8
23,1,0,0,1,2021-06-15,Female,31,25-34,2
23,0,1,0,1,2021-06-10,Female,56,55-64,16
23,0,0,0,0,2021-06-15,Female,26,25-34,11
23,0,0,0,0,2021-06-14,Male,71,70-74,20
23,0,1,0,1,2021-06-10,Female,65,65-69,3
23,0,0,0,0,2021-06-16,Male,37,35-44,3
23,1,4,0,5,2021-06-15,Male,70,70-74,3
23,2,1,0,3,2021-06-09,Female,60,55-64,20
23,0,0,0,0,2021-06-09,Male,34,25-34,3
23,0,0,0,0,2021-06-14,Male,41,35-44,18
23,0,0,0,0,2021-06-09,Female,46,45-54,10
23,0,0,0,0,2021-06-15,Male,39,35-44,6
23,0,0,0,0,2021-06-13,Male,54,45-54,18
23,0,3,0,3,2021-06-16,Female,31,25-34,21
23,0,4,0,4,2021-06-16,Female,34,25-34,3
23,0,0,0,0,2021-06-09,Male,33,25-34,22
23,1,0,0,1,2021-06-15,Male,69,65-69,5
23,1,0,0,1,2021-06-10,Male,56,55-64,3
23,0,0,0,0,2021-06-17,Male,5,5-9,1
23,0,0,0,0,2021-06-14,Male,47,45-54,17
23,1,0,0,1,2021-06-15,Female,55,55-64,14
23,0,1,0,1,2021-06-09,Female,67,65-69,21
23,0,0,0,0,2021-06-10,Female,68,65-69,18
23,1,0,0,1,2021-06-15,Male,60,55-64,2
23,2,0,0,2,2021-06-09,Male,20,20-24,2
23,0,0,0,0,2021-06-09,Female,23,20-24,9
23,0,1,0,1,2021-06-15,Female,60,55-64,10
23,0,0,0,0,2021-06-10,Female,37,35-44,3
23,0,0,0,0,2021-06-15,Female,56,55-64,21
23,1,4,0,5,2021-06-13,Female,61,55-64,2
23,0,2,0,2,2021-06-17,Female,73,70-74,3
23,3,0,0,3,2021-06-09,Male,1,1-4,13
23,0,1,0,1,2021-06-16,Female,47,45-54,3
23,0,0,0,0,2021-06-14,Male,39,35-44,15
23,1,12,0,13,2021-06-09,Male,68,65-69,20
23,1,0,0,1,2021-06-15,Male,10,10-14,16
23,2,1,0,3,2021-06-14,Male,12,10-14,3
23,0,0,5,5,2021-06-09,Male,24,20-24,11
23,2,0,0,2,2021-06-14,Female,15,15-19,13
23,1,0,0,1,2021-06-11,Male,79,75-79,15
23,1,1,0,2,2021-06-11,Male,66,65-69,3
23,4,0,0,4,2021-06-09,Female,16,15-19,3
23,0,0,0,0,2021-06-09,Female,27,25-34,2
23,0,2,0,2,2021-06-11,Male,23,20-24,3
23,2,0,0,2,2021-06-15,Female,7,5-9,2
23,5,0,0,5,2021-06-15,Male,17,15-19,16
23,1,0,0,1,2021-06-17,Male,30,25-34,3
23,1,0,0,1,2021-06-09,Male,32,25-34,17
23,3,0,0,3,2021-06-13,Male,19,15-19,14
23,0,0,0,0,2021-06-16,Male,76,75-79,3
23,1,0,0,1,2021-06-12,Female,54,45-54,3
23,1,0,0,1,2021-06-10,Female,68,65-69,13
23,1,7,0,8,2021-06-13,Male,58,55-64,20
23,0,2,0,2,2021-06-11,Male,42,35-44,19
23,0,0,0,0,2021-06-12,Male,53,45-54,3
23,1,0,0,1,2021-06-11,Male,48,45-54,3
23,1,0,0,1,2021-06-17,Male,73,70-74,1
23,3,1,0,4,2021-06-14,Male,10,10-14,20
23,3,1,0,4,2021-06-14,Male,11,10-14,17
23,0,1,0,1,2021-06-13,Male,12,10-14,3
23,0,0,0,0,2021-06-14,Male,65,65-69,19
23,1,1,0,2,2021-06-14,Female,67,65-69,19
23,1,0,0,1,2021-06-16,Female,68,65-69,19
23,1,15,23,39,2021-06-17,Female,14,10-14,1
23,1,0,0,1,2021-06-13,Male,55,55-64,3
23,2,1,0,3,2021-06-15,Male,81,80-84,16
23,0,0,0,0,2021-06-11,Male,51,45-54,18
23,0,3,0,3,2021-06-11,Male,51,45-54,3
23,1,40,0,41,2021-06-15,Female,50,45-54,2
23,0,0,0,0,2021-06-10,Female,21,20-24,15
23,3,0,0,3,2021-06-14,Female,10,10-14,3
23,0,11,0,11,2021-06-11,Female,48,45-54,18
23,1,0,0,1,2021-06-14,Male,72,70-74,19
23,0,0,0,0,2021-06-09,Male,20,20-24,20
23,0,0,0,0,2021-06-15,Female,66,65-69,3
23,0,0,0,0,2021-06-09,Male,28,25-34,18
23,1,0,0,1,2021-06-10,Female,32,25-34,2
23,2,0,0,2,2021-06-13,Female,13,10-14,9
23,1,0,0,1,2021-06-09,Female,63,55-64,21
23,1,1,0,2,2021-06-12,Female,53,45-54,15
23,0,0,0,0,2021-06-14,Male,66,65-69,22
23,0,0,0,0,2021-06-11,Male,57,55-64,14
23,0,0,0,0,2021-06-14,Male,66,65-69,21
23,1,0,0,1,2021-06-09,Male,64,55-64,22
23,0,1,0,1,2021-06-11,Female,69,65-69,17
23,1,0,0,1,2021-06-15,Female,62,55-64,3
23,2,0,0,2,2021-06-16,Female,69,65-69,15
23,1,1,0,2,2021-06-10,Male,31,25-34,13
23,0,0,0,0,2021-06-10,Male,34,25-34,3
23,0,1,0,1,2021-06-21,Female,22,20-24,1
23,0,0,0,0,2021-06-09,Female,30,25-34,18
23,1,0,0,1,2021-06-14,Male,72,70-74,21
23,0,1,0,1,2021-06-14,Female,63,55-64,20
23,2,0,0,2,2021-06-15,Male,71,70-74,18
23,0,0,0,0,2021-06-13,Female,23,20-24,9
23,1,0,0,1,2021-06-13,Female,56,55-64,3
23,0,0,0,0,2021-06-14,Female,22,20-24,2
23,5,0,0,5,2021-06-09,Female,16,15-19,20
23,3,0,0,3,2021-06-14,Female,65,65-69,22
23,0,2,0,2,2021-06-10,Female,62,55-64,19
23,0,0,0,0,2021-06-14,Female,32,25-34,17
23,1,0,0,1,2021-06-09,Female,60,55-64,3
23,0,1,0,1,2021-06-13,Male,58,55-64,3
23,2,0,0,2,2021-06-13,Male,55,55-64,20
23,0,4,0,4,2021-06-12,Male,53,45-54,3
23,0,0,0,0,2021-06-09,Female,43,35-44,14
23,2,0,0,2,2021-06-10,Female,59,55-64,3
23,2,0,0,2,2021-06-14,Male,37,35-44,3
23,0,2,0,2,2021-06-14,Female,32,25-34,3
23,3,1,4,8,2021-06-09,Female,2,1-4,2
23,1,1,0,2,2021-06-10,Male,55,55-64,3
23,1,0,0,1,2021-06-16,Female,26,25-34,3
23,0,0,0,0,2021-06-09,Female,23,20-24,17
23,3,4,0,7,2021-06-10,Female,18,15-19,3
23,0,0,0,0,2021-06-14,Female,6,5-9,2
23,2,0,0,2,2021-06-09,Female,12,10-14,3
23,1,1,0,2,2021-06-09,Male,56,55-64,16
23,0,0,0,0,2021-06-14,Male,65,65-69,3
23,0,0,0,0,2021-06-09,Female,25,25-34,10
23,0,7,0,7,2021-06-11,Male,66,65-69,3
23,1,0,0,1,2021-06-17,Male,76,75-79,1
23,0,0,0,0,2021-06-11,Male,54,45-54,20
23,0,3,0,3,2021-06-15,Male,40,35-44,19
23,1,0,0,1,2021-06-14,Male,60,55-64,3
23,2,4,0,6,2021-06-11,Female,49,45-54,2
23,0,2,0,2,2021-06-16,Male,85,85+,3
23,0,1,0,1,2021-06-14,Male,42,35-44,3
23,1,0,0,1,2021-06-10,Male,36,35-44,2
23,1,1,0,2,2021-06-14,Female,69,65-69,3
23,1,1,0,2,2021-06-14,Male,43,35-44,20
23,0,1,0,1,2021-06-09,Male,28,25-34,3
23,0,0,0,0,2021-06-16,Female,19,15-19,6
23,3,10,0,13,2021-06-09,Male,18,15-19,15
23,2,0,0,2,2021-06-14,Male,66,65-69,11
23,0,2,0,2,2021-06-15,Male,39,35-44,3
23,0,0,0,0,2021-06-17,Male,54,45-54,1
23,0,0,0,0,2021-06-09,Male,52,45-54,2
23,3,0,0,3,2021-06-14,Female,19,15-19,3
23,1,0,0,1,2021-06-09,Female,67,65-69,20
23,2,6,9,17,2021-06-09,Female,61,55-64,18
23,0,0,0,0,2021-06-09,Male,19,15-19,8
23,1,0,3,4,2021-06-16,Male,54,45-54,3
23,0,0,0,0,2021-06-09,Male,61,55-64,14
23,1,0,0,1,2021-06-11,Female,64,55-64,2
23,0,2,0,2,2021-06-14,Female,62,55-64,21
23,0,0,0,0,2021-06-10,Male,51,45-54,18
23,0,0,0,0,2021-06-09,Female,34,25-34,3
23,1,0,0,1,2021-06-10,Male,45,45-54,20
23,0,0,0,0,2021-06-13,Female,55,55-64,3
23,2,0,0,2,2021-06-14,Male,33,25-34,3
23,2,0,0,2,2021-06-14,Male,40,35-44,18
23,3,0,0,3,2021-06-10,Female,53,45-54,2
23,1,0,0,1,2021-06-14,Male,71,70-74,18
23,3,0,0,3,2021-06-12,Male,64,55-64,3
23,0,3,0,3,2021-06-15,Female,68,65-69,16
23,1,3,0,4,2021-06-09,Male,28,25-34,2
23,0,0,0,0,2021-06-16,Female,68,65-69,17
23,1,1,0,2,2021-06-14,Male,70,70-74,19
23,2,0,1,3,2021-06-09,Male,51,45-54,3
23,1,0,0,1,2021-06-10,Male,68,65-69,3
23,1,0,5,6,2021-06-12,Male,23,20-24,14
23,1,0,0,1,2021-06-09,Female,67,65-69,3
23,2,0,0,2,2021-06-11,Male,8,5-9,17
23,1,0,0,1,2021-06-14,Female,71,70-74,21
23,1,0,0,1,2021-06-14,Female,65,65-69,3
23,2,0,0,2,2021-06-14,Male,68,65-69,17
23,0,0,0,0,2021-06-14,Female,55,55-64,2
23,1,0,0,1,2021-06-10,Male,67,65-69,20
23,0,0,0,0,2021-06-09,Female,33,25-34,8
23,0,0,0,0,2021-06-16,Female,58,55-64,14
23,0,2,0,2,2021-06-15,Female,74,70-74,2
23,1,2,0,3,2021-06-10,Male,45,45-54,3
23,2,0,2,4,2021-06-14,Female,26,25-34,5
23,0,0,0,0,2021-06-14,Male,70,70-74,19
23,0,10,0,10,2021-06-10,Male,53,45-54,2
23,0,1,0,1,2021-06-16,Female,65,65-69,3
23,0,1,0,1,2021-06-14,Female,34,25-34,22
23,0,0,0,0,2021-06-12,Male,53,45-54,22
23,1,0,0,1,2021-06-09,Male,68,65-69,23
23,1,0,0,1,2021-06-09,Male,31,25-34,3
23,1,0,0,1,2021-06-15,Male,54,45-54,5
23,0,0,0,0,2021-06-09,Male,34,25-34,16
23,1,0,0,1,2021-06-12,Male,53,45-54,4
23,0,0,0,0,2021-06-15,Female,53,45-54,14
23,0,0,0,0,2021-06-09,Male,31,25-34,10
23,1,0,0,1,2021-06-11,Male,79,75-79,17
23,0,1,0,1,2021-06-11,Female,47,45-54,3
23,4,0,0,4,2021-06-09,Female,10,10-14,14
23,1,0,0,1,2021-06-14,Male,69,65-69,12
23,0,0,0,0,2021-06-10,Male,24,20-24,17
23,0,0,0,0,2021-06-09,Male,19,15-19,20
23,3,15,0,18,2021-06-15,Female,13,10-14,14
23,1,0,0,1,2021-06-15,Female,30,25-34,6
23,1,1,0,2,2021-06-13,Female,58,55-64,10
23,0,0,0,0,2021-06-11,Female,73,70-74,3
23,0,3,0,3,2021-06-15,Male,42,35-44,13
23,1,20,0,21,2021-06-12,Female,52,45-54,3
23,1,0,0,1,2021-06-11,Female,76,75-79,3
23,1,0,0,1,2021-06-10,Female,22,20-24,2
23,0,0,0,0,2021-06-22,Female,19,15-19,1
23,3,6,0,9,2021-06-10,Male,11,10-14,19
23,2,0,0,2,2021-06-14,Female,62,55-64,16
23,0,0,0,0,2021-06-14,Female,56,55-64,3
23,2,0,0,2,2021-06-15,Female,36,35-44,12
23,2,3,0,5,2021-06-09,Female,18,15-19,2
23,0,1,0,1,2021-06-22,Female,57,55-64,2
23,0,0,0,0,2021-06-09,Female,23,20-24,17
23,1,5,0,6,2021-06-11,Male,79,75-79,18
23,3,1,0,4,2021-06-14,Female,1,1-4,2
23,2,5,0,7,2021-06-13,Female,61,55-64,3
23,2,0,0,2,2021-06-10,Male,53,45-54,20
23,1,0,0,1,2021-06-14,Male,67,65-69,14
23,1,0,0,1,2021-06-12,Male,52,45-54,18
23,2,2,0,4,2021-06-12,Male,22,20-24,3
23,0,0,0,0,2021-06-11,Male,52,45-54,16
23,3,0,0,3,2021-06-09,Female,43,35-44,22
23,0,0,0,0,2021-06-14,Female,71,70-74,18
23,1,0,0,1,2021-06-11,Female,66,65-69,11
23,1,0,0,1,2021-06-15,Male,67,65-69,2
23,1,0,0,1,2021-06-12,Female,24,20-24,21
23,0,0,0,0,2021-06-10,Male,33,25-34,2
23,0,0,0,0,2021-06-11,Female,72,70-74,16
23,1,0,0,1,2021-06-16,Male,32,25-34,17
23,0,0,0,0,2021-06-10,Female,65,65-69,23
23,0,0,0,0,2021-06-14,Male,60,55-64,16
23,3,0,0,3,2021-06-14,Male,6,5-9,3
23,0,3,45,48,2021-06-16,Female,59,55-64,3
23,2,0,0,2,2021-06-10,Male,11,10-14,19
23,2,0,0,2,2021-06-12,Male,18,15-19,3
23,2,0,0,2,2021-06-09,Male,25,25-34,12
23,2,0,0,2,2021-06-14,Male,70,70-74,15
23,3,0,0,3,2021-06-14,Male,12,10-14,2
23,1,0,0,1,2021-06-14,Female,67,65-69,2
23,1,0,0,1,2021-06-14,Male,64,55-64,2
23,1,0,0,1,2021-06-12,Female,51,45-54,19
23,0,7,0,7,2021-06-16,Male,66,65-69,3
23,0,1,0,1,2021-06-14,Female,70,70-74,17
23,0,0,6,6,2021-06-09,Male,27,25-34,9
23,2,0,0,2,2021-06-10,Male,33,25-34,19
23,4,2,0,6,2021-06-15,Female,13,10-14,18
23,3,0,0,3,2021-06-10,Female,3,1-4,20
23,1,13,15,29,2021-06-16,Male,60,55-64,14
23,0,0,0,0,2021-06-09,Male,45,45-54,18
23,0,0,0,0,2021-06-14,Female,68,65-69,19
23,0,0,0,0,2021-06-10,Female,55,55-64,21
23,0,0,0,0,2021-06-14,Female,41,35-44,22
23,1,1,0,2,2021-06-09,Male,20,20-24,4
23,0,0,0,0,2021-06-09,Female,24,20-24,5
23,1,3,0,4,2021-06-15,Female,49,45-54,3
23,2,0,0,2,2021-06-10,Female,11,10-14,7
23,1,4,0,5,2021-06-14,Male,67,65-69,3
23,0,0,0,0,2021-06-09,Male,34,25-34,4
23,0,0,0,0,2021-06-15,Female,64,55-64,20
23,0,0,0,0,2021-06-09,Male,40,35-44,14
23,0,0,0,0,2021-06-14,Female,29,25-34,2
23,1,0,0,1,2021-06-12,Female,14,10-14,17
23,0,9,0,9,2021-06-10,Male,23,20-24,13
23,0,0,0,0,2021-06-09,Male,21,20-24,3
23,0,0,0,0,2021-06-11,Male,82,80-84,8
23,1,1,0,2,2021-06-15,Female,65,65-69,2
23,1,0,0,1,2021-06-09,Male,51,45-54,3
23,0,1,0,1,2021-06-11,Male,63,55-64,3
23,0,0,0,0,2021-06-14,Female,72,70-74,3
23,1,4,0,5,2021-06-14,Female,49,45-54,2
23,1,0,0,1,2021-06-16,Male,79,75-79,9
23,1,8,0,9,2021-06-14,Male,64,55-64,3
23,1,0,5,6,2021-06-14,Female,62,55-64,2
23,2,2,0,4,2021-06-09,Male,16,15-19,3
23,3,0,0,3,2021-06-11,Male,17,15-19,19
23,0,2,0,2,2021-06-11,Male,78,75-79,22
23,0,0,0,0,2021-06-09,Female,29,25-34,4
23,0,0,0,0,2021-06-09,Male,44,35-44,16
23,1,0,0,1,2021-06-09,Female,22,20-24,8
23,1,0,0,1,2021-06-09,Male,34,25-34,11
23,1,1,0,2,2021-06-09,Female,67,65-69,22
23,0,0,0,0,2021-06-14,Female,66,65-69,16
23,1,0,0,1,2021-06-09,Female,52,45-54,5
23,0,0,0,0,2021-06-11,Male,2,1-4,14
23,2,15,0,17,2021-06-09,Female,14,10-14,3
23,1,1,2,4,2021-06-17,Female,31,25-34,1
23,0,1,0,1,2021-06-09,Female,36,35-44,3
23,0,6,0,6,2021-06-14,Male,29,25-34,3
23,0,0,0,0,2021-06-11,Male,48,45-54,20
23,0,0,0,0,2021-06-10,Female,29,25-34,3
23,2,1,0,3,2021-06-17,Male,0,<1,1
23,3,1,0,4,2021-06-10,Female,9,5-9,3
23,0,0,0,0,2021-06-10,Male,43,35-44,2
23,1,0,0,1,2021-06-10,Male,52,45-54,3
23,0,2,0,2,2021-06-14,Male,40,35-44,20
23,1,5,0,6,2021-06-09,Female,66,65-69,23
23,1,4,0,5,2021-06-14,Female,63,55-64,3
23,0,1,0,1,2021-06-09,Male,38,35-44,20
23,1,0,0,1,2021-06-13,Male,60,55-64,3
23,2,2,0,4,2021-06-10,Male,11,10-14,3
23,2,15,0,17,2021-06-15,Male,75,75-79,15
23,0,0,0,0,2021-06-09,Male,31,25-34,20
23,2,1,0,3,2021-06-11,Female,62,55-64,17
23,0,1,0,1,2021-06-09,Female,23,20-24,3
23,0,0,0,0,2021-06-12,Female,54,45-54,19
23,0,0,0,0,2021-06-11,Male,58,55-64,13
23,1,2,0,3,2021-06-22,Female,68,65-69,21
23,3,0,0,3,2021-06-15,Female,5,5-9,13
23,0,2,0,2,2021-06-09,Male,49,45-54,16
23,2,0,0,2,2021-06-09,Female,44,35-44,15
23,0,0,0,0,2021-06-10,Male,40,35-44,21
23,1,0,0,1,2021-06-14,Male,64,55-64,20
23,0,0,0,0,2021-06-10,Male,58,55-64,8
23,0,0,0,0,2021-06-15,Male,41,35-44,21
23,0,0,0,0,2021-06-09,Male,11,10-14,3
23,0,0,0,0,2021-06-09,Female,13,10-14,14
23,0,0,0,0,2021-06-14,Male,35,35-44,14
23,0,2,0,2,2021-06-10,Female,50,45-54,3
23,1,0,0,1,2021-06-10,Male,67,65-69,3
23,2,4,0,6,2021-06-14,Male,69,65-69,14
23,1,4,0,5,2021-06-14,Male,68,65-69,11
23,0,0,0,0,2021-06-13,Female,59,55-64,20
23,1,0,0,1,2021-06-15,Female,35,35-44,16
23,2,0,0,2,2021-06-14,Female,58,55-64,14
23,0,3,0,3,2021-06-16,Female,70,70-74,2
23,1,4,0,5,2021-06-12,Female,52,45-54,2
23,0,0,0,0,2021-06-14,Male,56,55-64,7
23,2,0,0,2,2021-06-09,Female,2,1-4,3
23,1,0,0,1,2021-06-09,Male,40,35-44,3
23,1,0,0,1,2021-06-13,Female,60,55-64,21
23,0,0,0,0,2021-06-10,Male,10,10-14,20
23,1,0,0,1,2021-06-12,Male,16,15-19,19
23,1,0,0,1,2021-06-14,Male,66,65-69,19
23,4,0,0,4,2021-06-14,Female,0,<1,3
23,1,0,0,1,2021-06-10,Female,18,15-19,21
23,1,1,0,2,2021-06-14,Female,38,35-44,2
23,1,0,0,1,2021-06-15,Male,55,55-64,11
23,1,0,0,1,2021-06-14,Female,72,70-74,3
23,0,0,0,0,2021-06-09,Male,60,55-64,3
23,0,0,0,0,2021-06-11,Female,50,45-54,18
23,0,0,0,0,2021-06-20,Male,24,20-24,3
23,1,0,0,1,2021-06-15,Female,55,55-64,14
23,0,0,0,0,2021-06-10,Male,66,65-69,3
23,1,10,0,11,2021-06-09,Female,21,20-24,3
23,0,0,0,0,2021-06-09,Female,22,20-24,18
23,1,0,0,1,2021-06-09,Male,68,65-69,2
23,0,0,0,0,2021-06-11,Female,77,75-79,3
23,1,0,0,1,2021-06-15,Female,70,70-74,13
23,1,1,0,2,2021-06-14,Male,70,70-74,3
23,0,0,0,0,2021-06-14,Male,40,35-44,3
23,1,0,0,1,2021-06-09,Male,60,55-64,2
23,1,1,0,2,2021-06-11,Male,78,75-79,3
23,0,0,0,0,2021-06-10,Male,57,55-64,2
23,0,0,0,0,2021-06-15,Female,68,65-69,15
23,1,2,0,3,2021-06-16,Male,62,55-64,3
23,0,0,0,0,2021-06-14,Female,54,45-54,20
23,1,0,0,1,2021-06-11,Male,75,75-79,14
23,4,1,0,5,2021-06-22,Female,12,10-14,1
23,0,0,0,0,2021-06-09,Male,39,35-44,20
23,3,0,0,3,2021-06-14,Male,16,15-19,15
23,2,0,0,2,2021-06-11,Female,17,15-19,18
23,1,0,0,1,2021-06-09,Female,64,55-64,17
23,3,0,0,3,2021-06-09,Female,0,<1,14
23,1,0,0,1,2021-06-14,Female,25,25-34,9
23,0,0,0,0,2021-06-14,Female,66,65-69,18
23,0,0,0,0,2021-06-14,Female,66,65-69,17
23,1,0,0,1,2021-06-15,Female,38,35-44,3
23,3,0,0,3,2021-06-14,Male,4,1-4,2
23,0,0,0,0,2021-06-09,Female,42,35-44,3
23,0,1,0,1,2021-06-11,Female,81,80-84,3
23,0,0,0,0,2021-06-14,Female,69,65-69,3
23,4,0,0,4,2021-06-09,Male,33,25-34,11
23,0,0,0,0,2021-06-16,Female,34,25-34,2
23,1,0,0,1,2021-06-09,Male,53,45-54,14
23,2,0,0,2,2021-06-14,Female,65,65-69,2
23,1,0,0,1,2021-06-11,Female,68,65-69,13
23,1,0,0,1,2021-06-14,Female,67,65-69,3
23,0,2,0,2,2021-06-10,Male,53,45-54,22
23,0,17,0,17,2021-06-13,Female,53,45-54,3
23,1,0,0,1,2021-06-15,Female,41,35-44,14
23,2,0,0,2,2021-06-09,Male,17,15-19,2
23,1,0,0,1,2021-06-10,Female,25,25-34,2
23,0,0,0,0,2021-06-09,Female,31,25-34,19
23,1,0,0,1,2021-06-14,Male,57,55-64,17
23,0,0,0,0,2021-06-16,Female,33,25-34,2
23,1,0,0,1,2021-06-14,Male,66,65-69,17
23,0,1,0,1,2021-06-13,Female,59,55-64,10
23,1,0,0,1,2021-06-11,Female,76,75-79,15
23,1,1,0,2,2021-06-11,Male,77,75-79,2
23,0,0,0,0,2021-06-09,Female,24,20-24,2
23,0,6,0,6,2021-06-10,Male,21,20-24,8
23,1,0,0,1,2021-06-09,Female,29,25-34,14
23,5,2,0,7,2021-06-10,Female,23,20-24,2
23,2,0,0,2,2021-06-10,Male,14,10-14,17
23,1,4,0,5,2021-06-16,Female,18,15-19,3
23,1,0,0,1,2021-06-14,Male,68,65-69,3
23,0,0,0,0,2021-06-09,Male,27,25-34,3
23,1,0,0,1,2021-06-09,Female,31,25-34,2
23,0,2,0,2,2021-06-16,Female,71,70-74,10
23,0,0,0,0,2021-06-10,Female,59,55-64,2
23,0,0,0,0,2021-06-14,Female,69,65-69,20
23,2,6,0,8,2021-06-17,Female,9,5-9,1
23,2,0,0,2,2021-06-09,Male,73,70-74,19
23,1,0,0,1,2021-06-19,Female,21,20-24,1
23,1,4,0,5,2021-06-14,Male,62,55-64,13
23,0,0,0,0,2021-06-09,Female,21,20-24,11
23,1,5,0,6,2021-06-09,Male,69,65-69,5
23,1,0,0,1,2021-06-15,Male,8,5-9,9
23,0,1,0,1,2021-06-14,Male,63,55-64,17
23,1,2,0,3,2021-06-17,Female,66,65-69,1
23,1,0,0,1,2021-06-12,Female,52,45-54,3
23,0,0,0,0,2021-06-16,Female,29,25-34,10
23,0,1,0,1,2021-06-09,Male,45,45-54,19
23,0,20,0,20,2021-06-17,Female,81,80-84,1
23,5,8,0,13,2021-06-19,Female,18,15-19,1
23,1,0,0,1,2021-06-14,Male,55,55-64,17
23,1,0,0,1,2021-06-14,Female,66,65-69,2
23,0,0,0,0,2021-06-15,Male,20,20-24,2
23,1,0,40,41,2021-06-14,Male,56,55-64,3
23,2,0,0,2,2021-06-09,Male,19,15-19,2
23,1,4,0,5,2021-06-17,Male,72,70-74,1
23,1,0,0,1,2021-06-14,Female,70,70-74,17
23,1,0,0,1,2021-06-11,Female,81,80-84,3
23,0,1,0,1,2021-06-09,Female,37,35-44,2
23,1,3,0,4,2021-06-10,Female,59,55-64,2
23,2,0,0,2,2021-06-10,Female,66,65-69,3
23,0,0,0,0,2021-06-10,Male,27,25-34,3
23,1,0,0,1,2021-06-11,Female,74,70-74,12
23,1,0,0,1,2021-06-14,Female,68,65-69,20
23,0,0,0,0,2021-06-09,Male,42,35-44,3
23,3,1,0,4,2021-06-15,Female,65,65-69,3
23,1,0,0,1,2021-06-09,Male,55,55-64,23
23,1,0,0,1,2021-06-09,Female,62,55-64,22
23,1,0,0,1,2021-06-14,Male,55,55-64,11
23,2,0,0,2,2021-06-11,Female,62,55-64,22
23,1,1,0,2,2021-06-10,Male,53,45-54,22
23,1,0,5,6,2021-06-14,Male,69,65-69,3
23,0,0,0,0,2021-06-15,Female,66,65-69,21
23,0,0,0,0,2021-06-09,Male,44,35-44,4
23,0,0,0,0,2021-06-09,Male,66,65-69,20
23,1,1,0,2,2021-06-09,Female,60,55-64,19
23,1,0,0,1,2021-06-16,Female,25,25-34,7
23,1,2,0,3,2021-06-17,Female,24,20-24,3
23,0,0,0,0,2021-06-14,Female,69,65-69,18
23,1,2,0,3,2021-06-14,Female,65,65-69,3
23,2,0,0,2,2021-06-14,Female,10,10-14,18
23,2,2,0,4,2021-06-10,Male,10,10-14,17
23,1,1,0,2,2021-06-09,Female,63,55-64,21
23,1,0,0,1,2021-06-09,Male,51,45-54,5
23,0,1,0,1,2021-06-12,Female,52,45-54,21
23,1,0,10,11,2021-06-11,Male,85,85+,3
23,0,3,0,3,2021-06-09,Female,61,55-64,2
23,0,1,0,1,2021-06-09,Female,66,65-69,19
23,1,0,0,1,2021-06-09,Male,27,25-34,2
23,2,0,0,2,2021-06-14,Female,53,45-54,19
23,2,0,0,2,2021-06-11,Female,48,45-54,20
23,1,0,0,1,2021-06-15,Male,67,65-69,19
23,0,0,0,0,2021-06-14,Female,68,65-69,8
23,2,0,0,2,2021-06-14,Male,8,5-9,3
23,0,0,0,0,2021-06-09,Female,31,25-34,10
23,2,0,3,5,2021-06-10,Male,22,20-24,15
23,1,0,0,1,2021-06-14,Male,72,70-74,18
23,2,0,0,2,2021-06-14,Female,68,65-69,17
23,0,2,0,2,2021-06-09,Female,64,55-64,13
23,2,17,0,19,2021-06-15,Male,70,70-74,14
23,2,2,21,25,2021-06-15,Male,20,20-24,20
23,1,0,3,4,2021-06-14,Female,67,65-69,15
23,1,2,0,3,2021-06-13,Male,58,55-64,22
23,0,0,0,0,2021-06-09,Male,52,45-54,5
23,0,0,0,0,2021-06-14,Male,20,20-24,2
23,1,1,0,2,2021-06-16,Female,66,65-69,3
23,0,0,0,0,2021-06-11,Male,50,45-54,3
23,1,0,0,1,2021-06-14,Male,67,65-69,17
23,0,4,0,4,2021-06-14,Female,71,70-74,3
23,0,0,0,0,2021-06-09,Male,15,15-19,18
23,3,1,0,4,2021-06-09,Male,18,15-19,2
23,3,0,0,3,2021-06-14,Male,1,1-4,19
23,1,0,0,1,2021-06-14,Male,63,55-64,3
23,0,0,0,0,2021-06-13,Female,51,45-54,3
23,0,0,0,0,2021-06-09,Female,65,65-69,3
23,1,0,0,1,2021-06-10,Female,63,55-64,3
23,3,0,0,3,2021-06-22,Male,23,20-24,19
23,0,0,0,0,2021-06-09,Male,50,45-54,18
23,4,0,0,4,2021-06-14,Female,19,15-19,3
23,0,0,0,0,2021-06-10,Male,57,55-64,12
23,1,0,0,1,2021-06-14,Female,67,65-69,3
23,0,1,0,1,2021-06-10,Female,21,20-24,7
23,2,5,10,17,2021-06-09,Female,26,25-34,22
23,3,0,0,3,2021-06-09,Male,30,25-34,21
23,0,0,0,0,2021-06-09,Male,34,25-34,16
23,2,1,0,3,2021-06-14,Female,11,10-14,18
23,1,4,0,5,2021-06-15,Female,70,70-74,20
23,1,2,0,3,2021-06-16,Female,36,35-44,2
23,1,0,0,1,2021-06-10,Male,67,65-69,15
23,1,0,0,1,2021-06-11,Male,52,45-54,2
23,0,4,0,4,2021-06-10,Male,67,65-69,19
23,0,0,0,0,2021-06-13,Female,49,45-54,13
23,2,2,0,4,2021-06-09,Male,10,10-14,3
23,2,0,0,2,2021-06-15,Female,68,65-69,15
23,2,0,0,2,2021-06-10,Female,9,5-9,20
23,0,0,0,0,2021-06-10,Female,66,65-69,19
23,0,0,0,0,2021-06-14,Female,50,45-54,15
23,2,0,0,2,2021-06-14,Male,42,35-44,19
23,0,0,0,0,2021-06-11,Female,77,75-79,13
23,3,0,0,3,2021-06-15,Female,3,1-4,17
23,1,0,0,1,2021-06-14,Female,72,70-74,3
23,2,0,0,2,2021-06-15,Male,0,<1,3
23,0,0,0,0,2021-06-15,Male,41,35-44,14
23,1,0,0,1,2021-06-14,Female,62,55-64,15
23,0,2,0,2,2021-06-13,Female,61,55-64,3
23,0,3,0,3,2021-06-09,Female,54,45-54,3
23,1,0,0,1,2021-06-13,Male,55,55-64,11
23,1,0,0,1,2021-06-14,Male,68,65-69,20
23,5,0,0,5,2021-06-11,Female,20,20-24,3
23,4,16,0,20,2021-06-09,Male,8,5-9,22
23,0,65,30,95,2021-06-15,Male,65,65-69,3
23,1,0,0,1,2021-06-09,Female,1,1-4,4
23,2,0,0,2,2021-06-09,Female,4,1-4,3
23,0,0,0,0,2021-06-09,Male,32,25-34,2
23,4,1,0,5,2021-06-11,Male,77,75-79,4
23,0,0,0,0,2021-06-09,Male,24,20-24,4
23,1,0,0,1,2021-06-09,Male,30,25-34,5
23,2,0,0,2,2021-06-11,Female,73,70-74,3
23,1,1,0,2,2021-06-09,Female,51,45-54,3
23,1,0,0,1,2021-06-09,Male,56,55-64,3
23,1,6,0,7,2021-06-10,Female,52,45-54,3
23,2,2,0,4,2021-06-09,Female,1,1-4,18
23,3,0,0,3,2021-06-10,Female,28,25-34,17
23,0,0,0,0,2021-06-10,Male,57,55-64,2
23,2,0,0,2,2021-06-15,Male,52,45-54,18
23,1,2,0,3,2021-06-15,Female,69,65-69,15
23,0,0,0,0,2021-06-14,Male,66,65-69,3
23,0,0,0,0,2021-06-09,Male,44,35-44,3
23,0,0,0,0,2021-06-13,Male,61,55-64,19
23,0,0,0,0,2021-06-11,Male,51,45-54,3
23,1,0,0,1,2021-06-09,Female,65,65-69,3
23,0,0,0,0,2021-06-10,Male,1,1-4,2
23,3,0,0,3,2021-06-13,Female,62,55-64,18
23,0,0,0,0,2021-06-12,Male,52,45-54,14
23,0,0,0,0,2021-06-14,Male,63,55-64,5
23,1,0,0,1,2021-06-15,Male,66,65-69,21
23,3,0,0,3,2021-06-10,Male,8,5-9,3
23,0,4,0,4,2021-06-20,Female,22,20-24,1
23,1,10,0,11,2021-06-15,Female,40,35-44,17
23,0,0,0,0,2021-06-09,Male,50,45-54,3
23,1,0,0,1,2021-06-09,Male,46,45-54,3
23,3,0,0,3,2021-06-13,Male,53,45-54,22
23,0,2,0,2,2021-06-14,Male,57,55-64,3
23,0,0,0,0,2021-06-10,Male,52,45-54,17
23,0,0,0,0,2021-06-16,Male,21,20-24,2
23,1,10,0,11,2021-06-12,Male,54,45-54,18
23,1,0,0,1,2021-06-09,Male,69,65-69,3
23,0,3,0,3,2021-06-11,Female,61,55-64,17
23,1,1,0,2,2021-06-15,Female,70,70-74,3
23,1,2,0,3,2021-06-14,Female,54,45-54,22
23,0,0,0,0,2021-06-11,Female,76,75-79,3
23,1,0,0,1,2021-06-09,Male,33,25-34,19
23,0,0,0,0,2021-06-10,Female,49,45-54,18
23,4,0,0,4,2021-06-16,Female,42,35-44,12
23,0,4,0,4,2021-06-10,Male,43,35-44,2
23,0,0,0,0,2021-06-14,Male,67,65-69,15
23,1,0,0,1,2021-06-10,Male,67,65-69,20
23,3,21,0,24,2021-06-12,Male,18,15-19,2
23,0,0,0,0,2021-06-09,Male,41,35-44,20
23,0,0,0,0,2021-06-10,Male,59,55-64,19
23,0,0,0,0,2021-06-09,Male,42,35-44,23
23,0,1,0,1,2021-06-10,Male,67,65-69,22
23,3,0,1,4,2021-06-09,Female,31,25-34,3
23,0,0,0,0,2021-06-09,Female,35,35-44,18
23,2,1,0,3,2021-06-14,Female,1,1-4,4
23,1,0,0,1,2021-06-10,Male,64,55-64,18
23,0,0,0,0,2021-06-14,Female,69,65-69,19
23,2,0,0,2,2021-06-09,Male,51,45-54,13
23,0,0,0,0,2021-06-09,Male,18,15-19,2
23,0,0,0,0,2021-06-10,Male,49,45-54,2
23,4,0,0,4,2021-06-15,Male,2,1-4,20
23,0,11,0,11,2021-06-09,Female,23,20-24,2
23,4,0,0,4,2021-06-22,Female,50,45-54,3
23,0,0,0,0,2021-06-15,Male,55,55-64,17
23,0,2,0,2,2021-06-17,Female,65,65-69,1
23,0,0,0,0,2021-06-15,Male,58,55-64,21
23,1,1,0,2,2021-06-12,Male,48,45-54,18
23,3,0,0,3,2021-06-09,Male,11,10-14,9
23,0,1,0,1,2021-06-16,Female,35,35-44,17
23,0,1,0,1,2021-06-14,Female,47,45-54,3
23,1,1,0,2,2021-06-14,Male,62,55-64,22
23,0,2,0,2,2021-06-14,Female,57,55-64,23
23,3,4,0,7,2021-06-10,Male,13,10-14,21
23,1,5,0,6,2021-06-14,Female,37,35-44,2
23,0,0,0,0,2021-06-10,Male,65,65-69,3
23,2,0,2,4,2021-06-11,Male,78,75-79,17
23,0,2,0,2,2021-06-15,Male,22,20-24,2
23,0,0,0,0,2021-06-14,Male,49,45-54,3
23,1,0,0,1,2021-06-11,Female,23,20-24,7
23,2,12,0,14,2021-06-12,Female,53,45-54,2
23,0,0,0,0,2021-06-16,Female,15,15-19,16
23,0,0,0,0,2021-06-14,Male,34,25-34,3
23,0,0,0,0,2021-06-12,Male,47,45-54,19
23,1,0,0,1,2021-06-10,Male,65,65-69,2
23,1,0,0,1,2021-06-14,Male,70,70-74,3
23,0,0,0,0,2021-06-09,Male,34,25-34,2
23,1,13,0,14,2021-06-12,Female,18,15-19,3
23,1,0,0,1,2021-06-15,Male,67,65-69,18
23,4,0,0,4,2021-06-14,Female,17,15-19,13
23,2,0,0,2,2021-06-15,Male,51,45-54,14
23,2,0,0,2,2021-06-16,Female,4,1-4,3
23,2,2,0,4,2021-06-14,Female,66,65-69,17
23,1,1,0,2,2021-06-14,Male,68,65-69,3
23,0,0,0,0,2021-06-16,Male,27,25-34,19
23,1,0,0,1,2021-06-15,Female,72,70-74,3
23,0,1,0,1,2021-06-10,Male,48,45-54,19
23,3,0,0,3,2021-06-09,Male,2,1-4,4
23,1,0,0,1,2021-06-14,Male,70,70-74,3
23,0,1,0,1,2021-06-11,Male,34,25-34,3
23,3,0,0,3,2021-06-09,Female,18,15-19,3
23,0,0,0,0,2021-06-17,Female,21,20-24,1
23,0,0,0,0,2021-06-11,Male,52,45-54,20
23,1,0,0,1,2021-06-11,Male,75,75-79,3
23,2,0,0,2,2021-06-12,Male,23,20-24,16
23,0,0,0,0,2021-06-14,Female,38,35-44,3
23,0,2,0,2,2021-06-13,Female,56,55-64,3
23,0,2,0,2,2021-06-11,Male,29,25-34,9
23,4,2,11,17,2021-06-15,Female,3,1-4,14
23,2,0,0,2,2021-06-10,Female,14,10-14,16
23,0,0,0,0,2021-06-09,Male,62,55-64,18
23,2,0,0,2,2021-06-11,Male,14,10-14,22
23,2,0,0,2,2021-06-16,Male,71,70-74,7
23,3,1,0,4,2021-06-09,Male,17,15-19,3
23,0,3,0,3,2021-06-10,Male,31,25-34,2
23,2,0,0,2,2021-06-14,Female,63,55-64,19
23,2,1,0,3,2021-06-22,Female,79,75-79,6
23,1,0,0,1,2021-06-09,Male,45,45-54,14
23,2,1,0,3,2021-06-16,Female,64,55-64,23
23,1,0,0,1,2021-06-11,Female,74,70-74,21
23,0,1,0,1,2021-06-09,Male,40,35-44,2
23,2,1,0,3,2021-06-15,Female,10,10-14,2
23,0,2,0,2,2021-06-09,Male,54,45-54,15
23,1,0,0,1,2021-06-14,Female,65,65-69,3
23,3,0,0,3,2021-06-13,Female,13,10-14,3
23,1,3,0,4,2021-06-13,Male,52,45-54,2
23,0,0,0,0,2021-06-17,Male,68,65-69,1
23,0,2,0,2,2021-06-10,Female,50,45-54,3
23,0,1,0,1,2021-06-11,Male,77,75-79,13
23,0,0,0,0,2021-06-10,Female,54,45-54,17
23,1,0,0,1,2021-06-09,Male,29,25-34,3
23,0,4,0,4,2021-06-12,Female,54,45-54,4
23,1,0,0,1,2021-06-14,Female,34,25-34,16
23,2,0,0,2,2021-06-10,Male,8,5-9,15
23,1,7,14,22,2021-06-17,Female,12,10-14,1
23,1,0,0,1,2021-06-09,Male,30,25-34,3
23,2,0,0,2,2021-06-09,Female,12,10-14,19
23,1,0,0,1,2021-06-11,Female,51,45-54,19
23,2,0,5,7,2021-06-13,Male,57,55-64,19
23,0,0,0,0,2021-06-11,Male,51,45-54,5
23,0,4,0,4,2021-06-09,Female,43,35-44,10
23,0,3,0,3,2021-06-15,Female,62,55-64,15
23,3,32,0,35,2021-06-11,Female,13,10-14,2
23,0,3,0,3,2021-06-10,Female,42,35-44,6
23,0,0,0,0,2021-06-13,Female,59,55-64,18
23,1,0,0,1,2021-06-15,Male,57,55-64,15
23,2,0,0,2,2021-06-10,Male,66,65-69,22
23,1,2,0,3,2021-06-14,Female,54,45-54,11
23,3,0,0,3,2021-06-17,Female,34,25-34,11
23,3,4,0,7,2021-06-11,Female,2,1-4,3
23,0,0,3,3,2021-06-09,Female,36,35-44,8
23,0,0,0,0,2021-06-15,Male,61,55-64,22
23,1,0,0,1,2021-06-14,Male,66,65-69,22
23,1,0,0,1,2021-06-10,Female,56,55-64,14
23,0,0,0,0,2021-06-15,Male,60,55-64,3
23,0,0,0,0,2021-06-14,Male,34,25-34,17
23,2,0,0,2,2021-06-09,Female,9,5-9,4
23,1,0,0,1,2021-06-14,Female,53,45-54,8
23,1,0,0,1,2021-06-13,Female,59,55-64,21
23,0,0,0,0,2021-06-13,Male,54,45-54,3
23,2,1,0,3,2021-06-11,Male,73,70-74,18
23,1,0,0,1,2021-06-14,Female,67,65-69,3
23,2,0,0,2,2021-06-10,Male,48,45-54,2
23,2,1,0,3,2021-06-22,Female,1,1-4,3
23,1,0,0,1,2021-06-09,Female,30,25-34,3
23,2,1,0,3,2021-06-10,Male,34,25-34,17
23,0,0,0,0,2021-06-11,Female,37,35-44,16
23,1,0,0,1,2021-06-14,Male,63,55-64,14
23,1,0,0,1,2021-06-11,Female,47,45-54,14
23,4,1,0,5,2021-06-10,Female,22,20-24,14
23,0,1,0,1,2021-06-09,Male,63,55-64,18
23,0,0,0,0,2021-06-16,Male,38,35-44,12
23,0,0,0,0,2021-06-14,Female,21,20-24,3
23,0,4,0,4,2021-06-14,Female,69,65-69,18
23,2,4,0,6,2021-06-15,Female,66,65-69,18
23,0,0,0,0,2021-06-13,Male,54,45-54,20
23,0,2,0,2,2021-06-11,Male,32,25-34,2
23,0,0,0,0,2021-06-14,Female,35,35-44,15
23,0,0,1,1,2021-06-20,Female,23,20-24,1
23,0,1,0,1,2021-06-09,Male,57,55-64,20
23,1,0,0,1,2021-06-15,Male,63,55-64,3
23,0,4,0,4,2021-06-13,Female,56,55-64,21
23,1,0,0,1,2021-06-10,Female,27,25-34,2
23,0,1,0,1,2021-06-09,Female,68,65-69,22
23,2,1,0,3,2021-06-13,Female,18,15-19,3
23,2,0,0,2,2021-06-15,Male,42,35-44,14
23,0,0,0,0,2021-06-17,Female,68,65-69,6
23,1,1,0,2,2021-06-16,Male,73,70-74,17
23,6,0,0,6,2021-06-17,Female,22,20-24,1
23,1,0,0,1,2021-06-11,Male,67,65-69,17
23,1,0,0,1,2021-06-12,Female,24,20-24,9
23,1,0,0,1,2021-06-13,Female,73,70-74,15
23,0,0,0,0,2021-06-10,Male,31,25-34,16
23,0,0,0,0,2021-06-09,Female,50,45-54,3
23,3,36,0,39,2021-06-11,Male,7,5-9,3
23,2,0,0,2,2021-06-14,Female,70,70-74,19
23,0,0,0,0,2021-06-14,Female,71,70-74,18
23,0,0,0,0,2021-06-10,Male,33,25-34,3
23,0,2,0,2,2021-06-13,Female,60,55-64,3
23,0,2,1,3,2021-06-10,Male,67,65-69,23
23,2,0,0,2,2021-06-15,Male,1,1-4,3
23,0,0,0,0,2021-06-10,Female,26,25-34,18
23,0,0,0,0,2021-06-10,Female,56,55-64,14
23,0,0,0,0,2021-06-22,Female,74,70-74,16
23,1,0,0,1,2021-06-11,Male,81,80-84,18
23,0,0,0,0,2021-06-14,Male,61,55-64,17
23,1,0,0,1,2021-06-10,Female,54,45-54,20
23,0,25,0,25,2021-06-10,Female,58,55-64,3
23,1,1,0,2,2021-06-10,Male,63,55-64,21
23,1,0,0,1,2021-06-12,Male,20,20-24,3
23,1,5,0,6,2021-06-15,Female,67,65-69,3
23,0,0,0,0,2021-06-16,Female,68,65-69,15
23,0,0,0,0,2021-06-15,Female,68,65-69,3
23,1,0,5,6,2021-06-15,Female,28,25-34,21
23,0,0,0,0,2021-06-22,Female,48,45-54,10
23,0,0,0,0,2021-06-15,Female,14,10-14,18
23,0,1,0,1,2021-06-17,Female,74,70-74,1
23,0,0,0,0,2021-06-12,Male,54,45-54,19
23,3,0,0,3,2021-06-09,Male,1,1-4,5
23,2,0,0,2,2021-06-14,Male,1,1-4,3
23,2,0,0,2,2021-06-09,Male,5,5-9,4
23,0,3,0,3,2021-06-13,Female,54,45-54,2
23,1,1,0,2,2021-06-15,Female,64,55-64,3
23,2,0,0,2,2021-06-14,Male,19,15-19,14
23,1,2,0,3,2021-06-15,Male,71,70-74,2
23,1,0,0,1,2021-06-09,Male,35,35-44,22
23,0,1,0,1,2021-06-14,Female,35,35-44,5
23,0,4,0,4,2021-06-14,Female,72,70-74,21
23,1,0,0,1,2021-06-13,Female,54,45-54,3
23,0,0,0,0,2021-06-14,Female,27,25-34,14
23,3,0,0,3,2021-06-10,Male,42,35-44,20
23,0,0,0,0,2021-06-14,Female,63,55-64,10
23,1,0,0,1,2021-06-15,Male,21,20-24,3
23,6,3,0,9,2021-06-09,Female,8,5-9,2
23,1,0,0,1,2021-06-15,Female,25,25-34,19
23,3,0,0,3,2021-06-11,Male,18,15-19,3
23,1,0,0,1,2021-06-15,Male,33,25-34,18
23,0,0,0,0,2021-06-09,Female,43,35-44,20
23,2,3,0,5,2021-06-14,Female,72,70-74,16
23,0,2,0,2,2021-06-09,Male,59,55-64,17
23,1,0,0,1,2021-06-15,Female,54,45-54,3
23,0,5,0,5,2021-06-15,Male,55,55-64,18
23,3,5,0,8,2021-06-14,Male,6,5-9,18
23,4,0,0,4,2021-06-14,Female,36,35-44,22
23,0,0,0,0,2021-06-09,Female,59,55-64,21
23,2,0,0,2,2021-06-13,Female,1,1-4,4
23,1,0,0,1,2021-06-14,Male,70,70-74,15
23,1,0,0,1,2021-06-09,Male,67,65-69,21
23,0,0,0,0,2021-06-10,Male,43,35-44,3
23,2,0,0,2,2021-06-10,Male,6,5-9,3
23,1,0,0,1,2021-06-10,Female,7,5-9,2
23,0,1,0,1,2021-06-13,Male,60,55-64,3
23,3,0,0,3,2021-06-14,Male,49,45-54,14
23,0,1,0,1,2021-06-16,Male,76,75-79,17
23,0,10,0,10,2021-06-11,Female,49,45-54,8
23,0,0,0,0,2021-06-15,Female,48,45-54,3
23,0,0,0,0,2021-06-14,Male,52,45-54,21
23,1,0,0,1,2021-06-14,Female,76,75-79,15
23,3,0,0,3,2021-06-09,Male,34,25-34,3
23,2,0,0,2,2021-06-09,Male,5,5-9,3
23,0,0,0,0,2021-06-14,Male,31,25-34,3
23,3,0,0,3,2021-06-13,Female,4,1-4,3
23,1,0,0,1,2021-06-14,Female,64,55-64,14
23,2,0,0,2,2021-06-14,Male,66,65-69,18
23,3,0,0,3,2021-06-14,Male,18,15-19,13
23,1,0,0,1,2021-06-09,Female,43,35-44,2
23,4,4,20,28,2021-06-19,Male,18,15-19,1
23,1,0,0,1,2021-06-14,Male,27,25-34,2
23,0,1,78,79,2021-06-22,Male,48,45-54,7
23,0,3,0,3,2021-06-10,Male,40,35-44,2
23,0,1,0,1,2021-06-11,Male,75,75-79,17
23,2,0,0,2,2021-06-14,Male,18,15-19,3
23,0,0,0,0,2021-06-09,Male,36,35-44,10
23,0,0,0,0,2021-06-14,Male,36,35-44,9
23,0,1,0,1,2021-06-11,Male,74,70-74,8
23,0,9,0,9,2021-06-11,Female,66,65-69,22
23,4,0,0,4,2021-06-13,Female,17,15-19,12
23,0,1,0,1,2021-06-13,Female,54,45-54,18
23,1,0,0,1,2021-06-09,Female,46,45-54,20
23,1,0,0,1,2021-06-14,Female,48,45-54,3
23,1,0,0,1,2021-06-10,Female,21,20-24,3
23,0,0,0,0,2021-06-09,Male,28,25-34,7
23,1,2,0,3,2021-06-09,Female,33,25-34,2
23,1,0,0,1,2021-06-12,Male,54,45-54,18
23,0,4,0,4,2021-06-14,Male,71,70-74,3
23,0,0,0,0,2021-06-14,Female,63,55-64,20
23,0,0,0,0,2021-06-10,Female,24,20-24,12
23,2,3,0,5,2021-06-15,Male,74,70-74,16
23,1,3,0,4,2021-06-09,Female,71,70-74,22
23,1,0,0,1,2021-06-09,Female,25,25-34,10
23,0,0,0,0,2021-06-10,Male,12,10-14,3
23,1,2,0,3,2021-06-11,Male,74,70-74,15
23,3,0,0,3,2021-06-13,Male,61,55-64,3
23,0,3,0,3,2021-06-10,Male,27,25-34,21
23,1,0,0,1,2021-06-15,Female,78,75-79,9
23,1,0,0,1,2021-06-09,Male,28,25-34,23
23,0,0,0,0,2021-06-16,Female,31,25-34,17
23,0,0,0,0,2021-06-14,Female,65,65-69,17
23,1,0,0,1,2021-06-14,Male,42,35-44,20
23,2,0,0,2,2021-06-09,Female,1,1-4,4
23,0,0,0,0,2021-06-14,Male,71,70-74,21
23,1,0,0,1,2021-06-15,Male,40,35-44,10
23,1,0,0,1,2021-06-09,Male,51,45-54,2
23,0,5,0,5,2021-06-10,Female,69,65-69,23
23,1,3,0,4,2021-06-14,Male,67,65-69,3
23,1,3,0,4,2021-06-11,Female,80,80-84,3
23,1,0,0,1,2021-06-17,Male,65,65-69,1
23,2,0,0,2,2021-06-09,Male,26,25-34,3
23,1,2,0,3,2021-06-13,Male,73,70-74,9
23,1,0,0,1,2021-06-11,Male,76,75-79,2
23,0,0,0,0,2021-06-09,Male,61,55-64,18
23,0,1,0,1,2021-06-14,Female,40,35-44,3
23,0,0,0,0,2021-06-14,Male,7,5-9,17
23,0,0,0,0,2021-06-11,Female,34,25-34,19
23,1,0,0,1,2021-06-14,Male,69,65-69,22
23,2,0,0,2,2021-06-22,Male,68,65-69,12
23,2,0,0,2,2021-06-15,Female,67,65-69,16
23,0,0,0,0,2021-06-14,Female,40,35-44,10
23,1,0,0,1,2021-06-14,Male,64,55-64,3
23,1,3,0,4,2021-06-14,Male,69,65-69,21
23,3,15,0,18,2021-06-11,Male,19,15-19,16
23,0,0,0,0,2021-06-10,Female,56,55-64,22
23,1,1,0,2,2021-06-09,Male,14,10-14,3
23,2,0,0,2,2021-06-10,Female,53,45-54,18
23,1,0,0,1,2021-06-16,Male,67,65-69,18
23,1,2,0,3,2021-06-15,Female,67,65-69,3
23,1,0,0,1,2021-06-13,Male,56,55-64,17
23,3,0,0,3,2021-06-11,Male,5,5-9,17
23,1,1,0,2,2021-06-09,Male,43,35-44,2
23,1,0,0,1,2021-06-10,Male,42,35-44,16
23,3,0,0,3,2021-06-12,Female,23,20-24,2
23,1,0,2,3,2021-06-14,Male,38,35-44,2
23,0,0,0,0,2021-06-13,Female,54,45-54,15
23,1,6,0,7,2021-06-14,Male,72,70-74,3
23,0,0,0,0,2021-06-15,Female,55,55-64,15
23,0,0,0,0,2021-06-10,Female,60,55-64,23
23,3,0,0,3,2021-06-09,Female,1,1-4,19
23,1,0,0,1,2021-06-15,Female,60,55-64,17
23,3,0,0,3,2021-06-09,Male,1,1-4,3
23,2,0,1,3,2021-06-17,Female,8,5-9,1
23,1,1,0,2,2021-06-15,Male,63,55-64,2
23,3,7,19,29,2021-06-11,Male,8,5-9,14
23,2,0,0,2,2021-06-14,Male,72,70-74,2
23,3,0,0,3,2021-06-09,Female,33,25-34,2
23,0,0,0,0,2021-06-14,Male,58,55-64,2
23,4,0,0,4,2021-06-14,Female,55,55-64,17
23,0,1,0,1,2021-06-14,Male,66,65-69,3
23,2,0,0,2,2021-06-10,Female,56,55-64,19
23,1,3,0,4,2021-06-14,Male,59,55-64,2
23,0,0,0,0,2021-06-09,Female,21,20-24,3
23,1,2,0,3,2021-06-13,Female,60,55-64,22
23,0,0,0,0,2021-06-14,Female,41,35-44,3
23,4,0,0,4,2021-06-11,Male,16,15-19,3
23,0,0,0,0,2021-06-14,Male,70,70-74,22
23,3,0,0,3,2021-06-11,Male,48,45-54,14
23,2,0,0,2,2021-06-09,Male,33,25-34,7
23,1,5,0,6,2021-06-17,Female,26,25-34,1
23,2,0,0,2,2021-06-14,Male,66,65-69,7
23,0,0,0,0,2021-06-14,Male,4,1-4,3
23,2,3,0,5,2021-06-16,Male,3,1-4,3
23,1,1,0,2,2021-06-11,Female,52,45-54,21
23,1,0,0,1,2021-06-09,Male,65,65-69,2
23,3,15,0,18,2021-06-11,Female,11,10-14,3
23,3,0,0,3,2021-06-09,Male,69,65-69,17
23,2,0,0,2,2021-06-15,Male,72,70-74,18
23,1,0,0,1,2021-06-14,Male,67,65-69,3
23,2,0,0,2,2021-06-11,Male,78,75-79,17
23,0,0,0,0,2021-06-10,Female,67,65-69,3
23,2,0,0,2,2021-06-09,Male,10,10-14,3
23,0,0,0,0,2021-06-12,Male,53,45-54,3
23,0,4,0,4,2021-06-09,Female,62,55-64,3
23,2,0,0,2,2021-06-11,Male,52,45-54,16
23,0,3,0,3,2021-06-13,Male,56,55-64,3
23,1,1,0,2,2021-06-17,Male,70,70-74,19
23,1,0,0,1,2021-06-11,Male,81,80-84,2
23,2,15,0,17,2021-06-16,Male,12,10-14,3
23,0,0,0,0,2021-06-11,Male,52,45-54,19
23,3,0,0,3,2021-06-13,Female,17,15-19,19
23,1,1,0,2,2021-06-15,Female,40,35-44,3
23,0,0,0,0,2021-06-14,Female,70,70-74,3
23,1,0,0,1,2021-06-15,Female,65,65-69,22
23,5,0,0,5,2021-06-16,Female,52,45-54,15
23,2,0,0,2,2021-06-10,Female,38,35-44,18
23,3,1,0,4,2021-06-12,Female,12,10-14,9
23,0,1,0,1,2021-06-09,Female,43,35-44,3
23,4,0,0,4,2021-06-14,Male,11,10-14,10
23,2,0,0,2,2021-06-16,Female,7,5-9,2
23,0,0,0,0,2021-06-14,Male,58,55-64,15
23,1,0,0,1,2021-06-15,Female,28,25-34,8
23,0,0,0,0,2021-06-15,Male,68,65-69,7
23,0,0,0,0,2021-06-17,Male,71,70-74,1
23,2,3,0,5,2021-06-12,Male,12,10-14,3
23,1,0,0,1,2021-06-11,Female,52,45-54,3
23,0,0,1,1,2021-06-10,Female,49,45-54,14
23,3,0,0,3,2021-06-18,Female,18,15-19,1
23,0,3,0,3,2021-06-15,Female,59,55-64,9
23,0,0,0,0,2021-06-13,Male,60,55-64,16
23,0,0,0,0,2021-06-09,Female,56,55-64,20
23,2,0,0,2,2021-06-09,Male,19,15-19,2
23,0,0,0,0,2021-06-09,Male,64,55-64,19
23,0,0,0,0,2021-06-16,Male,37,35-44,15
23,1,2,0,3,2021-06-11,Female,36,35-44,3
23,0,0,0,0,2021-06-22,Male,37,35-44,18
23,2,0,0,2,2021-06-09,Male,1,1-4,2
23,2,2,0,4,2021-06-09,Female,48,45-54,2
23,1,10,0,11,2021-06-11,Male,15,15-19,10
23,2,0,0,2,2021-06-09,Male,64,55-64,17
23,1,2,0,3,2021-06-11,Male,51,45-54,14
23,0,0,0,0,2021-06-11,Male,74,70-74,15
23,2,6,1,9,2021-06-12,Female,52,45-54,16
23,0,3,0,3,2021-06-09,Male,18,15-19,3
23,4,0,0,4,2021-06-15,Female,18,15-19,2
23,1,0,0,1,2021-06-09,Male,63,55-64,3
23,2,0,0,2,2021-06-22,Male,10,10-14,14
23,2,0,0,2,2021-06-10,Female,18,15-19,3
23,1,4,0,5,2021-06-15,Female,15,15-19,19
23,0,3,0,3,2021-06-10,Male,62,55-64,19
23,2,0,0,2,2021-06-09,Male,15,15-19,10
23,1,1,0,2,2021-06-09,Male,51,45-54,10
23,3,0,0,3,2021-06-13,Male,31,25-34,3
23,0,1,0,1,2021-06-09,Female,41,35-44,2
23,0,0,0,0,2021-06-13,Male,54,45-54,14
23,1,10,0,11,2021-06-16,Male,52,45-54,9
23,1,1,0,2,2021-06-14,Male,64,55-64,3
23,1,0,0,1,2021-06-11,Male,54,45-54,18
23,2,1,0,3,2021-06-09,Female,65,65-69,21
23,1,3,20,24,2021-06-11,Male,29,25-34,2
23,3,0,0,3,2021-06-16,Female,4,1-4,3
23,1,0,0,1,2021-06-11,Male,79,75-79,13
23,1,0,0,1,2021-06-11,Male,62,55-64,20
23,0,0,0,0,2021-06-11,Male,42,35-44,3
23,0,2,0,2,2021-06-11,Male,64,55-64,3
23,3,0,7,10,2021-06-09,Male,18,15-19,18
23,4,2,0,6,2021-06-12,Male,17,15-19,12
23,0,0,0,0,2021-06-09,Male,53,45-54,18
23,1,0,0,1,2021-06-10,Female,61,55-64,3
23,1,0,0,1,2021-06-14,Female,51,45-54,16
23,3,26,0,29,2021-06-22,Male,9,5-9,3
23,0,0,0,0,2021-06-14,Female,61,55-64,19
23,3,0,0,3,2021-06-09,Male,10,10-14,22
23,0,0,0,0,2021-06-09,Female,1,1-4,2
23,1,0,0,1,2021-06-11,Female,27,25-34,10
23,0,0,0,0,2021-06-14,Male,41,35-44,16
23,0,0,0,0,2021-06-09,Male,40,35-44,3
23,3,1,0,4,2021-06-13,Female,60,55-64,8
23,1,4,0,5,2021-06-11,Female,50,45-54,3
23,2,0,0,2,2021-06-15,Female,68,65-69,11
23,3,0,0,3,2021-06-11,Female,6,5-9,3
23,2,0,0,2,2021-06-14,Female,28,25-34,2
23,3,0,0,3,2021-06-10,Female,1,1-4,8
23,0,6,0,6,2021-06-10,Male,68,65-69,3
23,1,0,0,1,2021-06-10,Male,39,35-44,3
23,4,0,0,4,2021-06-10,Female,3,1-4,3
23,0,0,0,0,2021-06-09,Female,40,35-44,3
23,0,0,0,0,2021-06-14,Female,66,65-69,21
23,0,0,0,0,2021-06-09,Female,39,35-44,2
23,0,2,0,2,2021-06-15,Male,64,55-64,12
23,0,0,0,0,2021-06-14,Male,38,35-44,19
23,1,1,0,2,2021-06-14,Male,56,55-64,4
23,0,6,0,6,2021-06-14,Female,24,20-24,13
23,1,0,0,1,2021-06-14,Female,64,55-64,16
23,0,0,0,0,2021-06-16,Female,66,65-69,8
23,0,1,0,1,2021-06-11,Female,68,65-69,22
23,0,0,0,0,2021-06-13,Male,61,55-64,3
23,1,0,0,1,2021-06-14,Male,59,55-64,3
23,0,0,0,0,2021-06-09,Female,44,35-44,14
23,0,1,0,1,2021-06-14,Male,65,65-69,3
23,1,2,0,3,2021-06-14,Female,40,35-44,17
23,1,0,0,1,2021-06-09,Male,46,45-54,3
23,0,1,0,1,2021-06-10,Female,68,65-69,20
23,1,0,0,1,2021-06-14,Female,38,35-44,13
23,0,0,0,0,2021-06-14,Female,47,45-54,12
23,1,0,0,1,2021-06-15,Female,34,25-34,17
23,0,0,0,0,2021-06-16,Male,67,65-69,15
23,1,0,0,1,2021-06-14,Female,52,45-54,22
23,0,0,0,0,2021-06-12,Female,24,20-24,20
23,3,0,0,3,2021-06-09,Female,23,20-24,3
23,3,2,0,5,2021-06-13,Female,55,55-64,12
23,1,1,0,2,2021-06-13,Female,18,15-19,18
23,0,0,0,0,2021-06-09,Female,44,35-44,18
23,0,0,0,0,2021-06-14,Female,22,20-24,5
23,1,0,0,1,2021-06-14,Male,67,65-69,14
23,2,0,0,2,2021-06-10,Female,63,55-64,20
23,0,5,0,5,2021-06-13,Female,51,45-54,16
23,1,2,0,3,2021-06-11,Male,78,75-79,2
23,1,0,0,1,2021-06-10,Male,61,55-64,3
23,0,1,0,1,2021-06-10,Male,43,35-44,7
23,0,0,0,0,2021-06-10,Female,67,65-69,20
23,0,0,0,0,2021-06-09,Female,8,5-9,2
23,1,0,0,1,2021-06-11,Female,73,70-74,17
23,1,0,0,1,2021-06-15,Male,37,35-44,14
23,0,0,0,0,2021-06-10,Male,59,55-64,21
23,0,0,0,0,2021-06-09,Male,26,25-34,3
23,1,0,0,1,2021-06-11,Male,79,75-79,18
23,0,7,0,7,2021-06-12,Male,22,20-24,2
23,4,26,0,30,2021-06-09,Female,13,10-14,3
23,2,28,0,30,2021-06-09,Female,14,10-14,18
23,1,0,0,1,2021-06-10,Male,31,25-34,3
23,1,0,0,1,2021-06-13,Female,53,45-54,16
23,2,0,0,2,2021-06-15,Male,69,65-69,20
23,1,0,0,1,2021-06-13,Female,56,55-64,20
23,2,0,0,2,2021-06-13,Female,61,55-64,14
23,0,0,0,0,2021-06-12,Male,54,45-54,2
23,3,0,0,3,2021-06-15,Male,9,5-9,2
23,1,0,0,1,2021-06-14,Female,62,55-64,18
23,2,0,0,2,2021-06-12,Female,48,45-54,3
23,1,0,0,1,2021-06-11,Male,64,55-64,23
23,1,0,0,1,2021-06-14,Male,65,65-69,2
23,0,1,0,1,2021-06-14,Female,30,25-34,3
23,2,7,0,9,2021-06-14,Male,73,70-74,20
23,1,2,0,3,2021-06-11,Female,31,25-34,2
23,1,0,0,1,2021-06-14,Female,65,65-69,19
23,2,0,0,2,2021-06-12,Male,54,45-54,18
23,1,1,0,2,2021-06-17,Male,71,70-74,1
23,0,2,0,2,2021-06-14,Female,67,65-69,18
23,1,0,0,1,2021-06-10,Male,47,45-54,3
23,1,1,0,2,2021-06-16,Male,66,65-69,3
23,0,0,0,0,2021-06-09,Male,12,10-14,8
23,3,10,0,13,2021-06-15,Female,24,20-24,3
23,0,5,0,5,2021-06-09,Female,38,35-44,7
23,0,0,0,0,2021-06-15,Male,46,45-54,3
23,0,13,0,13,2021-06-15,Female,72,70-74,20
23,2,0,0,2,2021-06-14,Female,72,70-74,19
23,0,0,0,0,2021-06-14,Female,66,65-69,11
23,1,3,0,4,2021-06-11,Female,50,45-54,21
23,3,0,0,3,2021-06-14,Female,59,55-64,19
23,0,0,0,0,2021-06-10,Female,34,25-34,18
23,1,0,0,1,2021-06-16,Male,74,70-74,11
23,2,1,0,3,2021-06-09,Female,2,1-4,14
23,1,0,0,1,2021-06-11,Female,51,45-54,16
23,0,0,0,0,2021-06-09,Male,57,55-64,2
23,0,0,0,0,2021-06-09,Female,41,35-44,22
23,0,1,0,1,2021-06-10,Female,53,45-54,3
23,0,0,0,0,2021-06-10,Male,22,20-24,22
23,0,0,0,0,2021-06-13,Male,55,55-64,22
23,0,0,0,0,2021-06-10,Female,44,35-44,2
23,0,0,0,0,2021-06-12,Male,24,20-24,16
23,0,0,0,0,2021-06-15,Female,37,35-44,21
23,3,22,0,25,2021-06-09,Female,7,5-9,19
23,1,0,0,1,2021-06-13,Male,55,55-64,19
23,1,0,0,1,2021-06-14,Male,64,55-64,3
23,0,1,0,1,2021-06-09,Female,20,20-24,9
23,5,1,0,6,2021-06-09,Male,15,15-19,18
23,0,0,0,0,2021-06-14,Male,40,35-44,8
23,1,4,0,5,2021-06-14,Female,57,55-64,18
23,1,0,0,1,2021-06-14,Female,68,65-69,18
23,0,1,0,1,2021-06-12,Female,85,85+,11
23,0,0,0,0,2021-06-14,Female,71,70-74,21
23,1,1,0,2,2021-06-11,Male,74,70-74,23
23,2,2,0,4,2021-06-09,Female,29,25-34,2
23,3,0,0,3,2021-06-14,Male,10,10-14,10
23,3,0,0,3,2021-06-09,Male,14,10-14,18
23,0,2,3,5,2021-06-12,Male,74,70-74,20
23,1,1,0,2,2021-06-10,Female,40,35-44,8
23,0,2,0,2,2021-06-16,Female,20,20-24,2
23,1,0,0,1,2021-06-10,Male,54,45-54,3
23,0,0,0,0,2021-06-10,Female,37,35-44,13
23,0,0,0,0,2021-06-16,Male,67,65-69,9
23,0,0,0,0,2021-06-10,Female,38,35-44,20
23,1,0,0,1,2021-06-13,Male,58,55-64,3
23,1,2,0,3,2021-06-22,Male,68,65-69,1
23,1,0,0,1,2021-06-13,Female,28,25-34,3
23,2,0,0,2,2021-06-15,Female,14,10-14,14
23,1,0,0,1,2021-06-14,Male,67,65-69,16
23,1,0,0,1,2021-06-13,Female,61,55-64,20
23,0,3,0,3,2021-06-09,Male,33,25-34,3
23,1,7,0,8,2021-06-22,Female,67,65-69,16
23,0,0,0,0,2021-06-14,Male,32,25-34,3
23,1,0,0,1,2021-06-14,Male,67,65-69,18
23,0,1,0,1,2021-06-15,Male,29,25-34,3
23,3,0,0,3,2021-06-15,Female,11,10-14,19
23,4,10,3,17,2021-06-17,Male,23,20-24,1
23,2,0,0,2,2021-06-17,Male,3,1-4,1
23,1,6,0,7,2021-06-09,Male,71,70-74,11
23,0,0,0,0,2021-06-15,Female,51,45-54,17
23,2,0,0,2,2021-06-15,Female,51,45-54,12
23,3,0,0,3,2021-06-09,Male,52,45-54,3
23,0,1,0,1,2021-06-15,Male,22,20-24,17
23,0,2,0,2,2021-06-14,Female,66,65-69,3
23,1,4,0,5,2021-06-14,Female,67,65-69,3
23,1,31,0,32,2021-06-10,Male,66,65-69,22
23,0,0,0,0,2021-06-16,Male,32,25-34,17
23,1,2,0,3,2021-06-11,Female,65,65-69,3
23,2,0,0,2,2021-06-11,Female,10,10-14,16
23,0,2,0,2,2021-06-11,Female,25,25-34,15
23,1,0,0,1,2021-06-17,Male,78,75-79,2
23,2,0,0,2,2021-06-15,Female,67,65-69,20
23,0,0,0,0,2021-06-11,Female,76,75-79,21
23,0,0,0,0,2021-06-15,Female,37,35-44,13
23,2,0,0,2,2021-06-16,Female,12,10-14,3
23,0,0,0,0,2021-06-10,Female,45,45-54,15
23,2,0,0,2,2021-06-15,Male,33,25-34,18
23,3,0,0,3,2021-06-09,Male,24,20-24,20
23,3,0,0,3,2021-06-09,Male,34,25-34,15
23,2,0,0,2,2021-06-14,Female,23,20-24,19
23,0,0,0,0,2021-06-13,Male,24,20-24,2
23,0,0,0,0,2021-06-16,Male,15,15-19,19
23,0,1,0,1,2021-06-16,Female,69,65-69,7
23,1,2,0,3,2021-06-10,Male,66,65-69,21
23,0,0,0,0,2021-06-17,Male,68,65-69,1
23,0,0,0,0,2021-06-09,Female,28,25-34,2
23,1,0,0,1,2021-06-09,Female,60,55-64,3
23,0,0,0,0,2021-06-10,Female,10,10-14,23
23,0,2,0,2,2021-06-14,Female,66,65-69,17
23,2,0,0,2,2021-06-14,Female,14,10-14,3
23,1,0,0,1,2021-06-11,Male,54,45-54,18
23,0,6,0,6,2021-06-10,Female,27,25-34,2
23,0,0,0,0,2021-06-10,Male,45,45-54,3
23,0,0,0,0,2021-06-09,Male,11,10-14,2
23,0,0,0,0,2021-06-10,Male,43,35-44,2
23,2,0,0,2,2021-06-13,Male,0,<1,4
23,0,0,0,0,2021-06-14,Male,54,45-54,2
23,0,0,0,0,2021-06-15,Male,42,35-44,3
23,0,1,0,1,2021-06-12,Male,21,20-24,12
23,3,0,0,3,2021-06-14,Female,9,5-9,3
23,0,0,0,0,2021-06-13,Male,59,55-64,16
23,1,0,0,1,2021-06-15,Male,63,55-64,22
23,0,0,0,0,2021-06-10,Male,30,25-34,5
23,0,3,0,3,2021-06-09,Male,34,25-34,2
23,0,3,0,3,2021-06-09,Male,18,15-19,3
23,2,0,0,2,2021-06-10,Male,66,65-69,19
23,0,0,0,0,2021-06-16,Female,38,35-44,10
23,2,2,0,4,2021-06-14,Female,22,20-24,8
23,1,1,0,2,2021-06-15,Female,67,65-69,16
23,3,0,0,3,2021-06-14,Male,15,15-19,4
23,1,11,0,12,2021-06-15,Female,66,65-69,3
23,0,0,0,0,2021-06-22,Male,30,25-34,10
23,1,0,0,1,2021-06-09,Male,22,20-24,2
23,1,0,0,1,2021-06-13,Male,29,25-34,3
23,1,2,0,3,2021-06-16,Female,29,25-34,4
23,1,5,30,36,2021-06-15,Male,68,65-69,11
23,1,4,0,5,2021-06-13,Female,62,55-64,17
23,1,4,0,5,2021-06-14,Female,53,45-54,20
23,1,0,0,1,2021-06-11,Male,75,75-79,9
23,1,0,0,1,2021-06-11,Female,49,45-54,21
23,2,0,0,2,2021-06-15,Female,9,5-9,2
23,1,0,0,1,2021-06-16,Female,40,35-44,3
23,0,1,0,1,2021-06-12,Female,73,70-74,14
23,1,0,0,1,2021-06-17,Female,66,65-69,1
23,0,0,0,0,2021-06-14,Female,67,65-69,3
23,0,0,0,0,2021-06-14,Male,65,65-69,16
23,3,1,0,4,2021-06-09,Male,30,25-34,12
23,0,0,0,0,2021-06-10,Female,67,65-69,3
23,0,0,0,0,2021-06-10,Male,44,35-44,2
23,0,0,0,0,2021-06-09,Female,26,25-34,22
23,1,0,0,1,2021-06-11,Male,40,35-44,20
23,0,1,0,1,2021-06-09,Female,44,35-44,3
23,0,0,0,0,2021-06-14,Male,34,25-34,16
23,1,1,0,2,2021-06-14,Male,62,55-64,19
23,0,2,0,2,2021-06-14,Female,69,65-69,18
23,1,0,0,1,2021-06-11,Male,41,35-44,3
23,1,0,0,1,2021-06-14,Male,68,65-69,21
23,3,0,0,3,2021-06-11,Male,19,15-19,3
23,3,2,0,5,2021-06-17,Female,21,20-24,1
23,2,0,0,2,2021-06-09,Female,36,35-44,4
23,2,0,0,2,2021-06-14,Male,11,10-14,23
23,4,2,0,6,2021-06-11,Female,12,10-14,17
23,0,0,0,0,2021-06-14,Male,56,55-64,17
23,1,2,0,3,2021-06-14,Male,71,70-74,18
23,1,0,0,1,2021-06-14,Female,29,25-34,9
23,1,5,0,6,2021-06-13,Male,56,55-64,3
23,0,0,0,0,2021-06-09,Male,41,35-44,2
23,2,0,0,2,2021-06-13,Female,61,55-64,19
23,1,2,0,3,2021-06-10,Female,28,25-34,2
23,0,0,0,0,2021-06-10,Male,46,45-54,15
23,5,4,1,10,2021-06-14,Female,66,65-69,3
23,1,0,1,2,2021-06-14,Female,58,55-64,2
23,1,0,0,1,2021-06-09,Male,2,1-4,13
23,1,0,0,1,2021-06-14,Female,67,65-69,12
23,0,0,0,0,2021-06-16,Male,19,15-19,2
23,0,0,0,0,2021-06-15,Female,67,65-69,3
23,0,0,0,0,2021-06-14,Female,70,70-74,11
23,1,0,0,1,2021-06-12,Female,52,45-54,3
23,0,2,0,2,2021-06-10,Female,26,25-34,2
23,1,0,0,1,2021-06-10,Male,46,45-54,16
23,0,0,0,0,2021-06-14,Female,35,35-44,19
23,3,1,0,4,2021-06-10,Female,33,25-34,20
23,0,0,0,0,2021-06-14,Male,58,55-64,21
23,2,0,0,2,2021-06-09,Male,64,55-64,22
23,1,0,15,16,2021-06-09,Female,63,55-64,21
23,2,0,0,2,2021-06-09,Male,4,1-4,4
23,1,0,0,1,2021-06-09,Female,64,55-64,20
23,0,0,0,0,2021-06-14,Male,65,65-69,3
23,1,1,0,2,2021-06-13,Female,57,55-64,3
23,3,0,0,3,2021-06-09,Female,44,35-44,19
23,1,1,0,2,2021-06-15,Female,69,65-69,21
23,1,0,0,1,2021-06-10,Male,53,45-54,19
23,2,0,0,2,2021-06-09,Male,50,45-54,21
23,1,2,0,3,2021-06-11,Male,36,35-44,3
23,1,0,0,1,2021-06-14,Female,64,55-64,15
23,1,0,0,1,2021-06-10,Female,68,65-69,21
23,0,0,0,0,2021-06-10,Male,17,15-19,20
23,2,0,0,2,2021-06-11,Male,59,55-64,20
23,1,2,0,3,2021-06-14,Female,64,55-64,3
23,0,4,0,4,2021-06-14,Male,33,25-34,20
23,1,0,0,1,2021-06-09,Female,31,25-34,2
23,3,0,0,3,2021-06-09,Female,1,1-4,2
23,2,0,0,2,2021-06-10,Female,14,10-14,2
23,2,0,0,2,2021-06-09,Male,13,10-14,3
23,2,0,0,2,2021-06-13,Female,17,15-19,3
23,0,0,0,0,2021-06-14,Female,65,65-69,17
23,1,0,0,1,2021-06-09,Female,53,45-54,2
23,3,0,0,3,2021-06-15,Male,66,65-69,4
23,3,0,0,3,2021-06-16,Female,35,35-44,3
23,1,1,0,2,2021-06-09,Male,68,65-69,23
23,0,0,0,0,2021-06-11,Male,13,10-14,20
23,0,0,0,0,2021-06-15,Female,39,35-44,3
23,2,0,0,2,2021-06-11,Male,77,75-79,16
23,0,0,0,0,2021-06-10,Male,68,65-69,3
23,0,0,1,1,2021-06-09,Male,37,35-44,3
23,1,0,0,1,2021-06-10,Female,59,55-64,21
23,1,1,0,2,2021-06-09,Male,42,35-44,3
23,1,0,0,1,2021-06-16,Male,33,25-34,3
23,6,0,0,6,2021-06-14,Female,15,15-19,22
23,1,0,0,1,2021-06-10,Male,70,70-74,4
23,2,0,0,2,2021-06-10,Female,2,1-4,2
23,0,0,0,0,2021-06-09,Female,47,45-54,2
23,3,15,0,18,2021-06-15,Male,14,10-14,19
23,1,0,0,1,2021-06-09,Male,47,45-54,3
23,1,0,0,1,2021-06-15,Female,71,70-74,2
23,1,0,0,1,2021-06-11,Male,77,75-79,3
23,2,0,0,2,2021-06-12,Male,24,20-24,14
23,1,0,0,1,2021-06-09,Male,2,1-4,17
23,4,5,0,9,2021-06-15,Male,2,1-4,2
23,0,1,0,1,2021-06-17,Female,40,35-44,14
23,0,0,0,0,2021-06-11,Male,15,15-19,17
23,0,0,0,0,2021-06-13,Female,56,55-64,3
23,3,5,0,8,2021-06-12,Male,53,45-54,3
23,2,0,0,2,2021-06-09,Male,51,45-54,19
23,1,0,0,1,2021-06-13,Male,47,45-54,12
23,0,0,0,0,2021-06-14,Female,68,65-69,2
23,0,1,0,1,2021-06-11,Male,51,45-54,3
23,0,0,0,0,2021-06-09,Female,34,25-34,2
23,2,1,0,3,2021-06-14,Male,64,55-64,3
23,0,3,0,3,2021-06-09,Male,40,35-44,19
23,0,0,0,0,2021-06-09,Female,34,25-34,21
23,2,0,0,2,2021-06-09,Male,4,1-4,2
23,0,0,0,0,2021-06-10,Male,31,25-34,9
23,1,0,0,1,2021-06-19,Female,4,1-4,1
23,0,0,0,0,2021-06-12,Female,19,15-19,5
23,0,0,0,0,2021-06-14,Female,68,65-69,11
23,4,0,0,4,2021-06-09,Female,19,15-19,10
23,0,1,0,1,2021-06-09,Male,46,45-54,19
23,0,3,0,3,2021-06-15,Female,66,65-69,19
23,3,7,19,29,2021-06-10,Male,12,10-14,3
23,2,1,0,3,2021-06-14,Female,71,70-74,6
23,0,0,0,0,2021-06-10,Female,19,15-19,4
23,9,0,0,9,2021-06-09,Female,18,15-19,14
23,0,0,0,0,2021-06-11,Female,53,45-54,19
23,0,0,0,0,2021-06-14,Female,28,25-34,10
23,2,0,0,2,2021-06-09,Male,39,35-44,2
23,0,0,0,0,2021-06-16,Male,71,70-74,9
23,2,0,0,2,2021-06-13,Male,26,25-34,17
23,1,0,0,1,2021-06-22,Female,55,55-64,2
23,2,0,0,2,2021-06-16,Female,13,10-14,12
23,0,1,0,1,2021-06-14,Female,28,25-34,17
23,0,5,0,5,2021-06-09,Male,44,35-44,10
23,0,0,0,0,2021-06-09,Male,16,15-19,14
23,0,0,0,0,2021-06-09,Female,67,65-69,19
23,0,0,0,0,2021-06-14,Female,68,65-69,15
23,0,0,0,0,2021-06-09,Female,69,65-69,21
23,1,0,0,1,2021-06-11,Female,52,45-54,5
23,1,0,0,1,2021-06-10,Female,57,55-64,3
23,0,2,0,2,2021-06-17,Female,28,25-34,9
23,0,0,0,0,2021-06-09,Female,42,35-44,2
23,1,2,0,3,2021-06-11,Male,76,75-79,3
23,1,4,0,5,2021-06-15,Male,65,65-69,3
23,1,0,0,1,2021-06-10,Male,30,25-34,2
23,1,10,0,11,2021-06-11,Female,16,15-19,2
23,5,2,0,7,2021-06-15,Male,13,10-14,20
23,1,3,0,4,2021-06-09,Male,70,70-74,3
23,3,0,0,3,2021-06-14,Female,4,1-4,3
23,2,0,0,2,2021-06-14,Male,48,45-54,21
23,3,1,6,10,2021-06-13,Male,3,1-4,3
23,0,1,0,1,2021-06-15,Female,38,35-44,16
23,1,0,0,1,2021-06-14,Female,69,65-69,3
23,0,0,0,0,2021-06-11,Female,79,75-79,3
23,1,0,0,1,2021-06-14,Female,65,65-69,3
23,0,0,0,0,2021-06-14,Male,54,45-54,16
23,2,1,0,3,2021-06-14,Male,68,65-69,12
23,1,0,0,1,2021-06-14,Female,40,35-44,10
23,0,5,0,5,2021-06-14,Female,70,70-74,3
23,0,0,0,0,2021-06-16,Female,19,15-19,2
23,1,0,0,1,2021-06-14,Female,69,65-69,3
23,0,1,0,1,2021-06-09,Male,49,45-54,19
23,1,0,0,1,2021-06-09,Male,64,55-64,18
23,0,0,0,0,2021-06-16,Male,40,35-44,3
23,0,3,0,3,2021-06-09,Male,62,55-64,5
23,1,0,0,1,2021-06-09,Male,36,35-44,19
23,1,0,0,1,2021-06-09,Female,33,25-34,2
23,1,0,0,1,2021-06-11,Male,50,45-54,20
23,0,3,0,3,2021-06-17,Male,53,45-54,1
23,0,0,0,0,2021-06-13,Male,53,45-54,5
23,0,0,0,0,2021-06-12,Female,51,45-54,3
23,1,1,0,2,2021-06-10,Female,53,45-54,2
23,1,0,0,1,2021-06-10,Female,66,65-69,3
23,1,0,0,1,2021-06-09,Male,49,45-54,2
23,0,0,0,0,2021-06-11,Female,53,45-54,18
23,1,0,0,1,2021-06-22,Female,22,20-24,1
23,2,0,0,2,2021-06-09,Male,69,65-69,21
23,0,0,0,0,2021-06-09,Male,45,45-54,3
23,2,0,0,2,2021-06-13,Female,48,45-54,19
23,3,1,0,4,2021-06-10,Male,21,20-24,20
23,3,0,0,3,2021-06-11,Male,85,85+,17
23,1,0,0,1,2021-06-15,Male,56,55-64,3
23,1,0,0,1,2021-06-15,Male,67,65-69,3
23,1,0,0,1,2021-06-16,Female,71,70-74,11
23,2,0,0,2,2021-06-16,Female,20,20-24,12
23,0,1,0,1,2021-06-13,Male,48,45-54,16
23,2,0,0,2,2021-06-14,Female,67,65-69,17
23,0,0,0,0,2021-06-11,Male,50,45-54,23
23,0,0,1,1,2021-06-10,Male,0,<1,13
23,1,0,0,1,2021-06-13,Male,4,1-4,4
23,0,1,0,1,2021-06-14,Male,23,20-24,14
23,0,0,0,0,2021-06-09,Male,34,25-34,2
23,0,2,0,2,2021-06-10,Male,45,45-54,3
23,3,1,0,4,2021-06-10,Male,9,5-9,2
23,1,0,0,1,2021-06-09,Female,46,45-54,3
23,0,0,0,0,2021-06-22,Female,30,25-34,2
23,0,0,0,0,2021-06-09,Male,29,25-34,17
23,2,0,0,2,2021-06-09,Male,38,35-44,3
23,2,0,0,2,2021-06-09,Female,20,20-24,8
23,2,0,0,2,2021-06-11,Male,75,75-79,20
23,2,0,0,2,2021-06-14,Male,62,55-64,3
23,2,16,0,18,2021-06-09,Female,12,10-14,11
23,0,0,0,0,2021-06-14,Male,31,25-34,18
23,0,0,0,0,2021-06-15,Female,31,25-34,2
23,2,0,0,2,2021-06-14,Male,66,65-69,15
23,0,0,0,0,2021-06-10,Female,31,25-34,8
23,0,5,0,5,2021-06-14,Female,66,65-69,3
23,0,3,0,3,2021-06-17,Male,69,65-69,1
23,2,7,0,9,2021-06-11,Female,80,80-84,18
23,2,1,0,3,2021-06-10,Female,17,15-19,3
23,1,0,0,1,2021-06-14,Female,70,70-74,21
23,0,0,0,0,2021-06-14,Female,70,70-74,23
23,1,0,0,1,2021-06-15,Male,71,70-74,21
23,3,10,0,13,2021-06-14,Female,65,65-69,3
23,0,2,0,2,2021-06-09,Female,60,55-64,3
23,1,3,0,4,2021-06-10,Female,53,45-54,2
23,3,0,1,4,2021-06-15,Male,14,10-14,15
23,0,6,0,6,2021-06-13,Male,61,55-64,22
23,1,0,0,1,2021-06-14,Female,70,70-74,3
23,0,2,0,2,2021-06-14,Male,36,35-44,2
23,1,3,100,104,2021-06-11,Male,20,20-24,2
23,0,0,0,0,2021-06-14,Male,67,65-69,11
23,2,3,0,5,2021-06-09,Male,54,45-54,2
23,1,0,0,1,2021-06-14,Female,12,10-14,19
23,1,2,80,83,2021-06-17,Female,52,45-54,1
23,3,0,0,3,2021-06-10,Male,0,<1,3
23,1,1,0,2,2021-06-12,Female,22,20-24,2
23,3,0,0,3,2021-06-09,Male,13,10-14,19
23,0,1,0,1,2021-06-14,Male,34,25-34,21
23,2,0,0,2,2021-06-14,Female,10,10-14,2
23,2,0,0,2,2021-06-11,Male,17,15-19,15
23,1,0,0,1,2021-06-09,Male,31,25-34,2
23,2,0,0,2,2021-06-10,Male,20,20-24,19
24,0,0,0,0,2021-07-10,Male,65,65-69,3
24,1,4,0,5,2021-07-08,Male,68,65-69,18
24,2,0,0,2,2021-07-14,Female,59,55-64,12
24,1,0,0,1,2021-07-13,Female,70,70-74,16
24,2,0,0,2,2021-07-07,Male,11,10-14,5
24,3,0,0,3,2021-07-12,Male,2,1-4,3
24,1,0,0,1,2021-07-15,Male,31,25-34,1
24,2,1,0,3,2021-07-09,Male,65,65-69,4
24,0,0,0,0,2021-07-12,Female,49,45-54,4
24,0,0,0,0,2021-07-13,Male,30,25-34,4
24,2,0,0,2,2021-07-09,Female,66,65-69,23
24,0,0,0,0,2021-07-12,Female,72,70-74,20
24,1,1,0,2,2021-07-19,Female,58,55-64,3
24,1,0,0,1,2021-07-12,Female,72,70-74,24
24,1,2,0,3,2021-07-11,Male,71,70-74,4
24,0,0,0,0,2021-07-09,Male,30,25-34,19
24,0,0,0,0,2021-07-09,Female,53,45-54,14
24,2,0,0,2,2021-07-12,Male,16,15-19,4
24,0,1,0,1,2021-07-19,Male,41,35-44,1
24,0,0,0,0,2021-07-13,Female,54,45-54,17
24,0,0,0,0,2021-07-08,Female,68,65-69,17
24,2,0,0,2,2021-07-10,Female,57,55-64,3
24,1,0,0,1,2021-07-10,Female,68,65-69,4
24,0,0,0,0,2021-07-12,Female,34,25-34,11
24,2,0,0,2,2021-07-09,Female,6,5-9,3
24,1,0,0,1,2021-07-11,Female,60,55-64,19
24,0,0,0,0,2021-07-09,Male,52,45-54,4
24,1,1,0,2,2021-07-12,Female,61,55-64,14
24,0,0,0,0,2021-07-12,Male,51,45-54,20
24,0,4,0,4,2021-07-08,Male,68,65-69,9
24,1,0,0,1,2021-07-12,Male,51,45-54,19
24,2,0,0,2,2021-07-11,Female,36,35-44,20
24,2,0,0,2,2021-07-12,Male,45,45-54,4
24,3,1,0,4,2021-07-10,Female,58,55-64,20
24,0,0,0,0,2021-07-09,Female,66,65-69,4
24,0,10,1,11,2021-07-13,Male,33,25-34,3
24,1,0,0,1,2021-07-13,Male,35,35-44,5
24,0,1,0,1,2021-07-12,Male,50,45-54,4
24,2,7,0,9,2021-07-10,Female,19,15-19,4
24,2,0,0,2,2021-07-13,Female,11,10-14,18
24,0,0,0,0,2021-07-12,Female,40,35-44,2
24,0,0,0,0,2021-07-12,Male,43,35-44,17
24,3,1,0,4,2021-07-13,Female,55,55-64,4
24,1,0,0,1,2021-07-10,Male,57,55-64,3
24,1,1,0,2,2021-07-09,Male,67,65-69,16
24,1,0,0,1,2021-07-08,Male,67,65-69,19
24,1,0,0,1,2021-07-13,Female,57,55-64,4
24,1,4,0,5,2021-07-12,Male,63,55-64,24
24,1,5,0,6,2021-07-12,Female,50,45-54,4
24,1,0,0,1,2021-07-11,Male,60,55-64,4
24,0,2,0,2,2021-07-12,Female,36,35-44,2
24,1,0,0,1,2021-07-12,Male,65,65-69,4
24,1,0,0,1,2021-07-12,Male,7,5-9,16
24,0,12,0,12,2021-07-14,Male,48,45-54,3
24,1,0,0,1,2021-07-15,Male,16,15-19,21
24,0,2,0,2,2021-07-13,Male,49,45-54,21
24,0,0,0,0,2021-07-15,Male,49,45-54,1
24,0,4,0,4,2021-07-13,Male,43,35-44,4
24,3,1,0,4,2021-07-14,Male,59,55-64,18
24,5,0,0,5,2021-07-07,Male,52,45-54,11
24,1,0,0,1,2021-07-14,Male,35,35-44,14
24,1,1,0,2,2021-07-09,Male,35,35-44,4
24,0,10,0,10,2021-07-09,Male,54,45-54,16
24,1,0,0,1,2021-07-12,Male,76,75-79,4
24,0,0,0,0,2021-07-11,Female,71,70-74,22
24,1,1,0,2,2021-07-09,Male,68,65-69,20
24,1,0,0,1,2021-07-08,Female,53,45-54,20
24,1,0,0,1,2021-07-10,Female,69,65-69,18
24,0,1,0,1,2021-07-12,Female,78,75-79,4
24,4,1,0,5,2021-07-09,Male,19,15-19,10
24,1,0,0,1,2021-07-10,Male,59,55-64,15
24,1,0,0,1,2021-07-11,Female,57,55-64,24
24,4,0,0,4,2021-07-15,Female,5,5-9,1
24,1,0,0,1,2021-07-08,Male,52,45-54,21
24,1,0,0,1,2021-07-13,Male,43,35-44,6
24,0,0,0,0,2021-07-12,Male,85,85+,21
24,2,2,25,29,2021-07-10,Male,16,15-19,3
24,0,0,0,0,2021-07-15,Male,30,25-34,1
24,0,0,0,0,2021-07-10,Female,69,65-69,19
24,0,1,0,1,2021-07-09,Male,54,45-54,9
24,1,0,0,1,2021-07-12,Male,33,25-34,4
24,0,3,0,3,2021-07-10,Female,70,70-74,4
24,3,0,0,3,2021-07-16,Female,22,20-24,1
24,1,0,0,1,2021-07-10,Male,58,55-64,22
24,0,2,0,2,2021-07-09,Male,68,65-69,22
24,0,25,0,25,2021-07-11,Male,35,35-44,4
24,0,2,0,2,2021-07-16,Female,22,20-24,1
24,0,0,0,0,2021-07-09,Female,16,15-19,3
24,1,2,0,3,2021-07-12,Male,72,70-74,17
24,0,0,0,0,2021-07-12,Male,77,75-79,19
24,0,0,0,0,2021-07-11,Male,27,25-34,11
24,1,1,0,2,2021-07-07,Male,72,70-74,21
24,0,0,0,0,2021-07-07,Male,44,35-44,14
24,1,0,0,1,2021-07-12,Female,12,10-14,2
24,0,0,0,0,2021-07-08,Male,52,45-54,21
24,1,0,0,1,2021-07-10,Female,38,35-44,3
24,0,1,0,1,2021-07-10,Female,38,35-44,4
24,0,0,0,0,2021-07-13,Male,37,35-44,10
24,0,0,0,0,2021-07-11,Male,61,55-64,4
24,0,0,0,0,2021-07-08,Male,53,45-54,16
24,3,0,0,3,2021-07-14,Female,18,15-19,2
24,0,0,0,0,2021-07-14,Female,56,55-64,3
24,0,3,0,3,2021-07-12,Male,43,35-44,3
24,1,0,0,1,2021-07-12,Male,39,35-44,4
24,1,0,2,3,2021-07-14,Female,71,70-74,4
24,0,0,0,0,2021-07-14,Female,60,55-64,11
24,1,6,0,7,2021-07-08,Male,67,65-69,4
24,1,1,0,2,2021-07-12,Male,39,35-44,21
24,3,2,22,27,2021-07-14,Male,6,5-9,5
24,2,0,0,2,2021-07-14,Male,70,70-74,18
24,0,2,0,2,2021-07-12,Female,77,75-79,18
24,0,0,0,0,2021-07-15,Male,33,25-34,1
24,3,1,0,4,2021-07-13,Male,3,1-4,8
24,2,0,0,2,2021-07-09,Male,66,65-69,4
24,1,0,0,1,2021-07-08,Female,68,65-69,21
24,0,2,0,2,2021-07-08,Female,52,45-54,13
24,1,0,0,1,2021-07-19,Male,62,55-64,20
24,3,0,0,3,2021-07-07,Female,44,35-44,16
24,0,0,0,0,2021-07-12,Male,38,35-44,4
24,2,0,0,2,2021-07-13,Female,20,20-24,10
24,0,0,0,0,2021-07-14,Male,56,55-64,4
24,0,0,0,0,2021-07-09,Male,35,35-44,2
24,1,0,0,1,2021-07-13,Female,60,55-64,4
24,0,0,0,0,2021-07-12,Male,85,85+,18
24,2,0,0,2,2021-07-12,Female,72,70-74,19
24,0,0,0,0,2021-07-12,Male,73,70-74,4
24,0,0,0,0,2021-07-07,Female,22,20-24,10
24,1,2,0,3,2021-07-12,Female,28,25-34,4
24,0,0,0,0,2021-07-12,Female,39,35-44,5
24,0,0,0,0,2021-07-10,Female,36,35-44,3
24,2,2,0,4,2021-07-12,Male,55,55-64,23
24,1,0,0,1,2021-07-11,Male,71,70-74,21
24,2,0,0,2,2021-07-13,Female,69,65-69,20
24,1,5,0,6,2021-07-08,Male,67,65-69,14
24,1,3,1,5,2021-07-09,Female,66,65-69,23
24,3,2,0,5,2021-07-11,Male,10,10-14,15
24,2,0,0,2,2021-07-11,Male,66,65-69,22
24,2,0,0,2,2021-07-09,Male,65,65-69,4
24,4,0,0,4,2021-07-12,Female,3,1-4,5
24,0,0,0,0,2021-07-13,Male,69,65-69,14
24,0,3,0,3,2021-07-08,Female,54,45-54,4
24,4,1,0,5,2021-07-13,Female,14,10-14,13
24,1,0,0,1,2021-07-13,Male,68,65-69,19
24,1,0,0,1,2021-07-15,Male,57,55-64,1
24,0,0,0,0,2021-07-13,Male,32,25-34,4
24,2,3,0,5,2021-07-11,Male,70,70-74,14
24,2,0,0,2,2021-07-09,Male,1,1-4,4
24,1,0,0,1,2021-07-10,Female,58,55-64,4
24,0,0,22,22,2021-07-09,Female,7,5-9,10
24,0,0,0,0,2021-07-12,Male,32,25-34,3
24,1,0,0,1,2021-07-07,Female,72,70-74,2
24,7,0,0,7,2021-07-12,Female,22,20-24,14
24,0,0,0,0,2021-07-12,Male,43,35-44,20
24,3,0,0,3,2021-07-13,Female,8,5-9,18
24,2,0,0,2,2021-07-12,Male,11,10-14,4
24,0,0,0,0,2021-07-12,Female,76,75-79,4
24,0,0,0,0,2021-07-15,Male,36,35-44,1
24,1,3,0,4,2021-07-12,Male,69,65-69,3
24,1,0,0,1,2021-07-07,Female,27,25-34,4
24,0,0,0,0,2021-07-11,Male,71,70-74,19
24,1,5,0,6,2021-07-11,Male,70,70-74,24
24,4,0,0,4,2021-07-11,Female,2,1-4,17
24,0,0,0,0,2021-07-13,Female,28,25-34,3
24,8,0,0,8,2021-07-18,Female,18,15-19,1
24,2,0,0,2,2021-07-09,Female,60,55-64,22
24,4,0,0,4,2021-07-12,Male,18,15-19,20
24,0,1,0,1,2021-07-09,Female,53,45-54,21
24,0,0,0,0,2021-07-14,Male,49,45-54,22
24,1,0,0,1,2021-07-12,Male,22,20-24,7
24,0,0,0,0,2021-07-12,Male,70,70-74,17
24,1,1,0,2,2021-07-11,Male,60,55-64,4
24,1,0,0,1,2021-07-11,Female,61,55-64,5
24,3,0,0,3,2021-07-12,Female,1,1-4,2
24,1,1,0,2,2021-07-10,Male,63,55-64,4
24,2,0,0,2,2021-07-09,Male,34,25-34,3
24,1,1,0,2,2021-07-12,Female,27,25-34,10
24,5,16,86,107,2021-07-15,Female,7,5-9,1
24,0,4,0,4,2021-07-12,Female,63,55-64,22
24,1,0,0,1,2021-07-15,Female,26,25-34,1
24,0,0,0,0,2021-07-12,Female,30,25-34,17
24,0,2,0,2,2021-07-12,Female,31,25-34,23
24,1,0,0,1,2021-07-11,Female,60,55-64,3
24,2,2,0,4,2021-07-09,Female,68,65-69,17
24,1,0,0,1,2021-07-07,Male,52,45-54,4
24,0,4,0,4,2021-07-15,Female,31,25-34,1
24,0,11,0,11,2021-07-11,Male,15,15-19,14
24,1,0,0,1,2021-07-12,Female,63,55-64,21
24,1,0,0,1,2021-07-15,Male,28,25-34,1
24,0,0,0,0,2021-07-13,Male,19,15-19,12
24,1,1,0,2,2021-07-15,Male,55,55-64,1
24,2,0,0,2,2021-07-12,Female,27,25-34,4
24,0,0,0,0,2021-07-10,Male,69,65-69,13
24,0,0,0,0,2021-07-15,Male,55,55-64,21
24,0,0,0,0,2021-07-12,Male,34,25-34,16
24,0,0,0,0,2021-07-13,Male,30,25-34,13
24,1,0,0,1,2021-07-12,Male,58,55-64,18
24,0,0,0,0,2021-07-07,Male,1,1-4,9
24,3,0,0,3,2021-07-12,Female,73,70-74,16
24,0,1,0,1,2021-07-12,Male,33,25-34,23
24,0,0,0,0,2021-07-10,Male,66,65-69,17
24,1,0,0,1,2021-07-09,Male,68,65-69,4
24,2,0,0,2,2021-07-12,Female,0,<1,4
24,2,0,0,2,2021-07-11,Female,46,45-54,7
24,0,0,0,0,2021-07-12,Female,31,25-34,4
24,0,3,10,13,2021-07-14,Female,71,70-74,4
24,1,0,0,1,2021-07-07,Female,44,35-44,4
24,2,0,0,2,2021-07-09,Female,31,25-34,18
24,0,0,0,0,2021-07-10,Male,35,35-44,10
24,0,0,0,0,2021-07-11,Female,67,65-69,9
24,0,0,0,0,2021-07-09,Male,47,45-54,4
24,0,0,0,0,2021-07-10,Male,38,35-44,18
24,1,0,0,1,2021-07-10,Female,68,65-69,4
24,1,0,0,1,2021-07-12,Male,12,10-14,4
24,1,5,0,6,2021-07-14,Female,23,20-24,11
24,1,0,0,1,2021-07-09,Male,66,65-69,19
24,0,0,0,0,2021-07-09,Male,64,55-64,21
24,1,6,0,7,2021-07-14,Male,69,65-69,4
24,0,0,0,0,2021-07-09,Male,30,25-34,14
24,2,0,0,2,2021-07-11,Female,26,25-34,19
24,0,3,0,3,2021-07-07,Female,44,35-44,4
24,0,1,0,1,2021-07-10,Male,69,65-69,19
24,1,0,0,1,2021-07-08,Female,68,65-69,13
24,0,0,0,0,2021-07-09,Male,53,45-54,4
24,2,0,0,2,2021-07-12,Male,42,35-44,18
24,2,0,0,2,2021-07-11,Male,59,55-64,23
24,1,0,0,1,2021-07-10,Male,65,65-69,2
24,0,0,0,0,2021-07-07,Female,63,55-64,20
24,0,0,0,0,2021-07-15,Male,34,25-34,1
24,0,0,0,0,2021-07-15,Male,30,25-34,1
24,1,2,0,3,2021-07-07,Male,61,55-64,4
24,1,0,0,1,2021-07-14,Female,30,25-34,3
24,0,0,0,0,2021-07-11,Male,70,70-74,19
24,0,0,0,0,2021-07-15,Female,26,25-34,1
24,1,0,0,1,2021-07-09,Male,65,65-69,4
24,3,0,0,3,2021-07-15,Female,19,15-19,1
24,0,0,0,0,2021-07-12,Female,54,45-54,8
24,2,0,0,2,2021-07-11,Male,70,70-74,15
24,1,1,0,2,2021-07-13,Male,55,55-64,4
24,3,0,0,3,2021-07-19,Female,17,15-19,17
24,2,0,0,2,2021-07-12,Female,4,1-4,5
24,1,0,0,1,2021-07-09,Male,66,65-69,22
24,0,0,0,0,2021-07-14,Female,66,65-69,2
24,4,20,0,24,2021-07-15,Female,16,15-19,1
24,0,3,0,3,2021-07-12,Female,70,70-74,8
24,3,0,0,3,2021-07-09,Female,20,20-24,4
24,1,0,0,1,2021-07-12,Male,39,35-44,4
24,0,0,0,0,2021-07-12,Male,32,25-34,3
24,0,0,0,0,2021-07-12,Male,41,35-44,5
24,1,4,0,5,2021-07-08,Female,54,45-54,4
24,0,0,0,0,2021-07-13,Female,69,65-69,3
24,1,0,0,1,2021-07-12,Male,52,45-54,3
24,1,1,0,2,2021-07-12,Female,80,80-84,19
24,0,0,0,0,2021-07-12,Female,34,25-34,3
24,1,0,0,1,2021-07-14,Male,49,45-54,5
24,1,6,0,7,2021-07-10,Male,57,55-64,17
24,1,0,0,1,2021-07-12,Male,34,25-34,3
24,1,0,0,1,2021-07-13,Female,29,25-34,20
24,3,0,0,3,2021-07-09,Male,9,5-9,3
24,1,0,0,1,2021-07-08,Male,52,45-54,7
24,1,0,0,1,2021-07-09,Female,67,65-69,17
24,2,0,0,2,2021-07-15,Male,16,15-19,1
24,1,0,0,1,2021-07-12,Female,64,55-64,4
24,0,0,0,0,2021-07-12,Female,51,45-54,7
24,0,2,0,2,2021-07-12,Female,43,35-44,4
24,0,0,0,0,2021-07-12,Female,74,70-74,2
24,0,13,0,13,2021-07-08,Male,67,65-69,3
24,1,0,0,1,2021-07-09,Male,53,45-54,18
24,0,0,0,0,2021-07-15,Male,37,35-44,1
24,0,0,0,0,2021-07-08,Male,53,45-54,14
24,0,4,0,4,2021-07-07,Female,81,80-84,4
24,0,0,0,0,2021-07-11,Male,27,25-34,4
24,1,1,2,4,2021-07-11,Male,71,70-74,21
24,1,2,0,3,2021-07-10,Female,69,65-69,24
24,0,0,0,0,2021-07-09,Female,52,45-54,22
24,1,0,8,9,2021-07-12,Male,34,25-34,3
24,1,0,0,1,2021-07-13,Female,61,55-64,19
24,3,0,0,3,2021-07-10,Female,18,15-19,2
24,0,0,0,0,2021-07-12,Male,31,25-34,3
24,3,2,0,5,2021-07-13,Male,8,5-9,19
24,1,0,0,1,2021-07-08,Male,54,45-54,4
24,0,0,0,0,2021-07-12,Female,32,25-34,9
24,2,2,0,4,2021-07-08,Male,66,65-69,20
24,2,0,0,2,2021-07-11,Male,58,55-64,3
24,0,0,0,0,2021-07-08,Male,46,45-54,4
24,1,0,0,1,2021-07-07,Female,59,55-64,21
24,1,1,0,2,2021-07-09,Male,64,55-64,3
24,1,1,0,2,2021-07-09,Female,28,25-34,2
24,0,0,0,0,2021-07-12,Male,72,70-74,4
24,0,0,0,0,2021-07-07,Female,66,65-69,22
24,1,0,0,1,2021-07-12,Female,42,35-44,14
24,1,1,0,2,2021-07-07,Female,60,55-64,20
24,1,0,0,1,2021-07-13,Male,63,55-64,4
24,0,0,0,0,2021-07-08,Female,67,65-69,11
24,0,0,0,0,2021-07-11,Male,71,70-74,24
24,0,0,0,0,2021-07-07,Male,44,35-44,4
24,0,1,3,4,2021-07-14,Female,72,70-74,19
24,1,0,0,1,2021-07-12,Male,75,75-79,22
24,1,2,0,3,2021-07-09,Female,68,65-69,4
24,0,0,0,0,2021-07-11,Male,59,55-64,3
24,0,0,0,0,2021-07-12,Male,51,45-54,17
24,2,0,0,2,2021-07-12,Female,31,25-34,19
24,0,0,0,0,2021-07-09,Female,30,25-34,4
24,0,0,0,0,2021-07-12,Male,39,35-44,11
24,1,0,0,1,2021-07-09,Female,64,55-64,4
24,1,0,0,1,2021-07-13,Female,57,55-64,3
24,0,3,0,3,2021-07-14,Male,51,45-54,3
24,2,15,0,17,2021-07-07,Male,14,10-14,3
24,2,0,0,2,2021-07-14,Male,34,25-34,10
24,0,0,0,0,2021-07-08,Male,54,45-54,20
24,1,0,0,1,2021-07-12,Female,72,70-74,2
24,0,1,0,1,2021-07-07,Female,65,65-69,6
24,0,0,0,0,2021-07-15,Female,8,5-9,1
24,4,0,0,4,2021-07-15,Male,5,5-9,1
24,2,0,0,2,2021-07-13,Male,8,5-9,2
24,0,0,0,0,2021-07-19,Female,30,25-34,4
24,1,0,0,1,2021-07-12,Female,50,45-54,19
24,3,0,0,3,2021-07-12,Male,18,15-19,2
24,2,2,0,4,2021-07-14,Male,55,55-64,3
24,2,1,0,3,2021-07-13,Male,16,15-19,20
24,1,0,0,1,2021-07-13,Female,53,45-54,4
24,3,1,0,4,2021-07-09,Female,19,15-19,3
24,0,0,0,0,2021-07-15,Male,53,45-54,1
24,1,0,0,1,2021-07-15,Male,50,45-54,1
24,0,0,0,0,2021-07-13,Male,65,65-69,18
24,0,1,0,1,2021-07-10,Male,69,65-69,21
24,0,0,0,0,2021-07-13,Male,23,20-24,4
24,1,0,0,1,2021-07-12,Female,58,55-64,21
24,0,0,0,0,2021-07-13,Male,34,25-34,3
24,2,3,0,5,2021-07-13,Female,39,35-44,4
24,1,0,0,1,2021-07-15,Female,33,25-34,1
24,2,4,0,6,2021-07-12,Female,1,1-4,3
24,2,3,0,5,2021-07-10,Male,19,15-19,4
24,0,0,0,0,2021-07-12,Female,48,45-54,4
24,0,0,0,0,2021-07-11,Male,12,10-14,20
24,0,2,0,2,2021-07-13,Female,26,25-34,5
24,0,1,0,1,2021-07-12,Male,71,70-74,22
24,0,1,0,1,2021-07-12,Male,41,35-44,18
24,1,9,0,10,2021-07-09,Female,53,45-54,4
24,2,40,0,42,2021-07-10,Female,58,55-64,3
24,2,0,0,2,2021-07-11,Female,70,70-74,24
24,1,1,0,2,2021-07-15,Female,21,20-24,1
24,0,0,0,0,2021-07-12,Male,38,35-44,18
24,1,5,0,6,2021-07-13,Female,64,55-64,3
24,3,0,0,3,2021-07-10,Male,20,20-24,13
24,1,20,0,21,2021-07-13,Female,8,5-9,15
24,0,0,0,0,2021-07-15,Male,29,25-34,1
24,0,1,0,1,2021-07-13,Male,22,20-24,11
24,2,0,0,2,2021-07-12,Female,73,70-74,17
24,0,0,0,0,2021-07-14,Male,52,45-54,18
24,1,0,0,1,2021-07-11,Female,60,55-64,24
24,0,0,0,0,2021-07-12,Male,44,35-44,22
24,2,1,0,3,2021-07-13,Male,63,55-64,11
24,2,0,0,2,2021-07-09,Female,63,55-64,18
24,1,0,0,1,2021-07-13,Female,55,55-64,3
24,2,0,0,2,2021-07-12,Male,74,70-74,20
24,1,13,0,14,2021-07-14,Female,32,25-34,7
24,2,0,0,2,2021-07-08,Female,53,45-54,22
24,0,0,0,0,2021-07-13,Male,43,35-44,3
24,0,0,0,0,2021-07-11,Male,69,65-69,19
24,0,0,4,4,2021-07-11,Male,26,25-34,4
24,1,1,0,2,2021-07-12,Male,34,25-34,23
24,0,0,0,0,2021-07-14,Female,21,20-24,3
24,0,0,0,0,2021-07-12,Male,48,45-54,18
24,3,5,1,9,2021-07-12,Male,70,70-74,19
24,2,0,0,2,2021-07-10,Male,55,55-64,4
24,2,2,0,4,2021-07-11,Male,16,15-19,4
24,1,1,0,2,2021-07-13,Male,68,65-69,22
24,1,0,0,1,2021-07-09,Female,22,20-24,4
24,0,8,0,8,2021-07-13,Male,62,55-64,18
24,1,1,0,2,2021-07-11,Male,71,70-74,16
24,1,3,0,4,2021-07-13,Male,69,65-69,3
24,1,0,0,1,2021-07-12,Female,2,1-4,4
24,0,0,0,0,2021-07-08,Male,44,35-44,16
24,0,0,0,0,2021-07-09,Male,28,25-34,4
24,1,1,0,2,2021-07-10,Female,57,55-64,22
24,0,0,0,0,2021-07-11,Female,59,55-64,19
24,3,10,0,13,2021-07-13,Male,23,20-24,12
24,0,0,0,0,2021-07-08,Female,67,65-69,20
24,0,0,0,0,2021-07-10,Male,54,45-54,4
24,0,1,0,1,2021-07-13,Female,76,75-79,4
24,0,0,0,0,2021-07-12,Male,21,20-24,2
24,1,2,0,3,2021-07-10,Female,56,55-64,4
24,0,0,0,0,2021-07-07,Male,45,45-54,15
24,3,0,0,3,2021-07-07,Male,22,20-24,2
24,2,1,0,3,2021-07-13,Female,23,20-24,2
24,0,3,0,3,2021-07-09,Female,64,55-64,18
24,0,3,0,3,2021-07-11,Male,70,70-74,4
24,1,0,0,1,2021-07-10,Male,29,25-34,4
24,3,0,0,3,2021-07-10,Female,19,15-19,4
24,2,0,0,2,2021-07-12,Female,12,10-14,6
24,1,1,0,2,2021-07-11,Female,61,55-64,24
24,1,0,0,1,2021-07-11,Male,61,55-64,9
24,1,0,0,1,2021-07-13,Male,49,45-54,19
24,1,2,0,3,2021-07-13,Female,54,45-54,24
24,1,0,0,1,2021-07-12,Male,61,55-64,3
24,0,0,0,0,2021-07-12,Male,56,55-64,19
24,0,2,0,2,2021-07-09,Female,66,65-69,23
24,4,0,0,4,2021-07-12,Male,7,5-9,17
24,0,4,0,4,2021-07-13,Female,25,25-34,3
24,1,0,0,1,2021-07-12,Male,79,75-79,18
24,0,6,0,6,2021-07-13,Female,67,65-69,18
24,0,0,0,0,2021-07-13,Male,39,35-44,20
24,2,0,0,2,2021-07-12,Female,19,15-19,17
24,1,0,0,1,2021-07-12,Female,56,55-64,20
24,0,2,0,2,2021-07-12,Female,74,70-74,4
24,0,0,0,0,2021-07-08,Male,54,45-54,18
24,1,0,0,1,2021-07-12,Female,71,70-74,4
24,2,0,0,2,2021-07-13,Male,5,5-9,3
24,1,0,0,1,2021-07-12,Male,69,65-69,22
24,2,0,0,2,2021-07-13,Male,18,15-19,18
24,4,0,17,21,2021-07-07,Female,10,10-14,4
24,0,2,0,2,2021-07-11,Male,37,35-44,24
24,0,0,0,0,2021-07-09,Male,66,65-69,9
24,1,3,0,4,2021-07-12,Male,41,35-44,24
24,0,1,0,1,2021-07-13,Male,33,25-34,20
24,1,1,0,2,2021-07-12,Male,66,65-69,4
24,0,1,0,1,2021-07-15,Female,27,25-34,2
24,2,0,0,2,2021-07-12,Male,62,55-64,23
24,0,0,0,0,2021-07-12,Female,1,1-4,12
24,1,2,0,3,2021-07-10,Female,69,65-69,17
24,0,0,0,0,2021-07-12,Female,70,70-74,14
24,1,0,0,1,2021-07-09,Male,68,65-69,14
24,0,0,0,0,2021-07-07,Male,9,5-9,20
24,0,1,0,1,2021-07-13,Male,46,45-54,4
24,1,2,0,3,2021-07-12,Female,34,25-34,17
24,0,0,0,0,2021-07-10,Male,69,65-69,22
24,1,0,0,1,2021-07-14,Female,69,65-69,2
24,0,1,0,1,2021-07-09,Male,29,25-34,20
24,1,0,0,1,2021-07-07,Female,21,20-24,4
24,1,0,0,1,2021-07-08,Male,13,10-14,4
24,0,0,0,0,2021-07-08,Female,54,45-54,20
24,1,0,0,1,2021-07-12,Male,43,35-44,4
24,3,2,0,5,2021-07-13,Male,6,5-9,18
24,0,0,0,0,2021-07-12,Male,31,25-34,11
24,2,26,0,28,2021-07-14,Female,10,10-14,3
24,0,0,0,0,2021-07-12,Male,51,45-54,3
24,0,0,0,0,2021-07-07,Male,77,75-79,15
24,1,1,0,2,2021-07-11,Male,60,55-64,4
24,0,0,1,1,2021-07-09,Male,47,45-54,18
24,0,0,0,0,2021-07-15,Male,42,35-44,2
24,2,0,39,41,2021-07-13,Female,1,1-4,3
24,1,2,0,3,2021-07-08,Male,53,45-54,21
24,0,0,0,0,2021-07-11,Female,71,70-74,14
24,2,5,3,10,2021-07-14,Female,69,65-69,10
24,1,10,0,11,2021-07-12,Male,33,25-34,18
24,3,0,0,3,2021-07-10,Male,70,70-74,19
24,0,4,0,4,2021-07-07,Female,34,25-34,3
24,2,0,0,2,2021-07-11,Female,69,65-69,17
24,3,0,0,3,2021-07-07,Male,15,15-19,21
24,2,0,0,2,2021-07-09,Male,65,65-69,20
24,0,1,0,1,2021-07-13,Male,50,45-54,21
24,1,4,0,5,2021-07-09,Male,66,65-69,3
24,0,0,0,0,2021-07-14,Male,66,65-69,15
24,2,0,0,2,2021-07-11,Female,67,65-69,14
24,1,4,0,5,2021-07-14,Female,74,70-74,3
24,1,0,0,1,2021-07-13,Male,22,20-24,2
24,0,0,100,100,2021-07-13,Male,36,35-44,2
24,1,0,0,1,2021-07-08,Female,66,65-69,13
24,0,0,0,0,2021-07-07,Male,48,45-54,4
24,1,0,0,1,2021-07-08,Male,67,65-69,22
24,0,0,0,0,2021-07-09,Male,65,65-69,22
24,1,0,0,1,2021-07-07,Female,18,15-19,4
24,0,4,0,4,2021-07-09,Female,31,25-34,4
24,1,0,0,1,2021-07-13,Male,34,25-34,3
24,2,0,0,2,2021-07-09,Female,68,65-69,23
24,1,2,0,3,2021-07-09,Male,68,65-69,22
24,0,0,0,0,2021-07-12,Male,41,35-44,16
24,1,0,0,1,2021-07-13,Male,75,75-79,14
24,3,0,0,3,2021-07-13,Male,15,15-19,3
24,1,0,0,1,2021-07-07,Male,45,45-54,4
24,0,0,0,0,2021-07-12,Female,49,45-54,4
24,2,0,0,2,2021-07-12,Female,5,5-9,4
24,1,1,0,2,2021-07-13,Female,45,45-54,14
24,0,0,0,0,2021-07-12,Female,72,70-74,4
24,1,0,0,1,2021-07-11,Male,57,55-64,4
24,1,3,0,4,2021-07-11,Female,57,55-64,3
24,0,0,0,0,2021-07-09,Male,53,45-54,9
24,2,0,0,2,2021-07-12,Male,71,70-74,16
24,0,0,0,0,2021-07-09,Female,54,45-54,4
24,3,0,0,3,2021-07-07,Male,18,15-19,4
24,0,1,0,1,2021-07-09,Male,65,65-69,4
24,1,5,0,6,2021-07-12,Female,42,35-44,3
24,0,0,0,0,2021-07-14,Female,20,20-24,12
24,0,2,0,2,2021-07-15,Male,52,45-54,1
24,1,1,0,2,2021-07-07,Male,55,55-64,4
24,2,0,0,2,2021-07-15,Female,5,5-9,1
24,0,0,0,0,2021-07-09,Female,52,45-54,22
24,1,1,0,2,2021-07-13,Female,67,65-69,3
24,1,1,0,2,2021-07-19,Male,32,25-34,1
24,5,0,0,5,2021-07-07,Male,14,10-14,21
24,0,0,0,0,2021-07-12,Female,60,55-64,18
24,1,7,0,8,2021-07-08,Female,67,65-69,4
24,3,0,0,3,2021-07-14,Female,1,1-4,14
24,2,0,2,4,2021-07-11,Male,26,25-34,4
24,0,0,0,0,2021-07-11,Male,47,45-54,12
24,0,0,0,0,2021-07-07,Male,56,55-64,4
24,0,0,0,0,2021-07-12,Male,82,80-84,21
24,1,0,0,1,2021-07-12,Female,71,70-74,3
24,2,0,0,2,2021-07-18,Female,7,5-9,14
24,3,0,0,3,2021-07-13,Male,1,1-4,7
24,0,0,0,0,2021-07-12,Female,59,55-64,15
24,0,0,0,0,2021-07-14,Male,6,5-9,17
24,1,0,0,1,2021-07-11,Male,59,55-64,4
24,0,0,0,0,2021-07-12,Female,51,45-54,10
24,0,0,0,0,2021-07-13,Male,49,45-54,18
24,1,0,0,1,2021-07-12,Male,44,35-44,5
24,1,0,0,1,2021-07-13,Female,53,45-54,15
24,2,8,0,10,2021-07-14,Female,17,15-19,4
24,1,10,2,13,2021-07-09,Male,65,65-69,2
24,0,1,0,1,2021-07-11,Male,25,25-34,21
24,0,0,0,0,2021-07-13,Male,21,20-24,16
24,0,2,0,2,2021-07-08,Female,44,35-44,3
24,2,2,0,4,2021-07-12,Male,72,70-74,22
24,0,0,0,0,2021-07-07,Male,35,35-44,23
24,0,0,0,0,2021-07-14,Female,37,35-44,4
24,2,0,0,2,2021-07-12,Female,35,35-44,15
24,0,0,0,0,2021-07-15,Male,38,35-44,1
24,1,0,0,1,2021-07-11,Male,72,70-74,4
24,0,0,8,8,2021-07-12,Male,29,25-34,4
24,1,2,0,3,2021-07-12,Female,67,65-69,3
24,0,0,0,0,2021-07-09,Female,67,65-69,18
24,3,0,0,3,2021-07-11,Male,24,20-24,19
24,1,0,0,1,2021-07-13,Female,9,5-9,17
24,1,0,0,1,2021-07-09,Female,68,65-69,16
24,0,0,0,0,2021-07-09,Male,68,65-69,21
24,1,0,0,1,2021-07-19,Male,43,35-44,1
24,1,1,0,2,2021-07-11,Male,64,55-64,3
24,2,0,0,2,2021-07-13,Female,0,<1,3
24,1,0,0,1,2021-07-09,Male,22,20-24,15
24,2,0,0,2,2021-07-14,Male,42,35-44,24
24,1,0,0,1,2021-07-07,Male,66,65-69,20
24,3,1,0,4,2021-07-15,Male,50,45-54,13
24,2,0,0,2,2021-07-12,Male,4,1-4,4
24,3,3,0,6,2021-07-10,Female,22,20-24,3
24,0,0,0,0,2021-07-11,Male,71,70-74,16
24,2,0,0,2,2021-07-12,Female,39,35-44,4
24,0,1,0,1,2021-07-11,Male,59,55-64,4
24,2,0,0,2,2021-07-14,Female,40,35-44,5
24,2,0,0,2,2021-07-10,Male,59,55-64,20
24,3,2,0,5,2021-07-13,Female,68,65-69,7
24,1,36,0,37,2021-07-13,Female,54,45-54,3
24,0,0,0,0,2021-07-08,Male,53,45-54,4
24,0,0,4,4,2021-07-10,Male,10,10-14,10
24,1,2,0,3,2021-07-14,Male,80,80-84,22
24,2,0,0,2,2021-07-13,Male,55,55-64,19
24,0,0,2,2,2021-07-07,Female,28,25-34,4
24,2,0,0,2,2021-07-13,Male,57,55-64,4
24,2,4,12,18,2021-07-10,Male,69,65-69,5
24,0,0,0,0,2021-07-12,Male,79,75-79,3
24,1,3,0,4,2021-07-09,Female,65,65-69,4
24,0,2,0,2,2021-07-14,Female,69,65-69,17
24,3,0,0,3,2021-07-09,Male,65,65-69,16
24,1,0,0,1,2021-07-12,Male,64,55-64,17
24,0,2,0,2,2021-07-08,Female,67,65-69,21
24,0,0,0,0,2021-07-13,Female,65,65-69,5
24,0,8,0,8,2021-07-14,Male,51,45-54,3
24,2,0,0,2,2021-07-12,Female,26,25-34,14
24,1,0,0,1,2021-07-09,Male,67,65-69,4
24,0,1,0,1,2021-07-10,Female,69,65-69,21
24,0,2,0,2,2021-07-09,Female,29,25-34,11
24,1,1,0,2,2021-07-10,Male,54,45-54,3
24,0,0,0,0,2021-07-10,Female,67,65-69,17
24,0,0,0,0,2021-07-12,Female,64,55-64,19
24,1,0,0,1,2021-07-11,Male,69,65-69,21
24,1,0,0,1,2021-07-12,Male,59,55-64,4
24,0,1,0,1,2021-07-12,Female,34,25-34,18
24,3,0,0,3,2021-07-15,Female,3,1-4,1
24,1,0,0,1,2021-07-15,Male,29,25-34,1
24,1,100,0,101,2021-07-15,Female,51,45-54,2
24,2,0,0,2,2021-07-13,Female,15,15-19,16
24,2,1,0,3,2021-07-12,Male,4,1-4,4
24,0,0,0,0,2021-07-08,Female,66,65-69,3
24,0,0,0,0,2021-07-09,Male,53,45-54,4
24,0,0,0,0,2021-07-12,Female,72,70-74,15
24,1,0,0,1,2021-07-10,Female,38,35-44,4
24,0,3,0,3,2021-07-13,Female,51,45-54,2
24,3,0,0,3,2021-07-08,Female,53,45-54,19
24,1,4,0,5,2021-07-15,Male,38,35-44,1
24,0,0,0,0,2021-07-12,Female,1,1-4,11
24,2,0,0,2,2021-07-09,Female,66,65-69,16
24,2,0,0,2,2021-07-12,Female,79,75-79,18
24,1,0,0,1,2021-07-11,Male,57,55-64,3
24,0,0,0,0,2021-07-11,Female,71,70-74,4
24,2,5,0,7,2021-07-09,Male,66,65-69,4
24,2,0,0,2,2021-07-12,Male,11,10-14,4
24,0,0,0,0,2021-07-10,Male,58,55-64,3
24,0,0,0,0,2021-07-09,Male,66,65-69,23
24,1,0,0,1,2021-07-13,Male,65,65-69,4
24,1,0,0,1,2021-07-11,Female,70,70-74,20
24,0,0,0,0,2021-07-07,Female,76,75-79,22
24,1,0,0,1,2021-07-13,Male,34,25-34,3
24,2,4,0,6,2021-07-13,Female,16,15-19,4
24,3,0,0,3,2021-07-11,Male,37,35-44,19
24,1,0,0,1,2021-07-07,Female,65,65-69,3
24,1,0,0,1,2021-07-12,Female,49,45-54,19
24,1,1,0,2,2021-07-12,Male,61,55-64,18
24,1,0,0,1,2021-07-08,Female,66,65-69,4
24,1,0,5,6,2021-07-07,Male,32,25-34,5
24,2,6,0,8,2021-07-15,Male,53,45-54,1
24,1,0,0,1,2021-07-12,Male,55,55-64,4
24,1,0,0,1,2021-07-13,Female,71,70-74,5
24,3,0,0,3,2021-07-09,Female,18,15-19,12
24,1,0,0,1,2021-07-12,Male,69,65-69,21
24,2,0,0,2,2021-07-10,Male,57,55-64,14
24,1,0,0,1,2021-07-12,Female,62,55-64,4
24,1,2,0,3,2021-07-13,Female,55,55-64,17
24,0,2,0,2,2021-07-12,Male,62,55-64,19
24,0,0,0,0,2021-07-07,Male,61,55-64,4
24,1,0,0,1,2021-07-14,Male,19,15-19,3
24,0,0,0,0,2021-07-13,Female,66,65-69,16
24,1,0,0,1,2021-07-12,Female,33,25-34,14
24,0,1,22,23,2021-07-07,Male,19,15-19,4
24,3,0,0,3,2021-07-12,Female,44,35-44,4
24,0,0,0,0,2021-07-12,Female,61,55-64,14
24,1,0,0,1,2021-07-09,Male,52,45-54,4
24,3,0,0,3,2021-07-13,Male,18,15-19,2
24,1,2,0,3,2021-07-12,Female,61,55-64,19
24,0,3,0,3,2021-07-12,Male,52,45-54,19
24,1,0,0,1,2021-07-12,Female,50,45-54,20
24,1,0,0,1,2021-07-11,Female,60,55-64,3
24,0,3,2,5,2021-07-13,Female,63,55-64,4
24,0,0,0,0,2021-07-12,Male,47,45-54,2
24,1,1,0,2,2021-07-09,Male,17,15-19,4
24,0,4,0,4,2021-07-12,Male,74,70-74,22
24,0,0,0,0,2021-07-12,Male,67,65-69,9
24,0,1,0,1,2021-07-09,Male,64,55-64,6
24,0,3,0,3,2021-07-08,Female,67,65-69,3
24,2,2,0,4,2021-07-12,Male,51,45-54,4
24,3,0,0,3,2021-07-08,Female,14,10-14,21
24,1,0,0,1,2021-07-12,Male,25,25-34,22
24,1,1,0,2,2021-07-11,Female,70,70-74,20
24,0,0,0,0,2021-07-12,Female,81,80-84,10
24,0,0,0,0,2021-07-14,Male,43,35-44,6
24,3,0,0,3,2021-07-08,Female,14,10-14,20
24,1,1,0,2,2021-07-12,Male,77,75-79,4
24,1,0,0,1,2021-07-12,Female,40,35-44,3
24,0,5,0,5,2021-07-19,Male,52,45-54,1
24,0,1,0,1,2021-07-07,Female,66,65-69,19
24,1,0,0,1,2021-07-10,Female,27,25-34,21
24,1,1,0,2,2021-07-12,Female,62,55-64,3
24,2,1,0,3,2021-07-13,Male,76,75-79,22
24,1,0,0,1,2021-07-09,Male,68,65-69,4
24,0,0,0,0,2021-07-09,Male,64,55-64,4
24,0,4,0,4,2021-07-07,Female,30,25-34,6
24,0,3,0,3,2021-07-13,Male,25,25-34,3
24,1,0,0,1,2021-07-12,Male,74,70-74,19
24,0,0,0,0,2021-07-07,Female,25,25-34,22
24,1,0,0,1,2021-07-15,Female,23,20-24,12
24,3,0,26,29,2021-07-19,Male,19,15-19,1
24,0,0,7,7,2021-07-14,Female,43,35-44,10
24,0,1,0,1,2021-07-19,Male,42,35-44,1
24,1,1,0,2,2021-07-09,Male,63,55-64,21
24,0,1,0,1,2021-07-09,Male,64,55-64,20
24,3,0,0,3,2021-07-07,Male,18,15-19,18
24,1,0,0,1,2021-07-13,Male,51,45-54,4
24,0,0,0,0,2021-07-09,Male,54,45-54,4
24,3,0,0,3,2021-07-19,Male,21,20-24,4
24,2,0,0,2,2021-07-10,Male,55,55-64,23
24,1,10,0,11,2021-07-07,Male,36,35-44,4
24,0,0,0,0,2021-07-09,Male,67,65-69,2
24,0,0,0,0,2021-07-12,Male,61,55-64,16
24,2,0,0,2,2021-07-13,Female,8,5-9,21
24,0,0,0,0,2021-07-09,Female,66,65-69,9
24,1,3,0,4,2021-07-19,Female,31,25-34,1
24,1,0,0,1,2021-07-12,Male,73,70-74,17
24,2,0,0,2,2021-07-12,Male,73,70-74,17
24,2,0,0,2,2021-07-15,Male,3,1-4,1
24,1,0,0,1,2021-07-08,Female,53,45-54,22
24,0,1,0,1,2021-07-10,Male,33,25-34,16
24,0,0,0,0,2021-07-12,Female,49,45-54,4
24,1,0,0,1,2021-07-12,Female,72,70-74,4
24,0,0,0,0,2021-07-15,Male,52,45-54,1
24,2,3,0,5,2021-07-15,Female,1,1-4,1
24,0,1,0,1,2021-07-12,Female,72,70-74,19
24,1,3,0,4,2021-07-11,Male,70,70-74,4
24,0,0,0,0,2021-07-11,Female,28,25-34,4
24,0,0,0,0,2021-07-10,Male,30,25-34,21
24,0,1,0,1,2021-07-11,Female,57,55-64,23
24,0,0,0,0,2021-07-09,Male,68,65-69,18
24,0,0,0,0,2021-07-14,Male,51,45-54,4
24,0,2,0,2,2021-07-08,Female,67,65-69,2
24,0,0,0,0,2021-07-09,Male,52,45-54,20
24,0,3,0,3,2021-07-11,Male,55,55-64,19
24,2,4,0,6,2021-07-13,Female,48,45-54,3
24,3,0,0,3,2021-07-14,Male,9,5-9,19
24,2,0,0,2,2021-07-14,Male,27,25-34,3
24,0,0,0,0,2021-07-12,Female,51,45-54,3
24,2,0,0,2,2021-07-07,Male,67,65-69,23
24,0,0,0,0,2021-07-07,Female,38,35-44,4
24,2,0,0,2,2021-07-12,Male,9,5-9,4
24,0,2,0,2,2021-07-10,Female,69,65-69,16
24,1,0,0,1,2021-07-12,Female,51,45-54,3
24,2,0,3,5,2021-07-09,Male,29,25-34,3
24,1,0,0,1,2021-07-15,Female,30,25-34,1
24,1,0,0,1,2021-07-11,Female,70,70-74,9
24,0,0,0,0,2021-07-13,Female,30,25-34,19
24,0,0,0,0,2021-07-08,Male,46,45-54,21
24,1,0,0,1,2021-07-12,Female,42,35-44,4
24,1,0,0,1,2021-07-13,Male,57,55-64,4
24,2,0,0,2,2021-07-10,Female,69,65-69,19
24,1,0,0,1,2021-07-14,Male,45,45-54,3
24,1,0,0,1,2021-07-12,Male,50,45-54,5
24,2,2,0,4,2021-07-10,Male,37,35-44,5
24,1,0,0,1,2021-07-11,Male,55,55-64,16
24,0,41,10,51,2021-07-15,Female,39,35-44,1
24,1,0,0,1,2021-07-12,Female,48,45-54,17
24,2,0,0,2,2021-07-07,Male,8,5-9,9
24,0,2,0,2,2021-07-13,Female,42,35-44,11
24,0,0,0,0,2021-07-13,Female,53,45-54,6
24,1,0,0,1,2021-07-09,Male,66,65-69,21
24,0,0,0,0,2021-07-15,Male,52,45-54,1
24,2,0,3,5,2021-07-12,Female,3,1-4,4
24,2,0,0,2,2021-07-13,Male,5,5-9,23
24,2,0,0,2,2021-07-12,Female,18,15-19,5
24,3,10,0,13,2021-07-14,Male,60,55-64,16
24,0,0,0,0,2021-07-12,Female,50,45-54,8
24,0,0,0,0,2021-07-12,Male,58,55-64,23
24,1,0,0,1,2021-07-09,Female,66,65-69,24
24,1,3,0,4,2021-07-15,Female,30,25-34,2
24,1,2,0,3,2021-07-14,Male,9,5-9,10
24,1,0,0,1,2021-07-08,Female,52,45-54,16
24,1,1,0,2,2021-07-08,Female,68,65-69,3
24,2,0,0,2,2021-07-13,Female,10,10-14,19
24,2,0,5,7,2021-07-14,Female,73,70-74,10
24,0,2,0,2,2021-07-15,Female,3,1-4,1
24,2,2,0,4,2021-07-11,Male,3,1-4,4
24,1,3,0,4,2021-07-12,Female,25,25-34,17
24,4,0,0,4,2021-07-10,Male,14,10-14,24
24,2,5,0,7,2021-07-13,Male,51,45-54,22
24,5,1,0,6,2021-07-13,Female,21,20-24,3
24,0,0,0,0,2021-07-12,Male,74,70-74,23
24,0,0,0,0,2021-07-12,Male,19,15-19,12
24,0,0,0,0,2021-07-12,Female,30,25-34,5
24,3,0,0,3,2021-07-08,Female,8,5-9,4
24,0,0,0,0,2021-07-08,Female,67,65-69,16
24,1,0,0,1,2021-07-10,Male,55,55-64,21
24,0,3,0,3,2021-07-12,Female,79,75-79,9
24,1,0,0,1,2021-07-09,Male,68,65-69,11
24,0,0,0,0,2021-07-13,Male,78,75-79,19
24,0,1,0,1,2021-07-13,Female,33,25-34,10
24,0,0,0,0,2021-07-12,Male,85,85+,16
24,0,0,0,0,2021-07-15,Female,3,1-4,3
24,2,5,0,7,2021-07-11,Male,54,45-54,4
24,0,0,0,0,2021-07-10,Male,69,65-69,4
24,0,0,0,0,2021-07-12,Male,32,25-34,13
24,1,0,0,1,2021-07-13,Female,67,65-69,14
24,0,0,0,0,2021-07-15,Male,27,25-34,1
24,0,0,0,0,2021-07-08,Male,66,65-69,19
24,1,1,0,2,2021-07-12,Male,60,55-64,23
24,1,0,0,1,2021-07-12,Male,55,55-64,20
24,0,0,0,0,2021-07-13,Male,69,65-69,3
24,0,0,0,0,2021-07-12,Female,70,70-74,3
24,0,0,0,0,2021-07-13,Female,25,25-34,23
24,1,0,0,1,2021-07-15,Male,46,45-54,2
24,0,6,0,6,2021-07-07,Male,50,45-54,4
24,1,0,0,1,2021-07-10,Male,34,25-34,20
24,1,0,0,1,2021-07-09,Male,52,45-54,23
24,2,1,0,3,2021-07-10,Male,69,65-69,4
24,2,0,0,2,2021-07-15,Male,12,10-14,2
24,0,0,0,0,2021-07-14,Female,66,65-69,10
24,0,1,0,1,2021-07-11,Female,24,20-24,21
24,0,0,0,0,2021-07-12,Female,49,45-54,24
24,0,0,0,0,2021-07-12,Male,41,35-44,4
24,0,2,0,2,2021-07-12,Male,40,35-44,16
24,0,0,0,0,2021-07-12,Male,70,70-74,21
24,2,3,0,5,2021-07-08,Male,67,65-69,4
24,2,1,0,3,2021-07-09,Female,64,55-64,23
24,1,0,0,1,2021-07-12,Male,70,70-74,4
24,1,0,0,1,2021-07-13,Female,54,45-54,4
24,1,1,4,6,2021-07-12,Male,58,55-64,3
24,1,3,0,4,2021-07-07,Male,64,55-64,20
24,2,0,0,2,2021-07-07,Male,43,35-44,4
24,1,0,1,2,2021-07-11,Female,23,20-24,5
24,0,0,0,0,2021-07-10,Male,38,35-44,15
24,0,0,0,0,2021-07-09,Female,21,20-24,11
24,2,2,0,4,2021-07-10,Female,38,35-44,20
24,1,1,0,2,2021-07-12,Male,34,25-34,6
24,0,0,0,0,2021-07-15,Male,49,45-54,1
24,0,0,0,0,2021-07-13,Female,23,20-24,11
24,1,0,0,1,2021-07-12,Female,76,75-79,4
24,1,0,0,1,2021-07-08,Male,54,45-54,3
24,2,0,0,2,2021-07-12,Female,61,55-64,21
24,0,0,0,0,2021-07-10,Female,58,55-64,4
24,1,3,0,4,2021-07-13,Female,57,55-64,16
24,0,0,0,0,2021-07-09,Female,65,65-69,3
24,2,0,0,2,2021-07-12,Male,3,1-4,4
24,1,0,0,1,2021-07-09,Male,53,45-54,19
24,0,8,0,8,2021-07-09,Female,66,65-69,24
24,1,0,0,1,2021-07-14,Female,47,45-54,2
24,3,1,0,4,2021-07-13,Female,27,25-34,3
24,1,2,0,3,2021-07-13,Male,4,1-4,4
24,0,3,0,3,2021-07-10,Female,67,65-69,20
24,0,0,0,0,2021-07-15,Female,34,25-34,2
24,0,3,0,3,2021-07-14,Female,70,70-74,17
24,3,0,0,3,2021-07-12,Female,5,5-9,18
24,1,0,0,1,2021-07-11,Female,37,35-44,4
24,0,1,0,1,2021-07-08,Male,54,45-54,18
24,2,0,0,2,2021-07-07,Female,9,5-9,3
24,0,0,0,0,2021-07-10,Male,55,55-64,17
24,0,0,0,0,2021-07-12,Male,73,70-74,3
24,5,1,0,6,2021-07-14,Male,1,1-4,8
24,1,1,0,2,2021-07-09,Male,54,45-54,3
24,3,14,0,17,2021-07-13,Male,18,15-19,4
24,1,1,0,2,2021-07-13,Male,58,55-64,19
24,2,3,0,5,2021-07-12,Male,40,35-44,22
24,0,1,0,1,2021-07-12,Male,39,35-44,20
24,1,0,1,2,2021-07-15,Male,53,45-54,1
24,0,0,0,0,2021-07-12,Male,40,35-44,18
24,3,0,0,3,2021-07-09,Female,21,20-24,19
24,1,0,0,1,2021-07-09,Male,67,65-69,4
24,0,0,0,0,2021-07-12,Female,17,15-19,13
24,0,0,5,5,2021-07-12,Female,49,45-54,3
24,1,1,0,2,2021-07-09,Female,66,65-69,4
24,2,0,0,2,2021-07-13,Female,5,5-9,20
24,1,1,0,2,2021-07-09,Male,66,65-69,22
24,0,0,0,0,2021-07-11,Male,61,55-64,19
24,0,0,0,0,2021-07-13,Female,39,35-44,3
24,1,30,0,31,2021-07-09,Female,64,55-64,8
24,3,0,100,103,2021-07-12,Male,20,20-24,2
24,0,1,0,1,2021-07-12,Male,73,70-74,19
24,0,0,0,0,2021-07-10,Female,58,55-64,19
24,1,0,0,1,2021-07-12,Male,48,45-54,4
24,0,0,0,0,2021-07-11,Female,23,20-24,3
24,1,1,0,2,2021-07-12,Male,71,70-74,22
24,0,0,0,0,2021-07-12,Female,15,15-19,23
24,1,0,0,1,2021-07-07,Male,63,55-64,23
24,1,2,0,3,2021-07-08,Male,68,65-69,24
24,1,1,0,2,2021-07-12,Female,47,45-54,3
24,0,0,5,5,2021-07-09,Male,20,20-24,4
24,2,0,0,2,2021-07-12,Male,77,75-79,11
24,0,0,0,0,2021-07-13,Male,65,65-69,3
24,2,0,0,2,2021-07-07,Male,46,45-54,4
24,1,0,0,1,2021-07-12,Male,60,55-64,3
24,1,0,0,1,2021-07-11,Female,71,70-74,20
24,1,0,0,1,2021-07-12,Male,74,70-74,4
24,0,1,0,1,2021-07-13,Male,52,45-54,13
24,0,1,0,1,2021-07-11,Female,61,55-64,15
24,0,0,0,0,2021-07-12,Female,62,55-64,8
24,3,0,0,3,2021-07-11,Male,7,5-9,24
24,2,0,0,2,2021-07-11,Female,56,55-64,22
24,0,0,0,0,2021-07-08,Male,53,45-54,14
24,1,2,0,3,2021-07-12,Male,72,70-74,4
24,0,3,0,3,2021-07-07,Male,44,35-44,4
24,0,0,0,0,2021-07-13,Female,36,35-44,19
24,2,4,0,6,2021-07-13,Male,56,55-64,18
24,0,1,0,1,2021-07-07,Female,45,45-54,3
24,1,2,0,3,2021-07-12,Male,63,55-64,20
24,0,0,0,0,2021-07-12,Female,61,55-64,3
24,0,24,0,24,2021-07-10,Male,58,55-64,3
24,0,0,0,0,2021-07-14,Male,66,65-69,13
24,1,1,0,2,2021-07-14,Male,68,65-69,3
24,0,0,0,0,2021-07-12,Male,48,45-54,3
24,0,1,0,1,2021-07-09,Male,54,45-54,17
24,2,1,0,3,2021-07-14,Female,18,15-19,2
24,2,1,0,3,2021-07-12,Female,73,70-74,13
24,2,0,0,2,2021-07-14,Male,79,75-79,15
24,1,0,0,1,2021-07-10,Male,69,65-69,3
24,0,2,0,2,2021-07-12,Female,24,20-24,7
24,1,0,0,1,2021-07-12,Female,66,65-69,20
24,1,0,0,1,2021-07-12,Male,77,75-79,4
24,2,0,0,2,2021-07-13,Male,10,10-14,6
24,5,0,0,5,2021-07-11,Female,10,10-14,19
24,2,2,0,4,2021-07-12,Female,4,1-4,4
24,1,0,0,1,2021-07-12,Male,65,65-69,24
24,1,1,0,2,2021-07-13,Female,52,45-54,19
24,2,10,0,12,2021-07-08,Female,23,20-24,23
24,1,0,0,1,2021-07-11,Female,56,55-64,3
24,0,3,0,3,2021-07-13,Male,32,25-34,4
24,1,1,0,2,2021-07-13,Female,47,45-54,3
24,0,0,0,0,2021-07-12,Female,73,70-74,17
24,0,6,0,6,2021-07-09,Male,64,55-64,4
24,1,3,0,4,2021-07-08,Male,52,45-54,4
24,0,1,0,1,2021-07-19,Female,20,20-24,1
24,1,1,0,2,2021-07-11,Male,65,65-69,4
24,1,0,30,31,2021-07-08,Male,54,45-54,19
24,0,0,1,1,2021-07-11,Male,61,55-64,4
24,1,0,0,1,2021-07-13,Male,62,55-64,4
24,1,1,0,2,2021-07-14,Male,70,70-74,4
24,3,3,0,6,2021-07-13,Female,11,10-14,4
24,1,0,0,1,2021-07-10,Female,55,55-64,20
24,0,0,0,0,2021-07-12,Male,66,65-69,2
24,1,0,0,1,2021-07-14,Female,57,55-64,4
24,2,0,0,2,2021-07-12,Male,15,15-19,5
24,0,1,0,1,2021-07-13,Male,60,55-64,21
24,1,0,0,1,2021-07-09,Female,29,25-34,3
24,0,33,0,33,2021-07-12,Female,21,20-24,8
24,0,0,0,0,2021-07-14,Female,67,65-69,12
24,3,0,0,3,2021-07-13,Female,0,<1,3
24,1,2,0,3,2021-07-09,Female,66,65-69,4
24,3,0,0,3,2021-07-15,Female,9,5-9,1
24,1,0,0,1,2021-07-15,Male,32,25-34,21
24,0,0,0,0,2021-07-09,Male,28,25-34,22
24,1,0,0,1,2021-07-13,Female,76,75-79,3
24,0,1,0,1,2021-07-12,Male,48,45-54,20
24,0,0,0,0,2021-07-14,Male,3,1-4,12
24,0,0,0,0,2021-07-12,Female,34,25-34,21
24,0,0,0,0,2021-07-12,Female,41,35-44,24
24,1,1,0,2,2021-07-10,Male,69,65-69,21
24,5,0,8,13,2021-07-13,Female,0,<1,3
24,0,2,0,2,2021-07-12,Male,73,70-74,13
24,2,1,0,3,2021-07-12,Female,74,70-74,17
24,2,0,0,2,2021-07-07,Female,0,<1,4
24,2,0,0,2,2021-07-09,Male,66,65-69,21
24,0,1,0,1,2021-07-12,Female,49,45-54,9
24,0,0,0,0,2021-07-15,Male,27,25-34,1
24,1,1,0,2,2021-07-09,Female,63,55-64,4
24,1,0,0,1,2021-07-09,Male,34,25-34,20
24,1,0,0,1,2021-07-12,Female,50,45-54,19
24,0,0,0,0,2021-07-14,Male,77,75-79,3
24,3,1,3,7,2021-07-16,Female,22,20-24,1
24,1,1,0,2,2021-07-12,Male,49,45-54,3
24,2,1,0,3,2021-07-09,Female,66,65-69,17
24,1,4,0,5,2021-07-11,Male,23,20-24,3
24,0,0,0,0,2021-07-10,Male,69,65-69,21
24,0,0,0,0,2021-07-12,Female,31,25-34,20
24,1,1,0,2,2021-07-11,Female,58,55-64,4
24,2,0,35,37,2021-07-15,Male,10,10-14,1
24,1,5,0,6,2021-07-11,Male,70,70-74,3
24,0,0,0,0,2021-07-11,Female,59,55-64,4
24,0,1,0,1,2021-07-12,Female,73,70-74,20
24,0,0,0,0,2021-07-10,Male,57,55-64,3
24,0,0,0,0,2021-07-12,Male,60,55-64,17
24,0,0,0,0,2021-07-15,Male,26,25-34,1
24,1,0,0,1,2021-07-12,Male,69,65-69,23
24,1,6,0,7,2021-07-14,Female,49,45-54,4
24,0,0,0,0,2021-07-15,Female,52,45-54,1
24,2,0,0,2,2021-07-11,Male,71,70-74,17
24,0,5,0,5,2021-07-13,Male,60,55-64,19
24,1,0,0,1,2021-07-13,Male,59,55-64,19
24,1,0,0,1,2021-07-07,Male,67,65-69,18
24,0,3,0,3,2021-07-08,Female,54,45-54,19
24,0,0,0,0,2021-07-12,Male,51,45-54,15
24,2,1,0,3,2021-07-13,Male,18,15-19,19
24,3,0,0,3,2021-07-12,Male,3,1-4,20
24,0,5,0,5,2021-07-13,Male,62,55-64,19
24,1,2,0,3,2021-07-11,Female,70,70-74,18
24,0,0,0,0,2021-07-08,Male,68,65-69,23
24,0,2,0,2,2021-07-11,Male,61,55-64,4
24,1,0,0,1,2021-07-14,Male,47,45-54,11
24,0,0,0,0,2021-07-11,Male,59,55-64,3
24,0,0,0,0,2021-07-11,Female,71,70-74,4
24,0,1,0,1,2021-07-11,Male,61,55-64,6
24,3,1,0,4,2021-07-09,Female,66,65-69,15
24,0,0,0,0,2021-07-09,Male,28,25-34,4
24,1,2,0,3,2021-07-12,Female,26,25-34,4
24,2,0,0,2,2021-07-13,Male,76,75-79,9
24,0,12,0,12,2021-07-10,Female,56,55-64,4
24,1,5,0,6,2021-07-11,Female,23,20-24,17
24,1,0,0,1,2021-07-09,Female,64,55-64,11
24,0,1,0,1,2021-07-10,Female,69,65-69,14
24,1,0,0,1,2021-07-14,Female,48,45-54,17
24,0,2,0,2,2021-07-10,Male,59,55-64,20
24,0,2,0,2,2021-07-13,Male,37,35-44,22
24,1,0,0,1,2021-07-11,Female,55,55-64,9
24,0,1,0,1,2021-07-13,Female,43,35-44,19
24,0,0,0,0,2021-07-08,Male,52,45-54,21
24,1,0,0,1,2021-07-12,Male,73,70-74,4
24,2,0,0,2,2021-07-13,Male,5,5-9,16
24,1,0,0,1,2021-07-14,Female,22,20-24,3
24,5,0,0,5,2021-07-12,Female,4,1-4,4
24,0,0,0,0,2021-07-07,Male,44,35-44,4
24,0,0,0,0,2021-07-07,Female,46,45-54,22
24,0,0,5,5,2021-07-12,Male,43,35-44,17
24,0,0,0,0,2021-07-15,Female,34,25-34,1
24,0,0,0,0,2021-07-13,Male,63,55-64,17
24,1,0,0,1,2021-07-13,Male,55,55-64,21
24,1,0,0,1,2021-07-13,Female,52,45-54,18
24,2,1,0,3,2021-07-12,Female,71,70-74,18
24,1,14,0,15,2021-07-09,Female,52,45-54,4
24,3,0,0,3,2021-07-09,Male,15,15-19,21
24,1,0,0,1,2021-07-11,Female,71,70-74,2
24,3,6,0,9,2021-07-11,Female,12,10-14,6
24,0,0,0,0,2021-07-10,Male,55,55-64,21
24,1,0,0,1,2021-07-10,Male,58,55-64,6
24,1,2,0,3,2021-07-07,Female,37,35-44,4
24,1,0,0,1,2021-07-11,Female,60,55-64,18
24,2,2,0,4,2021-07-09,Female,28,25-34,4
24,1,0,0,1,2021-07-10,Female,36,35-44,14
24,0,1,0,1,2021-07-11,Male,60,55-64,16
24,2,0,0,2,2021-07-08,Female,52,45-54,12
24,1,2,0,3,2021-07-12,Female,63,55-64,4
24,0,0,0,0,2021-07-09,Male,31,25-34,18
24,1,0,0,1,2021-07-09,Female,22,20-24,21
24,3,0,0,3,2021-07-12,Female,56,55-64,16
24,3,0,0,3,2021-07-08,Female,67,65-69,19
24,0,0,0,0,2021-07-08,Male,54,45-54,5
24,0,0,0,0,2021-07-10,Male,58,55-64,6
24,0,0,0,0,2021-07-14,Male,29,25-34,4
24,2,0,0,2,2021-07-12,Male,52,45-54,22
24,1,0,0,1,2021-07-12,Female,59,55-64,9
24,0,1,0,1,2021-07-09,Male,65,65-69,19
24,1,0,0,1,2021-07-13,Male,39,35-44,4
24,1,0,0,1,2021-07-12,Male,49,45-54,18
24,0,0,0,0,2021-07-13,Male,60,55-64,20
24,1,0,0,1,2021-07-10,Male,70,70-74,19
24,0,3,8,11,2021-07-12,Male,31,25-34,21
24,0,0,0,0,2021-07-13,Male,37,35-44,20
24,1,46,26,73,2021-07-14,Female,55,55-64,3
24,2,0,0,2,2021-07-14,Female,6,5-9,2
24,1,0,0,1,2021-07-10,Female,30,25-34,9
24,2,0,0,2,2021-07-15,Male,24,20-24,2
24,1,0,0,1,2021-07-13,Female,60,55-64,2
24,1,0,0,1,2021-07-10,Female,69,65-69,21
24,0,3,0,3,2021-07-14,Female,57,55-64,10
24,0,0,0,0,2021-07-12,Female,26,25-34,21
24,0,1,0,1,2021-07-13,Female,24,20-24,10
24,2,0,0,2,2021-07-10,Female,55,55-64,7
24,1,0,0,1,2021-07-13,Female,61,55-64,20
24,1,1,0,2,2021-07-08,Female,54,45-54,4
24,1,0,0,1,2021-07-12,Female,73,70-74,4
24,0,2,0,2,2021-07-09,Male,66,65-69,24
24,1,3,0,4,2021-07-09,Male,53,45-54,16
24,1,0,0,1,2021-07-13,Female,42,35-44,3
24,0,0,0,0,2021-07-12,Male,71,70-74,17
24,3,0,0,3,2021-07-09,Female,7,5-9,3
24,0,0,0,0,2021-07-09,Male,35,35-44,5
24,2,0,0,2,2021-07-09,Female,66,65-69,24
24,5,2,2,9,2021-07-15,Female,25,25-34,1
24,1,1,0,2,2021-07-07,Male,70,70-74,21
24,1,1,0,2,2021-07-07,Female,71,70-74,9
24,0,6,0,6,2021-07-09,Female,65,65-69,4
24,1,0,0,1,2021-07-12,Male,62,55-64,16
24,1,0,0,1,2021-07-13,Male,46,45-54,3
24,0,0,0,0,2021-07-15,Male,46,45-54,14
24,0,0,0,0,2021-07-09,Female,66,65-69,20
24,0,5,0,5,2021-07-13,Female,69,65-69,4
24,0,2,0,2,2021-07-16,Male,64,55-64,3
24,1,0,0,1,2021-07-12,Male,79,75-79,19
24,2,1,0,3,2021-07-12,Male,73,70-74,16
24,0,0,0,0,2021-07-09,Male,68,65-69,18
24,1,0,0,1,2021-07-07,Male,3,1-4,2
24,2,0,0,2,2021-07-13,Female,26,25-34,10
24,1,0,0,1,2021-07-09,Female,68,65-69,18
24,0,0,0,0,2021-07-19,Female,34,25-34,1
24,0,0,0,0,2021-07-13,Female,65,65-69,20
24,0,0,0,0,2021-07-13,Female,56,55-64,3
24,1,0,0,1,2021-07-13,Male,59,55-64,24
24,3,0,0,3,2021-07-10,Male,11,10-14,4
24,2,2,0,4,2021-07-13,Male,70,70-74,23
24,0,7,0,7,2021-07-07,Male,45,45-54,4
24,1,12,0,13,2021-07-08,Female,53,45-54,3
24,2,10,0,12,2021-07-07,Female,46,45-54,3
24,1,0,4,5,2021-07-07,Male,39,35-44,11
24,1,0,0,1,2021-07-09,Male,52,45-54,23
24,1,0,0,1,2021-07-11,Female,27,25-34,10
24,3,0,0,3,2021-07-13,Female,20,20-24,3
24,1,9,0,10,2021-07-10,Female,38,35-44,3
24,1,0,0,1,2021-07-12,Male,72,70-74,20
24,2,0,0,2,2021-07-09,Male,13,10-14,4
24,1,2,0,3,2021-07-09,Male,63,55-64,2
24,0,0,0,0,2021-07-12,Female,78,75-79,16
24,0,0,0,0,2021-07-12,Female,53,45-54,13
24,1,0,0,1,2021-07-13,Female,64,55-64,19
24,2,0,0,2,2021-07-12,Female,17,15-19,22
24,0,0,0,0,2021-07-15,Female,33,25-34,1
24,1,3,0,4,2021-07-12,Female,39,35-44,22
24,1,0,0,1,2021-07-13,Female,58,55-64,21
24,3,0,0,3,2021-07-12,Male,17,15-19,3
24,0,0,0,0,2021-07-09,Female,65,65-69,4
24,1,0,0,1,2021-07-14,Male,78,75-79,16
24,0,0,0,0,2021-07-08,Male,53,45-54,22
24,0,0,0,0,2021-07-13,Female,39,35-44,2
24,0,0,0,0,2021-07-12,Male,40,35-44,21
24,0,0,0,0,2021-07-10,Male,68,65-69,19
24,1,3,0,4,2021-07-09,Female,67,65-69,19
24,0,0,0,0,2021-07-14,Male,15,15-19,2
24,1,1,0,2,2021-07-11,Female,69,65-69,23
24,3,4,0,7,2021-07-14,Female,18,15-19,18
24,0,0,0,0,2021-07-09,Female,29,25-34,22
24,1,0,0,1,2021-07-13,Female,64,55-64,17
24,0,0,0,0,2021-07-11,Female,0,<1,4
24,0,0,0,0,2021-07-07,Female,22,20-24,9
24,0,0,0,0,2021-07-13,Male,16,15-19,11
24,1,1,0,2,2021-07-15,Female,49,45-54,12
24,1,0,0,1,2021-07-13,Male,66,65-69,17
24,0,0,0,0,2021-07-09,Female,68,65-69,21
24,0,0,0,0,2021-07-14,Female,49,45-54,18
24,2,0,0,2,2021-07-12,Female,50,45-54,17
24,1,4,0,5,2021-07-07,Female,72,70-74,3
24,1,0,0,1,2021-07-14,Male,62,55-64,13
24,0,0,0,0,2021-07-14,Male,23,20-24,16
24,2,0,0,2,2021-07-07,Female,19,15-19,4
24,0,0,0,0,2021-07-19,Male,60,55-64,19
24,1,1,0,2,2021-07-12,Male,68,65-69,4
24,0,0,0,0,2021-07-13,Female,32,25-34,4
24,1,0,0,1,2021-07-12,Male,60,55-64,20
24,2,2,0,4,2021-07-12,Female,50,45-54,4
24,0,0,0,0,2021-07-09,Male,34,25-34,3
24,2,0,0,2,2021-07-11,Male,26,25-34,21
24,2,0,0,2,2021-07-13,Female,17,15-19,3
24,1,1,0,2,2021-07-15,Female,43,35-44,4
24,2,0,0,2,2021-07-13,Female,23,20-24,7
24,2,0,0,2,2021-07-11,Male,57,55-64,18
24,0,1,0,1,2021-07-12,Female,41,35-44,3
24,2,0,0,2,2021-07-11,Male,70,70-74,19
24,1,0,0,1,2021-07-12,Female,20,20-24,3
24,2,0,0,2,2021-07-11,Male,70,70-74,22
24,1,0,0,1,2021-07-11,Male,64,55-64,4
24,1,0,0,1,2021-07-08,Female,46,45-54,4
24,0,1,0,1,2021-07-13,Male,60,55-64,20
24,0,0,0,0,2021-07-09,Female,52,45-54,4
24,3,0,0,3,2021-07-09,Male,64,55-64,4
24,0,2,0,2,2021-07-08,Male,52,45-54,16
24,2,16,25,43,2021-07-09,Male,31,25-34,20
24,1,0,0,1,2021-07-11,Female,67,65-69,4
24,1,0,0,1,2021-07-14,Male,0,<1,2
24,1,0,0,1,2021-07-12,Female,36,35-44,4
24,2,0,0,2,2021-07-12,Female,2,1-4,21
24,2,0,0,2,2021-07-08,Male,53,45-54,3
24,0,0,0,0,2021-07-09,Female,36,35-44,4
24,1,0,0,1,2021-07-10,Female,64,55-64,18
24,0,0,0,0,2021-07-12,Male,43,35-44,21
24,0,0,0,0,2021-07-07,Male,51,45-54,3
24,1,0,0,1,2021-07-12,Female,58,55-64,4
24,1,6,0,7,2021-07-15,Male,8,5-9,10
24,3,0,0,3,2021-07-12,Male,6,5-9,3
24,3,3,0,6,2021-07-13,Female,8,5-9,4
24,2,0,0,2,2021-07-19,Female,67,65-69,5
24,2,5,0,7,2021-07-17,Female,18,15-19,1
24,2,0,0,2,2021-07-14,Male,30,25-34,5
24,0,0,0,0,2021-07-10,Female,56,55-64,2
24,2,0,0,2,2021-07-12,Female,49,45-54,4
24,2,0,0,2,2021-07-07,Male,14,10-14,18
24,0,0,0,0,2021-07-11,Male,61,55-64,6
24,0,5,0,5,2021-07-13,Male,41,35-44,4
24,0,2,0,2,2021-07-15,Female,43,35-44,1
24,2,0,0,2,2021-07-09,Female,68,65-69,19
24,1,0,0,1,2021-07-07,Male,50,45-54,21
24,0,4,0,4,2021-07-19,Female,25,25-34,14
24,1,0,0,1,2021-07-12,Male,52,45-54,22
24,1,0,0,1,2021-07-11,Male,25,25-34,3
24,0,3,0,3,2021-07-13,Female,56,55-64,17
24,0,0,0,0,2021-07-13,Male,71,70-74,21
24,0,0,0,0,2021-07-13,Female,65,65-69,4
24,0,0,0,0,2021-07-14,Male,37,35-44,4
24,0,0,0,0,2021-07-11,Male,70,70-74,4
24,2,0,0,2,2021-07-07,Female,60,55-64,21
24,0,0,0,0,2021-07-12,Male,34,25-34,4
24,4,1,0,5,2021-07-11,Female,31,25-34,2
24,0,0,0,0,2021-07-12,Male,41,35-44,19
24,0,0,0,0,2021-07-09,Female,46,45-54,11
24,0,0,0,0,2021-07-12,Male,39,35-44,7
24,0,0,0,0,2021-07-08,Male,54,45-54,19
24,0,0,0,0,2021-07-12,Female,31,25-34,22
24,0,0,0,0,2021-07-12,Male,34,25-34,23
24,1,0,11,12,2021-07-13,Male,56,55-64,4
24,0,0,6,6,2021-07-12,Female,5,5-9,2
24,0,0,0,0,2021-07-08,Male,47,45-54,18
24,1,0,0,1,2021-07-13,Female,55,55-64,15
24,0,4,0,4,2021-07-10,Female,67,65-69,22
24,2,0,0,2,2021-07-13,Female,10,10-14,15
24,0,0,0,0,2021-07-09,Female,68,65-69,19
24,4,1,0,5,2021-07-12,Male,20,20-24,3
24,0,0,0,0,2021-07-11,Female,23,20-24,10
24,2,0,0,2,2021-07-08,Male,46,45-54,23
24,0,1,0,1,2021-07-11,Female,60,55-64,11
24,0,0,0,0,2021-07-11,Female,37,35-44,4
24,0,0,0,0,2021-07-09,Female,56,55-64,22
24,1,2,0,3,2021-07-11,Female,61,55-64,3
24,0,0,0,0,2021-07-12,Female,73,70-74,4
24,1,3,0,4,2021-07-12,Male,85,85+,3
24,0,0,15,15,2021-07-09,Male,30,25-34,18
24,0,0,0,0,2021-07-15,Male,54,45-54,1
24,0,2,0,2,2021-07-09,Female,47,45-54,4
24,0,0,0,0,2021-07-12,Male,40,35-44,16
24,1,12,0,13,2021-07-09,Male,68,65-69,21
24,1,0,0,1,2021-07-14,Male,14,10-14,17
24,0,1,40,41,2021-07-15,Female,23,20-24,2
24,2,0,0,2,2021-07-11,Female,55,55-64,10
24,0,0,0,0,2021-07-10,Male,12,10-14,4
24,0,0,0,0,2021-07-16,Male,24,20-24,12
24,1,0,0,1,2021-07-09,Male,66,65-69,4
24,2,2,0,4,2021-07-10,Male,19,15-19,12
24,2,1,0,3,2021-07-08,Male,68,65-69,10
24,1,2,0,3,2021-07-12,Male,74,70-74,14
24,0,0,0,0,2021-07-15,Male,59,55-64,1
24,2,0,0,2,2021-07-19,Male,0,<1,1
24,2,0,0,2,2021-07-10,Male,35,35-44,12
24,0,0,0,0,2021-07-15,Male,23,20-24,4
24,0,0,0,0,2021-07-16,Male,24,20-24,2
24,1,4,0,5,2021-07-13,Male,32,25-34,18
24,3,1,0,4,2021-07-13,Male,16,15-19,15
24,0,0,0,0,2021-07-12,Male,77,75-79,4
24,1,0,0,1,2021-07-14,Female,54,45-54,4
24,1,0,0,1,2021-07-15,Female,7,5-9,1
24,1,2,0,3,2021-07-09,Female,68,65-69,14
24,0,10,0,10,2021-07-08,Male,47,45-54,3
24,1,0,0,1,2021-07-10,Male,58,55-64,21
24,2,0,0,2,2021-07-07,Female,30,25-34,10
24,0,0,0,0,2021-07-15,Female,28,25-34,1
24,0,2,0,2,2021-07-12,Male,43,35-44,20
24,1,0,0,1,2021-07-08,Male,53,45-54,4
24,1,0,0,1,2021-07-12,Male,48,45-54,4
24,1,2,0,3,2021-07-14,Male,75,75-79,2
24,1,0,0,1,2021-07-13,Male,13,10-14,21
24,3,0,0,3,2021-07-12,Male,12,10-14,18
24,3,3,0,6,2021-07-13,Male,12,10-14,4
24,0,0,0,0,2021-07-09,Male,65,65-69,20
24,1,1,0,2,2021-07-08,Female,67,65-69,20
24,1,0,0,1,2021-07-09,Female,68,65-69,20
24,1,15,35,51,2021-07-13,Female,13,10-14,2
24,1,0,0,1,2021-07-10,Male,55,55-64,4
24,1,3,0,4,2021-07-16,Female,22,20-24,2
24,2,4,0,6,2021-07-12,Male,81,80-84,17
24,0,0,0,0,2021-07-12,Male,51,45-54,19
24,0,1,0,1,2021-07-12,Male,51,45-54,4
24,0,0,0,0,2021-07-12,Female,21,20-24,16
24,0,6,0,6,2021-07-15,Female,40,35-44,1
24,4,3,0,7,2021-07-11,Female,14,10-14,4
24,0,12,2,14,2021-07-12,Female,48,45-54,19
24,1,0,0,1,2021-07-12,Male,72,70-74,20
24,0,0,0,0,2021-07-09,Female,31,25-34,15
24,0,0,0,0,2021-07-09,Male,24,20-24,21
24,0,0,0,0,2021-07-09,Female,66,65-69,4
24,1,0,0,1,2021-07-09,Male,28,25-34,19
24,2,0,0,2,2021-07-11,Female,11,10-14,10
24,1,0,0,1,2021-07-09,Female,63,55-64,22
24,1,0,0,1,2021-07-08,Female,53,45-54,16
24,0,0,0,0,2021-07-09,Male,66,65-69,23
24,0,0,0,0,2021-07-12,Male,57,55-64,15
24,0,0,0,0,2021-07-09,Male,67,65-69,22
24,1,0,0,1,2021-07-09,Male,64,55-64,23
24,0,0,0,0,2021-07-10,Female,70,70-74,18
24,1,4,0,5,2021-07-12,Female,62,55-64,4
24,2,0,0,2,2021-07-13,Female,69,65-69,16
24,1,0,0,1,2021-07-14,Male,31,25-34,14
24,0,0,0,0,2021-07-12,Male,34,25-34,4
24,2,0,0,2,2021-07-12,Female,22,20-24,2
24,1,0,0,1,2021-07-12,Male,73,70-74,22
24,0,4,0,4,2021-07-12,Female,63,55-64,21
24,0,1,0,1,2021-07-11,Male,45,45-54,8
24,2,0,0,2,2021-07-12,Male,71,70-74,19
24,0,0,0,0,2021-07-13,Female,23,20-24,10
24,1,1,0,2,2021-07-10,Female,56,55-64,4
24,0,0,0,0,2021-07-15,Male,52,45-54,1
24,5,1,0,6,2021-07-09,Female,18,15-19,21
24,3,5,0,8,2021-07-09,Female,65,65-69,23
24,0,0,0,0,2021-07-12,Female,62,55-64,20
24,1,0,0,1,2021-07-14,Female,60,55-64,4
24,0,1,0,1,2021-07-10,Male,58,55-64,4
24,2,0,0,2,2021-07-10,Male,55,55-64,21
24,1,0,0,1,2021-07-12,Male,55,55-64,11
24,0,3,0,3,2021-07-13,Male,53,45-54,4
24,0,0,0,0,2021-07-07,Female,43,35-44,15
24,0,0,0,0,2021-07-11,Female,67,65-69,17
24,1,0,0,1,2021-07-15,Male,30,25-34,1
24,1,1,0,2,2021-07-11,Female,59,55-64,4
24,0,0,0,0,2021-07-10,Male,37,35-44,4
24,3,0,0,3,2021-07-09,Female,4,1-4,3
24,1,0,0,1,2021-07-10,Male,55,55-64,4
24,1,1,0,2,2021-07-07,Female,23,20-24,18
24,1,2,0,3,2021-07-14,Female,19,15-19,9
24,3,2,0,5,2021-07-13,Female,18,15-19,4
24,1,0,0,1,2021-07-12,Male,5,5-9,3
24,2,0,0,2,2021-07-12,Female,11,10-14,4
24,1,2,0,3,2021-07-10,Male,56,55-64,17
24,0,1,0,1,2021-07-09,Male,65,65-69,4
24,0,0,0,0,2021-07-07,Female,25,25-34,11
24,0,0,0,0,2021-07-13,Male,67,65-69,4
24,1,0,2,3,2021-07-07,Male,76,75-79,2
24,0,1,0,1,2021-07-09,Male,54,45-54,21
24,0,0,0,0,2021-07-14,Male,61,55-64,9
24,0,3,0,3,2021-07-13,Male,40,35-44,20
24,1,0,0,1,2021-07-12,Male,60,55-64,4
24,2,0,0,2,2021-07-12,Female,49,45-54,3
24,1,1,0,2,2021-07-13,Male,85,85+,4
24,0,1,0,1,2021-07-12,Male,42,35-44,4
24,1,0,0,1,2021-07-07,Male,37,35-44,3
24,1,1,0,2,2021-07-10,Female,69,65-69,4
24,0,0,0,0,2021-07-09,Male,28,25-34,4
24,3,0,0,3,2021-07-09,Male,67,65-69,2
24,0,0,0,0,2021-07-13,Male,16,15-19,16
24,2,0,0,2,2021-07-13,Male,66,65-69,12
24,0,1,0,1,2021-07-15,Male,39,35-44,4
24,0,0,0,0,2021-07-08,Male,52,45-54,3
24,2,4,0,6,2021-07-12,Female,61,55-64,19
24,3,15,0,18,2021-07-15,Female,5,5-9,1
24,0,0,0,0,2021-07-09,Male,19,15-19,9
24,1,0,0,1,2021-07-09,Male,54,45-54,4
24,0,0,0,0,2021-07-11,Male,61,55-64,15
24,3,0,0,3,2021-07-15,Male,5,5-9,1
24,1,0,0,1,2021-07-13,Female,64,55-64,3
24,0,1,0,1,2021-07-12,Female,62,55-64,22
24,0,1,0,1,2021-07-13,Female,34,25-34,4
24,1,1,0,2,2021-07-13,Male,45,45-54,21
24,0,3,0,3,2021-07-10,Female,55,55-64,4
24,1,0,0,1,2021-07-13,Female,70,70-74,2
24,0,0,0,0,2021-07-12,Male,33,25-34,4
24,0,1,0,1,2021-07-15,Male,19,15-19,19
24,3,0,0,3,2021-07-13,Female,53,45-54,3
24,1,0,0,1,2021-07-07,Male,71,70-74,19
24,0,1,0,1,2021-07-09,Female,68,65-69,17
24,0,0,0,0,2021-07-09,Female,69,65-69,18
24,1,1,0,2,2021-07-11,Male,70,70-74,20
24,2,1,0,3,2021-07-07,Male,51,45-54,4
24,0,0,0,0,2021-07-13,Male,68,65-69,4
24,1,0,0,1,2021-07-12,Male,23,20-24,15
24,0,1,0,1,2021-07-19,Male,44,35-44,1
24,1,0,0,1,2021-07-09,Female,67,65-69,4
24,2,3,0,5,2021-07-12,Male,8,5-9,18
24,0,0,0,0,2021-07-11,Female,71,70-74,22
24,1,0,0,1,2021-07-09,Female,65,65-69,4
24,2,0,0,2,2021-07-12,Male,68,65-69,18
24,0,0,0,0,2021-07-09,Female,65,65-69,3
24,1,2,0,3,2021-07-09,Male,67,65-69,21
24,0,0,0,0,2021-07-10,Female,58,55-64,15
24,2,0,0,2,2021-07-10,Male,57,55-64,8
24,1,0,0,1,2021-07-12,Female,26,25-34,6
24,0,3,0,3,2021-07-11,Male,70,70-74,20
24,0,9,0,9,2021-07-09,Male,53,45-54,3
24,3,1,0,4,2021-07-14,Female,49,45-54,2
24,0,2,0,2,2021-07-09,Female,65,65-69,4
24,0,0,0,0,2021-07-13,Female,34,25-34,23
24,0,0,0,0,2021-07-08,Male,53,45-54,23
24,1,0,0,1,2021-07-08,Male,68,65-69,24
24,1,0,20,21,2021-07-12,Male,31,25-34,4
24,1,0,0,1,2021-07-09,Male,54,45-54,6
24,0,0,0,0,2021-07-12,Male,35,35-44,17
24,1,1,0,2,2021-07-08,Male,53,45-54,5
24,0,0,0,0,2021-07-12,Male,31,25-34,11
24,1,1,0,2,2021-07-12,Male,79,75-79,18
24,0,2,0,2,2021-07-08,Female,47,45-54,4
24,4,0,0,4,2021-07-12,Female,13,10-14,15
24,0,0,0,0,2021-07-11,Male,25,25-34,18
24,0,0,0,0,2021-07-10,Male,19,15-19,21
24,1,0,0,1,2021-07-09,Female,30,25-34,7
24,1,0,0,1,2021-07-10,Female,58,55-64,11
24,1,0,0,1,2021-07-13,Female,74,70-74,4
24,0,3,0,3,2021-07-12,Male,42,35-44,14
24,1,0,0,1,2021-07-12,Female,52,45-54,4
24,1,0,0,1,2021-07-12,Female,76,75-79,4
24,1,1,0,2,2021-07-12,Male,65,65-69,3
24,3,7,0,10,2021-07-07,Male,12,10-14,20
24,1,0,0,1,2021-07-12,Female,62,55-64,17
24,2,0,0,2,2021-07-13,Female,36,35-44,13
24,2,2,0,4,2021-07-10,Female,18,15-19,3
24,3,0,0,3,2021-07-18,Male,18,15-19,1
24,0,0,0,0,2021-07-11,Female,23,20-24,18
24,2,0,0,2,2021-07-13,Male,79,75-79,19
24,2,2,0,4,2021-07-09,Female,3,1-4,3
24,2,0,0,2,2021-07-11,Female,61,55-64,4
24,2,0,0,2,2021-07-08,Male,53,45-54,21
24,1,0,0,1,2021-07-14,Female,34,25-34,13
24,1,0,0,1,2021-07-08,Male,67,65-69,15
24,1,0,0,1,2021-07-08,Male,52,45-54,19
24,3,0,0,3,2021-07-18,Male,19,15-19,1
24,0,0,0,0,2021-07-13,Male,52,45-54,17
24,3,0,0,3,2021-07-10,Female,43,35-44,23
24,1,0,0,1,2021-07-12,Female,71,70-74,19
24,1,0,0,1,2021-07-13,Female,66,65-69,12
24,1,11,0,12,2021-07-09,Male,67,65-69,3
24,1,0,0,1,2021-07-11,Female,24,20-24,22
24,0,0,0,0,2021-07-12,Male,33,25-34,3
24,0,0,0,0,2021-07-07,Female,72,70-74,17
24,0,1,0,1,2021-07-12,Male,32,25-34,18
24,0,0,0,0,2021-07-10,Female,69,65-69,24
24,0,0,0,0,2021-07-12,Male,60,55-64,17
24,3,17,0,20,2021-07-10,Male,6,5-9,4
24,3,0,4,7,2021-07-10,Female,37,35-44,12
24,2,0,0,2,2021-07-07,Male,13,10-14,20
24,2,0,0,2,2021-07-11,Male,19,15-19,4
24,2,0,0,2,2021-07-11,Male,25,25-34,13
24,2,0,0,2,2021-07-13,Male,70,70-74,16
24,1,0,0,1,2021-07-11,Male,71,70-74,8
24,1,10,2,13,2021-07-08,Female,67,65-69,3
24,1,0,0,1,2021-07-15,Male,40,35-44,1
24,1,0,0,1,2021-07-07,Male,64,55-64,3
24,1,0,0,1,2021-07-13,Female,51,45-54,20
24,2,0,0,2,2021-07-09,Male,66,65-69,4
24,0,0,0,0,2021-07-11,Female,70,70-74,18
24,2,0,0,2,2021-07-12,Male,33,25-34,20
24,4,2,0,6,2021-07-13,Female,14,10-14,19
24,3,0,0,3,2021-07-14,Female,3,1-4,21
24,1,0,0,1,2021-07-13,Male,39,35-44,13
24,0,0,0,0,2021-07-07,Male,45,45-54,19
24,0,0,0,0,2021-07-09,Male,5,5-9,10
24,0,0,0,0,2021-07-08,Female,68,65-69,20
24,1,0,0,1,2021-07-19,Female,59,55-64,18
24,0,4,0,4,2021-07-15,Female,22,20-24,1
24,0,0,3,3,2021-07-15,Female,7,5-9,1
24,0,1,0,1,2021-07-11,Female,55,55-64,22
24,3,0,0,3,2021-07-13,Male,70,70-74,13
24,0,0,0,0,2021-07-07,Female,41,35-44,23
24,1,0,0,1,2021-07-09,Male,20,20-24,5
24,0,0,0,0,2021-07-15,Female,24,20-24,6
24,1,0,0,1,2021-07-13,Female,49,45-54,4
24,3,0,0,3,2021-07-13,Male,6,5-9,6
24,2,0,0,2,2021-07-12,Female,12,10-14,8
24,1,1,0,2,2021-07-08,Male,67,65-69,4
24,0,0,0,0,2021-07-09,Male,35,35-44,5
24,2,0,0,2,2021-07-12,Female,16,15-19,3
24,0,0,0,0,2021-07-09,Female,65,65-69,21
24,0,0,0,0,2021-07-12,Male,40,35-44,15
24,2,0,0,2,2021-07-15,Female,1,1-4,1
24,0,0,0,0,2021-07-19,Female,29,25-34,3
24,0,0,0,0,2021-07-09,Female,10,10-14,18
24,0,1,0,1,2021-07-11,Male,23,20-24,14
24,0,0,0,0,2021-07-16,Male,21,20-24,4
24,0,0,0,0,2021-07-12,Male,82,80-84,9
24,1,0,0,1,2021-07-08,Female,53,45-54,23
24,1,0,0,1,2021-07-12,Male,51,45-54,4
24,0,1,0,1,2021-07-17,Male,23,20-24,1
24,0,2,0,2,2021-07-07,Male,63,55-64,4
24,0,0,0,0,2021-07-13,Female,72,70-74,4
24,1,0,0,1,2021-07-14,Female,49,45-54,3
24,1,1,0,2,2021-07-13,Male,79,75-79,10
24,1,3,0,4,2021-07-09,Male,64,55-64,4
24,1,0,0,1,2021-07-12,Female,62,55-64,3
24,0,0,0,0,2021-07-11,Male,36,35-44,8
24,3,0,0,3,2021-07-12,Female,33,25-34,3
24,0,0,0,0,2021-07-11,Male,19,15-19,4
24,3,0,0,3,2021-07-07,Male,22,20-24,20
24,0,1,0,1,2021-07-12,Male,78,75-79,23
24,0,2,0,2,2021-07-09,Female,29,25-34,5
24,0,0,0,0,2021-07-07,Male,44,35-44,17
24,1,0,0,1,2021-07-07,Female,22,20-24,9
24,1,2,0,3,2021-07-12,Male,34,25-34,12
24,0,0,0,0,2021-07-08,Female,67,65-69,23
24,0,2,0,2,2021-07-11,Female,66,65-69,17
24,1,0,0,1,2021-07-12,Female,52,45-54,6
24,0,0,0,0,2021-07-12,Male,3,1-4,15
24,2,0,0,2,2021-07-12,Female,13,10-14,4
24,0,0,0,0,2021-07-11,Female,36,35-44,4
24,0,0,0,0,2021-07-12,Male,48,45-54,21
24,0,0,0,0,2021-07-07,Female,29,25-34,4
24,2,0,0,2,2021-07-07,Male,0,<1,2
24,3,0,0,3,2021-07-08,Female,6,5-9,4
24,0,0,0,0,2021-07-07,Male,43,35-44,3
24,0,0,0,0,2021-07-12,Male,40,35-44,21
24,1,7,0,8,2021-07-13,Female,66,65-69,24
24,1,6,0,7,2021-07-09,Female,63,55-64,4
24,0,0,0,0,2021-07-12,Male,39,35-44,21
24,1,2,0,3,2021-07-11,Male,60,55-64,4
24,2,2,14,18,2021-07-08,Male,11,10-14,4
24,2,1,0,3,2021-07-14,Male,75,75-79,16
24,0,0,0,0,2021-07-07,Male,31,25-34,21
24,2,2,0,4,2021-07-11,Female,62,55-64,18
24,0,0,0,0,2021-07-13,Female,24,20-24,4
24,0,0,0,0,2021-07-13,Female,54,45-54,20
24,0,0,0,0,2021-07-09,Male,58,55-64,14
24,1,0,0,1,2021-07-08,Female,68,65-69,22
24,0,0,0,0,2021-07-15,Male,8,5-9,1
24,3,3,0,6,2021-07-11,Female,9,5-9,14
24,1,0,0,1,2021-07-12,Male,49,45-54,17
24,2,0,0,2,2021-07-07,Female,45,45-54,16
24,0,0,0,0,2021-07-07,Male,40,35-44,22
24,1,0,0,1,2021-07-09,Male,65,65-69,21
24,0,0,0,0,2021-07-12,Male,59,55-64,9
24,1,0,0,1,2021-07-15,Male,53,45-54,1
24,0,0,0,0,2021-07-13,Male,41,35-44,22
24,1,0,10,11,2021-07-17,Male,19,15-19,1
24,0,1,0,1,2021-07-12,Male,27,25-34,4
24,4,0,0,4,2021-07-07,Female,13,10-14,15
24,0,0,0,0,2021-07-12,Female,50,45-54,4
24,1,0,0,1,2021-07-08,Male,67,65-69,4
24,2,0,0,2,2021-07-10,Male,69,65-69,15
24,1,1,0,2,2021-07-08,Male,68,65-69,12
24,0,0,0,0,2021-07-10,Female,59,55-64,21
24,2,0,0,2,2021-07-08,Female,53,45-54,18
24,1,0,0,1,2021-07-09,Female,35,35-44,17
24,2,0,0,2,2021-07-11,Female,58,55-64,15
24,1,0,3,4,2021-07-08,Female,52,45-54,3
24,0,0,0,0,2021-07-11,Male,57,55-64,8
24,2,0,0,2,2021-07-09,Female,1,1-4,4
24,1,0,0,1,2021-07-12,Male,40,35-44,4
24,1,0,0,1,2021-07-11,Female,60,55-64,22
24,0,0,0,0,2021-07-12,Male,10,10-14,21
24,1,0,0,1,2021-07-10,Male,15,15-19,20
24,1,0,0,1,2021-07-07,Male,66,65-69,20
24,4,0,0,4,2021-07-12,Female,0,<1,4
24,1,0,0,1,2021-07-10,Female,38,35-44,3
24,1,2,0,3,2021-07-11,Female,72,70-74,4
24,0,0,20,20,2021-07-11,Male,60,55-64,4
24,1,0,0,1,2021-07-10,Female,55,55-64,15
24,0,0,0,0,2021-07-09,Male,66,65-69,4
24,1,3,0,4,2021-07-14,Female,33,25-34,2
24,0,7,0,7,2021-07-12,Female,22,20-24,4
24,0,0,0,0,2021-07-09,Female,22,20-24,19
24,2,15,50,67,2021-07-14,Female,18,15-19,15
24,1,0,0,1,2021-07-09,Male,65,65-69,2
24,1,0,0,1,2021-07-12,Male,68,65-69,3
24,0,0,0,0,2021-07-12,Female,77,75-79,4
24,0,0,0,0,2021-07-15,Male,42,35-44,1
24,1,0,0,1,2021-07-13,Female,70,70-74,14
24,1,0,0,1,2021-07-11,Male,70,70-74,4
24,0,0,0,0,2021-07-12,Male,40,35-44,4
24,2,0,0,2,2021-07-09,Male,60,55-64,3
24,1,0,0,1,2021-07-12,Male,78,75-79,4
24,0,0,0,0,2021-07-10,Male,57,55-64,3
24,1,1,0,2,2021-07-14,Male,62,55-64,4
24,0,1,0,1,2021-07-11,Female,54,45-54,21
24,1,1,0,2,2021-07-12,Male,75,75-79,15
24,0,0,0,0,2021-07-07,Male,39,35-44,21
24,3,0,0,3,2021-07-12,Male,16,15-19,16
24,0,0,0,0,2021-07-12,Male,36,35-44,17
24,2,0,0,2,2021-07-09,Female,17,15-19,19
24,3,0,0,3,2021-07-13,Female,0,<1,15
24,1,0,0,1,2021-07-12,Female,25,25-34,10
24,0,0,0,0,2021-07-11,Female,66,65-69,19
24,2,2,0,4,2021-07-13,Female,13,10-14,8
24,0,0,0,0,2021-07-12,Female,66,65-69,18
24,3,0,7,10,2021-07-08,Female,35,35-44,4
24,0,0,5,5,2021-07-12,Female,81,80-84,4
24,0,0,0,0,2021-07-12,Female,34,25-34,3
24,1,0,0,1,2021-07-08,Male,53,45-54,15
24,2,0,0,2,2021-07-12,Female,65,65-69,3
24,1,0,0,1,2021-07-09,Female,68,65-69,14
24,0,2,0,2,2021-07-14,Male,53,45-54,23
24,0,1,0,1,2021-07-07,Female,53,45-54,4
24,1,0,0,1,2021-07-12,Male,36,35-44,3
24,1,0,0,1,2021-07-14,Female,25,25-34,3
24,0,0,0,0,2021-07-09,Female,31,25-34,20
24,1,0,0,1,2021-07-12,Male,57,55-64,18
24,1,6,0,7,2021-07-09,Male,66,65-69,18
24,2,10,0,12,2021-07-10,Male,67,65-69,20
24,1,1,0,2,2021-07-12,Female,76,75-79,16
24,1,0,0,1,2021-07-07,Male,29,25-34,2
24,2,0,0,2,2021-07-13,Female,5,5-9,19
24,1,1,0,2,2021-07-12,Male,77,75-79,3
24,0,0,0,0,2021-07-12,Female,24,20-24,3
24,0,0,0,0,2021-07-09,Male,23,20-24,9
24,1,0,0,1,2021-07-09,Female,29,25-34,15
24,4,2,0,6,2021-07-14,Female,31,25-34,3
24,1,4,0,5,2021-07-11,Female,18,15-19,4
24,0,0,0,0,2021-07-09,Male,68,65-69,4
24,0,0,0,0,2021-07-10,Male,27,25-34,4
24,2,2,0,4,2021-07-09,Female,68,65-69,3
24,1,0,0,1,2021-07-13,Female,31,25-34,3
24,0,6,0,6,2021-07-11,Female,59,55-64,3
24,0,5,0,5,2021-07-11,Female,70,70-74,21
24,2,2,0,4,2021-07-07,Male,73,70-74,20
24,1,0,0,1,2021-07-13,Male,62,55-64,14
24,1,0,0,1,2021-07-09,Female,25,25-34,12
24,1,0,0,1,2021-07-11,Male,69,65-69,6
24,1,5,0,6,2021-07-07,Female,66,65-69,2
24,1,0,0,1,2021-07-08,Female,52,45-54,4
24,2,0,0,2,2021-07-15,Male,48,45-54,1
24,0,4,0,4,2021-07-12,Male,45,45-54,20
24,0,0,0,0,2021-07-12,Female,81,80-84,2
24,1,0,0,1,2021-07-12,Male,55,55-64,18
24,1,0,0,1,2021-07-13,Female,65,65-69,3
24,0,0,0,0,2021-07-12,Male,20,20-24,3
24,1,0,0,1,2021-07-10,Male,56,55-64,4
24,1,1,0,2,2021-07-10,Female,70,70-74,18
24,1,0,0,1,2021-07-12,Female,81,80-84,4
24,1,1,0,2,2021-07-11,Female,60,55-64,3
24,2,0,0,2,2021-07-12,Female,63,55-64,16
24,2,4,0,6,2021-07-09,Female,66,65-69,4
24,0,0,0,0,2021-07-13,Male,27,25-34,4
24,1,0,0,1,2021-07-13,Female,74,70-74,13
24,1,0,0,1,2021-07-11,Female,69,65-69,21
24,2,3,0,5,2021-07-19,Female,53,45-54,1
24,0,0,0,0,2021-07-12,Male,43,35-44,4
24,3,1,0,4,2021-07-13,Female,65,65-69,4
24,1,2,0,3,2021-07-10,Male,55,55-64,24
24,1,0,0,1,2021-07-12,Female,62,55-64,23
24,0,0,0,0,2021-07-11,Male,55,55-64,12
24,1,0,0,1,2021-07-15,Female,50,45-54,1
24,2,0,0,2,2021-07-12,Female,62,55-64,23
24,1,3,0,4,2021-07-16,Female,18,15-19,2
24,1,1,0,2,2021-07-08,Male,53,45-54,23
24,1,10,0,11,2021-07-11,Male,69,65-69,4
24,0,2,0,2,2021-07-13,Female,66,65-69,22
24,0,6,0,6,2021-07-07,Male,44,35-44,5
24,0,0,0,0,2021-07-07,Male,66,65-69,21
24,1,2,0,3,2021-07-14,Female,60,55-64,20
24,1,0,0,1,2021-07-12,Male,66,65-69,16
24,1,2,0,3,2021-07-11,Female,24,20-24,4
24,1,6,0,7,2021-07-09,Female,65,65-69,4
24,0,0,0,0,2021-07-07,Female,10,10-14,19
24,2,1,0,3,2021-07-12,Male,11,10-14,18
24,1,0,2,3,2021-07-13,Female,63,55-64,22
24,1,0,0,1,2021-07-11,Male,56,55-64,6
24,0,3,0,3,2021-07-14,Female,52,45-54,22
24,1,0,0,1,2021-07-12,Male,85,85+,4
24,0,2,0,2,2021-07-11,Female,61,55-64,3
24,1,0,0,1,2021-07-13,Male,27,25-34,3
24,2,0,0,2,2021-07-09,Female,53,45-54,20
24,2,0,0,2,2021-07-12,Female,48,45-54,21
24,1,0,0,1,2021-07-13,Male,67,65-69,20
24,1,0,0,1,2021-07-15,Male,30,25-34,1
24,2,0,0,2,2021-07-12,Male,22,20-24,16
24,1,0,0,1,2021-07-11,Male,72,70-74,19
24,2,0,0,2,2021-07-10,Female,68,65-69,18
24,0,0,0,0,2021-07-09,Female,65,65-69,14
24,1,0,0,1,2021-07-12,Male,71,70-74,15
24,2,1,0,3,2021-07-09,Male,23,20-24,21
24,1,3,0,4,2021-07-10,Female,67,65-69,16
24,1,2,0,3,2021-07-10,Male,59,55-64,23
24,0,0,0,0,2021-07-12,Male,50,45-54,4
24,1,0,0,1,2021-07-13,Male,67,65-69,18
24,3,0,0,3,2021-07-13,Male,3,1-4,20
24,1,2,0,3,2021-07-09,Male,63,55-64,4
24,0,0,0,0,2021-07-15,Female,51,45-54,4
24,0,0,0,0,2021-07-14,Female,65,65-69,4
24,1,0,0,1,2021-07-12,Female,63,55-64,4
24,0,0,0,0,2021-07-12,Male,22,20-24,20
24,0,1,0,1,2021-07-12,Male,50,45-54,19
24,4,0,0,4,2021-07-12,Female,15,15-19,4
24,1,0,0,1,2021-07-09,Female,67,65-69,4
24,0,1,0,1,2021-07-14,Female,21,20-24,8
24,2,1,47,50,2021-07-13,Female,26,25-34,23
24,0,0,0,0,2021-07-12,Male,34,25-34,17
24,2,2,19,23,2021-07-12,Female,11,10-14,19
24,1,5,0,6,2021-07-12,Female,70,70-74,21
24,1,0,0,1,2021-07-08,Male,67,65-69,16
24,0,0,0,0,2021-07-08,Female,36,35-44,3
24,0,0,0,0,2021-07-08,Male,67,65-69,20
24,0,0,0,0,2021-07-14,Male,13,10-14,4
24,2,0,0,2,2021-07-13,Female,7,5-9,21
24,0,0,0,0,2021-07-09,Female,67,65-69,20
24,0,0,0,0,2021-07-13,Female,50,45-54,16
24,2,0,0,2,2021-07-12,Male,43,35-44,20
24,0,1,0,1,2021-07-13,Female,77,75-79,14
24,1,2,0,3,2021-07-12,Female,73,70-74,4
24,0,0,0,0,2021-07-13,Male,41,35-44,15
24,1,1,0,2,2021-07-12,Female,62,55-64,16
24,0,2,0,2,2021-07-11,Female,61,55-64,4
24,0,6,0,6,2021-07-08,Female,54,45-54,4
24,1,0,0,1,2021-07-10,Male,55,55-64,12
24,1,0,0,1,2021-07-08,Male,68,65-69,21
24,4,0,0,4,2021-07-08,Male,7,5-9,23
24,0,0,0,0,2021-07-09,Male,65,65-69,4
24,0,0,0,0,2021-07-07,Female,3,1-4,5
24,2,0,0,2,2021-07-07,Female,4,1-4,4
24,1,0,0,1,2021-07-12,Male,32,25-34,3
24,0,0,0,0,2021-07-12,Male,24,20-24,5
24,3,0,0,3,2021-07-14,Male,30,25-34,6
24,2,0,2,4,2021-07-12,Female,73,70-74,4
24,4,0,0,4,2021-07-13,Female,3,1-4,6
24,1,2,0,3,2021-07-14,Female,51,45-54,4
24,1,3,0,4,2021-07-12,Male,56,55-64,4
24,1,0,0,1,2021-07-07,Female,52,45-54,4
24,0,3,0,3,2021-07-11,Male,57,55-64,3
24,0,0,0,0,2021-07-13,Male,57,55-64,2
24,2,0,0,2,2021-07-08,Male,52,45-54,19
24,1,2,0,3,2021-07-10,Female,69,65-69,16
24,0,0,0,0,2021-07-15,Male,44,35-44,4
24,2,0,0,2,2021-07-11,Male,61,55-64,20
24,1,0,0,1,2021-07-14,Female,65,65-69,4
24,0,0,0,0,2021-07-19,Male,4,1-4,3
24,0,0,0,0,2021-07-11,Female,62,55-64,19
24,0,0,1,1,2021-07-14,Male,52,45-54,15
24,0,0,0,0,2021-07-12,Male,63,55-64,6
24,1,0,0,1,2021-07-09,Female,65,65-69,3
24,1,1,0,2,2021-07-09,Male,66,65-69,22
24,2,5,0,7,2021-07-11,Female,23,20-24,2
24,3,3,0,6,2021-07-12,Male,7,5-9,4
24,1,0,0,1,2021-07-14,Female,40,35-44,18
24,0,0,0,0,2021-07-07,Male,50,45-54,4
24,1,3,0,4,2021-07-15,Male,59,55-64,1
24,1,0,0,1,2021-07-07,Male,46,45-54,4
24,2,0,0,2,2021-07-15,Female,18,15-19,1
24,3,6,0,9,2021-07-09,Male,53,45-54,23
24,0,30,0,30,2021-07-10,Male,57,55-64,4
24,0,0,0,0,2021-07-08,Male,52,45-54,18
24,0,0,0,0,2021-07-12,Female,62,55-64,3
24,1,10,0,11,2021-07-09,Male,54,45-54,19
24,0,3,0,3,2021-07-12,Female,61,55-64,18
24,1,3,0,4,2021-07-12,Female,70,70-74,4
24,0,0,0,0,2021-07-15,Female,6,5-9,1
24,1,0,0,1,2021-07-12,Female,54,45-54,23
24,1,0,0,1,2021-07-13,Male,33,25-34,20
24,0,0,0,0,2021-07-13,Female,49,45-54,19
24,2,0,0,2,2021-07-15,Female,12,10-14,1
24,0,2,0,2,2021-07-07,Male,43,35-44,3
24,0,0,0,0,2021-07-13,Male,67,65-69,16
24,1,0,0,1,2021-07-08,Male,67,65-69,21
24,3,0,0,3,2021-07-12,Male,17,15-19,3
24,0,0,0,0,2021-07-12,Male,41,35-44,21
24,0,0,22,22,2021-07-11,Male,60,55-64,20
24,0,0,0,0,2021-07-12,Male,42,35-44,24
24,0,1,0,1,2021-07-09,Male,67,65-69,23
24,3,1,0,4,2021-07-09,Female,31,25-34,4
24,0,0,0,0,2021-07-14,Female,35,35-44,19
24,2,3,100,105,2021-07-10,Female,3,1-4,5
24,1,2,0,3,2021-07-09,Male,64,55-64,19
24,0,0,0,0,2021-07-10,Female,69,65-69,20
24,0,0,0,0,2021-07-07,Male,27,25-34,2
24,2,0,0,2,2021-07-12,Male,51,45-54,14
24,0,0,0,0,2021-07-10,Male,18,15-19,3
24,1,0,0,1,2021-07-15,Male,52,45-54,1
24,4,1,0,5,2021-07-13,Male,3,1-4,21
24,4,1,0,5,2021-07-13,Female,50,45-54,4
24,2,36,100,138,2021-07-15,Female,53,45-54,1
24,0,5,0,5,2021-07-09,Female,65,65-69,2
24,0,1,0,1,2021-07-12,Male,58,55-64,22
24,1,2,0,3,2021-07-08,Male,48,45-54,19
24,3,0,0,3,2021-07-12,Male,11,10-14,10
24,0,1,0,1,2021-07-10,Female,35,35-44,18
24,0,14,0,14,2021-07-08,Female,47,45-54,4
24,0,1,0,1,2021-07-09,Female,27,25-34,3
24,1,0,0,1,2021-07-12,Male,62,55-64,23
24,0,0,0,0,2021-07-15,Male,10,10-14,1
24,0,0,3,3,2021-07-19,Female,24,20-24,11
24,0,7,0,7,2021-07-13,Female,68,65-69,24
24,3,4,0,7,2021-07-07,Male,13,10-14,22
24,1,0,0,1,2021-07-10,Female,37,35-44,3
24,0,4,0,4,2021-07-09,Male,65,65-69,4
24,0,0,0,0,2021-07-12,Female,38,35-44,19
24,1,0,0,1,2021-07-13,Female,22,20-24,3
24,0,4,0,4,2021-07-13,Male,50,45-54,4
24,1,0,0,1,2021-07-15,Male,54,45-54,1
24,0,0,0,0,2021-07-11,Female,57,55-64,3
24,0,0,0,0,2021-07-09,Male,22,20-24,2
24,0,0,0,0,2021-07-09,Male,34,25-34,4
24,0,1,0,1,2021-07-09,Male,47,45-54,20
24,1,0,0,1,2021-07-14,Male,65,65-69,3
24,1,0,0,1,2021-07-11,Male,70,70-74,4
24,0,0,0,0,2021-07-14,Male,34,25-34,3
24,1,1,0,2,2021-07-11,Female,18,15-19,4
24,1,0,0,1,2021-07-08,Male,67,65-69,19
24,4,0,0,4,2021-07-12,Female,17,15-19,14
24,2,0,0,2,2021-07-13,Male,51,45-54,15
24,2,3,3,8,2021-07-09,Female,66,65-69,18
24,1,0,0,1,2021-07-12,Male,68,65-69,4
24,0,0,0,0,2021-07-09,Male,27,25-34,20
24,1,0,0,1,2021-07-12,Female,72,70-74,4
24,0,1,0,1,2021-07-13,Male,48,45-54,20
24,3,0,0,3,2021-07-07,Male,1,1-4,5
24,1,0,0,1,2021-07-07,Male,70,70-74,4
24,0,2,0,2,2021-07-12,Male,34,25-34,4
24,3,0,0,3,2021-07-13,Female,19,15-19,4
24,0,0,2,2,2021-07-13,Female,21,20-24,2
24,0,0,0,0,2021-07-09,Male,52,45-54,21
24,1,0,0,1,2021-07-12,Male,76,75-79,4
24,2,0,0,2,2021-07-09,Male,20,20-24,17
24,0,1,0,1,2021-07-11,Female,38,35-44,4
24,0,2,0,2,2021-07-10,Female,56,55-64,4
24,0,0,0,0,2021-07-15,Male,54,45-54,1
24,1,0,0,1,2021-07-15,Male,9,5-9,1
24,0,1,0,1,2021-07-11,Female,56,55-64,3
24,0,0,0,0,2021-07-09,Male,29,25-34,10
24,4,2,0,6,2021-07-14,Female,2,1-4,15
24,1,0,0,1,2021-07-12,Female,55,55-64,3
24,2,4,0,6,2021-07-08,Female,14,10-14,17
24,0,0,0,0,2021-07-12,Male,62,55-64,19
24,0,4,0,4,2021-07-13,Female,31,25-34,9
24,0,12,0,12,2021-07-15,Male,58,55-64,1
24,2,0,0,2,2021-07-07,Male,12,10-14,23
24,2,2,0,4,2021-07-13,Male,71,70-74,8
24,2,2,0,4,2021-07-09,Male,18,15-19,4
24,0,0,0,0,2021-07-13,Male,32,25-34,3
24,2,2,0,4,2021-07-12,Female,63,55-64,20
24,0,0,0,0,2021-07-13,Female,79,75-79,7
24,1,0,0,1,2021-07-14,Male,45,45-54,15
24,2,1,0,3,2021-07-13,Female,64,55-64,24
24,1,0,0,1,2021-07-12,Female,49,45-54,22
24,0,3,0,3,2021-07-12,Male,41,35-44,3
24,0,1,0,1,2021-07-12,Male,54,45-54,16
24,1,1,0,2,2021-07-09,Female,65,65-69,4
24,3,1,0,4,2021-07-09,Female,13,10-14,4
24,0,0,0,0,2021-07-19,Male,26,25-34,1
24,1,0,0,1,2021-07-19,Male,52,45-54,3
24,0,0,0,0,2021-07-10,Male,68,65-69,2
24,0,3,0,3,2021-07-13,Female,50,45-54,4
24,0,0,0,0,2021-07-13,Female,54,45-54,18
24,1,0,0,1,2021-07-12,Male,29,25-34,4
24,1,0,0,1,2021-07-08,Female,54,45-54,5
24,0,0,0,0,2021-07-12,Male,8,5-9,16
24,1,0,0,1,2021-07-14,Male,30,25-34,4
24,2,0,0,2,2021-07-07,Female,10,10-14,20
24,1,0,0,1,2021-07-13,Female,51,45-54,20
24,1,0,0,1,2021-07-10,Male,57,55-64,20
24,0,0,0,0,2021-07-12,Male,51,45-54,6
24,0,2,0,2,2021-07-12,Female,43,35-44,11
24,0,0,0,0,2021-07-12,Female,62,55-64,16
24,1,0,3,4,2021-07-11,Female,60,55-64,19
24,1,0,0,1,2021-07-14,Male,57,55-64,16
24,2,1,0,3,2021-07-10,Male,66,65-69,23
24,1,1,0,2,2021-07-14,Female,54,45-54,12
24,5,3,0,8,2021-07-14,Female,9,5-9,13
24,3,0,0,3,2021-07-12,Female,4,1-4,4
24,0,0,4,4,2021-07-13,Female,36,35-44,9
24,1,3,0,4,2021-07-11,Male,62,55-64,23
24,0,0,0,0,2021-07-09,Male,66,65-69,23
24,1,0,0,1,2021-07-10,Female,56,55-64,15
24,0,0,0,0,2021-07-11,Male,60,55-64,4
24,0,0,0,0,2021-07-12,Male,34,25-34,18
24,2,0,0,2,2021-07-13,Female,5,5-9,5
24,1,1,0,2,2021-07-12,Female,54,45-54,9
24,1,0,0,1,2021-07-07,Female,59,55-64,22
24,0,1,0,1,2021-07-08,Male,54,45-54,4
24,2,0,0,2,2021-07-12,Male,73,70-74,19
24,1,0,0,1,2021-07-08,Female,67,65-69,4
24,2,0,0,2,2021-07-12,Male,48,45-54,3
24,2,0,0,2,2021-07-09,Female,4,1-4,4
24,1,0,0,1,2021-07-07,Female,30,25-34,4
24,2,0,0,2,2021-07-09,Male,34,25-34,18
24,0,0,0,0,2021-07-10,Female,37,35-44,17
24,0,1,0,1,2021-07-14,Male,47,45-54,8
24,1,0,0,1,2021-07-12,Male,63,55-64,15
24,1,0,0,1,2021-07-08,Female,47,45-54,15
24,4,1,0,5,2021-07-09,Female,22,20-24,15
24,0,0,0,0,2021-07-12,Male,63,55-64,19
24,0,2,0,2,2021-07-10,Female,21,20-24,4
24,0,1,0,1,2021-07-10,Female,69,65-69,19
24,2,2,0,4,2021-07-09,Female,66,65-69,19
24,4,0,0,4,2021-07-09,Female,35,35-44,14
24,0,0,0,0,2021-07-10,Male,54,45-54,21
24,0,0,0,0,2021-07-12,Male,32,25-34,3
24,0,2,0,2,2021-07-10,Female,36,35-44,16
24,0,1,0,1,2021-07-10,Male,57,55-64,21
24,1,0,0,1,2021-07-13,Male,63,55-64,4
24,0,1,0,1,2021-07-11,Female,56,55-64,22
24,0,0,0,0,2021-07-07,Female,27,25-34,3
24,0,2,0,2,2021-07-08,Female,68,65-69,23
24,2,0,0,2,2021-07-10,Female,16,15-19,4
24,2,0,0,2,2021-07-15,Male,42,35-44,15
24,0,0,0,0,2021-07-08,Female,68,65-69,7
24,1,0,0,1,2021-07-11,Female,24,20-24,10
24,1,0,0,1,2021-07-13,Female,73,70-74,16
24,0,0,1,1,2021-07-13,Male,32,25-34,17
24,0,0,0,0,2021-07-07,Female,50,45-54,4
24,1,4,0,5,2021-07-19,Female,56,55-64,11
24,2,0,0,2,2021-07-15,Male,26,25-34,1
24,2,2,0,4,2021-07-10,Female,71,70-74,20
24,0,0,0,0,2021-07-11,Female,71,70-74,19
24,0,1,0,1,2021-07-13,Male,33,25-34,4
24,0,2,0,2,2021-07-09,Male,67,65-69,24
24,2,0,0,2,2021-07-12,Male,2,1-4,4
24,2,0,0,2,2021-07-15,Male,18,15-19,1
24,0,0,0,0,2021-07-07,Female,27,25-34,19
24,1,0,0,1,2021-07-10,Female,56,55-64,15
24,0,0,0,0,2021-07-14,Male,61,55-64,18
24,1,0,0,1,2021-07-07,Female,54,45-54,21
24,0,7,0,7,2021-07-10,Female,58,55-64,4
24,1,1,0,2,2021-07-12,Male,63,55-64,22
24,3,0,0,3,2021-07-09,Male,20,20-24,4
24,0,0,0,0,2021-07-07,Female,67,65-69,4
24,1,1,0,2,2021-07-12,Female,68,65-69,4
24,1,4,0,5,2021-07-09,Female,28,25-34,22
24,0,0,0,0,2021-07-13,Male,27,25-34,4
24,4,0,0,4,2021-07-12,Female,48,45-54,11
24,0,0,0,0,2021-07-13,Female,11,10-14,19
24,0,0,0,0,2021-07-08,Male,54,45-54,20
24,3,0,0,3,2021-07-15,Male,0,<1,1
24,3,0,0,3,2021-07-12,Male,4,1-4,6
24,2,1,0,3,2021-07-14,Male,1,1-4,4
24,0,7,0,7,2021-07-14,Female,54,45-54,3
24,1,0,0,1,2021-07-10,Female,64,55-64,4
24,1,2,0,3,2021-07-11,Male,71,70-74,3
24,1,0,0,1,2021-07-07,Male,35,35-44,23
24,3,2,0,5,2021-07-10,Male,64,55-64,3
24,0,2,0,2,2021-07-10,Female,35,35-44,6
24,0,3,0,3,2021-07-12,Female,72,70-74,22
24,1,0,0,1,2021-07-09,Female,54,45-54,4
24,3,0,0,3,2021-07-12,Male,42,35-44,21
24,0,0,0,0,2021-07-12,Female,63,55-64,11
24,5,0,0,5,2021-07-07,Female,8,5-9,3
24,1,0,0,1,2021-07-11,Female,25,25-34,20
24,3,0,0,3,2021-07-08,Male,18,15-19,4
24,1,0,0,1,2021-07-13,Male,33,25-34,19
24,0,0,0,0,2021-07-12,Female,43,35-44,21
24,2,0,0,2,2021-07-11,Female,72,70-74,17
24,0,1,0,1,2021-07-13,Male,59,55-64,18
24,1,0,0,1,2021-07-09,Female,55,55-64,4
24,1,0,0,1,2021-07-12,Male,32,25-34,9
24,3,3,0,6,2021-07-14,Male,7,5-9,19
24,3,0,0,3,2021-07-10,Female,37,35-44,23
24,1,0,0,1,2021-07-07,Female,59,55-64,22
24,0,0,0,0,2021-07-11,Female,7,5-9,5
24,1,0,0,1,2021-07-11,Male,70,70-74,16
24,1,0,0,1,2021-07-07,Male,67,65-69,22
24,1,1,0,2,2021-07-11,Female,66,65-69,3
24,0,0,0,0,2021-07-14,Male,43,35-44,4
24,2,0,0,2,2021-07-07,Male,5,5-9,4
24,1,0,0,1,2021-07-19,Female,6,5-9,3
24,0,0,0,0,2021-07-11,Male,60,55-64,4
24,3,0,0,3,2021-07-12,Male,49,45-54,15
24,0,0,0,0,2021-07-12,Female,58,55-64,19
24,0,2,0,2,2021-07-15,Female,49,45-54,9
24,0,0,0,0,2021-07-12,Female,48,45-54,4
24,0,0,0,0,2021-07-14,Male,53,45-54,22
24,1,2,3,6,2021-07-12,Female,76,75-79,16
24,3,0,0,3,2021-07-14,Male,34,25-34,4
24,0,0,0,0,2021-07-13,Male,7,5-9,4
24,0,0,0,0,2021-07-19,Male,26,25-34,12
24,3,15,0,18,2021-07-13,Female,3,1-4,4
24,0,0,0,0,2021-07-15,Female,26,25-34,1
24,1,0,0,1,2021-07-09,Female,64,55-64,15
24,2,0,0,2,2021-07-09,Male,66,65-69,19
24,3,0,0,3,2021-07-12,Male,15,15-19,14
24,1,0,0,1,2021-07-07,Female,43,35-44,3
24,0,2,0,2,2021-07-19,Female,41,35-44,1
24,0,1,0,1,2021-07-13,Male,48,45-54,8
24,0,11,0,11,2021-07-12,Male,59,55-64,2
24,0,0,0,0,2021-07-12,Male,75,75-79,18
24,2,0,0,2,2021-07-12,Male,19,15-19,4
24,0,0,0,0,2021-07-09,Male,35,35-44,11
24,0,0,0,0,2021-07-10,Male,36,35-44,10
24,0,0,0,0,2021-07-12,Male,74,70-74,9
24,0,1,0,1,2021-07-09,Female,66,65-69,23
24,4,1,0,5,2021-07-11,Female,18,15-19,13
24,1,0,0,1,2021-07-15,Male,32,25-34,1
24,1,0,0,1,2021-07-07,Female,46,45-54,21
24,1,0,0,1,2021-07-08,Female,58,55-64,4
24,1,0,0,1,2021-07-12,Female,21,20-24,4
24,1,0,0,1,2021-07-12,Male,54,45-54,19
24,0,0,0,0,2021-07-11,Male,71,70-74,4
24,0,0,0,0,2021-07-10,Female,63,55-64,21
24,2,3,0,5,2021-07-14,Male,74,70-74,17
24,1,0,0,1,2021-07-11,Female,71,70-74,23
24,1,0,0,1,2021-07-08,Female,54,45-54,11
24,1,0,0,1,2021-07-12,Male,74,70-74,16
24,3,0,0,3,2021-07-11,Male,61,55-64,4
24,0,3,0,3,2021-07-15,Male,28,25-34,22
24,1,0,0,1,2021-07-12,Female,78,75-79,10
24,1,1,0,2,2021-07-09,Male,28,25-34,24
24,0,0,0,0,2021-07-09,Female,31,25-34,18
24,0,0,0,0,2021-07-09,Female,65,65-69,18
24,1,0,0,1,2021-07-12,Male,42,35-44,21
24,3,1,0,4,2021-07-07,Female,4,1-4,5
24,0,1,0,1,2021-07-11,Male,71,70-74,22
24,2,2,0,4,2021-07-13,Male,52,45-54,3
24,1,0,0,1,2021-07-12,Male,51,45-54,3
24,0,0,0,0,2021-07-10,Female,69,65-69,24
24,1,10,25,36,2021-07-08,Male,67,65-69,4
24,1,0,0,1,2021-07-12,Female,80,80-84,4
24,2,0,4,6,2021-07-13,Male,19,15-19,2
24,1,0,0,1,2021-07-09,Male,65,65-69,2
24,0,0,6,6,2021-07-12,Male,26,25-34,4
24,1,0,0,1,2021-07-12,Male,77,75-79,3
24,0,5,0,5,2021-07-12,Female,40,35-44,4
24,0,0,0,0,2021-07-12,Male,9,5-9,18
24,0,0,0,0,2021-07-12,Female,34,25-34,20
24,1,0,0,1,2021-07-11,Male,69,65-69,23
24,0,0,0,0,2021-07-19,Male,51,45-54,1
24,2,0,0,2,2021-07-09,Female,67,65-69,17
24,0,0,0,0,2021-07-12,Female,41,35-44,11
24,1,0,0,1,2021-07-09,Male,66,65-69,4
24,1,1,0,2,2021-07-10,Male,69,65-69,22
24,0,1,0,1,2021-07-19,Male,15,15-19,17
24,0,0,0,0,2021-07-15,Male,31,25-34,1
24,0,3,0,3,2021-07-10,Female,57,55-64,23
24,1,0,0,1,2021-07-12,Male,14,10-14,4
24,2,1,0,3,2021-07-13,Female,54,45-54,19
24,3,0,0,3,2021-07-07,Female,3,1-4,11
24,1,5,0,6,2021-07-13,Male,67,65-69,19
24,1,2,0,3,2021-07-10,Female,67,65-69,4
24,1,0,0,1,2021-07-11,Male,56,55-64,18
24,3,0,0,3,2021-07-13,Male,6,5-9,18
24,1,1,0,2,2021-07-07,Male,44,35-44,3
24,1,0,0,1,2021-07-12,Male,43,35-44,17
24,2,0,0,2,2021-07-14,Female,23,20-24,3
24,1,0,0,1,2021-07-11,Male,38,35-44,3
24,0,0,0,0,2021-07-08,Female,54,45-54,16
24,1,20,0,21,2021-07-14,Male,72,70-74,4
24,0,1,0,1,2021-07-12,Female,60,55-64,24
24,3,0,0,3,2021-07-14,Female,2,1-4,20
24,1,2,0,3,2021-07-16,Female,24,20-24,3
24,1,0,0,1,2021-07-11,Female,60,55-64,18
24,0,0,0,0,2021-07-07,Male,4,1-4,4
24,3,0,0,3,2021-07-12,Female,9,5-9,2
24,1,1,0,2,2021-07-14,Male,63,55-64,3
24,3,7,0,10,2021-07-13,Male,8,5-9,15
24,2,0,0,2,2021-07-11,Male,72,70-74,3
24,3,0,0,3,2021-07-12,Female,33,25-34,3
24,0,0,0,0,2021-07-12,Male,58,55-64,3
24,4,0,0,4,2021-07-11,Female,55,55-64,18
24,2,0,0,2,2021-07-12,Male,67,65-69,3
24,0,1,0,1,2021-07-13,Male,66,65-69,4
24,2,0,0,2,2021-07-14,Female,56,55-64,20
24,0,1,0,1,2021-07-09,Female,21,20-24,4
24,1,0,0,1,2021-07-11,Female,61,55-64,23
24,0,0,0,0,2021-07-12,Female,41,35-44,4
24,4,0,0,4,2021-07-12,Male,18,15-19,4
24,0,1,0,1,2021-07-11,Male,70,70-74,23
24,3,0,0,3,2021-07-12,Male,48,45-54,15
24,0,0,0,0,2021-07-10,Female,55,55-64,18
24,0,1,0,1,2021-07-12,Male,33,25-34,8
24,1,0,0,1,2021-07-13,Female,26,25-34,2
24,1,0,0,1,2021-07-13,Male,62,55-64,15
24,1,31,87,119,2021-07-08,Female,67,65-69,2
24,2,0,0,2,2021-07-12,Male,3,1-4,4
24,1,0,0,1,2021-07-12,Female,52,45-54,22
24,1,1,0,2,2021-07-09,Male,65,65-69,3
24,3,0,0,3,2021-07-09,Female,11,10-14,4
24,0,6,0,6,2021-07-19,Male,39,35-44,1
24,2,0,0,2,2021-07-10,Male,69,65-69,18
24,2,0,0,2,2021-07-12,Male,72,70-74,19
24,2,2,0,4,2021-07-14,Male,59,55-64,3
24,1,0,0,1,2021-07-09,Male,67,65-69,4
24,2,0,0,2,2021-07-14,Male,78,75-79,18
24,2,0,0,2,2021-07-12,Male,10,10-14,4
24,1,0,0,1,2021-07-13,Male,53,45-54,4
24,2,4,0,6,2021-07-13,Female,67,65-69,13
24,0,0,0,0,2021-07-12,Female,62,55-64,4
24,2,2,0,4,2021-07-08,Male,52,45-54,17
24,0,11,0,11,2021-07-10,Male,56,55-64,4
24,0,0,0,0,2021-07-12,Male,81,80-84,3
24,0,0,0,0,2021-07-13,Male,52,45-54,20
24,3,0,0,3,2021-07-10,Female,16,15-19,20
24,1,3,0,4,2021-07-13,Female,40,35-44,4
24,0,0,0,0,2021-07-11,Female,70,70-74,4
24,1,0,0,1,2021-07-09,Female,65,65-69,23
24,5,0,0,5,2021-07-12,Female,52,45-54,16
24,2,0,0,2,2021-07-12,Female,38,35-44,19
24,0,3,0,3,2021-07-19,Male,32,25-34,1
24,0,0,0,0,2021-07-07,Female,43,35-44,4
24,4,0,0,4,2021-07-12,Male,13,10-14,11
24,0,2,0,2,2021-07-11,Male,58,55-64,16
24,1,0,0,1,2021-07-14,Female,28,25-34,9
24,0,0,0,0,2021-07-19,Male,71,70-74,2
24,2,3,50,55,2021-07-07,Male,14,10-14,4
24,1,7,0,8,2021-07-15,Male,54,45-54,1
24,0,2,0,2,2021-07-13,Female,52,45-54,4
24,3,20,20,43,2021-07-15,Female,7,5-9,1
24,0,0,7,7,2021-07-14,Female,49,45-54,15
24,0,0,0,0,2021-07-17,Female,18,15-19,2
24,0,2,0,2,2021-07-12,Female,59,55-64,10
24,0,4,0,4,2021-07-11,Male,60,55-64,17
24,0,0,0,0,2021-07-09,Female,56,55-64,21
24,1,1,0,2,2021-07-14,Male,19,15-19,3
24,0,0,0,0,2021-07-07,Male,65,65-69,20
24,0,0,0,0,2021-07-07,Male,37,35-44,16
24,0,0,0,0,2021-07-13,Male,37,35-44,19
24,2,0,0,2,2021-07-12,Female,48,45-54,3
24,1,10,0,11,2021-07-09,Male,16,15-19,11
24,2,0,0,2,2021-07-12,Male,64,55-64,18
24,1,1,0,2,2021-07-08,Male,52,45-54,15
24,0,1,0,1,2021-07-16,Male,18,15-19,4
24,1,3,0,4,2021-07-14,Male,63,55-64,4
24,1,2,0,3,2021-07-07,Female,74,70-74,14
24,2,0,0,2,2021-07-13,Female,18,15-19,4
24,1,5,0,6,2021-07-07,Female,19,15-19,20
24,0,2,0,2,2021-07-13,Male,62,55-64,20
24,1,1,7,9,2021-07-10,Female,55,55-64,15
24,2,1,0,3,2021-07-07,Male,18,15-19,11
24,1,0,0,1,2021-07-12,Male,51,45-54,11
24,3,0,0,3,2021-07-09,Male,31,25-34,4
24,0,14,0,14,2021-07-07,Female,41,35-44,3
24,0,0,0,0,2021-07-13,Male,54,45-54,15
24,1,1,0,2,2021-07-09,Male,52,45-54,10
24,1,0,0,1,2021-07-15,Female,29,25-34,1
24,1,1,0,2,2021-07-09,Male,65,65-69,4
24,1,0,0,1,2021-07-09,Male,54,45-54,19
24,2,0,0,2,2021-07-09,Female,66,65-69,22
24,2,2,10,14,2021-07-09,Male,29,25-34,3
24,1,0,0,1,2021-07-12,Male,62,55-64,21
24,0,0,0,0,2021-07-12,Male,42,35-44,4
24,0,1,0,1,2021-07-19,Male,30,25-34,1
24,0,1,0,1,2021-07-09,Male,64,55-64,4
24,3,0,0,3,2021-07-09,Male,18,15-19,19
24,3,0,0,3,2021-07-09,Male,18,15-19,13
24,0,3,0,3,2021-07-09,Male,53,45-54,19
24,1,0,0,1,2021-07-11,Female,61,55-64,4
24,1,0,0,1,2021-07-13,Female,51,45-54,17
24,0,0,0,0,2021-07-14,Female,61,55-64,20
24,3,0,67,70,2021-07-14,Male,11,10-14,23
24,0,0,0,0,2021-07-09,Female,27,25-34,11
24,0,0,0,0,2021-07-12,Male,41,35-44,17
24,0,0,0,0,2021-07-12,Male,40,35-44,4
24,2,1,0,3,2021-07-15,Female,24,20-24,1
24,3,0,0,3,2021-07-11,Female,60,55-64,9
24,1,1,0,2,2021-07-12,Female,50,45-54,4
24,2,1,0,3,2021-07-13,Female,68,65-69,12
24,3,3,0,6,2021-07-15,Female,3,1-4,1
24,3,0,0,3,2021-07-08,Female,10,10-14,4
24,0,0,0,0,2021-07-09,Female,28,25-34,3
24,3,0,0,3,2021-07-11,Female,3,1-4,9
24,0,7,0,7,2021-07-09,Male,68,65-69,4
24,1,0,11,12,2021-07-12,Male,39,35-44,4
24,4,0,0,4,2021-07-12,Female,1,1-4,4
24,0,0,0,0,2021-07-10,Female,38,35-44,4
24,0,0,0,0,2021-07-09,Female,66,65-69,22
24,0,0,0,0,2021-07-12,Female,39,35-44,3
24,0,0,0,0,2021-07-12,Male,64,55-64,13
24,2,3,0,5,2021-07-09,Male,68,65-69,12
24,1,0,0,1,2021-07-14,Male,38,35-44,20
24,1,0,0,1,2021-07-11,Male,56,55-64,5
24,0,0,88,88,2021-07-12,Female,25,25-34,14
24,1,3,0,4,2021-07-09,Female,64,55-64,17
24,0,0,0,0,2021-07-09,Female,68,65-69,23
24,0,0,0,0,2021-07-11,Male,61,55-64,4
24,1,9,0,10,2021-07-12,Male,59,55-64,4
24,0,0,0,0,2021-07-14,Female,44,35-44,15
24,0,0,0,0,2021-07-13,Male,65,65-69,4
24,0,0,0,0,2021-07-12,Female,40,35-44,18
24,1,0,0,1,2021-07-13,Male,46,45-54,4
24,0,3,0,3,2021-07-08,Female,68,65-69,21
24,1,3,0,4,2021-07-19,Male,11,10-14,1
24,1,0,0,1,2021-07-10,Female,38,35-44,14
24,0,0,0,0,2021-07-13,Female,7,5-9,9
24,1,0,0,1,2021-07-09,Female,52,45-54,23
24,0,0,0,0,2021-07-11,Female,24,20-24,21
24,0,0,0,0,2021-07-11,Female,23,20-24,4
24,2,2,0,4,2021-07-13,Female,55,55-64,13
24,0,0,0,0,2021-07-11,Female,16,15-19,19
24,0,0,0,0,2021-07-07,Female,44,35-44,19
24,0,31,0,31,2021-07-13,Female,22,20-24,6
24,1,0,0,1,2021-07-09,Male,67,65-69,15
24,2,0,0,2,2021-07-13,Female,63,55-64,21
24,0,6,0,6,2021-07-14,Female,52,45-54,17
24,1,0,0,1,2021-07-12,Male,78,75-79,3
24,1,0,0,1,2021-07-11,Male,62,55-64,4
24,0,3,0,3,2021-07-09,Male,43,35-44,8
24,1,0,0,1,2021-07-12,Female,73,70-74,18
24,0,0,0,0,2021-07-12,Male,59,55-64,22
24,0,0,0,0,2021-07-11,Male,26,25-34,4
24,1,3,0,4,2021-07-12,Male,79,75-79,19
24,4,0,0,4,2021-07-14,Female,14,10-14,4
24,2,4,0,6,2021-07-07,Female,12,10-14,19
24,1,0,0,1,2021-07-10,Male,44,35-44,14
24,1,0,0,1,2021-07-09,Male,31,25-34,4
24,2,1,0,3,2021-07-11,Male,69,65-69,21
24,1,0,100,101,2021-07-10,Female,56,55-64,21
24,2,1,0,3,2021-07-11,Female,61,55-64,15
24,0,0,0,0,2021-07-12,Male,54,45-54,3
24,0,0,0,0,2021-07-12,Male,8,5-9,3
24,1,0,0,1,2021-07-12,Female,62,55-64,19
24,1,3,0,4,2021-07-09,Male,68,65-69,17
24,3,0,0,3,2021-07-12,Female,48,45-54,4
24,3,7,0,10,2021-07-15,Male,9,5-9,1
24,1,0,0,1,2021-07-11,Male,65,65-69,24
24,1,2,0,3,2021-07-09,Male,65,65-69,3
24,0,2,0,2,2021-07-19,Female,30,25-34,4
24,2,0,0,2,2021-07-12,Male,73,70-74,21
24,1,0,0,1,2021-07-09,Female,65,65-69,20
24,2,0,0,2,2021-07-09,Male,54,45-54,19
24,1,0,0,1,2021-07-12,Male,71,70-74,2
24,0,3,0,3,2021-07-08,Female,67,65-69,19
24,1,2,0,3,2021-07-08,Male,57,55-64,4
24,0,1,0,1,2021-07-15,Female,28,25-34,1
24,0,0,0,0,2021-07-14,Female,32,25-34,10
24,1,0,0,1,2021-07-08,Male,66,65-69,4
24,0,0,0,0,2021-07-12,Male,12,10-14,9
24,1,0,0,1,2021-07-15,Female,24,20-24,4
24,0,0,0,0,2021-07-10,Female,38,35-44,8
24,0,0,0,0,2021-07-15,Male,46,45-54,4
24,0,1,0,1,2021-07-13,Female,72,70-74,21
24,2,7,0,9,2021-07-12,Female,72,70-74,20
24,1,1,0,2,2021-07-12,Female,50,45-54,22
24,3,0,0,3,2021-07-09,Female,59,55-64,20
24,0,0,0,0,2021-07-12,Female,34,25-34,19
24,2,1,0,3,2021-07-07,Female,3,1-4,15
24,1,0,0,1,2021-07-13,Female,67,65-69,2
24,0,0,0,0,2021-07-12,Female,51,45-54,17
24,0,0,0,0,2021-07-10,Male,57,55-64,3
24,0,0,0,0,2021-07-12,Female,41,35-44,23
24,0,0,0,0,2021-07-09,Female,53,45-54,4
24,0,0,0,0,2021-07-10,Male,55,55-64,23
24,0,2,0,2,2021-07-07,Female,44,35-44,3
24,0,0,0,0,2021-07-13,Male,53,45-54,17
24,0,0,0,0,2021-07-13,Female,37,35-44,22
24,3,0,0,3,2021-07-13,Female,8,5-9,20
24,1,0,0,1,2021-07-10,Male,55,55-64,20
24,1,0,0,1,2021-07-09,Male,64,55-64,4
24,2,1,0,3,2021-07-13,Male,62,55-64,20
24,0,0,0,0,2021-07-14,Female,21,20-24,10
24,0,0,0,0,2021-07-12,Male,41,35-44,9
24,1,1,0,2,2021-07-11,Female,57,55-64,19
24,1,0,0,1,2021-07-13,Female,68,65-69,19
24,0,0,0,0,2021-07-12,Female,85,85+,12
24,0,0,0,0,2021-07-11,Female,71,70-74,22
24,1,2,0,3,2021-07-12,Male,74,70-74,24
24,0,0,0,0,2021-07-13,Male,10,10-14,11
24,1,1,0,2,2021-07-13,Female,40,35-44,9
24,0,8,0,8,2021-07-14,Male,39,35-44,2
24,0,3,0,3,2021-07-12,Female,20,20-24,3
24,1,1,0,2,2021-07-08,Male,55,55-64,4
24,0,0,0,0,2021-07-10,Female,37,35-44,14
24,0,0,0,0,2021-07-13,Female,38,35-44,21
24,1,0,0,1,2021-07-10,Male,58,55-64,4
24,1,0,0,1,2021-07-09,Male,68,65-69,2
24,1,0,0,1,2021-07-10,Female,28,25-34,4
24,0,0,0,0,2021-07-13,Female,13,10-14,15
24,1,0,0,1,2021-07-08,Male,67,65-69,17
24,1,0,0,1,2021-07-11,Female,61,55-64,21
24,0,3,0,3,2021-07-12,Male,33,25-34,4
24,0,0,0,0,2021-07-12,Male,32,25-34,4
24,1,1,0,2,2021-07-08,Male,67,65-69,19
24,1,1,0,2,2021-07-15,Female,23,20-24,1
24,3,0,0,3,2021-07-14,Female,11,10-14,20
24,0,0,0,0,2021-07-15,Male,34,25-34,1
24,4,5,0,9,2021-07-13,Male,23,20-24,2
24,2,4,0,6,2021-07-12,Male,1,1-4,2
24,1,2,0,3,2021-07-13,Male,71,70-74,12
24,0,0,0,0,2021-07-12,Female,51,45-54,18
24,1,0,0,1,2021-07-15,Male,42,35-44,1
24,1,0,0,1,2021-07-13,Male,39,35-44,2
24,3,0,0,3,2021-07-13,Male,52,45-54,4
24,0,2,0,2,2021-07-09,Female,66,65-69,4
24,1,0,0,1,2021-07-13,Female,67,65-69,4
24,1,3,0,4,2021-07-09,Male,66,65-69,23
24,0,0,0,0,2021-07-12,Male,32,25-34,18
24,1,0,0,1,2021-07-09,Female,65,65-69,4
24,0,0,0,0,2021-07-12,Female,71,70-74,3
24,1,0,0,1,2021-07-12,Female,12,10-14,17
24,1,0,0,1,2021-07-15,Male,34,25-34,1
24,0,2,0,2,2021-07-13,Female,25,25-34,16
24,1,0,0,1,2021-07-14,Male,78,75-79,3
24,3,0,0,3,2021-07-13,Female,65,65-69,22
24,0,1,0,1,2021-07-13,Female,76,75-79,22
24,2,0,0,2,2021-07-12,Female,13,10-14,4
24,0,0,0,0,2021-07-08,Female,45,45-54,16
24,0,0,0,0,2021-07-13,Male,72,70-74,19
24,0,0,0,0,2021-07-13,Male,34,25-34,16
24,2,0,0,2,2021-07-12,Female,23,20-24,20
24,0,0,0,0,2021-07-13,Male,24,20-24,3
24,0,0,0,0,2021-07-12,Male,19,15-19,20
24,0,2,0,2,2021-07-13,Female,69,65-69,8
24,1,6,0,7,2021-07-09,Male,66,65-69,22
24,0,0,0,0,2021-07-13,Female,28,25-34,3
24,1,0,0,1,2021-07-12,Female,60,55-64,4
24,1,0,0,1,2021-07-14,Male,56,55-64,11
24,2,0,0,2,2021-07-12,Female,14,10-14,24
24,4,0,0,4,2021-07-19,Female,18,15-19,1
24,0,3,0,3,2021-07-09,Female,66,65-69,18
24,2,0,0,2,2021-07-12,Female,14,10-14,4
24,1,2,0,3,2021-07-12,Male,55,55-64,19
24,0,0,0,0,2021-07-07,Male,45,45-54,4
24,2,0,0,2,2021-07-12,Male,12,10-14,3
24,2,1,0,3,2021-07-12,Male,0,<1,5
24,0,0,0,0,2021-07-11,Male,21,20-24,13
24,2,4,0,6,2021-07-15,Male,53,45-54,1
24,3,0,0,3,2021-07-14,Female,8,5-9,4
24,1,0,0,1,2021-07-13,Male,63,55-64,23
24,0,0,0,0,2021-07-09,Male,30,25-34,6
24,0,0,0,0,2021-07-14,Male,34,25-34,3
24,0,1,0,1,2021-07-12,Male,18,15-19,4
24,1,0,0,1,2021-07-19,Female,30,25-34,1
24,2,0,0,2,2021-07-09,Male,66,65-69,20
24,1,0,0,1,2021-07-13,Female,67,65-69,17
24,4,4,0,8,2021-07-15,Male,3,1-4,1
24,1,2,0,3,2021-07-12,Female,66,65-69,4
24,1,1,29,31,2021-07-09,Male,68,65-69,12
24,0,0,0,0,2021-07-12,Female,62,55-64,18
24,1,1,0,2,2021-07-13,Female,31,25-34,14
24,2,0,0,2,2021-07-15,Female,5,5-9,1
24,1,0,0,1,2021-07-09,Female,53,45-54,21
24,1,0,0,1,2021-07-12,Female,49,45-54,22
24,1,0,0,1,2021-07-13,Female,40,35-44,4
24,1,0,0,1,2021-07-09,Female,66,65-69,2
24,0,0,0,0,2021-07-08,Female,67,65-69,4
24,1,0,0,1,2021-07-11,Male,65,65-69,17
24,3,0,0,3,2021-07-09,Male,30,25-34,13
24,0,0,0,0,2021-07-13,Female,67,65-69,4
24,0,1,0,1,2021-07-12,Male,45,45-54,3
24,0,0,0,0,2021-07-11,Female,26,25-34,23
24,0,2,0,2,2021-07-09,Female,31,25-34,4
24,0,0,0,0,2021-07-12,Female,22,20-24,18
24,1,0,0,1,2021-07-12,Male,41,35-44,21
24,0,3,0,3,2021-07-12,Female,44,35-44,4
24,0,0,0,0,2021-07-12,Male,34,25-34,17
24,1,4,0,5,2021-07-12,Male,62,55-64,20
24,0,1,0,1,2021-07-10,Female,69,65-69,19
24,0,0,0,0,2021-07-12,Female,32,25-34,3
24,1,0,0,1,2021-07-13,Male,41,35-44,4
24,1,0,0,1,2021-07-09,Male,68,65-69,22
24,0,6,0,6,2021-07-15,Male,26,25-34,1
24,3,1,0,4,2021-07-09,Female,21,20-24,2
24,2,0,0,2,2021-07-14,Female,36,35-44,5
24,2,0,0,2,2021-07-10,Male,11,10-14,24
24,4,0,0,4,2021-07-09,Female,10,10-14,18
24,1,3,0,4,2021-07-11,Male,71,70-74,19
24,1,0,0,1,2021-07-14,Male,21,20-24,3
24,1,0,0,1,2021-07-12,Female,29,25-34,10
24,1,0,0,1,2021-07-10,Male,57,55-64,4
24,0,0,0,0,2021-07-07,Male,41,35-44,3
24,2,0,0,2,2021-07-11,Female,61,55-64,20
24,0,1,5,6,2021-07-15,Male,38,35-44,1
24,1,4,0,5,2021-07-13,Female,28,25-34,3
24,3,1,0,4,2021-07-13,Female,18,15-19,9
24,0,5,0,5,2021-07-13,Male,46,45-54,16
24,1,0,0,1,2021-07-11,Male,2,1-4,14
24,1,3,0,4,2021-07-09,Female,68,65-69,13
24,1,0,0,1,2021-07-09,Female,52,45-54,4
24,0,2,0,2,2021-07-11,Female,26,25-34,3
24,2,0,0,2,2021-07-10,Female,35,35-44,20
24,3,1,0,4,2021-07-13,Female,33,25-34,21
24,0,0,0,0,2021-07-10,Male,58,55-64,22
24,2,2,0,4,2021-07-09,Male,64,55-64,23
24,1,0,15,16,2021-07-12,Female,63,55-64,22
24,1,0,0,1,2021-07-09,Female,64,55-64,21
24,0,0,0,0,2021-07-09,Male,65,65-69,4
24,1,0,0,1,2021-07-15,Female,32,25-34,1
24,1,2,0,3,2021-07-10,Female,57,55-64,4
24,0,0,0,0,2021-07-13,Female,44,35-44,20
24,1,1,0,2,2021-07-10,Female,69,65-69,22
24,1,0,0,1,2021-07-12,Male,50,45-54,22
24,1,0,0,1,2021-07-12,Male,36,35-44,4
24,1,0,0,1,2021-07-12,Female,54,45-54,16
24,1,0,0,1,2021-07-12,Female,68,65-69,22
24,2,0,0,2,2021-07-13,Male,59,55-64,21
24,1,2,0,3,2021-07-09,Female,64,55-64,4
24,3,2,0,5,2021-07-14,Male,13,10-14,12
24,0,0,0,0,2021-07-12,Male,33,25-34,21
24,1,0,0,1,2021-07-07,Female,31,25-34,3
24,1,0,0,1,2021-07-10,Male,58,55-64,2
24,3,15,0,18,2021-07-14,Male,7,5-9,8
24,2,0,0,2,2021-07-13,Female,10,10-14,3
24,1,0,0,1,2021-07-12,Male,49,45-54,4
24,0,0,0,0,2021-07-12,Male,33,25-34,3
24,2,0,0,2,2021-07-07,Female,16,15-19,4
24,0,0,0,0,2021-07-09,Female,65,65-69,18
24,0,0,0,0,2021-07-07,Female,54,45-54,3
24,3,0,0,3,2021-07-13,Female,35,35-44,4
24,1,2,0,3,2021-07-09,Male,68,65-69,24
24,0,0,0,0,2021-07-12,Male,11,10-14,21
24,0,0,0,0,2021-07-14,Female,39,35-44,4
24,2,0,0,2,2021-07-12,Male,77,75-79,17
24,0,0,0,0,2021-07-09,Male,68,65-69,4
24,0,0,0,0,2021-07-10,Male,37,35-44,4
24,1,0,0,1,2021-07-11,Female,59,55-64,22
24,1,4,0,5,2021-07-12,Male,42,35-44,4
24,1,0,0,1,2021-07-15,Female,28,25-34,1
24,1,0,0,1,2021-07-13,Male,33,25-34,4
24,6,0,0,6,2021-07-12,Female,18,15-19,23
24,1,4,0,5,2021-07-12,Male,70,70-74,5
24,2,0,0,2,2021-07-13,Female,2,1-4,3
24,0,0,0,0,2021-07-14,Female,47,45-54,3
24,1,0,21,22,2021-07-14,Male,67,65-69,11
24,0,0,0,0,2021-07-10,Female,68,65-69,15
24,2,16,0,18,2021-07-13,Male,10,10-14,20
24,1,1,0,2,2021-07-08,Male,47,45-54,4
24,1,2,0,3,2021-07-07,Female,72,70-74,3
24,1,0,0,1,2021-07-12,Male,77,75-79,4
24,2,0,0,2,2021-07-11,Male,24,20-24,15
24,1,0,15,16,2021-07-15,Female,30,25-34,5
24,0,0,0,0,2021-07-12,Male,12,10-14,18
24,0,0,0,0,2021-07-13,Female,40,35-44,15
24,2,0,0,2,2021-07-12,Male,19,15-19,18
24,0,0,0,0,2021-07-10,Female,56,55-64,4
24,2,2,0,4,2021-07-09,Male,53,45-54,4
24,2,0,0,2,2021-07-12,Male,51,45-54,20
24,0,1,0,1,2021-07-19,Female,31,25-34,1
24,0,3,0,3,2021-07-13,Female,68,65-69,3
24,0,2,0,2,2021-07-13,Male,51,45-54,4
24,0,0,0,0,2021-07-12,Female,34,25-34,3
24,2,0,0,2,2021-07-09,Male,65,65-69,4
24,0,1,0,1,2021-07-12,Male,40,35-44,20
24,0,0,0,0,2021-07-15,Male,27,25-34,1
24,0,0,0,0,2021-07-12,Female,35,35-44,22
24,2,0,0,2,2021-07-12,Male,1,1-4,3
24,0,0,0,0,2021-07-14,Female,3,1-4,2
24,3,0,0,3,2021-07-12,Female,19,15-19,6
24,6,1,0,7,2021-07-12,Female,19,15-19,11
24,2,0,0,2,2021-07-11,Male,0,<1,3
24,0,0,0,0,2021-07-07,Male,46,45-54,20
24,0,3,0,3,2021-07-13,Female,66,65-69,20
24,0,0,0,0,2021-07-10,Male,69,65-69,2
24,3,9,16,28,2021-07-14,Male,12,10-14,4
24,1,2,0,3,2021-07-11,Male,72,70-74,5
24,0,0,0,0,2021-07-09,Female,19,15-19,5
24,9,0,0,9,2021-07-12,Female,20,20-24,15
24,0,0,0,0,2021-07-08,Female,53,45-54,20
24,0,0,0,0,2021-07-09,Female,29,25-34,11
24,2,0,0,2,2021-07-10,Male,39,35-44,3
24,0,0,0,0,2021-07-14,Male,71,70-74,10
24,2,0,0,2,2021-07-14,Male,26,25-34,18
24,2,0,0,2,2021-07-19,Female,13,10-14,13
24,0,1,0,1,2021-07-12,Female,28,25-34,18
24,1,0,0,1,2021-07-14,Female,74,70-74,13
24,0,0,0,0,2021-07-09,Male,18,15-19,15
24,0,0,0,0,2021-07-08,Female,68,65-69,20
24,0,0,0,0,2021-07-09,Female,68,65-69,16
24,0,0,0,0,2021-07-12,Female,69,65-69,22
24,0,0,0,0,2021-07-11,Male,27,25-34,9
24,2,0,0,2,2021-07-08,Female,52,45-54,6
24,1,0,0,1,2021-07-12,Male,19,15-19,4
24,0,0,0,0,2021-07-19,Male,54,45-54,1
24,0,0,0,0,2021-07-12,Female,42,35-44,3
24,1,0,0,1,2021-07-13,Male,76,75-79,4
24,1,0,0,1,2021-07-09,Male,65,65-69,4
24,0,0,0,0,2021-07-18,Male,24,20-24,2
24,1,1,0,2,2021-07-10,Male,30,25-34,3
24,1,12,0,13,2021-07-13,Female,18,15-19,3
24,5,0,0,5,2021-07-15,Male,13,10-14,21
24,1,2,0,3,2021-07-13,Male,70,70-74,4
24,3,0,0,3,2021-07-12,Female,2,1-4,4
24,2,2,0,4,2021-07-11,Female,55,55-64,19
24,0,1,0,1,2021-07-19,Male,53,45-54,1
24,0,0,0,0,2021-07-12,Male,61,55-64,3
24,0,1,0,1,2021-07-11,Female,38,35-44,17
24,0,0,0,0,2021-07-12,Female,79,75-79,4
24,1,0,0,1,2021-07-09,Female,65,65-69,4
24,0,0,0,0,2021-07-13,Male,54,45-54,17
24,2,0,0,2,2021-07-14,Male,68,65-69,13
24,1,0,0,1,2021-07-13,Female,40,35-44,11
24,0,0,0,0,2021-07-11,Female,70,70-74,4
24,0,0,0,0,2021-07-10,Female,20,20-24,3
24,1,2,0,3,2021-07-10,Female,69,65-69,4
24,0,1,0,1,2021-07-12,Male,49,45-54,20
24,2,0,0,2,2021-07-12,Female,74,70-74,6
24,0,1,0,1,2021-07-13,Male,41,35-44,4
24,0,0,0,0,2021-07-12,Male,62,55-64,6
24,1,0,0,1,2021-07-10,Male,36,35-44,20
24,1,0,0,1,2021-07-12,Female,33,25-34,3
24,0,4,0,4,2021-07-11,Male,53,45-54,2
24,0,2,0,2,2021-07-09,Male,53,45-54,6
24,0,3,0,3,2021-07-19,Female,33,25-34,1
24,0,0,0,0,2021-07-12,Female,51,45-54,4
24,1,0,0,1,2021-07-09,Female,53,45-54,3
24,1,6,0,7,2021-07-13,Male,53,45-54,3
24,1,0,0,1,2021-07-09,Female,66,65-69,4
24,1,1,0,2,2021-07-13,Female,52,45-54,11
24,1,0,0,1,2021-07-13,Male,59,55-64,3
24,2,0,0,2,2021-07-10,Male,69,65-69,22
24,0,0,5,5,2021-07-07,Male,47,45-54,4
24,2,0,0,2,2021-07-12,Female,48,45-54,20
24,4,2,0,6,2021-07-15,Female,4,1-4,1
24,3,10,0,13,2021-07-09,Male,21,20-24,21
24,2,0,0,2,2021-07-11,Female,66,65-69,6
24,2,0,0,2,2021-07-12,Male,85,85+,18
24,1,1,0,2,2021-07-10,Male,56,55-64,4
24,1,0,0,1,2021-07-13,Female,32,25-34,12
24,2,0,0,2,2021-07-08,Male,11,10-14,15
24,1,0,0,1,2021-07-08,Male,67,65-69,4
24,1,0,0,1,2021-07-11,Female,71,70-74,12
24,2,0,0,2,2021-07-12,Female,21,20-24,13
24,0,0,0,0,2021-07-08,Male,48,45-54,17
24,2,4,0,6,2021-07-08,Female,67,65-69,18
24,0,0,0,0,2021-07-12,Male,51,45-54,24
24,0,0,0,0,2021-07-11,Male,0,<1,14
24,1,0,0,1,2021-07-14,Male,3,1-4,5
24,0,0,0,0,2021-07-13,Male,34,25-34,3
24,0,0,0,0,2021-07-07,Male,45,45-54,4
24,0,0,0,0,2021-07-15,Male,32,25-34,1
24,3,1,0,4,2021-07-08,Male,8,5-9,3
24,1,0,0,1,2021-07-07,Female,46,45-54,4
24,0,0,0,0,2021-07-14,Female,32,25-34,3
24,0,0,0,0,2021-07-07,Male,29,25-34,18
24,1,0,0,1,2021-07-15,Female,37,35-44,1
24,3,0,0,3,2021-07-12,Male,38,35-44,4
24,2,0,0,2,2021-07-07,Female,20,20-24,9
24,2,0,0,2,2021-07-12,Male,55,55-64,21
24,2,1,0,3,2021-07-12,Male,62,55-64,4
24,1,0,10,11,2021-07-15,Male,30,25-34,1
24,2,0,0,2,2021-07-12,Female,10,10-14,12
24,0,0,0,0,2021-07-12,Male,31,25-34,19
24,0,0,0,0,2021-07-15,Female,31,25-34,3
24,2,0,0,2,2021-07-09,Male,66,65-69,16
24,0,0,0,0,2021-07-07,Male,43,35-44,20
24,0,0,0,0,2021-07-13,Female,31,25-34,9
24,0,0,0,0,2021-07-09,Female,66,65-69,4
24,2,0,0,2,2021-07-13,Female,80,80-84,19
24,2,0,0,2,2021-07-08,Female,16,15-19,4
24,0,0,0,0,2021-07-19,Female,23,20-24,1
24,1,0,0,1,2021-07-11,Female,70,70-74,22
24,0,0,0,0,2021-07-07,Female,70,70-74,24
24,1,5,0,6,2021-07-11,Male,71,70-74,22
24,3,6,0,9,2021-07-09,Female,65,65-69,4
24,1,0,0,1,2021-07-14,Female,58,55-64,2
24,0,0,0,0,2021-07-12,Female,60,55-64,4
24,1,3,0,4,2021-07-08,Female,53,45-54,3
24,1,0,0,1,2021-07-15,Female,49,45-54,1
24,0,0,0,0,2021-07-12,Male,62,55-64,23
24,0,0,0,0,2021-07-15,Male,22,20-24,1
24,1,0,2,3,2021-07-11,Female,70,70-74,4
24,0,2,0,2,2021-07-12,Male,36,35-44,3
24,2,4,0,6,2021-07-12,Male,20,20-24,3
24,0,0,0,0,2021-07-10,Male,67,65-69,12
24,2,2,0,4,2021-07-08,Male,54,45-54,3
24,2,0,0,2,2021-07-10,Female,13,10-14,20
24,1,0,60,61,2021-07-14,Female,53,45-54,2
24,3,0,0,3,2021-07-13,Male,2,1-4,4
24,0,1,0,1,2021-07-18,Female,22,20-24,3
24,3,0,0,3,2021-07-12,Male,12,10-14,20
24,0,0,0,0,2021-07-12,Male,34,25-34,22
24,2,0,0,2,2021-07-11,Female,11,10-14,3
24,2,1,0,3,2021-07-09,Male,20,20-24,20
25,1,6,0,7,2021-08-07,Male,69,65-69,19
25,2,0,0,2,2021-08-06,Male,12,10-14,6
25,1,0,0,1,2021-08-07,Male,1,1-4,4
25,1,0,0,1,2021-08-06,Male,31,25-34,2
25,2,0,0,2,2021-08-06,Male,65,65-69,5
25,0,0,0,0,2021-08-08,Female,49,45-54,5
25,0,0,0,0,2021-08-11,Male,60,55-64,1
25,0,0,0,0,2021-08-04,Male,29,25-34,5
25,0,0,0,0,2021-08-12,Female,12,10-14,1
25,2,1,0,3,2021-08-07,Female,66,65-69,24
25,0,1,0,1,2021-08-09,Female,72,70-74,21
25,1,0,1,2,2021-08-11,Male,61,55-64,1
25,1,0,0,1,2021-08-05,Female,58,55-64,4
25,1,0,0,1,2021-08-09,Male,71,70-74,5
25,0,0,0,0,2021-08-11,Female,33,25-34,3
25,0,0,0,0,2021-08-09,Female,53,45-54,15
25,0,0,0,0,2021-08-04,Female,54,45-54,18
25,2,16,0,18,2021-08-11,Male,5,5-9,1
25,0,0,0,0,2021-08-10,Female,68,65-69,18
25,2,0,0,2,2021-08-05,Female,57,55-64,4
25,1,0,0,1,2021-08-07,Female,68,65-69,5
25,0,0,0,0,2021-08-09,Female,35,35-44,12
25,0,0,0,0,2021-08-06,Female,7,5-9,4
25,1,0,0,1,2021-08-05,Female,60,55-64,20
25,0,17,6,23,2021-08-13,Male,29,25-34,1
25,0,0,0,0,2021-08-04,Male,52,45-54,5
25,1,31,0,32,2021-08-06,Female,62,55-64,15
25,0,0,0,0,2021-08-10,Male,51,45-54,21
25,0,0,0,0,2021-08-07,Male,68,65-69,10
25,1,0,0,1,2021-08-09,Male,51,45-54,20
25,0,0,0,0,2021-08-06,Female,36,35-44,21
25,1,5,0,6,2021-08-11,Female,54,45-54,1
25,1,3,0,4,2021-08-11,Male,41,35-44,1
25,3,0,0,3,2021-08-05,Female,58,55-64,21
25,2,19,0,21,2021-08-11,Female,1,1-4,1
25,3,0,0,3,2021-08-09,Male,7,5-9,4
25,0,0,0,0,2021-08-06,Female,66,65-69,5
25,1,0,0,1,2021-08-10,Male,35,35-44,6
25,0,1,0,1,2021-08-08,Male,50,45-54,5
25,2,0,0,2,2021-08-10,Female,11,10-14,19
25,0,4,0,4,2021-08-07,Female,40,35-44,3
25,1,3,0,4,2021-08-11,Male,44,35-44,1
25,0,0,0,0,2021-08-09,Male,33,25-34,18
25,3,0,0,3,2021-08-05,Female,55,55-64,5
25,1,0,0,1,2021-08-09,Male,57,55-64,4
25,2,0,0,2,2021-08-11,Male,65,65-69,1
25,1,2,0,3,2021-08-07,Male,67,65-69,17
25,1,0,0,1,2021-08-09,Male,67,65-69,20
25,1,0,0,1,2021-08-10,Female,57,55-64,5
25,1,0,0,1,2021-08-06,Male,63,55-64,25
25,1,0,0,1,2021-08-08,Female,50,45-54,5
25,3,1,0,4,2021-08-11,Male,6,5-9,1
25,1,2,0,3,2021-08-06,Male,60,55-64,5
25,1,11,0,12,2021-08-06,Male,65,65-69,5
25,0,0,0,0,2021-08-09,Male,48,45-54,4
25,2,1,0,3,2021-08-05,Male,19,15-19,22
25,0,0,0,0,2021-08-10,Male,49,45-54,22
25,0,1,0,1,2021-08-08,Male,49,45-54,2
25,0,16,9,25,2021-08-08,Male,43,35-44,5
25,5,0,0,5,2021-08-04,Male,52,45-54,12
25,1,0,0,1,2021-08-09,Male,35,35-44,15
25,1,0,0,1,2021-08-09,Male,35,35-44,5
25,0,10,0,10,2021-08-04,Male,54,45-54,17
25,1,0,0,1,2021-08-08,Male,77,75-79,5
25,0,0,0,0,2021-08-09,Female,71,70-74,23
25,1,1,0,2,2021-08-07,Male,68,65-69,21
25,1,2,0,3,2021-08-04,Female,53,45-54,21
25,1,0,0,1,2021-08-11,Female,31,25-34,1
25,1,1,0,2,2021-08-07,Female,70,70-74,19
25,0,0,1,1,2021-08-11,Male,56,55-64,1
25,0,3,0,3,2021-08-08,Female,78,75-79,5
25,4,0,0,4,2021-08-04,Male,19,15-19,11
25,1,0,0,1,2021-08-12,Male,24,20-24,1
25,1,0,0,1,2021-08-09,Male,59,55-64,16
25,1,0,0,1,2021-08-05,Female,57,55-64,25
25,4,0,0,4,2021-08-09,Female,5,5-9,2
25,2,5,0,7,2021-08-11,Female,16,15-19,1
25,1,0,0,1,2021-08-04,Male,52,45-54,22
25,1,2,0,3,2021-08-09,Male,43,35-44,7
25,0,0,0,0,2021-08-09,Male,24,20-24,6
25,2,2,11,15,2021-08-05,Male,16,15-19,4
25,0,4,0,4,2021-08-05,Male,30,25-34,2
25,0,0,0,0,2021-08-07,Female,62,55-64,20
25,0,0,0,0,2021-08-11,Female,67,65-69,11
25,1,0,0,1,2021-08-11,Female,32,25-34,1
25,3,0,0,3,2021-08-10,Male,3,1-4,11
25,0,1,0,1,2021-08-05,Male,54,45-54,10
25,0,0,0,0,2021-08-11,Male,62,55-64,1
25,1,9,0,10,2021-08-11,Male,33,25-34,1
25,1,0,0,1,2021-08-06,Male,33,25-34,5
25,0,0,0,0,2021-08-08,Female,70,70-74,5
25,0,2,0,2,2021-08-11,Male,40,35-44,1
25,3,0,0,3,2021-08-04,Female,22,20-24,2
25,1,0,0,1,2021-08-07,Male,58,55-64,23
25,0,0,0,0,2021-08-07,Male,68,65-69,23
25,1,0,0,1,2021-08-11,Male,70,70-74,1
25,0,0,0,0,2021-08-06,Male,35,35-44,5
25,0,2,0,2,2021-08-10,Female,22,20-24,2
25,2,0,0,2,2021-08-07,Female,17,15-19,4
25,1,0,0,1,2021-08-08,Male,72,70-74,18
25,0,4,0,4,2021-08-09,Male,77,75-79,20
25,0,0,0,0,2021-08-04,Male,27,25-34,12
25,1,0,0,1,2021-08-09,Male,72,70-74,22
25,1,0,0,1,2021-08-07,Female,13,10-14,3
25,1,0,0,1,2021-08-07,Female,38,35-44,4
25,0,1,0,1,2021-08-09,Female,38,35-44,5
25,0,0,0,0,2021-08-09,Male,61,55-64,5
25,0,0,0,0,2021-08-04,Male,53,45-54,17
25,3,0,0,3,2021-08-04,Female,18,15-19,3
25,1,0,0,1,2021-08-08,Male,44,35-44,15
25,0,4,0,4,2021-08-08,Female,56,55-64,4
25,0,0,0,0,2021-08-11,Female,33,25-34,1
25,0,43,0,43,2021-08-08,Male,43,35-44,4
25,1,1,0,2,2021-08-07,Male,39,35-44,5
25,1,0,0,1,2021-08-09,Female,71,70-74,5
25,0,0,0,0,2021-08-05,Female,61,55-64,12
25,1,2,0,3,2021-08-07,Male,67,65-69,5
25,1,3,0,4,2021-08-07,Male,39,35-44,22
25,3,0,0,3,2021-08-10,Male,8,5-9,6
25,2,0,0,2,2021-08-11,Male,70,70-74,19
25,0,2,0,2,2021-08-08,Female,78,75-79,19
25,0,0,0,0,2021-08-06,Male,33,25-34,2
25,2,0,0,2,2021-08-09,Male,66,65-69,5
25,1,0,0,1,2021-08-07,Female,68,65-69,22
25,1,2,0,3,2021-08-07,Male,62,55-64,21
25,0,0,0,0,2021-08-11,Female,78,75-79,1
25,1,0,0,1,2021-08-11,Female,66,65-69,1
25,0,3,0,3,2021-08-11,Male,56,55-64,5
25,1,1,0,2,2021-08-11,Female,71,70-74,1
25,1,0,0,1,2021-08-05,Female,60,55-64,5
25,0,0,0,0,2021-08-08,Male,85,85+,19
25,2,0,0,2,2021-08-08,Female,72,70-74,20
25,0,0,0,0,2021-08-08,Male,73,70-74,5
25,1,0,0,1,2021-08-04,Female,22,20-24,11
25,1,0,0,1,2021-08-05,Female,28,25-34,5
25,0,0,0,0,2021-08-07,Female,36,35-44,4
25,2,2,0,4,2021-08-09,Male,55,55-64,24
25,0,0,0,0,2021-08-06,Male,32,25-34,10
25,1,1,0,2,2021-08-07,Male,71,70-74,22
25,2,0,0,2,2021-08-08,Female,69,65-69,21
25,1,0,0,1,2021-08-09,Male,67,65-69,15
25,1,52,0,53,2021-08-06,Female,66,65-69,24
25,3,1,0,4,2021-08-09,Male,11,10-14,16
25,2,0,0,2,2021-08-08,Male,67,65-69,23
25,1,0,0,1,2021-08-06,Male,65,65-69,5
25,2,2,0,4,2021-08-08,Female,2,1-4,6
25,0,3,0,3,2021-08-11,Female,36,35-44,1
25,0,0,0,0,2021-08-08,Male,69,65-69,15
25,0,0,0,0,2021-08-04,Female,54,45-54,5
25,4,0,0,4,2021-08-10,Female,14,10-14,14
25,1,0,0,1,2021-08-05,Male,57,55-64,2
25,0,0,0,0,2021-08-06,Male,32,25-34,5
25,2,0,0,2,2021-08-07,Male,70,70-74,15
25,1,0,0,1,2021-08-05,Female,58,55-64,5
25,0,0,0,0,2021-08-06,Male,32,25-34,4
25,1,0,0,1,2021-08-08,Female,72,70-74,3
25,1,0,0,1,2021-08-13,Female,22,20-24,1
25,0,0,0,0,2021-08-08,Female,24,20-24,15
25,0,0,0,0,2021-08-08,Male,43,35-44,21
25,1,0,0,1,2021-08-11,Male,39,35-44,1
25,3,0,0,3,2021-08-06,Female,6,5-9,19
25,1,0,0,1,2021-08-11,Female,39,35-44,1
25,2,1,0,3,2021-08-04,Female,14,10-14,5
25,0,0,0,0,2021-08-09,Female,75,75-79,5
25,1,0,0,1,2021-08-07,Male,69,65-69,4
25,0,0,0,0,2021-08-09,Male,71,70-74,20
25,1,7,0,8,2021-08-07,Male,70,70-74,25
25,0,0,0,0,2021-08-07,Female,4,1-4,18
25,0,0,0,0,2021-08-09,Female,28,25-34,4
25,2,0,0,2,2021-08-08,Female,60,55-64,23
25,0,2,0,2,2021-08-05,Female,53,45-54,22
25,0,0,0,0,2021-08-08,Male,49,45-54,23
25,1,2,0,3,2021-08-06,Female,65,65-69,2
25,1,0,0,1,2021-08-11,Male,43,35-44,1
25,1,10,0,11,2021-08-09,Male,60,55-64,5
25,1,0,0,1,2021-08-06,Female,61,55-64,6
25,0,1,0,1,2021-08-11,Female,27,25-34,1
25,2,1,0,3,2021-08-06,Male,63,55-64,5
25,1,0,0,1,2021-08-11,Female,66,65-69,3
25,2,0,0,2,2021-08-07,Male,34,25-34,4
25,1,1,0,2,2021-08-10,Female,28,25-34,11
25,1,2,0,3,2021-08-10,Female,31,25-34,24
25,1,0,0,1,2021-08-05,Female,60,55-64,4
25,4,4,0,8,2021-08-11,Male,12,10-14,1
25,2,0,0,2,2021-08-13,Female,23,20-24,1
25,1,0,0,1,2021-08-04,Male,52,45-54,5
25,1,0,0,1,2021-08-05,Male,17,15-19,15
25,1,0,0,1,2021-08-09,Female,63,55-64,22
25,1,10,0,11,2021-08-11,Female,30,25-34,1
25,0,0,0,0,2021-08-10,Male,18,15-19,13
25,1,2,0,3,2021-08-05,Male,55,55-64,2
25,2,1,0,3,2021-08-05,Female,27,25-34,5
25,0,0,0,0,2021-08-10,Male,69,65-69,14
25,0,1,0,1,2021-08-07,Male,55,55-64,22
25,2,0,0,2,2021-08-06,Male,30,25-34,14
25,1,0,0,1,2021-08-05,Male,58,55-64,19
25,0,0,0,0,2021-08-09,Female,74,70-74,17
25,0,0,0,0,2021-08-06,Male,32,25-34,24
25,0,0,0,0,2021-08-07,Male,66,65-69,18
25,1,2,0,3,2021-08-07,Male,68,65-69,5
25,2,0,0,2,2021-08-06,Female,0,<1,5
25,2,0,0,2,2021-08-08,Female,46,45-54,8
25,0,0,0,0,2021-08-06,Female,31,25-34,5
25,1,0,0,1,2021-08-08,Female,44,35-44,5
25,0,0,0,0,2021-08-05,Female,31,25-34,19
25,2,0,0,2,2021-08-08,Female,67,65-69,10
25,0,0,0,0,2021-08-09,Male,47,45-54,5
25,0,0,0,0,2021-08-07,Male,38,35-44,19
25,1,0,0,1,2021-08-07,Female,68,65-69,5
25,1,1,0,2,2021-08-07,Female,63,55-64,18
25,1,0,0,1,2021-08-04,Female,23,20-24,12
25,1,2,0,3,2021-08-07,Male,66,65-69,20
25,0,0,0,0,2021-08-07,Male,64,55-64,22
25,1,0,0,1,2021-08-11,Male,34,25-34,2
25,0,2,0,2,2021-08-08,Male,69,65-69,20
25,1,0,0,1,2021-08-09,Female,68,65-69,14
25,1,0,0,1,2021-08-05,Male,59,55-64,24
25,1,0,0,1,2021-08-09,Male,65,65-69,3
25,0,0,0,0,2021-08-06,Female,63,55-64,21
25,0,1,0,1,2021-08-06,Male,34,25-34,2
25,1,0,0,1,2021-08-06,Male,61,55-64,5
25,1,0,0,1,2021-08-10,Female,30,25-34,4
25,1,0,0,1,2021-08-09,Male,54,45-54,4
25,3,0,0,3,2021-08-09,Male,33,25-34,15
25,0,0,0,0,2021-08-04,Female,54,45-54,9
25,2,0,0,2,2021-08-07,Male,70,70-74,16
25,0,0,0,0,2021-08-09,Male,25,25-34,16
25,1,0,0,1,2021-08-09,Male,55,55-64,5
25,1,0,0,1,2021-08-07,Male,66,65-69,23
25,0,31,0,31,2021-08-11,Male,53,45-54,1
25,2,0,0,2,2021-08-09,Female,60,55-64,4
25,2,0,0,2,2021-08-11,Female,53,45-54,1
25,3,0,0,3,2021-08-04,Female,21,20-24,5
25,0,6,0,6,2021-08-08,Male,39,35-44,5
25,0,0,0,0,2021-08-09,Male,32,25-34,4
25,3,0,0,3,2021-08-11,Male,0,<1,4
25,0,0,0,0,2021-08-07,Male,42,35-44,6
25,1,1,0,2,2021-08-04,Female,54,45-54,5
25,0,0,0,0,2021-08-10,Female,69,65-69,4
25,1,0,0,1,2021-08-07,Female,25,25-34,7
25,1,0,0,1,2021-08-09,Male,52,45-54,4
25,1,1,0,2,2021-08-08,Male,43,35-44,2
25,1,0,0,1,2021-08-09,Female,80,80-84,20
25,1,0,0,1,2021-08-08,Male,57,55-64,18
25,1,0,0,1,2021-08-05,Female,29,25-34,21
25,1,0,0,1,2021-08-04,Male,52,45-54,8
25,1,7,0,8,2021-08-08,Female,67,65-69,18
25,0,0,0,0,2021-08-08,Male,24,20-24,9
25,1,0,0,1,2021-08-06,Female,64,55-64,5
25,0,0,0,0,2021-08-08,Female,51,45-54,8
25,0,1,0,1,2021-08-08,Female,74,70-74,3
25,1,0,0,1,2021-08-04,Male,53,45-54,19
25,0,0,0,0,2021-08-05,Male,53,45-54,15
25,0,5,5,10,2021-08-08,Female,81,80-84,5
25,0,0,0,0,2021-08-04,Male,27,25-34,5
25,0,11,0,11,2021-08-11,Female,26,25-34,1
25,1,0,0,1,2021-08-08,Male,71,70-74,22
25,1,4,0,5,2021-08-07,Female,69,65-69,25
25,0,0,0,0,2021-08-04,Female,53,45-54,23
25,1,0,0,1,2021-08-06,Male,34,25-34,4
25,1,0,0,1,2021-08-10,Male,29,25-34,20
25,3,0,0,3,2021-08-09,Female,56,55-64,3
25,0,0,0,0,2021-08-11,Male,49,45-54,1
25,1,0,0,1,2021-08-06,Male,31,25-34,4
25,3,4,0,7,2021-08-09,Male,5,5-9,20
25,1,0,0,1,2021-08-04,Male,54,45-54,5
25,0,0,0,0,2021-08-06,Female,33,25-34,10
25,3,2,0,5,2021-08-07,Male,66,65-69,21
25,1,0,0,1,2021-08-11,Male,15,15-19,1
25,1,3,0,4,2021-08-06,Male,64,55-64,4
25,0,0,0,0,2021-08-09,Female,28,25-34,3
25,0,0,0,0,2021-08-08,Male,72,70-74,5
25,0,0,0,0,2021-08-07,Female,67,65-69,23
25,1,0,0,1,2021-08-09,Female,42,35-44,15
25,1,0,0,1,2021-08-09,Female,61,55-64,21
25,1,0,0,1,2021-08-09,Male,63,55-64,5
25,0,0,0,0,2021-08-09,Female,67,65-69,12
25,1,0,0,1,2021-08-09,Male,44,35-44,5
25,0,1,0,1,2021-08-10,Female,72,70-74,20
25,1,0,0,1,2021-08-09,Male,75,75-79,23
25,1,2,0,3,2021-08-07,Female,68,65-69,5
25,0,3,0,3,2021-08-05,Male,59,55-64,4
25,2,0,0,2,2021-08-09,Female,65,65-69,15
25,0,0,0,0,2021-08-08,Male,51,45-54,18
25,1,1,0,2,2021-08-06,Female,32,25-34,20
25,0,0,0,0,2021-08-07,Male,39,35-44,12
25,1,0,0,1,2021-08-10,Female,65,65-69,5
25,0,0,0,0,2021-08-05,Female,57,55-64,4
25,0,6,0,6,2021-08-09,Male,51,45-54,4
25,1,0,0,1,2021-08-11,Male,77,75-79,1
25,2,0,0,2,2021-08-08,Male,11,10-14,4
25,0,0,0,0,2021-08-04,Male,54,45-54,21
25,2,0,0,2,2021-08-11,Male,52,45-54,1
25,1,1,0,2,2021-08-09,Female,72,70-74,3
25,0,0,0,0,2021-08-06,Female,65,65-69,7
25,0,0,0,0,2021-08-05,Female,25,25-34,9
25,4,0,0,4,2021-08-06,Female,0,<1,2
25,2,0,0,2,2021-08-08,Male,69,65-69,7
25,1,0,0,1,2021-08-08,Female,50,45-54,20
25,0,0,0,0,2021-08-11,Female,34,25-34,1
25,1,0,0,1,2021-08-11,Male,71,70-74,1
25,1,0,2,3,2021-08-11,Female,37,35-44,1
25,0,3,0,3,2021-08-11,Female,54,45-54,1
25,0,0,0,0,2021-08-11,Female,24,20-24,1
25,0,0,0,0,2021-08-07,Male,11,10-14,18
25,1,3,0,4,2021-08-08,Male,16,15-19,21
25,0,0,0,0,2021-08-11,Female,48,45-54,1
25,0,1,0,1,2021-08-09,Male,65,65-69,19
25,1,3,0,4,2021-08-07,Male,69,65-69,22
25,0,0,0,0,2021-08-11,Male,23,20-24,5
25,1,0,0,1,2021-08-09,Female,58,55-64,22
25,0,0,0,0,2021-08-11,Male,14,10-14,1
25,0,0,0,0,2021-08-07,Male,34,25-34,4
25,0,1,0,1,2021-08-11,Male,69,65-69,1
25,0,5,0,5,2021-08-09,Female,50,45-54,2
25,0,0,0,0,2021-08-11,Female,54,45-54,1
25,0,0,0,0,2021-08-08,Male,12,10-14,2
25,0,0,0,0,2021-08-11,Male,52,45-54,1
25,2,4,0,6,2021-08-07,Female,2,1-4,4
25,1,3,0,4,2021-08-11,Female,53,45-54,1
25,0,0,0,0,2021-08-08,Male,51,45-54,21
25,2,3,0,5,2021-08-05,Male,15,15-19,5
25,0,0,0,0,2021-08-04,Male,10,10-14,21
25,2,0,0,2,2021-08-11,Female,0,<1,1
25,2,2,0,4,2021-08-11,Male,0,<1,1
25,0,0,0,0,2021-08-09,Male,71,70-74,23
25,1,0,0,1,2021-08-05,Female,54,45-54,5
25,2,15,0,17,2021-08-09,Female,58,55-64,4
25,2,1,0,3,2021-08-07,Female,70,70-74,25
25,0,0,0,0,2021-08-08,Male,39,35-44,19
25,3,0,0,3,2021-08-04,Male,20,20-24,14
25,0,1,0,1,2021-08-07,Female,6,5-9,16
25,0,0,0,0,2021-08-05,Male,29,25-34,2
25,0,0,0,0,2021-08-10,Male,22,20-24,12
25,2,1,0,3,2021-08-09,Female,73,70-74,18
25,0,2,0,2,2021-08-09,Male,52,45-54,19
25,1,0,0,1,2021-08-05,Female,60,55-64,25
25,2,0,0,2,2021-08-09,Male,63,55-64,12
25,2,0,0,2,2021-08-06,Female,63,55-64,19
25,0,0,0,0,2021-08-10,Male,34,25-34,4
25,1,0,0,1,2021-08-10,Female,24,20-24,9
25,1,0,0,1,2021-08-05,Female,55,55-64,4
25,2,0,0,2,2021-08-08,Male,74,70-74,21
25,3,0,0,3,2021-08-11,Male,4,1-4,1
25,2,2,0,4,2021-08-04,Female,53,45-54,23
25,0,0,0,0,2021-08-08,Male,43,35-44,4
25,0,1,0,1,2021-08-07,Male,69,65-69,20
25,0,0,0,0,2021-08-06,Male,34,25-34,24
25,3,0,0,3,2021-08-11,Female,17,15-19,1
25,0,0,0,0,2021-08-09,Male,48,45-54,19
25,3,0,0,3,2021-08-07,Male,70,70-74,20
25,0,0,0,0,2021-08-11,Female,48,45-54,1
25,2,3,0,5,2021-08-05,Male,55,55-64,5
25,2,0,0,2,2021-08-06,Male,16,15-19,5
25,2,1,0,3,2021-08-07,Male,68,65-69,23
25,1,0,0,1,2021-08-10,Female,22,20-24,5
25,2,0,0,2,2021-08-11,Male,39,35-44,1
25,1,0,0,1,2021-08-07,Female,4,1-4,5
25,0,1,0,1,2021-08-10,Female,18,15-19,9
25,1,1,0,2,2021-08-11,Male,63,55-64,1
25,3,0,0,3,2021-08-11,Male,10,10-14,1
25,0,0,0,0,2021-08-11,Female,37,35-44,1
25,0,0,0,0,2021-08-05,Male,28,25-34,5
25,0,0,0,0,2021-08-05,Female,57,55-64,23
25,0,0,0,0,2021-08-05,Female,59,55-64,20
25,0,0,0,0,2021-08-07,Female,67,65-69,21
25,1,0,0,1,2021-08-08,Female,73,70-74,3
25,2,6,0,8,2021-08-11,Female,27,25-34,1
25,0,0,0,0,2021-08-07,Male,54,45-54,5
25,1,2,0,3,2021-08-11,Female,45,45-54,1
25,0,1,0,1,2021-08-08,Female,76,75-79,5
25,0,0,0,0,2021-08-13,Male,21,20-24,3
25,1,4,0,5,2021-08-09,Female,56,55-64,5
25,0,0,0,0,2021-08-08,Male,45,45-54,16
25,0,3,0,3,2021-08-06,Female,64,55-64,19
25,0,3,0,3,2021-08-07,Male,70,70-74,5
25,1,0,0,1,2021-08-05,Male,29,25-34,5
25,1,2,0,3,2021-08-06,Female,61,55-64,25
25,0,0,0,0,2021-08-11,Male,23,20-24,1
25,1,0,0,1,2021-08-06,Male,61,55-64,10
25,2,0,0,2,2021-08-09,Male,49,45-54,20
25,0,0,0,0,2021-08-12,Female,22,20-24,1
25,2,0,0,2,2021-08-11,Female,3,1-4,1
25,1,0,0,1,2021-08-10,Female,54,45-54,25
25,1,100,0,101,2021-08-11,Female,22,20-24,1
25,0,0,0,0,2021-08-05,Male,56,55-64,20
25,0,0,0,0,2021-08-06,Female,66,65-69,24
25,1,0,0,1,2021-08-11,Male,54,45-54,1
25,4,0,0,4,2021-08-08,Male,6,5-9,18
25,2,0,0,2,2021-08-13,Male,18,15-19,1
25,1,0,0,1,2021-08-08,Male,80,80-84,19
25,0,2,0,2,2021-08-07,Female,67,65-69,19
25,2,0,0,2,2021-08-08,Female,15,15-19,18
25,1,0,0,1,2021-08-05,Female,56,55-64,21
25,0,0,0,0,2021-08-08,Female,71,70-74,8
25,2,0,0,2,2021-08-11,Male,21,20-24,1
25,1,3,0,4,2021-08-07,Female,71,70-74,5
25,0,0,0,0,2021-08-13,Female,18,15-19,1
25,0,2,0,2,2021-08-11,Female,42,35-44,1
25,0,3,0,3,2021-08-08,Male,37,35-44,25
25,1,1,0,2,2021-08-11,Female,23,20-24,1
25,0,0,0,0,2021-08-11,Female,61,55-64,1
25,1,1,0,2,2021-08-11,Female,69,65-69,1
25,1,3,0,4,2021-08-07,Male,41,35-44,25
25,1,0,0,1,2021-08-11,Female,32,25-34,1
25,2,3,0,5,2021-08-11,Female,54,45-54,1
25,1,1,0,2,2021-08-06,Male,66,65-69,5
25,0,3,0,3,2021-08-11,Male,41,35-44,1
25,2,0,0,2,2021-08-06,Male,62,55-64,24
25,0,0,0,0,2021-08-12,Female,21,20-24,1
25,1,3,0,4,2021-08-11,Female,23,20-24,1
25,0,2,0,2,2021-08-07,Female,70,70-74,15
25,1,1,0,2,2021-08-07,Male,69,65-69,15
25,1,3,0,4,2021-08-11,Female,28,25-34,1
25,1,0,0,1,2021-08-06,Female,34,25-34,18
25,0,0,0,0,2021-08-07,Male,69,65-69,23
25,0,2,0,2,2021-08-05,Male,29,25-34,21
25,0,3,0,3,2021-08-13,Male,23,20-24,1
25,1,0,0,1,2021-08-04,Male,12,10-14,5
25,0,0,0,0,2021-08-05,Female,54,45-54,21
25,1,0,0,1,2021-08-08,Male,43,35-44,5
25,2,1,0,3,2021-08-09,Male,5,5-9,19
25,0,0,0,0,2021-08-05,Male,31,25-34,12
25,2,2,0,4,2021-08-10,Female,11,10-14,4
25,0,0,0,0,2021-08-09,Male,51,45-54,4
25,0,13,0,13,2021-08-11,Male,34,25-34,1
25,1,0,0,1,2021-08-11,Female,69,65-69,1
25,1,0,0,1,2021-08-11,Male,71,70-74,1
25,0,1,0,1,2021-08-09,Male,47,45-54,19
25,0,0,0,0,2021-08-07,Male,42,35-44,3
25,2,0,0,2,2021-08-07,Female,1,1-4,4
25,1,6,0,7,2021-08-05,Male,53,45-54,22
25,0,1,0,1,2021-08-08,Female,71,70-74,15
25,0,10,0,10,2021-08-09,Male,33,25-34,19
25,3,0,0,3,2021-08-07,Male,70,70-74,20
25,1,0,0,1,2021-08-07,Female,69,65-69,18
25,3,0,0,3,2021-08-06,Male,16,15-19,22
25,2,0,0,2,2021-08-13,Male,39,35-44,1
25,2,0,0,2,2021-08-06,Male,65,65-69,21
25,0,0,0,0,2021-08-08,Male,50,45-54,22
25,1,0,0,1,2021-08-10,Male,66,65-69,4
25,1,0,0,1,2021-08-08,Male,66,65-69,16
25,1,2,0,3,2021-08-07,Female,67,65-69,15
25,0,0,0,0,2021-08-11,Female,30,25-34,1
25,1,0,0,1,2021-08-10,Male,22,20-24,3
25,1,0,0,1,2021-08-07,Female,66,65-69,14
25,1,0,0,1,2021-08-11,Male,21,20-24,1
25,0,1,0,1,2021-08-08,Male,48,45-54,5
25,1,0,0,1,2021-08-11,Male,0,<1,1
25,0,0,0,0,2021-08-07,Male,67,65-69,23
25,0,0,0,0,2021-08-07,Male,65,65-69,23
25,0,0,0,0,2021-08-05,Female,31,25-34,5
25,1,0,0,1,2021-08-07,Male,34,25-34,4
25,1,0,0,1,2021-08-07,Male,68,65-69,23
25,0,5,2,7,2021-08-11,Female,22,20-24,1
25,0,0,0,0,2021-08-09,Male,41,35-44,17
25,1,0,0,1,2021-08-09,Male,75,75-79,15
25,3,1,0,4,2021-08-09,Male,18,15-19,4
25,1,0,0,1,2021-08-08,Male,45,45-54,5
25,1,1,0,2,2021-08-11,Male,68,65-69,1
25,0,0,0,0,2021-08-08,Female,49,45-54,5
25,2,0,0,2,2021-08-08,Female,8,5-9,5
25,1,1,0,2,2021-08-08,Female,45,45-54,15
25,0,0,0,0,2021-08-09,Female,72,70-74,5
25,1,0,0,1,2021-08-05,Male,57,55-64,5
25,1,2,0,3,2021-08-10,Female,57,55-64,4
25,0,0,0,0,2021-08-05,Male,53,45-54,10
25,2,0,0,2,2021-08-08,Male,71,70-74,17
25,0,1,0,1,2021-08-05,Female,54,45-54,5
25,1,2,0,3,2021-08-08,Male,19,15-19,5
25,2,2,0,4,2021-08-11,Male,8,5-9,1
25,0,0,0,0,2021-08-08,Male,65,65-69,5
25,0,1,0,1,2021-08-04,Male,52,45-54,2
25,1,0,0,1,2021-08-05,Male,55,55-64,5
25,2,1,0,3,2021-08-07,Female,8,5-9,2
25,0,0,0,0,2021-08-04,Female,52,45-54,23
25,1,0,12,13,2021-08-12,Male,15,15-19,1
25,0,0,0,0,2021-08-06,Female,60,55-64,19
25,1,4,0,5,2021-08-07,Female,67,65-69,5
25,2,32,6,40,2021-08-11,Male,42,35-44,1
25,1,0,9,10,2021-08-09,Male,26,25-34,5
25,0,1,0,1,2021-08-08,Male,48,45-54,13
25,0,5,0,5,2021-08-05,Male,56,55-64,5
25,0,0,0,0,2021-08-09,Male,73,70-74,3
25,1,1,0,2,2021-08-08,Male,82,80-84,22
25,2,0,0,2,2021-08-09,Female,40,35-44,2
25,1,0,1,2,2021-08-08,Female,71,70-74,4
25,2,0,0,2,2021-08-04,Female,5,5-9,15
25,0,0,0,0,2021-08-06,Female,59,55-64,16
25,1,0,0,1,2021-08-05,Male,59,55-64,5
25,0,0,0,0,2021-08-09,Female,51,45-54,11
25,0,0,0,0,2021-08-08,Male,49,45-54,19
25,1,0,0,1,2021-08-08,Male,44,35-44,6
25,1,0,0,1,2021-08-13,Female,43,35-44,1
25,0,1,0,1,2021-08-04,Female,18,15-19,5
25,0,1,0,1,2021-08-04,Male,25,25-34,22
25,0,0,0,0,2021-08-09,Male,22,20-24,17
25,0,1,0,1,2021-08-10,Female,44,35-44,4
25,2,0,0,2,2021-08-08,Male,72,70-74,23
25,0,0,0,0,2021-08-07,Male,35,35-44,24
25,3,0,0,3,2021-08-10,Female,22,20-24,11
25,2,0,0,2,2021-08-09,Female,35,35-44,16
25,3,1,0,4,2021-08-08,Male,15,15-19,3
25,0,0,0,0,2021-08-07,Male,38,35-44,2
25,1,0,0,1,2021-08-08,Male,72,70-74,5
25,1,0,0,1,2021-08-09,Male,29,25-34,5
25,0,0,0,0,2021-08-08,Female,67,65-69,19
25,3,0,0,3,2021-08-04,Male,24,20-24,20
25,1,0,1,2,2021-08-09,Female,9,5-9,18
25,0,1,0,1,2021-08-13,Male,63,55-64,1
25,1,0,0,1,2021-08-07,Female,68,65-69,17
25,0,0,0,0,2021-08-07,Male,68,65-69,22
25,1,0,0,1,2021-08-09,Male,43,35-44,2
25,1,1,3,5,2021-08-08,Male,64,55-64,4
25,2,0,0,2,2021-08-08,Female,0,<1,4
25,2,0,0,2,2021-08-07,Male,42,35-44,25
25,0,2,0,2,2021-08-11,Female,42,35-44,1
25,0,0,0,0,2021-08-08,Male,71,70-74,17
25,2,0,0,2,2021-08-07,Female,39,35-44,5
25,0,1,0,1,2021-08-05,Male,59,55-64,5
25,0,2,0,2,2021-08-11,Male,39,35-44,1
25,1,0,0,1,2021-08-04,Female,54,45-54,4
25,0,0,0,0,2021-08-04,Male,53,45-54,5
25,2,0,0,2,2021-08-08,Male,14,10-14,11
25,2,0,0,2,2021-08-08,Male,55,55-64,20
25,2,5,16,23,2021-08-07,Male,69,65-69,6
25,2,0,0,2,2021-08-11,Female,17,15-19,1
25,0,0,0,0,2021-08-09,Male,79,75-79,4
25,1,4,0,5,2021-08-06,Female,65,65-69,5
25,0,0,0,0,2021-08-08,Female,69,65-69,18
25,2,0,0,2,2021-08-06,Male,65,65-69,17
25,1,0,0,1,2021-08-07,Male,64,55-64,18
25,0,3,0,3,2021-08-07,Female,67,65-69,22
25,2,0,0,2,2021-08-04,Female,26,25-34,15
25,1,0,0,1,2021-08-09,Male,68,65-69,5
25,0,1,0,1,2021-08-07,Female,69,65-69,22
25,0,0,0,0,2021-08-09,Female,33,25-34,8
25,0,3,0,3,2021-08-05,Female,29,25-34,12
25,1,0,0,1,2021-08-06,Male,32,25-34,7
25,0,0,0,0,2021-08-11,Female,4,1-4,1
25,0,4,0,4,2021-08-10,Male,54,45-54,4
25,0,0,0,0,2021-08-07,Female,67,65-69,18
25,2,0,0,2,2021-08-11,Female,2,1-4,1
25,0,1,0,1,2021-08-06,Female,64,55-64,20
25,2,0,0,2,2021-08-11,Female,0,<1,1
25,1,0,0,1,2021-08-11,Male,58,55-64,1
25,1,0,0,1,2021-08-05,Male,59,55-64,5
25,0,0,0,0,2021-08-05,Male,29,25-34,2
25,2,0,0,2,2021-08-09,Female,18,15-19,17
25,2,0,0,2,2021-08-07,Male,4,1-4,5
25,0,0,0,0,2021-08-11,Male,56,55-64,1
25,1,0,0,1,2021-08-08,Male,68,65-69,4
25,0,0,0,0,2021-08-09,Male,54,45-54,5
25,0,0,0,0,2021-08-09,Female,72,70-74,16
25,1,0,0,1,2021-08-07,Female,38,35-44,5
25,0,2,0,2,2021-08-11,Female,51,45-54,3
25,2,0,0,2,2021-08-12,Female,18,15-19,1
25,1,0,0,1,2021-08-11,Female,27,25-34,1
25,3,0,0,3,2021-08-04,Female,53,45-54,20
25,0,0,0,0,2021-08-11,Male,27,25-34,1
25,2,0,0,2,2021-08-07,Male,62,55-64,20
25,2,0,0,2,2021-08-09,Female,67,65-69,17
25,2,0,0,2,2021-08-08,Female,79,75-79,19
25,3,5,0,8,2021-08-05,Female,18,15-19,2
25,1,0,0,1,2021-08-05,Male,57,55-64,4
25,0,0,0,0,2021-08-08,Female,71,70-74,5
25,2,0,0,2,2021-08-08,Male,66,65-69,5
25,0,1,0,1,2021-08-05,Male,58,55-64,4
25,0,5,0,5,2021-08-06,Male,66,65-69,24
25,1,0,0,1,2021-08-10,Male,65,65-69,5
25,0,0,0,0,2021-08-09,Male,42,35-44,15
25,1,6,0,7,2021-08-08,Female,70,70-74,21
25,0,0,0,0,2021-08-08,Female,76,75-79,23
25,1,0,0,1,2021-08-13,Male,34,25-34,4
25,2,1,0,3,2021-08-08,Female,18,15-19,5
25,2,0,0,2,2021-08-09,Male,37,35-44,20
25,1,0,0,1,2021-08-06,Female,65,65-69,4
25,1,0,0,1,2021-08-08,Female,49,45-54,20
25,1,3,0,4,2021-08-06,Male,62,55-64,19
25,1,0,0,1,2021-08-07,Female,66,65-69,5
25,1,8,0,9,2021-08-05,Male,53,45-54,2
25,1,0,0,1,2021-08-10,Male,55,55-64,5
25,1,2,0,3,2021-08-11,Female,39,35-44,1
25,6,0,0,6,2021-08-08,Female,4,1-4,3
25,1,0,0,1,2021-08-09,Male,69,65-69,22
25,3,0,0,3,2021-08-12,Male,21,20-24,1
25,2,0,0,2,2021-08-05,Male,57,55-64,15
25,1,0,0,1,2021-08-06,Female,62,55-64,5
25,0,1,0,1,2021-08-09,Male,63,55-64,20
25,0,0,0,0,2021-08-06,Male,61,55-64,5
25,0,1,0,1,2021-08-07,Female,66,65-69,17
25,0,0,0,0,2021-08-11,Male,38,35-44,1
25,0,0,0,0,2021-08-09,Female,33,25-34,15
25,2,0,0,2,2021-08-08,Male,18,15-19,5
25,1,0,0,1,2021-08-04,Male,52,45-54,5
25,1,0,0,1,2021-08-08,Female,61,55-64,20
25,0,1,0,1,2021-08-09,Male,52,45-54,20
25,1,0,0,1,2021-08-10,Female,60,55-64,4
25,0,7,1,8,2021-08-08,Female,63,55-64,5
25,0,0,0,0,2021-08-08,Male,47,45-54,3
25,0,0,0,0,2021-08-05,Male,18,15-19,5
25,0,0,0,0,2021-08-13,Male,42,35-44,1
25,0,0,0,0,2021-08-08,Male,74,70-74,23
25,3,3,0,6,2021-08-12,Female,18,15-19,1
25,0,8,0,8,2021-08-07,Female,67,65-69,4
25,1,0,0,1,2021-08-04,Male,52,45-54,5
25,3,1,0,4,2021-08-08,Female,10,10-14,22
25,1,4,0,5,2021-08-09,Female,70,70-74,21
25,0,2,0,2,2021-08-08,Female,81,80-84,11
25,1,0,0,1,2021-08-05,Female,14,10-14,21
25,0,0,10,10,2021-08-11,Male,31,25-34,1
25,1,0,0,1,2021-08-08,Male,77,75-79,5
25,1,0,2,3,2021-08-07,Female,40,35-44,4
25,0,1,0,1,2021-08-06,Female,66,65-69,20
25,1,0,1,2,2021-08-07,Female,27,25-34,22
25,1,0,0,1,2021-08-10,Female,63,55-64,4
25,0,0,0,0,2021-08-11,Female,66,65-69,1
25,2,1,1,4,2021-08-08,Male,76,75-79,23
25,1,2,0,3,2021-08-07,Male,68,65-69,5
25,0,0,0,0,2021-08-06,Male,64,55-64,5
25,0,1,0,1,2021-08-05,Female,30,25-34,7
25,0,0,0,0,2021-08-04,Male,25,25-34,4
25,1,1,0,2,2021-08-09,Male,74,70-74,20
25,1,0,0,1,2021-08-04,Female,25,25-34,23
25,1,0,0,1,2021-08-11,Male,36,35-44,1
25,1,0,0,1,2021-08-07,Female,23,20-24,13
25,0,0,0,0,2021-08-09,Female,65,65-69,2
25,1,1,0,2,2021-08-06,Male,64,55-64,22
25,1,0,0,1,2021-08-11,Male,70,70-74,1
25,0,0,0,0,2021-08-09,Female,30,25-34,3
25,3,0,0,3,2021-08-09,Male,18,15-19,19
25,0,0,0,0,2021-08-08,Male,51,45-54,5
25,0,0,0,0,2021-08-04,Male,54,45-54,5
25,2,0,0,2,2021-08-05,Male,55,55-64,24
25,1,2,0,3,2021-08-09,Male,36,35-44,5
25,1,1,0,2,2021-08-07,Male,68,65-69,3
25,0,0,0,0,2021-08-11,Female,31,25-34,1
25,0,5,0,5,2021-08-06,Female,66,65-69,10
25,1,0,0,1,2021-08-08,Male,73,70-74,18
25,2,0,0,2,2021-08-08,Male,73,70-74,18
25,0,0,2,2,2021-08-07,Male,34,25-34,2
25,1,0,0,1,2021-08-05,Female,53,45-54,23
25,0,0,0,0,2021-08-07,Male,19,15-19,17
25,0,1,0,1,2021-08-09,Female,49,45-54,5
25,1,0,0,1,2021-08-08,Female,72,70-74,5
25,2,0,0,2,2021-08-12,Female,22,20-24,1
25,0,3,0,3,2021-08-05,Male,52,45-54,2
25,0,1,0,1,2021-08-10,Female,72,70-74,20
25,0,0,0,0,2021-08-06,Female,28,25-34,5
25,0,0,0,0,2021-08-06,Male,30,25-34,22
25,0,3,0,3,2021-08-06,Female,57,55-64,24
25,0,0,0,0,2021-08-07,Male,68,65-69,19
25,0,10,0,10,2021-08-07,Female,67,65-69,3
25,0,0,0,0,2021-08-04,Male,52,45-54,21
25,2,1,0,3,2021-08-08,Female,48,45-54,4
25,0,0,0,0,2021-08-09,Male,27,25-34,4
25,0,1,0,1,2021-08-08,Female,51,45-54,4
25,2,0,0,2,2021-08-07,Male,67,65-69,24
25,2,0,0,2,2021-08-10,Male,8,5-9,5
25,3,15,22,40,2021-08-11,Female,8,5-9,1
25,1,0,0,1,2021-08-09,Female,51,45-54,4
25,1,0,4,5,2021-08-06,Male,30,25-34,4
25,1,1,0,2,2021-08-10,Female,70,70-74,10
25,0,1,0,1,2021-08-08,Male,46,45-54,22
25,1,0,0,1,2021-08-07,Female,42,35-44,5
25,1,0,0,1,2021-08-10,Male,57,55-64,5
25,2,0,0,2,2021-08-07,Female,69,65-69,20
25,1,0,0,1,2021-08-09,Male,46,45-54,4
25,1,8,0,9,2021-08-08,Male,50,45-54,6
25,2,2,0,4,2021-08-07,Male,37,35-44,6
25,1,0,0,1,2021-08-06,Male,55,55-64,17
25,1,1,0,2,2021-08-09,Female,48,45-54,18
25,0,3,0,3,2021-08-07,Female,42,35-44,12
25,1,0,0,1,2021-08-06,Male,64,55-64,22
25,0,0,0,0,2021-08-09,Female,53,45-54,7
25,1,2,0,3,2021-08-06,Male,67,65-69,22
25,1,0,0,1,2021-08-11,Female,32,25-34,1
25,2,0,0,2,2021-08-08,Male,8,5-9,24
25,3,3,0,6,2021-08-13,Female,7,5-9,1
25,3,10,0,13,2021-08-08,Male,60,55-64,17
25,1,0,0,1,2021-08-11,Female,34,25-34,2
25,0,0,0,0,2021-08-08,Female,51,45-54,9
25,2,0,0,2,2021-08-12,Female,18,15-19,1
25,0,0,0,0,2021-08-08,Male,59,55-64,24
25,3,0,0,3,2021-08-11,Female,18,15-19,1
25,1,0,0,1,2021-08-06,Female,66,65-69,25
25,1,0,0,1,2021-08-04,Male,52,45-54,17
25,2,0,0,2,2021-08-11,Male,8,5-9,1
25,2,0,0,2,2021-08-07,Female,10,10-14,20
25,0,0,0,0,2021-08-11,Female,61,55-64,1
25,4,0,0,4,2021-08-10,Female,1,1-4,2
25,0,2,0,2,2021-08-11,Female,40,35-44,1
25,2,2,0,4,2021-08-07,Male,3,1-4,5
25,2,0,0,2,2021-08-04,Female,25,25-34,18
25,4,4,0,8,2021-08-05,Male,11,10-14,25
25,2,0,0,2,2021-08-09,Male,51,45-54,23
25,0,0,0,0,2021-08-08,Male,74,70-74,24
25,0,1,0,1,2021-08-05,Female,30,25-34,6
25,3,0,0,3,2021-08-08,Female,6,5-9,5
25,0,1,0,1,2021-08-07,Female,67,65-69,17
25,0,0,0,0,2021-08-07,Male,71,70-74,13
25,1,1,0,2,2021-08-05,Male,55,55-64,22
25,0,1,0,1,2021-08-11,Male,72,70-74,1
25,0,2,0,2,2021-08-09,Female,79,75-79,10
25,0,0,0,0,2021-08-08,Male,78,75-79,20
25,0,0,0,0,2021-08-06,Female,33,25-34,11
25,0,0,0,0,2021-08-08,Male,85,85+,17
25,3,0,0,3,2021-08-13,Male,41,35-44,1
25,0,0,0,0,2021-08-08,Female,4,1-4,4
25,1,1,0,2,2021-08-04,Male,54,45-54,5
25,0,0,0,0,2021-08-07,Male,69,65-69,5
25,1,19,0,20,2021-08-12,Female,24,20-24,1
25,0,0,0,0,2021-08-06,Male,33,25-34,14
25,1,0,0,1,2021-08-08,Female,64,55-64,15
25,1,1,0,2,2021-08-09,Female,67,65-69,15
25,1,0,0,1,2021-08-05,Male,60,55-64,24
25,1,0,0,1,2021-08-05,Male,55,55-64,21
25,0,2,0,2,2021-08-10,Male,69,65-69,4
25,0,1,0,1,2021-08-11,Male,37,35-44,1
25,1,0,0,1,2021-08-11,Male,38,35-44,1
25,0,0,0,0,2021-08-10,Female,70,70-74,4
25,0,0,0,0,2021-08-05,Female,25,25-34,24
25,1,0,0,1,2021-08-08,Male,46,45-54,3
25,1,0,0,1,2021-08-11,Male,79,75-79,1
25,0,5,0,5,2021-08-08,Male,50,45-54,5
25,1,0,0,1,2021-08-06,Male,34,25-34,21
25,1,0,0,1,2021-08-06,Male,52,45-54,24
25,2,0,0,2,2021-08-07,Male,69,65-69,5
25,2,0,0,2,2021-08-08,Male,10,10-14,3
25,0,0,0,0,2021-08-11,Female,66,65-69,11
25,0,1,0,1,2021-08-11,Female,21,20-24,1
25,0,0,0,0,2021-08-11,Female,51,45-54,1
25,0,1,0,1,2021-08-06,Female,24,20-24,22
25,0,0,0,0,2021-08-08,Female,49,45-54,25
25,0,0,0,0,2021-08-07,Male,41,35-44,5
25,1,0,0,1,2021-08-05,Female,49,45-54,3
25,2,8,0,10,2021-08-11,Female,31,25-34,1
25,0,0,0,0,2021-08-07,Male,70,70-74,22
25,2,3,0,5,2021-08-07,Male,68,65-69,5
25,2,0,0,2,2021-08-06,Female,64,55-64,24
25,1,1,0,2,2021-08-07,Male,70,70-74,5
25,1,0,3,4,2021-08-05,Male,58,55-64,4
25,1,3,0,4,2021-08-09,Male,64,55-64,21
25,2,0,0,2,2021-08-08,Male,43,35-44,5
25,1,0,0,1,2021-08-10,Female,23,20-24,6
25,1,5,0,6,2021-08-13,Male,60,55-64,1
25,0,0,0,0,2021-08-10,Male,39,35-44,16
25,0,3,0,3,2021-08-11,Female,52,45-54,1
25,0,4,0,4,2021-08-11,Male,52,45-54,1
25,2,2,0,4,2021-08-07,Female,38,35-44,21
25,0,1,0,1,2021-08-08,Male,49,45-54,2
25,0,0,0,0,2021-08-04,Female,23,20-24,12
25,0,6,0,6,2021-08-11,Female,54,45-54,1
25,1,0,0,1,2021-08-09,Female,77,75-79,5
25,1,0,0,1,2021-08-04,Male,54,45-54,4
25,2,3,0,5,2021-08-09,Female,61,55-64,22
25,0,0,0,0,2021-08-07,Female,69,65-69,5
25,0,0,0,0,2021-08-06,Female,65,65-69,4
25,1,0,0,1,2021-08-06,Male,1,1-4,5
25,1,0,0,1,2021-08-04,Male,53,45-54,20
25,0,1,0,1,2021-08-06,Female,66,65-69,25
25,1,0,0,1,2021-08-09,Female,47,45-54,3
25,1,2,0,3,2021-08-06,Male,3,1-4,5
25,0,7,0,7,2021-08-11,Female,67,65-69,1
25,0,0,0,0,2021-08-08,Female,67,65-69,21
25,0,14,0,14,2021-08-10,Female,34,25-34,3
25,0,0,0,0,2021-08-08,Female,70,70-74,18
25,2,2,0,4,2021-08-08,Female,6,5-9,19
25,0,1,0,1,2021-08-04,Male,54,45-54,19
25,1,1,0,2,2021-08-11,Male,57,55-64,1
25,3,0,0,3,2021-08-12,Female,18,15-19,1
25,1,0,0,1,2021-08-11,Female,1,1-4,1
25,0,0,0,0,2021-08-08,Male,73,70-74,4
25,5,1,0,6,2021-08-09,Male,3,1-4,9
25,1,3,0,4,2021-08-11,Male,5,5-9,1
25,1,0,0,1,2021-08-05,Male,54,45-54,4
25,1,3,0,4,2021-08-09,Male,18,15-19,5
25,0,0,0,0,2021-08-06,Male,61,55-64,3
25,1,7,0,8,2021-08-10,Male,58,55-64,20
25,1,0,0,1,2021-08-08,Male,40,35-44,23
25,1,2,0,3,2021-08-11,Female,30,25-34,1
25,0,2,0,2,2021-08-10,Male,39,35-44,21
25,0,0,0,0,2021-08-07,Male,40,35-44,19
25,1,0,0,1,2021-08-11,Female,59,55-64,1
25,1,0,2,3,2021-08-11,Male,55,55-64,1
25,1,0,0,1,2021-08-07,Male,67,65-69,5
25,0,0,0,0,2021-08-07,Female,24,20-24,14
25,0,0,0,0,2021-08-08,Female,49,45-54,4
25,1,1,0,2,2021-08-07,Female,66,65-69,5
25,0,4,0,4,2021-08-11,Female,40,35-44,1
25,0,0,0,0,2021-08-09,Male,31,25-34,3
25,1,0,0,1,2021-08-09,Female,5,5-9,21
25,0,0,0,0,2021-08-06,Male,66,65-69,23
25,0,0,0,0,2021-08-10,Male,61,55-64,20
25,1,0,0,1,2021-08-06,Male,66,65-69,4
25,0,0,0,0,2021-08-04,Female,19,15-19,9
25,0,0,0,0,2021-08-07,Female,39,35-44,4
25,1,0,0,1,2021-08-10,Female,64,55-64,9
25,0,0,0,0,2021-08-08,Male,73,70-74,20
25,1,0,0,1,2021-08-11,Female,33,25-34,11
25,0,0,0,0,2021-08-05,Female,58,55-64,20
25,1,1,0,2,2021-08-08,Male,49,45-54,5
25,0,0,25,25,2021-08-09,Male,44,35-44,14
25,0,49,0,49,2021-08-11,Female,30,25-34,1
25,0,0,0,0,2021-08-08,Female,17,15-19,24
25,0,0,0,0,2021-08-11,Male,52,45-54,1
25,1,0,0,1,2021-08-11,Male,65,65-69,1
25,1,3,0,4,2021-08-07,Male,68,65-69,25
25,2,9,7,18,2021-08-13,Male,2,1-4,1
25,1,2,0,3,2021-08-11,Female,30,25-34,1
25,0,0,0,0,2021-08-09,Female,48,45-54,4
25,0,3,0,3,2021-08-09,Male,20,20-24,5
25,2,7,0,9,2021-08-09,Male,77,75-79,12
25,0,0,0,0,2021-08-07,Male,65,65-69,4
25,2,0,0,2,2021-08-08,Male,46,45-54,5
25,1,0,0,1,2021-08-06,Male,61,55-64,4
25,1,0,0,1,2021-08-08,Female,71,70-74,21
25,1,0,0,1,2021-08-09,Male,74,70-74,5
25,0,1,0,1,2021-08-04,Male,52,45-54,14
25,0,1,0,1,2021-08-05,Female,61,55-64,16
25,3,0,0,3,2021-08-06,Male,9,5-9,25
25,2,2,0,4,2021-08-09,Female,56,55-64,23
25,0,0,0,0,2021-08-04,Male,54,45-54,15
25,0,0,0,0,2021-08-11,Male,74,70-74,1
25,0,5,0,5,2021-08-08,Male,72,70-74,5
25,0,4,0,4,2021-08-08,Male,44,35-44,5
25,0,0,0,0,2021-08-06,Female,36,35-44,20
25,2,4,11,17,2021-08-05,Male,56,55-64,19
25,0,1,0,1,2021-08-09,Female,45,45-54,4
25,0,0,0,0,2021-08-11,Female,25,25-34,1
25,1,1,0,2,2021-08-06,Male,63,55-64,21
25,0,1,0,1,2021-08-11,Male,59,55-64,1
25,0,0,0,0,2021-08-05,Male,58,55-64,4
25,0,0,0,0,2021-08-10,Male,54,45-54,14
25,1,0,0,1,2021-08-07,Male,68,65-69,4
25,1,0,8,9,2021-08-11,Female,53,45-54,1
25,0,0,0,0,2021-08-08,Male,48,45-54,4
25,0,1,0,1,2021-08-06,Male,54,45-54,18
25,0,2,0,2,2021-08-04,Female,18,15-19,3
25,2,2,0,4,2021-08-08,Female,73,70-74,14
25,1,0,0,1,2021-08-09,Female,18,15-19,3
25,0,0,0,0,2021-08-07,Male,12,10-14,21
25,2,0,0,2,2021-08-09,Male,79,75-79,16
25,1,0,0,1,2021-08-07,Male,69,65-69,4
25,0,0,0,0,2021-08-09,Female,24,20-24,8
25,1,0,0,1,2021-08-08,Male,77,75-79,5
25,2,0,0,2,2021-08-06,Female,1,1-4,5
25,1,2,0,3,2021-08-06,Male,65,65-69,25
25,1,3,0,4,2021-08-04,Female,52,45-54,20
25,1,2,3,6,2021-08-11,Male,18,15-19,1
25,2,0,0,2,2021-08-04,Female,22,20-24,24
25,1,0,0,1,2021-08-05,Female,56,55-64,4
25,0,1,0,1,2021-08-10,Male,33,25-34,5
25,0,0,0,0,2021-08-08,Female,73,70-74,18
25,1,0,0,1,2021-08-10,Male,34,25-34,4
25,0,2,0,2,2021-08-07,Male,64,55-64,5
25,4,0,0,4,2021-08-06,Female,36,35-44,15
25,0,0,0,0,2021-08-11,Female,18,15-19,1
25,1,0,0,1,2021-08-06,Male,52,45-54,5
25,1,3,0,4,2021-08-07,Male,65,65-69,5
25,1,0,60,61,2021-08-09,Male,54,45-54,20
25,2,0,0,2,2021-08-11,Female,18,15-19,1
25,1,0,0,1,2021-08-06,Male,61,55-64,5
25,3,0,0,3,2021-08-08,Female,14,10-14,5
25,2,1,0,3,2021-08-09,Male,56,55-64,23
25,0,0,0,0,2021-08-11,Female,60,55-64,1
25,0,0,0,0,2021-08-10,Male,66,65-69,3
25,3,0,0,3,2021-08-13,Male,21,20-24,1
25,0,0,0,0,2021-08-07,Male,60,55-64,22
25,1,0,0,1,2021-08-05,Female,29,25-34,4
25,0,1,0,1,2021-08-06,Female,60,55-64,19
25,1,0,0,1,2021-08-11,Female,32,25-34,1
25,0,2,0,2,2021-08-11,Male,43,35-44,1
25,0,1,0,1,2021-08-09,Female,67,65-69,13
25,1,0,0,1,2021-08-11,Male,52,45-54,1
25,2,1,0,3,2021-08-12,Female,23,20-24,1
25,3,0,0,3,2021-08-06,Female,0,<1,4
25,0,0,0,0,2021-08-10,Female,24,20-24,20
25,1,5,0,6,2021-08-06,Female,66,65-69,5
25,3,0,0,3,2021-08-07,Female,5,5-9,2
25,1,0,0,1,2021-08-07,Male,33,25-34,22
25,1,4,0,5,2021-08-11,Female,34,25-34,2
25,0,0,0,0,2021-08-05,Male,28,25-34,23
25,1,0,0,1,2021-08-09,Female,76,75-79,4
25,0,1,0,1,2021-08-10,Male,48,45-54,21
25,2,0,0,2,2021-08-11,Female,17,15-19,1
25,0,0,0,0,2021-08-07,Female,35,35-44,22
25,0,0,0,0,2021-08-07,Female,41,35-44,25
25,2,0,0,2,2021-08-11,Female,53,45-54,1
25,1,1,0,2,2021-08-07,Male,69,65-69,22
25,5,0,0,5,2021-08-09,Female,0,<1,4
25,0,0,0,0,2021-08-09,Male,73,70-74,14
25,2,1,0,3,2021-08-08,Female,74,70-74,18
25,2,0,0,2,2021-08-06,Male,66,65-69,22
25,0,1,0,1,2021-08-08,Female,49,45-54,10
25,1,1,0,2,2021-08-10,Female,63,55-64,5
25,1,0,0,1,2021-08-06,Male,34,25-34,21
25,1,0,0,1,2021-08-09,Female,62,55-64,20
25,1,0,0,1,2021-08-08,Male,49,45-54,4
25,2,2,0,4,2021-08-06,Female,66,65-69,18
25,1,0,0,1,2021-08-08,Male,23,20-24,4
25,0,0,0,0,2021-08-07,Male,70,70-74,22
25,0,0,0,0,2021-08-11,Female,37,35-44,1
25,0,0,0,0,2021-08-06,Female,31,25-34,21
25,1,0,0,1,2021-08-05,Female,58,55-64,5
25,1,2,0,3,2021-08-08,Male,63,55-64,11
25,2,4,0,6,2021-08-08,Male,10,10-14,2
25,0,0,0,0,2021-08-11,Male,21,20-24,1
25,1,12,0,13,2021-08-11,Male,51,45-54,1
25,4,0,0,4,2021-08-11,Male,3,1-4,1
25,3,1,0,4,2021-08-11,Female,2,1-4,1
25,0,3,0,3,2021-08-11,Female,34,25-34,1
25,1,0,0,1,2021-08-12,Female,9,5-9,1
25,0,0,0,0,2021-08-09,Male,57,55-64,4
25,0,0,1,1,2021-08-04,Male,26,25-34,2
25,1,2,0,3,2021-08-08,Male,69,65-69,24
25,1,0,0,1,2021-08-08,Female,49,45-54,5
25,0,0,0,0,2021-08-04,Female,52,45-54,2
25,3,12,0,15,2021-08-09,Female,60,55-64,7
25,2,0,0,2,2021-08-10,Male,71,70-74,18
25,0,0,0,0,2021-08-10,Male,60,55-64,20
25,1,0,0,1,2021-08-11,Male,73,70-74,1
25,1,0,0,1,2021-08-08,Male,67,65-69,19
25,0,0,0,0,2021-08-04,Female,54,45-54,20
25,0,0,0,0,2021-08-09,Male,51,45-54,16
25,3,0,0,3,2021-08-06,Male,2,1-4,21
25,1,0,0,1,2021-08-06,Female,32,25-34,20
25,0,1,0,1,2021-08-06,Male,62,55-64,20
25,1,2,0,3,2021-08-07,Female,70,70-74,19
25,1,0,0,1,2021-08-09,Female,52,45-54,3
25,0,0,0,0,2021-08-07,Male,68,65-69,24
25,0,12,0,12,2021-08-11,Female,26,25-34,1
25,0,43,0,43,2021-08-06,Male,61,55-64,5
25,0,1,0,1,2021-08-06,Male,60,55-64,4
25,0,0,0,0,2021-08-06,Male,61,55-64,7
25,1,1,0,2,2021-08-11,Male,38,35-44,1
25,0,0,0,0,2021-08-06,Male,28,25-34,5
25,1,0,0,1,2021-08-11,Male,44,35-44,3
25,0,1,0,1,2021-08-06,Female,56,55-64,5
25,1,6,0,7,2021-08-10,Female,24,20-24,18
25,1,0,0,1,2021-08-10,Female,64,55-64,12
25,1,1,0,2,2021-08-11,Female,23,20-24,1
25,0,0,0,0,2021-08-11,Male,48,45-54,1
25,0,2,0,2,2021-08-05,Male,59,55-64,21
25,0,0,0,0,2021-08-08,Male,37,35-44,23
25,1,30,64,95,2021-08-11,Female,59,55-64,1
25,1,0,0,1,2021-08-08,Male,8,5-9,8
25,1,0,0,1,2021-08-06,Female,36,35-44,5
25,3,0,0,3,2021-08-11,Male,7,5-9,1
25,1,2,0,3,2021-08-08,Male,73,70-74,5
25,2,0,0,2,2021-08-11,Male,5,5-9,17
25,3,0,0,3,2021-08-08,Male,16,15-19,1
25,4,0,0,4,2021-08-06,Female,2,1-4,5
25,0,0,0,0,2021-08-08,Male,43,35-44,5
25,0,0,0,0,2021-08-08,Female,46,45-54,23
25,1,0,0,1,2021-08-12,Female,21,20-24,1
25,3,2,0,5,2021-08-09,Male,69,65-69,17
25,0,0,0,0,2021-08-08,Male,43,35-44,18
25,0,0,0,0,2021-08-07,Female,34,25-34,2
25,0,0,0,0,2021-08-09,Female,37,35-44,2
25,0,0,0,0,2021-08-07,Male,63,55-64,18
25,1,0,0,1,2021-08-05,Male,55,55-64,22
25,1,0,0,1,2021-08-06,Female,52,45-54,19
25,0,0,0,0,2021-08-06,Female,66,65-69,18
25,3,0,0,3,2021-08-07,Male,18,15-19,22
25,1,0,0,1,2021-08-08,Female,71,70-74,3
25,3,5,0,8,2021-08-08,Female,10,10-14,7
25,0,2,0,2,2021-08-05,Male,55,55-64,22
25,0,0,0,0,2021-08-05,Male,58,55-64,7
25,1,0,0,1,2021-08-07,Female,60,55-64,19
25,2,2,0,4,2021-08-05,Female,28,25-34,5
25,0,0,0,0,2021-08-09,Female,36,35-44,15
25,0,1,0,1,2021-08-05,Male,60,55-64,17
25,1,0,0,1,2021-08-06,Female,63,55-64,5
25,0,0,0,0,2021-08-05,Male,31,25-34,19
25,1,0,0,1,2021-08-04,Female,21,20-24,22
25,3,0,0,3,2021-08-09,Female,56,55-64,17
25,3,0,0,3,2021-08-07,Female,67,65-69,20
25,0,1,0,1,2021-08-04,Male,54,45-54,6
25,0,10,0,10,2021-08-05,Male,29,25-34,5
25,2,0,0,2,2021-08-04,Male,52,45-54,23
25,0,0,4,4,2021-08-11,Male,7,5-9,1
25,1,0,0,1,2021-08-05,Female,59,55-64,10
25,0,2,0,2,2021-08-08,Male,65,65-69,20
25,0,0,0,0,2021-08-07,Male,39,35-44,5
25,1,0,0,1,2021-08-08,Male,49,45-54,19
25,2,0,0,2,2021-08-11,Male,0,<1,1
25,0,0,0,0,2021-08-07,Male,60,55-64,21
25,1,0,0,1,2021-08-07,Male,70,70-74,20
25,0,5,0,5,2021-08-06,Male,31,25-34,22
25,0,0,0,0,2021-08-07,Male,37,35-44,21
25,2,0,0,2,2021-08-07,Female,5,5-9,3
25,2,0,0,2,2021-08-09,Male,24,20-24,3
25,1,1,6,8,2021-08-11,Female,45,45-54,1
25,2,0,0,2,2021-08-07,Female,69,65-69,22
25,0,1,0,1,2021-08-04,Female,26,25-34,22
25,2,1,0,3,2021-08-13,Male,21,20-24,1
25,2,0,7,9,2021-08-05,Female,55,55-64,8
25,1,0,0,1,2021-08-06,Female,61,55-64,21
25,1,0,0,1,2021-08-04,Female,54,45-54,5
25,0,0,0,0,2021-08-11,Male,41,35-44,17
25,0,0,0,0,2021-08-13,Male,58,55-64,1
25,1,0,0,1,2021-08-08,Female,73,70-74,5
25,0,0,0,0,2021-08-06,Male,66,65-69,25
25,1,1,0,2,2021-08-05,Male,53,45-54,17
25,1,0,0,1,2021-08-07,Female,42,35-44,4
25,0,4,0,4,2021-08-11,Male,71,70-74,1
25,3,0,0,3,2021-08-06,Female,3,1-4,4
25,0,0,0,0,2021-08-10,Female,24,20-24,8
25,2,0,0,2,2021-08-09,Male,35,35-44,6
25,1,0,3,4,2021-08-11,Female,54,45-54,1
25,1,1,0,2,2021-08-09,Male,70,70-74,22
25,2,2,0,4,2021-08-08,Female,71,70-74,10
25,0,1,1,2,2021-08-06,Female,65,65-69,5
25,1,0,0,1,2021-08-06,Male,62,55-64,17
25,0,0,0,0,2021-08-09,Male,66,65-69,4
25,0,0,0,0,2021-08-10,Female,60,55-64,5
25,0,0,0,0,2021-08-08,Male,47,45-54,15
25,0,0,0,0,2021-08-06,Female,66,65-69,21
25,0,0,0,0,2021-08-09,Female,69,65-69,5
25,0,0,0,0,2021-08-06,Male,64,55-64,4
25,1,2,0,3,2021-08-11,Female,29,25-34,1
25,1,1,0,2,2021-08-08,Male,80,80-84,20
25,2,2,0,4,2021-08-08,Male,73,70-74,17
25,0,0,0,0,2021-08-07,Male,68,65-69,19
25,1,2,0,3,2021-08-12,Male,5,5-9,1
25,1,0,0,1,2021-08-09,Female,68,65-69,19
25,0,0,0,0,2021-08-07,Female,65,65-69,21
25,0,0,0,0,2021-08-05,Female,56,55-64,4
25,3,3,0,6,2021-08-07,Male,12,10-14,5
25,2,0,0,2,2021-08-07,Male,70,70-74,24
25,0,3,0,3,2021-08-08,Male,45,45-54,5
25,2,0,0,2,2021-08-08,Female,46,45-54,4
25,1,0,0,1,2021-08-09,Female,27,25-34,11
25,3,0,0,3,2021-08-11,Female,20,20-24,4
25,1,0,0,1,2021-08-09,Female,38,35-44,4
25,0,0,0,0,2021-08-11,Male,51,45-54,1
25,0,0,0,0,2021-08-08,Female,73,70-74,4
25,3,1,0,4,2021-08-04,Male,13,10-14,5
25,1,4,0,5,2021-08-06,Male,63,55-64,3
25,0,2,0,2,2021-08-09,Female,78,75-79,17
25,1,0,0,1,2021-08-12,Female,21,20-24,1
25,1,0,0,1,2021-08-06,Female,64,55-64,20
25,1,0,0,1,2021-08-13,Male,60,55-64,1
25,2,0,0,2,2021-08-07,Female,19,15-19,23
25,0,9,0,9,2021-08-06,Female,34,25-34,2
25,0,31,0,31,2021-08-11,Female,34,25-34,1
25,1,2,0,3,2021-08-08,Female,39,35-44,23
25,0,1,0,1,2021-08-11,Female,53,45-54,1
25,3,0,0,3,2021-08-05,Male,19,15-19,4
25,3,0,0,3,2021-08-11,Female,4,1-4,1
25,0,0,0,0,2021-08-06,Female,65,65-69,5
25,1,0,0,1,2021-08-09,Male,78,75-79,17
25,0,0,0,0,2021-08-04,Male,53,45-54,23
25,0,0,0,0,2021-08-11,Female,57,55-64,1
25,1,2,0,3,2021-08-11,Female,55,55-64,1
25,0,0,0,0,2021-08-09,Male,7,5-9,3
25,0,1,0,1,2021-08-08,Male,40,35-44,22
25,0,0,0,0,2021-08-07,Male,68,65-69,20
25,0,1,0,1,2021-08-11,Female,34,25-34,1
25,1,0,0,1,2021-08-07,Female,67,65-69,20
25,1,0,0,1,2021-08-07,Female,69,65-69,24
25,3,0,0,3,2021-08-04,Female,18,15-19,19
25,0,3,0,3,2021-08-05,Female,29,25-34,23
25,4,0,0,4,2021-08-07,Female,33,25-34,18
25,1,0,0,1,2021-08-06,Female,64,55-64,18
25,0,0,0,0,2021-08-04,Female,3,1-4,5
25,0,0,0,0,2021-08-05,Female,22,20-24,10
25,0,0,0,0,2021-08-08,Female,47,45-54,19
25,1,0,6,7,2021-08-06,Male,66,65-69,18
25,0,0,11,11,2021-08-07,Female,68,65-69,22
25,0,5,0,5,2021-08-13,Male,56,55-64,1
25,1,0,0,1,2021-08-09,Female,72,70-74,4
25,1,0,0,1,2021-08-11,Male,47,45-54,1
25,0,0,0,0,2021-08-04,Female,17,15-19,5
25,0,0,0,0,2021-08-06,Male,60,55-64,20
25,1,0,0,1,2021-08-07,Male,68,65-69,5
25,1,0,0,1,2021-08-04,Male,4,1-4,13
25,0,0,0,0,2021-08-10,Female,32,25-34,5
25,1,0,0,1,2021-08-05,Male,60,55-64,21
25,1,2,0,3,2021-08-11,Male,58,55-64,1
25,0,0,0,0,2021-08-06,Male,34,25-34,4
25,2,0,0,2,2021-08-09,Male,26,25-34,22
25,0,0,0,0,2021-08-11,Female,34,25-34,1
25,2,0,0,2,2021-08-09,Female,16,15-19,4
25,1,4,0,5,2021-08-08,Female,43,35-44,5
25,2,3,0,5,2021-08-13,Male,23,20-24,1
25,0,1,0,1,2021-08-09,Female,41,35-44,4
25,0,3,0,3,2021-08-13,Male,36,35-44,1
25,4,1,0,5,2021-08-11,Female,17,15-19,1
25,0,0,0,0,2021-08-09,Male,48,45-54,7
25,0,0,0,0,2021-08-07,Male,70,70-74,23
25,1,0,0,1,2021-08-07,Male,64,55-64,5
25,1,0,0,1,2021-08-09,Female,46,45-54,5
25,0,1,0,1,2021-08-05,Male,60,55-64,21
25,1,0,0,1,2021-08-04,Female,52,45-54,5
25,0,1,0,1,2021-08-04,Male,53,45-54,17
25,2,1,0,3,2021-08-09,Male,31,25-34,21
25,0,19,100,119,2021-08-11,Male,36,35-44,1
25,1,4,5,10,2021-08-11,Female,31,25-34,1
25,1,0,0,1,2021-08-07,Female,67,65-69,5
25,1,3,34,38,2021-08-11,Female,8,5-9,1
25,1,0,0,1,2021-08-06,Female,36,35-44,5
25,2,0,0,2,2021-08-04,Male,53,45-54,4
25,0,0,0,0,2021-08-09,Male,41,35-44,5
25,1,0,0,1,2021-08-06,Female,64,55-64,19
25,0,0,0,0,2021-08-08,Male,51,45-54,4
25,0,0,0,0,2021-08-09,Female,48,45-54,3
25,1,4,0,5,2021-08-11,Female,30,25-34,1
25,3,1,0,4,2021-08-05,Male,6,5-9,4
25,3,0,0,3,2021-08-08,Female,8,5-9,5
25,0,3,0,3,2021-08-11,Female,33,25-34,1
25,0,0,0,0,2021-08-05,Female,56,55-64,3
25,2,0,0,2,2021-08-09,Female,49,45-54,5
25,1,0,0,1,2021-08-11,Male,68,65-69,1
25,2,4,0,6,2021-08-08,Female,19,15-19,2
25,0,0,0,0,2021-08-06,Male,61,55-64,7
25,0,37,0,37,2021-08-08,Male,41,35-44,5
25,1,4,0,5,2021-08-11,Male,61,55-64,1
25,0,1,0,1,2021-08-04,Female,25,25-34,15
25,1,0,0,1,2021-08-09,Male,52,45-54,23
25,2,0,0,2,2021-08-07,Male,25,25-34,4
25,1,0,0,1,2021-08-09,Male,44,35-44,9
25,1,0,0,1,2021-08-11,Male,36,35-44,1
25,0,2,0,2,2021-08-10,Female,56,55-64,18
25,0,0,0,0,2021-08-08,Male,71,70-74,22
25,0,0,0,0,2021-08-06,Female,65,65-69,5
25,0,0,0,0,2021-08-10,Male,37,35-44,5
25,0,3,0,3,2021-08-09,Male,70,70-74,5
25,2,0,0,2,2021-08-06,Female,61,55-64,22
25,0,0,0,0,2021-08-06,Male,34,25-34,5
25,0,0,0,0,2021-08-11,Female,66,65-69,1
25,1,3,0,4,2021-08-13,Male,21,20-24,1
25,0,0,0,0,2021-08-08,Male,41,35-44,20
25,0,0,0,0,2021-08-08,Female,46,45-54,12
25,1,0,0,1,2021-08-11,Male,65,65-69,1
25,0,0,0,0,2021-08-07,Male,39,35-44,8
25,0,0,0,0,2021-08-04,Male,54,45-54,20
25,1,3,0,4,2021-08-13,Male,40,35-44,1
25,0,0,0,0,2021-08-06,Male,34,25-34,24
25,1,0,0,1,2021-08-11,Female,31,25-34,1
25,0,0,0,0,2021-08-08,Male,47,45-54,19
25,1,0,0,1,2021-08-12,Female,24,20-24,1
25,0,2,0,2,2021-08-07,Female,67,65-69,23
25,2,0,0,2,2021-08-08,Female,13,10-14,16
25,0,0,0,0,2021-08-09,Female,68,65-69,20
25,1,0,0,1,2021-08-08,Male,60,55-64,3
25,1,0,0,1,2021-08-11,Female,44,35-44,1
25,0,0,0,0,2021-08-04,Female,23,20-24,11
25,2,0,0,2,2021-08-11,Female,17,15-19,1
25,0,0,0,0,2021-08-08,Female,70,70-74,18
25,1,0,0,1,2021-08-08,Male,46,45-54,24
25,0,4,0,4,2021-08-09,Female,60,55-64,12
25,0,0,0,0,2021-08-07,Female,37,35-44,5
25,0,0,0,0,2021-08-08,Female,56,55-64,23
25,1,8,0,9,2021-08-06,Female,61,55-64,4
25,0,0,0,0,2021-08-08,Female,74,70-74,5
25,0,0,8,8,2021-08-05,Male,30,25-34,19
25,0,0,0,0,2021-08-08,Female,47,45-54,5
25,0,0,0,0,2021-08-07,Male,18,15-19,10
25,0,0,0,0,2021-08-08,Male,39,35-44,17
25,0,1,0,1,2021-08-11,Male,52,45-54,1
25,1,7,0,8,2021-08-09,Male,68,65-69,22
25,0,0,0,0,2021-08-07,Male,10,10-14,18
25,0,3,0,3,2021-08-12,Male,18,15-19,1
25,3,0,0,3,2021-08-08,Female,19,15-19,14
25,1,0,0,1,2021-08-08,Male,79,75-79,16
25,2,0,0,2,2021-08-10,Male,68,65-69,11
25,0,2,0,2,2021-08-08,Male,48,45-54,14
25,0,3,0,3,2021-08-06,Male,59,55-64,2
25,2,1,0,3,2021-08-07,Male,0,<1,2
25,1,0,0,1,2021-08-11,Female,22,20-24,1
25,1,0,0,1,2021-08-12,Female,20,20-24,1
25,2,0,0,2,2021-08-09,Female,30,25-34,10
25,0,2,0,2,2021-08-10,Male,23,20-24,5
25,5,0,0,5,2021-08-05,Male,15,15-19,17
25,1,2,0,3,2021-08-10,Male,32,25-34,19
25,3,15,0,18,2021-08-11,Male,4,1-4,1
25,3,0,0,3,2021-08-08,Male,18,15-19,16
25,0,0,0,0,2021-08-08,Male,77,75-79,5
25,1,2,0,3,2021-08-09,Male,76,75-79,3
25,1,0,0,1,2021-08-07,Female,5,5-9,2
25,1,4,0,5,2021-08-09,Female,68,65-69,15
25,1,0,0,1,2021-08-05,Male,58,55-64,22
25,0,1,0,1,2021-08-10,Male,43,35-44,21
25,1,0,0,1,2021-08-11,Female,46,45-54,1
25,1,0,0,1,2021-08-04,Male,53,45-54,5
25,1,2,0,3,2021-08-08,Male,73,70-74,3
25,1,0,0,1,2021-08-11,Male,60,55-64,1
25,3,0,0,3,2021-08-05,Male,13,10-14,5
25,2,0,0,2,2021-08-06,Male,65,65-69,21
25,1,2,0,3,2021-08-07,Female,67,65-69,21
25,1,0,0,1,2021-08-07,Female,68,65-69,21
25,1,0,0,1,2021-08-07,Male,55,55-64,5
25,1,10,0,11,2021-08-12,Female,22,20-24,3
25,2,5,0,7,2021-08-08,Male,81,80-84,18
25,0,0,0,0,2021-08-08,Male,51,45-54,20
25,0,1,0,1,2021-08-08,Male,51,45-54,5
25,1,31,0,32,2021-08-08,Female,50,45-54,3
25,0,7,0,7,2021-08-07,Female,40,35-44,2
25,1,0,0,1,2021-08-11,Female,27,25-34,1
25,0,4,0,4,2021-08-08,Female,48,45-54,20
25,0,0,0,0,2021-08-04,Male,20,20-24,22
25,0,0,0,0,2021-08-07,Female,66,65-69,5
25,0,0,0,0,2021-08-05,Male,28,25-34,20
25,1,0,0,1,2021-08-06,Female,63,55-64,23
25,1,1,0,2,2021-08-04,Female,53,45-54,17
25,0,0,0,0,2021-08-06,Male,66,65-69,24
25,0,0,0,0,2021-08-08,Male,57,55-64,16
25,3,0,0,3,2021-08-09,Female,23,20-24,2
25,0,1,0,1,2021-08-07,Male,67,65-69,23
25,1,0,0,1,2021-08-06,Male,64,55-64,24
25,0,2,0,2,2021-08-08,Female,70,70-74,19
25,1,2,0,3,2021-08-06,Female,62,55-64,5
25,1,0,0,1,2021-08-09,Male,32,25-34,15
25,0,1,0,1,2021-08-06,Male,34,25-34,5
25,0,0,0,0,2021-08-10,Female,29,25-34,19
25,1,0,0,1,2021-08-11,Female,31,25-34,1
25,1,0,0,1,2021-08-08,Male,73,70-74,23
25,0,0,0,0,2021-08-11,Male,60,55-64,1
25,2,2,0,4,2021-08-09,Female,46,45-54,10
25,1,1,0,2,2021-08-11,Male,37,35-44,1
25,0,3,0,3,2021-08-06,Female,63,55-64,22
25,0,0,0,0,2021-08-06,Female,36,35-44,21
25,2,0,0,2,2021-08-09,Male,71,70-74,20
25,1,0,0,1,2021-08-05,Female,56,55-64,5
25,1,0,0,1,2021-08-09,Male,52,45-54,2
25,3,0,0,3,2021-08-06,Female,66,65-69,24
25,0,0,0,0,2021-08-06,Female,62,55-64,21
25,1,11,0,12,2021-08-05,Female,60,55-64,5
25,0,0,0,0,2021-08-09,Male,58,55-64,5
25,0,0,0,0,2021-08-11,Male,44,35-44,1
25,2,0,0,2,2021-08-05,Male,55,55-64,22
25,0,0,0,0,2021-08-07,Male,64,55-64,2
25,1,0,1,2,2021-08-09,Male,55,55-64,12
25,0,0,0,0,2021-08-09,Female,43,35-44,16
25,0,0,0,0,2021-08-05,Male,30,25-34,2
25,0,0,0,0,2021-08-06,Female,32,25-34,4
25,1,4,0,5,2021-08-11,Male,61,55-64,1
25,1,0,0,1,2021-08-05,Male,55,55-64,5
25,1,2,0,3,2021-08-04,Female,23,20-24,19
25,3,3,0,6,2021-08-06,Female,18,15-19,5
25,2,0,0,2,2021-08-06,Female,12,10-14,5
25,1,0,0,1,2021-08-05,Male,56,55-64,18
25,0,0,0,0,2021-08-07,Male,65,65-69,5
25,0,2,0,2,2021-08-11,Male,67,65-69,5
25,1,2,0,3,2021-08-08,Male,76,75-79,3
25,0,1,0,1,2021-08-05,Male,54,45-54,22
25,1,1,0,2,2021-08-04,Female,53,45-54,2
25,0,3,0,3,2021-08-07,Male,40,35-44,21
25,1,1,0,2,2021-08-05,Male,60,55-64,5
25,1,2,0,3,2021-08-08,Female,49,45-54,4
25,0,0,0,0,2021-08-08,Male,37,35-44,4
25,1,1,0,2,2021-08-11,Male,74,70-74,1
25,1,1,0,2,2021-08-07,Female,69,65-69,5
25,0,1,0,1,2021-08-09,Male,28,25-34,5
25,0,0,0,0,2021-08-11,Male,12,10-14,1
25,2,0,0,2,2021-08-10,Male,66,65-69,13
25,0,1,0,1,2021-08-08,Male,39,35-44,5
25,0,1,0,1,2021-08-04,Male,52,45-54,4
25,1,0,0,1,2021-08-07,Female,67,65-69,21
25,1,1,51,53,2021-08-09,Female,61,55-64,20
25,0,0,0,0,2021-08-11,Male,45,45-54,2
25,0,3,0,3,2021-08-11,Male,21,20-24,1
25,0,0,0,0,2021-08-05,Male,17,15-19,10
25,1,0,1,2,2021-08-05,Male,54,45-54,5
25,0,0,0,0,2021-08-09,Male,61,55-64,16
25,0,0,0,0,2021-08-06,Female,62,55-64,23
25,0,0,0,0,2021-08-08,Male,51,45-54,19
25,0,0,0,0,2021-08-07,Female,34,25-34,5
25,0,2,0,2,2021-08-05,Female,55,55-64,5
25,1,0,0,1,2021-08-09,Female,70,70-74,3
25,1,3,0,4,2021-08-11,Male,72,70-74,1
25,1,0,0,1,2021-08-09,Male,71,70-74,20
25,1,4,0,5,2021-08-04,Male,63,55-64,4
25,0,1,0,1,2021-08-07,Female,68,65-69,18
25,0,0,0,0,2021-08-11,Female,52,45-54,1
25,0,2,0,2,2021-08-08,Female,59,55-64,19
25,1,0,0,1,2021-08-07,Male,70,70-74,21
25,2,0,0,2,2021-08-08,Male,51,45-54,5
25,1,0,0,1,2021-08-10,Male,68,65-69,5
25,1,1,6,8,2021-08-04,Male,23,20-24,16
25,1,0,0,1,2021-08-07,Female,67,65-69,5
25,2,2,0,4,2021-08-08,Male,9,5-9,19
25,1,3,0,4,2021-08-07,Male,42,35-44,2
25,1,0,0,1,2021-08-09,Female,71,70-74,23
25,0,0,0,0,2021-08-11,Female,50,45-54,1
25,2,0,0,2,2021-08-09,Male,68,65-69,19
25,0,12,0,12,2021-08-07,Female,66,65-69,4
25,1,0,0,1,2021-08-07,Male,67,65-69,22
25,0,4,0,4,2021-08-12,Male,19,15-19,1
25,0,1,0,1,2021-08-05,Female,58,55-64,16
25,1,0,6,7,2021-08-08,Male,45,45-54,4
25,1,0,0,1,2021-08-09,Male,57,55-64,9
25,0,0,0,0,2021-08-09,Female,26,25-34,7
25,1,0,0,1,2021-08-11,Male,67,65-69,1
25,0,0,0,0,2021-08-08,Male,70,70-74,21
25,0,8,0,8,2021-08-05,Male,53,45-54,4
25,3,0,0,3,2021-08-11,Female,50,45-54,1
25,0,1,0,1,2021-08-06,Female,65,65-69,5
25,0,0,0,0,2021-08-10,Female,34,25-34,24
25,0,0,0,0,2021-08-11,Female,67,65-69,1
25,0,0,0,0,2021-08-11,Male,48,45-54,1
25,1,0,0,1,2021-08-07,Male,68,65-69,25
25,1,0,0,1,2021-08-05,Male,31,25-34,5
25,1,1,0,2,2021-08-05,Male,54,45-54,7
25,0,2,0,2,2021-08-13,Male,35,35-44,18
25,1,2,0,3,2021-08-04,Male,53,45-54,6
25,1,0,0,1,2021-08-08,Male,79,75-79,19
25,0,2,0,2,2021-08-10,Female,47,45-54,5
25,1,0,0,1,2021-08-08,Female,12,10-14,16
25,1,0,0,1,2021-08-08,Male,69,65-69,13
25,2,0,0,2,2021-08-09,Male,22,20-24,9
25,0,0,0,0,2021-08-05,Male,25,25-34,19
25,0,0,0,0,2021-08-09,Male,16,15-19,22
25,1,0,0,1,2021-08-05,Female,30,25-34,8
25,1,1,0,2,2021-08-05,Female,58,55-64,12
25,1,0,0,1,2021-08-08,Female,74,70-74,5
25,0,0,0,0,2021-08-05,Female,52,45-54,5
25,1,0,0,1,2021-08-09,Female,76,75-79,5
25,1,7,0,8,2021-08-09,Male,65,65-69,4
25,1,0,0,1,2021-08-11,Female,33,25-34,1
25,1,1,0,2,2021-08-10,Female,62,55-64,18
25,1,4,0,5,2021-08-11,Female,41,35-44,1
25,2,1,0,3,2021-08-04,Female,18,15-19,4
25,0,0,0,0,2021-08-10,Female,58,55-64,3
25,1,0,0,1,2021-08-12,Female,24,20-24,1
25,2,0,0,2,2021-08-11,Male,18,15-19,2
25,0,0,0,0,2021-08-05,Female,23,20-24,19
25,2,1,0,3,2021-08-06,Female,61,55-64,5
25,1,0,0,1,2021-08-09,Female,34,25-34,14
25,1,1,0,2,2021-08-07,Male,67,65-69,16
25,1,0,0,1,2021-08-04,Male,52,45-54,20
25,1,0,0,1,2021-08-11,Female,44,35-44,1
25,2,6,0,8,2021-08-12,Male,4,1-4,1
25,2,0,0,2,2021-08-13,Male,22,20-24,4
25,1,0,0,1,2021-08-08,Female,43,35-44,24
25,1,0,0,1,2021-08-09,Female,66,65-69,13
25,1,4,0,5,2021-08-08,Male,67,65-69,4
25,1,0,0,1,2021-08-04,Female,25,25-34,23
25,0,0,0,0,2021-08-06,Male,33,25-34,4
25,0,0,0,0,2021-08-08,Female,72,70-74,18
25,0,0,0,0,2021-08-06,Male,32,25-34,19
25,0,0,0,0,2021-08-07,Female,65,65-69,25
25,0,0,0,0,2021-08-05,Male,60,55-64,18
25,3,0,0,3,2021-08-07,Male,8,5-9,5
25,0,4,5,9,2021-08-07,Female,59,55-64,4
25,3,0,2,5,2021-08-10,Female,37,35-44,13
25,2,0,0,2,2021-08-09,Male,11,10-14,21
25,2,0,0,2,2021-08-07,Male,19,15-19,5
25,2,0,0,2,2021-08-04,Male,25,25-34,14
25,2,0,0,2,2021-08-08,Male,70,70-74,17
25,1,0,0,1,2021-08-09,Female,67,65-69,4
25,1,0,0,1,2021-08-10,Male,40,35-44,2
25,1,1,0,2,2021-08-06,Male,64,55-64,4
25,2,0,0,2,2021-08-08,Female,51,45-54,21
25,2,4,0,6,2021-08-06,Male,66,65-69,5
25,2,0,0,2,2021-08-11,Female,10,10-14,1
25,0,6,0,6,2021-08-07,Female,70,70-74,19
25,4,2,0,6,2021-08-08,Female,17,15-19,20
25,1,2,25,28,2021-08-11,Female,37,35-44,1
25,1,4,0,5,2021-08-11,Female,33,25-34,1
25,1,2,0,3,2021-08-11,Male,67,65-69,1
25,0,0,0,0,2021-08-09,Male,45,45-54,20
25,0,0,0,0,2021-08-07,Male,9,5-9,11
25,0,1,0,1,2021-08-08,Female,68,65-69,21
25,1,0,0,1,2021-08-05,Female,59,55-64,19
25,0,0,0,0,2021-08-06,Female,7,5-9,2
25,0,0,0,0,2021-08-05,Female,55,55-64,23
25,0,0,0,0,2021-08-07,Female,42,35-44,24
25,0,0,0,0,2021-08-09,Male,20,20-24,6
25,0,0,0,0,2021-08-08,Female,24,20-24,7
25,1,0,0,1,2021-08-07,Female,32,25-34,2
25,1,2,0,3,2021-08-10,Female,49,45-54,5
25,0,0,0,0,2021-08-13,Male,58,55-64,1
25,1,2,0,3,2021-08-08,Male,67,65-69,5
25,0,0,0,0,2021-08-13,Male,53,45-54,1
25,0,0,0,0,2021-08-06,Male,35,35-44,6
25,0,0,0,0,2021-08-09,Female,65,65-69,22
25,3,0,0,3,2021-08-07,Male,40,35-44,16
25,1,4,0,5,2021-08-11,Male,52,45-54,1
25,0,0,0,0,2021-08-09,Female,10,10-14,19
25,1,4,0,5,2021-08-13,Male,40,35-44,1
25,0,1,0,1,2021-08-11,Male,23,20-24,1
25,0,0,0,0,2021-08-09,Male,83,80-84,10
25,3,0,0,3,2021-08-11,Female,40,35-44,1
25,1,0,0,1,2021-08-04,Female,53,45-54,24
25,1,0,0,1,2021-08-08,Male,51,45-54,5
25,0,2,0,2,2021-08-06,Male,63,55-64,5
25,0,3,7,10,2021-08-11,Male,63,55-64,1
25,0,0,0,0,2021-08-08,Female,72,70-74,5
25,1,2,0,3,2021-08-10,Female,49,45-54,4
25,1,7,0,8,2021-08-07,Male,64,55-64,5
25,1,0,0,1,2021-08-10,Female,49,45-54,9
25,0,0,0,0,2021-08-10,Male,23,20-24,21
25,0,1,0,1,2021-08-08,Male,78,75-79,24
25,1,0,0,1,2021-08-11,Male,57,55-64,1
25,0,0,0,0,2021-08-05,Female,29,25-34,6
25,0,0,0,0,2021-08-09,Male,44,35-44,18
25,2,0,0,2,2021-08-08,Female,67,65-69,24
25,0,1,0,1,2021-08-06,Female,66,65-69,18
25,1,0,0,1,2021-08-04,Female,52,45-54,7
25,0,0,0,0,2021-08-09,Male,2,1-4,16
25,0,0,0,0,2021-08-10,Female,36,35-44,5
25,0,0,0,0,2021-08-08,Male,48,45-54,22
25,3,2,0,5,2021-08-11,Male,22,20-24,1
25,0,0,0,0,2021-08-05,Female,29,25-34,5
25,3,0,0,3,2021-08-10,Female,5,5-9,5
25,1,0,0,1,2021-08-05,Male,52,45-54,4
25,0,0,0,0,2021-08-07,Male,40,35-44,22
25,1,8,0,9,2021-08-07,Female,66,65-69,25
25,1,4,0,5,2021-08-06,Female,63,55-64,5
25,0,0,0,0,2021-08-07,Male,39,35-44,22
25,1,0,0,1,2021-08-05,Male,60,55-64,5
25,0,0,0,0,2021-08-06,Male,31,25-34,22
25,2,2,0,4,2021-08-09,Female,62,55-64,19
25,0,0,0,0,2021-08-09,Female,54,45-54,21
25,0,0,0,0,2021-08-09,Male,58,55-64,15
25,1,0,0,1,2021-08-07,Female,68,65-69,23
25,2,0,0,2,2021-08-06,Male,36,35-44,2
25,3,0,0,3,2021-08-07,Female,7,5-9,15
25,0,0,0,0,2021-08-09,Male,41,35-44,23
25,1,0,0,1,2021-08-09,Male,65,65-69,22
25,0,0,0,0,2021-08-06,Male,59,55-64,10
25,1,3,0,4,2021-08-04,Male,53,45-54,2
25,0,1,0,1,2021-08-08,Male,41,35-44,23
25,0,0,0,0,2021-08-09,Female,12,10-14,16
25,0,0,0,0,2021-08-08,Male,35,35-44,15
25,0,0,0,0,2021-08-08,Female,50,45-54,5
25,1,0,0,1,2021-08-07,Male,67,65-69,5
25,2,1,0,3,2021-08-07,Male,69,65-69,16
25,1,0,0,1,2021-08-09,Female,64,55-64,3
25,1,1,0,2,2021-08-07,Male,68,65-69,13
25,1,3,0,4,2021-08-11,Male,38,35-44,1
25,0,0,0,0,2021-08-05,Female,59,55-64,22
25,0,0,0,0,2021-08-13,Male,54,45-54,1
25,0,0,0,0,2021-08-10,Female,70,70-74,3
25,1,0,0,1,2021-08-04,Female,52,45-54,4
25,0,0,0,0,2021-08-07,Male,57,55-64,9
25,2,0,0,2,2021-08-04,Female,3,1-4,5
25,1,0,0,1,2021-08-05,Female,60,55-64,23
25,0,0,0,0,2021-08-10,Male,10,10-14,22
25,1,0,0,1,2021-08-05,Male,16,15-19,21
25,1,2,0,3,2021-08-06,Female,63,55-64,9
25,1,0,0,1,2021-08-06,Male,66,65-69,21
25,4,0,0,4,2021-08-07,Female,4,1-4,5
25,0,0,0,0,2021-08-11,Female,25,25-34,1
25,0,0,0,0,2021-08-08,Female,16,15-19,22
25,1,0,0,1,2021-08-07,Female,38,35-44,4
25,1,0,0,1,2021-08-06,Male,55,55-64,12
25,1,1,0,2,2021-08-11,Female,32,25-34,1
25,0,15,69,84,2021-08-05,Male,60,55-64,5
25,1,0,0,1,2021-08-06,Female,60,55-64,2
25,0,0,0,0,2021-08-08,Male,24,20-24,4
25,0,0,0,0,2021-08-06,Male,66,65-69,5
25,0,3,0,3,2021-08-11,Female,29,25-34,1
25,0,1,0,1,2021-08-04,Female,22,20-24,5
25,0,0,0,0,2021-08-04,Female,22,20-24,20
25,1,1,0,2,2021-08-09,Male,66,65-69,3
25,0,0,0,0,2021-08-11,Female,65,65-69,1
25,1,2,0,3,2021-08-09,Male,69,65-69,4
25,0,1,0,1,2021-08-10,Female,77,75-79,5
25,0,3,0,3,2021-08-11,Male,29,25-34,1
25,0,0,0,0,2021-08-11,Female,47,45-54,1
25,1,4,2,7,2021-08-09,Male,70,70-74,5
25,0,0,15,15,2021-08-07,Male,40,35-44,5
25,4,2,0,6,2021-08-11,Male,22,20-24,1
25,1,0,0,1,2021-08-08,Male,78,75-79,5
25,0,10,0,10,2021-08-05,Male,57,55-64,4
25,0,0,0,0,2021-08-07,Female,38,35-44,5
25,1,1,1,3,2021-08-06,Male,62,55-64,5
25,0,3,0,3,2021-08-07,Female,54,45-54,22
25,1,0,0,1,2021-08-09,Male,75,75-79,16
25,4,0,0,4,2021-08-08,Female,12,10-14,2
25,0,0,0,0,2021-08-07,Male,40,35-44,22
25,2,0,0,2,2021-08-05,Male,15,15-19,17
25,0,2,0,2,2021-08-13,Male,36,35-44,18
25,3,0,0,3,2021-08-08,Female,0,<1,16
25,1,2,0,3,2021-08-11,Male,32,25-34,2
25,0,1,0,1,2021-08-11,Female,51,45-54,1
25,1,0,0,1,2021-08-11,Female,30,25-34,1
25,1,0,0,1,2021-08-11,Female,39,35-44,1
25,3,1,0,4,2021-08-09,Male,3,1-4,3
25,0,0,0,0,2021-08-11,Female,21,20-24,1
25,0,0,0,0,2021-08-08,Female,37,35-44,5
25,0,1,0,1,2021-08-08,Female,81,80-84,5
25,0,0,0,0,2021-08-08,Female,69,65-69,4
25,0,0,1,1,2021-08-11,Male,34,25-34,12
25,2,0,0,2,2021-08-10,Female,65,65-69,4
25,0,1,0,1,2021-08-04,Male,53,45-54,24
25,0,1,0,1,2021-08-04,Female,53,45-54,5
25,0,0,2,2,2021-08-07,Male,41,35-44,4
25,0,2,0,2,2021-08-13,Male,20,20-24,1
25,0,0,0,0,2021-08-09,Male,31,25-34,21
25,1,0,0,1,2021-08-09,Male,57,55-64,19
25,2,0,0,2,2021-08-11,Male,49,45-54,1
25,2,16,0,18,2021-08-07,Male,68,65-69,21
25,2,0,0,2,2021-08-11,Male,3,1-4,1
25,0,2,0,2,2021-08-11,Male,68,65-69,1
25,1,0,0,1,2021-08-08,Male,77,75-79,4
25,0,5,0,5,2021-08-09,Male,20,20-24,10
25,1,0,0,1,2021-08-09,Female,29,25-34,16
25,5,2,0,7,2021-08-10,Female,25,25-34,4
25,2,0,0,2,2021-08-08,Male,13,10-14,18
25,3,0,0,3,2021-08-11,Male,19,15-19,1
25,1,4,0,5,2021-08-08,Female,18,15-19,5
25,0,0,0,0,2021-08-07,Male,69,65-69,5
25,0,0,0,0,2021-08-05,Male,27,25-34,5
25,1,0,0,1,2021-08-08,Female,68,65-69,4
25,1,0,0,1,2021-08-10,Female,31,25-34,4
25,0,1,0,1,2021-08-10,Female,71,70-74,11
25,1,0,0,1,2021-08-11,Female,56,55-64,2
25,1,2,0,3,2021-08-11,Male,65,65-69,1
25,0,2,0,2,2021-08-05,Female,59,55-64,4
25,0,1,0,1,2021-08-07,Female,70,70-74,22
25,1,5,0,6,2021-08-13,Female,47,45-54,1
25,2,0,0,2,2021-08-08,Male,74,70-74,21
25,1,0,0,1,2021-08-07,Male,62,55-64,15
25,0,0,0,0,2021-08-09,Female,22,20-24,13
25,0,2,0,2,2021-08-11,Female,52,45-54,1
25,1,0,25,26,2021-08-07,Male,69,65-69,7
25,0,1,0,1,2021-08-06,Male,63,55-64,18
25,0,5,0,5,2021-08-06,Female,66,65-69,3
25,1,0,0,1,2021-08-04,Female,52,45-54,5
25,2,0,0,2,2021-08-09,Male,69,65-69,18
25,1,4,0,5,2021-08-11,Male,68,65-69,1
25,2,0,0,2,2021-08-08,Male,48,45-54,2
25,0,4,0,4,2021-08-09,Male,45,45-54,21
25,0,0,0,0,2021-08-08,Female,81,80-84,3
25,0,0,0,0,2021-08-11,Female,70,70-74,1
25,1,0,0,1,2021-08-10,Male,55,55-64,19
25,1,0,0,1,2021-08-09,Female,66,65-69,4
25,1,0,0,1,2021-08-11,Female,18,15-19,1
25,1,1,29,31,2021-08-08,Male,72,70-74,2
25,1,4,0,5,2021-08-09,Female,70,70-74,19
25,1,0,0,1,2021-08-08,Female,81,80-84,5
25,1,0,0,1,2021-08-11,Female,69,65-69,1
25,1,10,0,11,2021-08-06,Female,60,55-64,4
25,2,0,0,2,2021-08-06,Female,66,65-69,5
25,2,1,0,3,2021-08-11,Female,4,1-4,1
25,1,0,0,1,2021-08-09,Female,74,70-74,14
25,1,1,0,2,2021-08-08,Female,69,65-69,22
25,2,2,0,4,2021-08-10,Female,53,45-54,2
25,1,6,0,7,2021-08-11,Male,44,35-44,1
25,0,3,0,3,2021-08-08,Male,43,35-44,5
25,2,2,0,4,2021-08-11,Male,15,15-19,1
25,1,0,0,1,2021-08-05,Male,55,55-64,25
25,1,0,0,1,2021-08-09,Female,50,45-54,2
25,0,11,0,11,2021-08-13,Female,21,20-24,1
25,2,0,0,2,2021-08-06,Female,62,55-64,24
25,1,3,0,4,2021-08-06,Male,53,45-54,24
25,0,4,0,4,2021-08-09,Female,66,65-69,23
25,0,45,18,63,2021-08-08,Male,45,45-54,6
25,0,0,0,0,2021-08-07,Male,66,65-69,22
25,1,3,1,5,2021-08-09,Female,60,55-64,21
25,1,0,0,1,2021-08-09,Female,24,20-24,5
25,0,0,0,0,2021-08-08,Female,69,65-69,19
25,1,6,0,7,2021-08-07,Female,65,65-69,5
25,2,0,0,2,2021-08-11,Male,37,35-44,1
25,2,0,0,2,2021-08-08,Female,14,10-14,20
25,1,3,0,4,2021-08-11,Male,12,10-14,19
25,1,0,0,1,2021-08-09,Female,63,55-64,23
25,2,0,0,2,2021-08-06,Male,56,55-64,7
25,0,1,0,1,2021-08-09,Female,53,45-54,23
25,0,6,0,6,2021-08-06,Female,61,55-64,4
25,0,2,0,2,2021-08-09,Female,66,65-69,20
25,1,0,0,1,2021-08-13,Male,28,25-34,4
25,2,0,0,2,2021-08-05,Female,53,45-54,21
25,2,0,0,2,2021-08-09,Female,48,45-54,22
25,1,0,0,1,2021-08-07,Male,67,65-69,21
25,0,0,0,0,2021-08-09,Female,68,65-69,9
25,1,0,0,1,2021-08-05,Male,31,25-34,2
25,2,0,0,2,2021-08-06,Male,8,5-9,4
25,0,0,0,0,2021-08-08,Female,45,45-54,21
25,1,0,0,1,2021-08-08,Male,72,70-74,20
25,2,0,0,2,2021-08-09,Female,68,65-69,19
25,0,0,0,0,2021-08-11,Female,11,10-14,1
25,2,2,0,4,2021-08-08,Male,24,20-24,22
25,1,4,0,5,2021-08-09,Female,67,65-69,17
25,1,2,0,3,2021-08-05,Male,59,55-64,24
25,1,6,0,7,2021-08-08,Female,66,65-69,4
25,0,0,0,0,2021-08-08,Male,50,45-54,5
25,0,6,0,6,2021-08-12,Female,23,20-24,1
25,1,0,0,1,2021-08-10,Male,67,65-69,19
25,0,2,0,2,2021-08-08,Female,72,70-74,4
25,3,0,0,3,2021-08-09,Male,4,1-4,21
25,1,2,0,3,2021-08-11,Female,28,25-34,1
25,1,1,0,2,2021-08-06,Male,63,55-64,5
25,0,0,0,0,2021-08-08,Female,51,45-54,5
25,0,0,0,0,2021-08-09,Female,65,65-69,5
25,0,0,0,0,2021-08-11,Male,22,20-24,1
25,1,0,0,1,2021-08-05,Female,59,55-64,11
25,1,0,0,1,2021-08-06,Female,63,55-64,5
25,3,0,0,3,2021-08-09,Male,18,15-19,21
25,0,0,0,0,2021-08-09,Male,50,45-54,20
25,1,0,0,1,2021-08-10,Female,67,65-69,5
25,1,0,0,1,2021-08-11,Male,42,35-44,1
25,0,0,3,3,2021-08-10,Female,26,25-34,24
25,3,0,0,3,2021-08-05,Male,30,25-34,22
25,0,0,0,0,2021-08-11,Female,26,25-34,1
25,1,7,0,8,2021-08-11,Female,56,55-64,1
25,2,2,0,4,2021-08-08,Female,11,10-14,20
25,1,4,0,5,2021-08-07,Female,70,70-74,22
25,1,2,0,3,2021-08-08,Male,67,65-69,17
25,0,4,0,4,2021-08-11,Male,62,55-64,1
25,1,0,0,1,2021-08-04,Male,52,45-54,4
25,0,5,0,5,2021-08-07,Male,67,65-69,21
25,0,1,0,1,2021-08-08,Female,49,45-54,14
25,2,2,0,4,2021-08-13,Male,10,10-14,5
25,2,0,0,2,2021-08-08,Female,68,65-69,16
25,0,0,0,0,2021-08-09,Female,67,65-69,21
25,0,0,0,0,2021-08-08,Female,50,45-54,17
25,2,0,0,2,2021-08-08,Male,43,35-44,21
25,0,2,0,2,2021-08-10,Female,77,75-79,15
25,1,0,0,1,2021-08-08,Female,73,70-74,5
25,1,0,0,1,2021-08-11,Male,73,70-74,1
25,0,0,0,0,2021-08-08,Male,41,35-44,16
25,1,1,0,2,2021-08-11,Female,42,35-44,1
25,0,11,0,11,2021-08-06,Female,61,55-64,5
25,0,4,0,4,2021-08-04,Female,54,45-54,5
25,1,0,0,1,2021-08-11,Female,54,45-54,1
25,1,0,0,1,2021-08-07,Male,68,65-69,22
25,4,0,0,4,2021-08-04,Male,9,5-9,24
25,0,1,61,62,2021-08-09,Male,65,65-69,5
25,2,0,0,2,2021-08-08,Female,1,1-4,5
25,1,0,0,1,2021-08-06,Male,32,25-34,4
25,4,0,0,4,2021-08-10,Male,77,75-79,5
25,2,0,0,2,2021-08-09,Male,44,35-44,7
25,0,0,0,0,2021-08-04,Male,24,20-24,6
25,3,0,0,3,2021-08-11,Male,8,5-9,1
25,3,0,0,3,2021-08-06,Male,31,25-34,7
25,2,1,0,3,2021-08-08,Female,73,70-74,5
25,4,0,0,4,2021-08-08,Female,4,1-4,7
25,1,0,0,1,2021-08-05,Male,57,55-64,5
25,1,0,0,1,2021-08-04,Female,52,45-54,5
25,2,0,0,2,2021-08-09,Female,4,1-4,19
25,3,0,0,3,2021-08-10,Female,33,25-34,18
25,0,0,0,0,2021-08-10,Male,57,55-64,4
25,2,0,0,2,2021-08-04,Male,52,45-54,20
25,0,0,0,0,2021-08-08,Male,66,65-69,4
25,6,0,0,6,2021-08-11,Female,4,1-4,1
25,2,0,0,2,2021-08-06,Male,61,55-64,21
25,0,2,0,2,2021-08-09,Male,51,45-54,4
25,1,2,0,3,2021-08-09,Female,65,65-69,5
25,0,6,0,6,2021-08-06,Female,62,55-64,20
25,3,0,0,3,2021-08-11,Male,60,55-64,1
25,1,1,0,2,2021-08-06,Male,66,65-69,23
25,2,1,0,3,2021-08-04,Female,23,20-24,3
25,3,3,0,6,2021-08-09,Male,8,5-9,5
25,1,0,0,1,2021-08-09,Female,40,35-44,19
25,0,4,0,4,2021-08-09,Male,51,45-54,5
25,0,0,0,0,2021-08-11,Female,63,55-64,1
25,1,0,0,1,2021-08-05,Male,59,55-64,2
25,0,0,0,0,2021-08-11,Male,58,55-64,3
25,1,0,17,18,2021-08-08,Male,46,45-54,5
25,2,0,0,2,2021-08-04,Female,18,15-19,2
25,3,4,0,7,2021-08-05,Male,53,45-54,24
25,1,0,2,3,2021-08-11,Female,65,65-69,3
25,0,0,0,0,2021-08-05,Male,57,55-64,5
25,0,0,0,0,2021-08-04,Male,52,45-54,19
25,0,11,0,11,2021-08-06,Female,62,55-64,4
25,1,0,0,1,2021-08-11,Male,54,45-54,1
25,1,0,0,1,2021-08-07,Male,69,65-69,4
25,0,0,0,0,2021-08-06,Female,61,55-64,19
25,1,1,0,2,2021-08-07,Female,70,70-74,5
25,0,0,0,0,2021-08-05,Female,6,5-9,2
25,0,0,0,0,2021-08-08,Female,17,15-19,13
25,1,1,0,2,2021-08-09,Female,54,45-54,24
25,0,0,0,0,2021-08-09,Female,76,75-79,4
25,1,0,0,1,2021-08-11,Male,27,25-34,1
25,0,4,0,4,2021-08-11,Female,30,25-34,1
25,1,0,0,1,2021-08-09,Female,42,35-44,13
25,0,0,0,0,2021-08-11,Female,51,45-54,1
25,0,0,0,0,2021-08-07,Male,67,65-69,17
25,1,0,0,1,2021-08-07,Male,67,65-69,22
25,3,0,0,3,2021-08-04,Male,18,15-19,4
25,0,0,0,0,2021-08-07,Male,41,35-44,22
25,0,0,0,0,2021-08-09,Male,60,55-64,21
25,0,6,0,6,2021-08-07,Male,42,35-44,25
25,0,0,0,0,2021-08-07,Male,67,65-69,24
25,3,3,0,6,2021-08-06,Female,31,25-34,5
25,0,0,0,0,2021-08-09,Female,35,35-44,20
25,2,17,0,19,2021-08-07,Female,4,1-4,6
25,1,0,0,1,2021-08-06,Male,64,55-64,20
25,0,0,0,0,2021-08-07,Female,69,65-69,21
25,2,0,0,2,2021-08-09,Male,51,45-54,15
25,0,0,0,0,2021-08-04,Male,18,15-19,4
25,1,1,0,2,2021-08-10,Male,52,45-54,2
25,3,0,0,3,2021-08-10,Male,3,1-4,22
25,2,1,0,3,2021-08-10,Female,54,45-54,2
25,0,2,0,2,2021-08-06,Female,65,65-69,3
25,1,1,0,2,2021-08-08,Male,48,45-54,20
25,0,0,0,0,2021-08-11,Male,20,20-24,1
25,3,0,0,3,2021-08-09,Male,11,10-14,11
25,1,15,20,36,2021-08-11,Male,66,65-69,1
25,0,1,0,1,2021-08-07,Female,35,35-44,19
25,0,0,0,0,2021-08-10,Female,47,45-54,5
25,1,0,0,1,2021-08-06,Male,62,55-64,10
25,0,2,0,2,2021-08-06,Female,27,25-34,4
25,1,2,0,3,2021-08-11,Male,74,70-74,1
25,1,2,0,3,2021-08-06,Male,62,55-64,24
25,0,0,6,6,2021-08-09,Female,24,20-24,12
25,0,6,0,6,2021-08-07,Female,68,65-69,25
25,0,2,0,2,2021-08-09,Male,11,10-14,23
25,1,0,0,1,2021-08-07,Female,37,35-44,4
25,0,0,0,0,2021-08-06,Male,65,65-69,5
25,2,0,0,2,2021-08-08,Male,78,75-79,18
25,1,0,0,1,2021-08-11,Female,34,25-34,1
25,5,0,0,5,2021-08-08,Female,38,35-44,20
25,0,2,0,2,2021-08-06,Female,57,55-64,4
25,0,0,0,0,2021-08-09,Female,17,15-19,17
25,0,0,0,0,2021-08-06,Male,34,25-34,5
25,0,2,0,2,2021-08-10,Male,47,45-54,21
25,1,0,0,1,2021-08-08,Male,66,65-69,4
25,3,1,0,4,2021-08-11,Female,0,<1,1
25,1,0,0,1,2021-08-07,Male,71,70-74,5
25,0,0,0,0,2021-08-08,Male,34,25-34,4
25,1,4,0,5,2021-08-05,Female,18,15-19,5
25,1,0,0,1,2021-08-07,Male,67,65-69,20
25,4,0,0,4,2021-08-07,Female,17,15-19,15
25,2,0,0,2,2021-08-10,Male,51,45-54,16
25,0,0,0,0,2021-08-11,Male,32,25-34,1
25,2,1,0,3,2021-08-10,Female,66,65-69,19
25,0,0,0,0,2021-08-09,Male,68,65-69,5
25,1,0,0,1,2021-08-11,Female,27,25-34,1
25,0,1,0,1,2021-08-11,Female,60,55-64,1
25,1,3,0,4,2021-08-12,Female,24,20-24,1
25,3,0,0,3,2021-08-08,Female,19,15-19,8
25,0,0,0,0,2021-08-08,Male,28,25-34,21
25,0,0,0,0,2021-08-11,Female,27,25-34,1
25,1,0,0,1,2021-08-08,Female,72,70-74,5
25,0,1,0,1,2021-08-13,Male,48,45-54,21
25,0,0,0,0,2021-08-05,Male,2,1-4,6
25,1,0,0,1,2021-08-07,Male,70,70-74,5
25,0,1,0,1,2021-08-07,Male,34,25-34,5
25,3,0,0,3,2021-08-10,Female,19,15-19,5
25,2,2,0,4,2021-08-11,Female,11,10-14,1
25,0,0,0,0,2021-08-04,Male,52,45-54,22
25,3,0,0,3,2021-08-13,Male,4,1-4,1
25,1,0,0,1,2021-08-08,Male,76,75-79,5
25,1,0,0,1,2021-08-11,Male,65,65-69,1
25,2,1,0,3,2021-08-04,Female,22,20-24,18
25,0,0,0,0,2021-08-07,Female,38,35-44,5
25,0,3,0,3,2021-08-09,Female,56,55-64,5
25,0,0,0,0,2021-08-04,Male,54,45-54,2
25,0,0,0,0,2021-08-06,Female,56,55-64,4
25,4,0,0,4,2021-08-09,Female,2,1-4,16
25,1,0,0,1,2021-08-07,Female,55,55-64,4
25,2,0,0,2,2021-08-06,Male,62,55-64,20
25,0,1,0,1,2021-08-05,Female,31,25-34,10
25,0,5,0,5,2021-08-05,Male,58,55-64,2
25,0,0,0,0,2021-08-11,Male,61,55-64,1
25,2,0,0,2,2021-08-08,Male,10,10-14,24
25,0,0,0,0,2021-08-11,Male,42,35-44,1
25,1,0,0,1,2021-08-09,Male,71,70-74,9
25,2,0,0,2,2021-08-07,Male,18,15-19,5
25,2,1,0,3,2021-08-06,Female,63,55-64,21
25,2,0,0,2,2021-08-06,Female,65,65-69,25
25,1,3,0,4,2021-08-08,Female,74,70-74,23
25,1,2,0,3,2021-08-11,Male,69,65-69,1
25,0,5,0,5,2021-08-09,Male,41,35-44,4
25,0,0,0,0,2021-08-04,Male,54,45-54,17
25,1,0,0,1,2021-08-06,Female,65,65-69,5
25,3,0,0,3,2021-08-05,Female,13,10-14,5
25,1,0,0,1,2021-08-05,Male,52,45-54,4
25,0,0,0,0,2021-08-07,Male,68,65-69,3
25,0,4,0,4,2021-08-09,Female,51,45-54,5
25,0,3,0,3,2021-08-10,Male,72,70-74,14
25,0,0,0,0,2021-08-04,Female,54,45-54,19
25,1,4,0,5,2021-08-04,Female,54,45-54,6
25,1,0,0,1,2021-08-06,Female,34,25-34,17
25,2,0,0,2,2021-08-06,Male,6,5-9,17
25,0,4,2,6,2021-08-11,Female,31,25-34,1
25,0,10,0,10,2021-08-11,Female,65,65-69,1
25,0,0,0,0,2021-08-11,Male,78,75-79,1
25,0,0,0,0,2021-08-11,Female,21,20-24,1
25,1,0,0,1,2021-08-08,Female,51,45-54,21
25,2,0,0,2,2021-08-05,Male,57,55-64,21
25,0,2,0,2,2021-08-08,Male,51,45-54,7
25,0,0,0,0,2021-08-08,Female,43,35-44,12
25,0,0,0,0,2021-08-11,Female,30,25-34,1
25,0,1,0,1,2021-08-06,Female,62,55-64,17
25,0,0,0,0,2021-08-06,Female,60,55-64,20
25,2,0,0,2,2021-08-07,Male,66,65-69,24
25,0,0,0,0,2021-08-07,Female,36,35-44,10
25,2,0,0,2,2021-08-09,Male,71,70-74,13
25,0,0,0,0,2021-08-06,Male,62,55-64,24
25,0,1,0,1,2021-08-06,Male,66,65-69,24
25,1,0,0,1,2021-08-05,Female,56,55-64,16
25,0,0,0,0,2021-08-09,Male,60,55-64,5
25,0,0,0,0,2021-08-06,Male,34,25-34,19
25,1,0,0,1,2021-08-05,Female,59,55-64,23
25,0,0,0,0,2021-08-04,Male,54,45-54,5
25,2,0,0,2,2021-08-08,Male,73,70-74,20
25,1,0,0,1,2021-08-07,Female,67,65-69,5
25,1,0,0,1,2021-08-10,Male,48,45-54,4
25,2,0,0,2,2021-08-05,Female,1,1-4,5
25,2,0,0,2,2021-08-08,Male,74,70-74,13
25,0,0,0,0,2021-08-05,Female,30,25-34,5
25,2,0,0,2,2021-08-07,Male,34,25-34,19
25,0,0,0,0,2021-08-07,Female,37,35-44,18
25,1,0,0,1,2021-08-09,Male,63,55-64,16
25,1,3,0,4,2021-08-08,Female,47,45-54,16
25,2,0,0,2,2021-08-07,Female,23,20-24,16
25,0,0,0,0,2021-08-06,Male,63,55-64,20
25,0,1,0,1,2021-08-07,Female,21,20-24,5
25,0,0,0,0,2021-08-07,Female,69,65-69,20
25,2,4,0,6,2021-08-08,Female,66,65-69,20
25,0,0,0,0,2021-08-05,Male,54,45-54,22
25,0,2,0,2,2021-08-07,Male,32,25-34,4
25,0,0,0,0,2021-08-06,Female,36,35-44,17
25,4,0,0,4,2021-08-11,Female,23,20-24,2
25,2,0,0,2,2021-08-11,Male,19,15-19,1
25,0,0,0,0,2021-08-05,Male,57,55-64,22
25,0,4,0,4,2021-08-09,Female,56,55-64,23
25,1,1,0,2,2021-08-04,Female,27,25-34,4
25,0,0,0,0,2021-08-07,Female,68,65-69,24
25,3,1,0,4,2021-08-11,Male,4,1-4,1
25,2,0,0,2,2021-08-09,Female,13,10-14,3
25,2,1,0,3,2021-08-08,Male,42,35-44,16
25,0,0,0,0,2021-08-07,Female,68,65-69,8
25,1,1,0,2,2021-08-08,Male,73,70-74,18
25,1,0,0,1,2021-08-04,Female,24,20-24,11
25,0,1,0,1,2021-08-11,Male,24,20-24,1
25,1,0,0,1,2021-08-08,Female,73,70-74,17
25,0,1,0,1,2021-08-11,Female,25,25-34,1
25,2,2,0,4,2021-08-11,Male,9,5-9,1
25,0,0,0,0,2021-08-08,Female,50,45-54,5
25,3,2,0,5,2021-08-09,Male,13,10-14,4
25,0,0,0,0,2021-08-11,Male,44,35-44,1
25,1,0,0,1,2021-08-10,Female,56,55-64,12
25,2,2,0,4,2021-08-04,Male,26,25-34,2
25,2,0,0,2,2021-08-08,Female,51,45-54,21
25,0,3,0,3,2021-08-09,Female,60,55-64,4
25,0,0,0,0,2021-08-07,Male,67,65-69,25
25,3,0,0,3,2021-08-11,Male,35,35-44,1
25,2,0,0,2,2021-08-08,Male,3,1-4,5
25,2,1,3,6,2021-08-04,Male,18,15-19,2
25,0,0,0,0,2021-08-04,Female,27,25-34,20
25,0,0,0,0,2021-08-09,Female,75,75-79,17
25,1,1,0,2,2021-08-10,Male,81,80-84,19
25,0,0,0,0,2021-08-07,Male,61,55-64,19
25,1,0,0,1,2021-08-04,Female,54,45-54,22
25,0,4,0,4,2021-08-05,Female,58,55-64,5
25,1,1,0,2,2021-08-10,Male,63,55-64,23
25,2,0,0,2,2021-08-04,Male,20,20-24,5
25,0,1,0,1,2021-08-07,Female,67,65-69,5
25,1,0,0,1,2021-08-11,Male,58,55-64,1
25,0,1,0,1,2021-08-09,Female,68,65-69,16
25,1,0,0,1,2021-08-07,Female,68,65-69,5
25,1,4,0,5,2021-08-06,Female,28,25-34,23
25,0,0,0,0,2021-08-06,Male,27,25-34,5
25,0,0,0,0,2021-08-08,Female,10,10-14,20
25,0,0,0,0,2021-08-10,Female,74,70-74,2
25,0,0,0,0,2021-08-04,Male,54,45-54,21
25,3,0,0,3,2021-08-06,Male,3,1-4,7
25,2,1,0,3,2021-08-09,Male,4,1-4,5
25,2,11,0,13,2021-08-11,Female,3,1-4,1
25,3,6,0,9,2021-08-11,Female,2,1-4,1
25,0,6,0,6,2021-08-04,Female,54,45-54,4
25,1,0,0,1,2021-08-07,Female,64,55-64,5
25,0,0,0,0,2021-08-12,Male,19,15-19,1
25,2,1,0,3,2021-08-07,Male,17,15-19,15
25,1,2,0,3,2021-08-07,Male,71,70-74,4
25,1,0,0,1,2021-08-06,Male,35,35-44,24
25,0,1,0,1,2021-08-06,Female,36,35-44,7
25,0,7,0,7,2021-08-08,Female,72,70-74,23
25,1,0,0,1,2021-08-09,Female,54,45-54,5
25,0,0,0,0,2021-08-10,Female,63,55-64,12
25,1,0,0,1,2021-08-11,Male,58,55-64,1
25,0,0,0,0,2021-08-11,Female,51,45-54,1
25,1,0,0,1,2021-08-07,Male,33,25-34,20
25,0,0,0,0,2021-08-09,Female,43,35-44,22
25,2,4,0,6,2021-08-08,Female,72,70-74,18
25,0,1,0,1,2021-08-07,Male,59,55-64,19
25,1,0,0,1,2021-08-09,Female,55,55-64,5
25,0,6,0,6,2021-08-10,Male,55,55-64,19
25,3,2,0,5,2021-08-07,Female,37,35-44,24
25,1,0,0,1,2021-08-05,Female,60,55-64,23
25,0,0,0,0,2021-08-04,Female,6,5-9,6
25,1,1,0,2,2021-08-07,Male,70,70-74,17
25,1,1,0,2,2021-08-07,Male,67,65-69,23
25,2,0,0,2,2021-08-10,Male,6,5-9,5
25,0,0,0,0,2021-08-11,Male,44,35-44,1
25,0,0,0,0,2021-08-05,Male,60,55-64,5
25,3,0,0,3,2021-08-09,Male,49,45-54,16
25,0,4,0,4,2021-08-11,Male,61,55-64,1
25,0,1,0,1,2021-08-09,Female,49,45-54,10
25,1,2,25,28,2021-08-11,Female,24,20-24,1
25,0,0,0,0,2021-08-09,Female,48,45-54,5
25,0,0,0,0,2021-08-04,Male,53,45-54,23
25,1,3,0,4,2021-08-11,Male,15,15-19,1
25,1,3,0,4,2021-08-08,Female,76,75-79,17
25,2,0,0,2,2021-08-13,Male,9,5-9,5
25,0,1,0,1,2021-08-04,Male,26,25-34,13
25,3,0,0,3,2021-08-11,Female,70,70-74,1
25,3,0,0,3,2021-08-09,Male,18,15-19,15
25,1,0,1,2,2021-08-08,Female,43,35-44,4
25,0,1,0,1,2021-08-08,Female,41,35-44,2
25,0,3,0,3,2021-08-11,Male,40,35-44,3
25,0,0,0,0,2021-08-11,Female,68,65-69,1
25,0,0,0,0,2021-08-09,Male,75,75-79,19
25,2,0,0,2,2021-08-06,Male,18,15-19,5
25,0,0,0,0,2021-08-06,Male,37,35-44,12
25,0,0,0,0,2021-08-07,Male,36,35-44,11
25,0,0,0,0,2021-08-08,Male,74,70-74,10
25,0,0,0,0,2021-08-11,Male,65,65-69,1
25,0,1,0,1,2021-08-07,Female,66,65-69,24
25,0,0,0,0,2021-08-11,Male,70,70-74,1
25,0,1,0,1,2021-08-04,Female,54,45-54,19
25,0,0,0,0,2021-08-11,Male,54,45-54,1
25,0,3,0,3,2021-08-11,Male,52,45-54,1
25,1,0,0,1,2021-08-08,Female,46,45-54,22
25,1,0,0,1,2021-08-07,Female,48,45-54,5
25,1,5,0,6,2021-08-06,Female,21,20-24,5
25,1,0,0,1,2021-08-11,Male,63,55-64,1
25,1,0,0,1,2021-08-09,Female,33,25-34,3
25,1,0,0,1,2021-08-04,Male,54,45-54,20
25,0,10,0,10,2021-08-11,Female,27,25-34,1
25,0,0,0,0,2021-08-10,Male,71,70-74,5
25,1,0,0,1,2021-08-12,Female,19,15-19,1
25,0,0,0,0,2021-08-08,Female,63,55-64,22
25,2,4,0,6,2021-08-11,Male,3,1-4,1
25,2,5,0,7,2021-08-08,Male,75,75-79,18
25,1,0,0,1,2021-08-08,Female,71,70-74,24
25,1,1,0,2,2021-08-04,Female,54,45-54,12
25,2,0,0,2,2021-08-06,Female,63,55-64,12
25,1,0,22,23,2021-08-09,Male,74,70-74,17
25,3,0,0,3,2021-08-06,Male,61,55-64,5
25,0,1,0,1,2021-08-05,Male,28,25-34,23
25,1,0,0,1,2021-08-05,Male,29,25-34,25
25,0,1,0,1,2021-08-08,Female,32,25-34,19
25,0,0,0,0,2021-08-07,Female,65,65-69,19
25,2,0,0,2,2021-08-07,Male,42,35-44,22
25,3,0,0,3,2021-08-09,Female,1,1-4,6
25,0,1,0,1,2021-08-08,Male,71,70-74,23
25,1,2,0,3,2021-08-11,Female,34,25-34,1
25,2,0,0,2,2021-08-11,Male,43,35-44,1
25,1,0,0,1,2021-08-11,Female,60,55-64,1
25,1,0,0,1,2021-08-08,Male,51,45-54,4
25,0,3,0,3,2021-08-07,Female,69,65-69,25
25,1,2,0,3,2021-08-07,Male,67,65-69,5
25,1,0,0,1,2021-08-08,Female,80,80-84,5
25,0,0,0,0,2021-08-08,Male,65,65-69,3
25,2,0,0,2,2021-08-13,Male,45,45-54,1
25,1,2,0,3,2021-08-09,Male,73,70-74,10
25,1,0,8,9,2021-08-10,Male,77,75-79,4
25,0,0,0,0,2021-08-06,Male,61,55-64,19
25,0,0,0,0,2021-08-11,Male,27,25-34,1
25,0,40,0,40,2021-08-07,Female,40,35-44,5
25,0,0,0,0,2021-08-09,Female,35,35-44,21
25,1,0,0,1,2021-08-07,Male,69,65-69,24
25,0,0,0,0,2021-08-08,Male,51,45-54,2
25,2,0,0,2,2021-08-07,Female,67,65-69,18
25,0,0,0,0,2021-08-07,Female,41,35-44,12
25,1,0,0,1,2021-08-07,Male,65,65-69,5
25,1,5,0,6,2021-08-08,Male,69,65-69,23
25,3,10,0,13,2021-08-08,Male,17,15-19,18
25,1,0,0,1,2021-08-08,Female,44,35-44,2
25,0,0,0,0,2021-08-05,Male,36,35-44,2
25,0,0,0,0,2021-08-08,Female,57,55-64,24
25,1,0,0,1,2021-08-06,Male,11,10-14,5
25,1,0,0,1,2021-08-08,Male,67,65-69,20
25,1,0,0,1,2021-08-05,Male,56,55-64,19
25,3,0,0,3,2021-08-09,Male,5,5-9,19
25,1,3,0,4,2021-08-09,Male,44,35-44,4
25,1,0,0,1,2021-08-08,Male,43,35-44,18
25,1,1,1,3,2021-08-08,Male,38,35-44,4
25,4,1,0,5,2021-08-11,Male,0,<1,1
25,0,0,0,0,2021-08-05,Female,54,45-54,17
25,1,1,0,2,2021-08-11,Male,72,70-74,5
25,0,0,0,0,2021-08-11,Female,55,55-64,16
25,0,0,0,0,2021-08-06,Female,60,55-64,25
25,3,0,0,3,2021-08-09,Female,2,1-4,21
25,1,0,0,1,2021-08-10,Female,60,55-64,19
25,3,0,0,3,2021-08-09,Male,1,1-4,5
25,1,2,1,4,2021-08-09,Male,63,55-64,4
25,2,0,0,2,2021-08-08,Male,72,70-74,4
25,0,4,0,4,2021-08-07,Male,58,55-64,4
25,4,0,0,4,2021-08-05,Female,55,55-64,19
25,0,2,0,2,2021-08-07,Male,66,65-69,5
25,2,0,0,2,2021-08-05,Female,56,55-64,21
25,1,0,0,1,2021-08-05,Male,59,55-64,3
25,0,0,0,0,2021-08-05,Female,21,20-24,5
25,1,1,0,2,2021-08-06,Female,61,55-64,24
25,0,2,0,2,2021-08-07,Female,41,35-44,5
25,0,1,0,1,2021-08-07,Male,70,70-74,24
25,3,0,0,3,2021-08-08,Male,48,45-54,16
25,0,1,0,1,2021-08-05,Female,55,55-64,19
25,0,0,0,0,2021-08-11,Male,83,80-84,1
25,0,0,0,0,2021-08-06,Male,33,25-34,9
25,1,0,0,1,2021-08-09,Female,26,25-34,3
25,1,2,0,3,2021-08-09,Female,56,55-64,16
25,1,0,0,1,2021-08-07,Female,67,65-69,3
25,2,0,0,2,2021-08-08,Male,1,1-4,5
25,1,2,0,3,2021-08-04,Female,52,45-54,23
25,1,1,0,2,2021-08-06,Male,65,65-69,4
25,3,0,0,3,2021-08-09,Female,11,10-14,5
25,0,0,0,0,2021-08-07,Male,39,35-44,2
25,1,6,0,7,2021-08-11,Female,69,65-69,1
25,2,6,0,8,2021-08-08,Male,72,70-74,20
25,0,1,0,1,2021-08-09,Female,63,55-64,3
25,1,0,0,1,2021-08-11,Female,30,25-34,1
25,1,0,0,1,2021-08-07,Male,68,65-69,5
25,2,0,0,2,2021-08-08,Male,78,75-79,19
25,0,2,0,2,2021-08-07,Female,68,65-69,4
25,2,0,0,2,2021-08-07,Male,14,10-14,5
25,2,13,3,18,2021-08-11,Female,30,25-34,1
25,2,0,0,2,2021-08-04,Male,52,45-54,18
25,0,11,0,11,2021-08-05,Male,56,55-64,5
25,1,0,0,1,2021-08-11,Male,65,65-69,1
25,0,0,0,0,2021-08-04,Male,52,45-54,21
25,2,0,0,2,2021-08-11,Male,52,45-54,1
25,3,0,0,3,2021-08-07,Female,15,15-19,21
25,1,2,0,3,2021-08-07,Female,40,35-44,5
25,0,0,0,0,2021-08-08,Female,70,70-74,5
25,2,0,0,2,2021-08-12,Female,7,5-9,1
25,1,0,0,1,2021-08-09,Female,66,65-69,24
25,5,0,0,5,2021-08-05,Female,52,45-54,17
25,2,0,0,2,2021-08-08,Female,38,35-44,20
25,1,1,0,2,2021-08-11,Male,66,65-69,1
25,0,3,0,3,2021-08-06,Male,33,25-34,2
25,0,0,0,0,2021-08-08,Female,43,35-44,5
25,0,0,0,0,2021-08-09,Male,58,55-64,17
25,2,1,0,3,2021-08-12,Male,18,15-19,1
25,0,0,0,0,2021-08-08,Male,72,70-74,3
25,1,0,12,13,2021-08-05,Male,11,10-14,5
25,1,7,0,8,2021-08-04,Male,54,45-54,2
25,1,1,0,2,2021-08-05,Female,52,45-54,5
25,3,2,0,5,2021-08-07,Female,5,5-9,2
25,1,0,6,7,2021-08-08,Female,49,45-54,16
25,0,1,0,1,2021-08-10,Female,18,15-19,3
25,0,0,0,0,2021-08-11,Male,67,65-69,1
25,0,2,0,2,2021-08-05,Male,60,55-64,18
25,0,13,0,13,2021-08-11,Female,50,45-54,1
25,0,0,0,0,2021-08-04,Female,56,55-64,22
25,1,0,0,1,2021-08-09,Male,19,15-19,4
25,3,0,0,3,2021-08-06,Female,65,65-69,21
25,0,0,0,0,2021-08-09,Male,37,35-44,20
25,2,2,0,4,2021-08-08,Female,48,45-54,4
25,3,3,0,6,2021-08-05,Female,4,1-4,14
25,2,0,0,2,2021-08-05,Female,54,45-54,11
25,1,10,0,11,2021-08-04,Male,15,15-19,12
25,2,0,0,2,2021-08-06,Male,64,55-64,19
25,1,0,0,1,2021-08-04,Male,52,45-54,16
25,0,0,0,0,2021-08-09,Male,75,75-79,16
25,0,4,0,4,2021-08-07,Male,18,15-19,5
25,2,3,0,5,2021-08-11,Male,12,10-14,1
25,1,3,0,4,2021-08-08,Female,74,70-74,15
25,1,1,0,2,2021-08-08,Female,17,15-19,21
25,0,8,1,9,2021-08-06,Male,62,55-64,21
25,3,2,62,67,2021-08-12,Female,18,15-19,1
25,2,0,0,2,2021-08-08,Male,16,15-19,12
25,1,9,0,10,2021-08-08,Male,51,45-54,12
25,3,0,0,3,2021-08-06,Male,32,25-34,5
25,0,0,0,0,2021-08-07,Female,41,35-44,4
25,0,0,0,0,2021-08-11,Female,69,65-69,1
25,1,0,0,1,2021-08-11,Male,19,15-19,1
25,0,0,0,0,2021-08-04,Male,54,45-54,16
25,1,1,0,2,2021-08-05,Male,52,45-54,11
25,1,0,0,1,2021-08-06,Male,65,65-69,5
25,1,1,0,2,2021-08-12,Female,22,20-24,1
25,1,0,0,1,2021-08-04,Male,54,45-54,20
25,0,0,0,0,2021-08-11,Male,57,55-64,1
25,2,1,0,3,2021-08-06,Female,66,65-69,23
25,3,2,10,15,2021-08-05,Male,29,25-34,4
25,1,0,0,1,2021-08-06,Male,62,55-64,22
25,0,0,0,0,2021-08-07,Male,42,35-44,5
25,0,1,0,1,2021-08-06,Male,64,55-64,5
25,1,0,0,1,2021-08-09,Male,17,15-19,20
25,0,1,0,1,2021-08-04,Male,19,15-19,14
25,0,3,0,3,2021-08-04,Male,53,45-54,20
25,1,1,0,2,2021-08-06,Female,62,55-64,5
25,1,0,0,1,2021-08-09,Female,51,45-54,18
25,0,0,0,0,2021-08-06,Female,61,55-64,21
25,3,0,0,3,2021-08-04,Male,12,10-14,24
25,1,0,0,1,2021-08-09,Female,27,25-34,12
25,0,0,0,0,2021-08-09,Male,41,35-44,18
25,0,0,0,0,2021-08-07,Male,40,35-44,5
25,2,0,0,2,2021-08-05,Female,24,20-24,2
25,2,0,0,2,2021-08-09,Female,60,55-64,10
25,1,0,0,1,2021-08-10,Female,51,45-54,5
25,1,2,0,3,2021-08-11,Female,34,25-34,1
25,0,3,0,3,2021-08-07,Male,68,65-69,5
25,1,0,20,21,2021-08-07,Male,39,35-44,5
25,0,0,0,0,2021-08-08,Female,38,35-44,5
25,0,0,0,0,2021-08-07,Female,66,65-69,23
25,0,0,0,0,2021-08-07,Female,39,35-44,4
25,0,1,0,1,2021-08-08,Male,64,55-64,14
25,1,3,0,4,2021-08-07,Male,68,65-69,13
25,1,1,0,2,2021-08-08,Male,38,35-44,21
25,1,1,0,2,2021-08-07,Male,56,55-64,6
25,2,0,0,2,2021-08-11,Male,5,5-9,1
25,1,1,0,2,2021-08-06,Female,64,55-64,18
25,0,0,0,0,2021-08-08,Female,68,65-69,24
25,0,0,0,0,2021-08-06,Male,61,55-64,5
25,1,0,0,1,2021-08-05,Male,59,55-64,5
25,0,0,0,0,2021-08-08,Female,44,35-44,16
25,0,4,0,4,2021-08-06,Male,65,65-69,5
25,1,3,0,4,2021-08-10,Female,40,35-44,19
25,1,0,0,1,2021-08-08,Male,46,45-54,5
25,0,3,0,3,2021-08-07,Female,68,65-69,22
25,1,0,0,1,2021-08-05,Male,7,5-9,2
25,1,0,0,1,2021-08-09,Female,38,35-44,15
25,0,0,0,0,2021-08-07,Female,6,5-9,10
25,1,0,0,1,2021-08-09,Female,56,55-64,2
25,1,0,0,1,2021-08-09,Female,52,45-54,24
25,2,0,0,2,2021-08-11,Female,50,45-54,1
25,2,11,0,13,2021-08-07,Female,55,55-64,14
25,0,0,0,0,2021-08-05,Female,15,15-19,20
25,0,0,0,0,2021-08-08,Female,44,35-44,20
25,2,0,2,4,2021-08-11,Male,10,10-14,1
25,1,0,0,1,2021-08-09,Male,67,65-69,16
25,2,0,0,2,2021-08-06,Female,63,55-64,22
25,0,5,0,5,2021-08-11,Female,52,45-54,18
25,1,0,1,2,2021-08-08,Male,78,75-79,4
25,1,0,0,1,2021-08-06,Male,62,55-64,5
25,0,0,0,0,2021-08-11,Female,28,25-34,1
25,1,0,0,1,2021-08-08,Female,73,70-74,19
25,0,0,0,0,2021-08-04,Male,26,25-34,5
25,1,30,0,31,2021-08-11,Female,26,25-34,1
25,1,4,0,5,2021-08-08,Male,79,75-79,20
25,4,0,0,4,2021-08-09,Female,12,10-14,5
25,1,4,8,13,2021-08-06,Female,63,55-64,16
25,1,0,0,1,2021-08-06,Male,31,25-34,5
25,3,2,0,5,2021-08-11,Female,11,10-14,1
25,2,0,0,2,2021-08-07,Male,69,65-69,22
25,1,0,0,1,2021-08-05,Female,56,55-64,22
25,2,1,0,3,2021-08-06,Female,62,55-64,16
25,1,16,0,17,2021-08-11,Female,32,25-34,1
25,1,0,0,1,2021-08-06,Female,62,55-64,20
25,1,3,0,4,2021-08-07,Male,68,65-69,18
25,3,0,0,3,2021-08-09,Female,48,45-54,5
25,3,0,0,3,2021-08-10,Male,9,5-9,2
25,1,3,0,4,2021-08-06,Male,65,65-69,25
25,1,0,0,1,2021-08-06,Male,65,65-69,4
25,0,0,0,0,2021-08-06,Female,30,25-34,5
25,2,1,0,3,2021-08-08,Male,74,70-74,22
25,1,0,0,1,2021-08-11,Female,30,25-34,1
25,1,0,0,1,2021-08-09,Female,65,65-69,21
25,2,0,0,2,2021-08-09,Male,55,55-64,20
25,1,0,0,1,2021-08-09,Male,71,70-74,3
25,3,6,0,9,2021-08-11,Male,14,10-14,1
25,0,2,0,2,2021-08-09,Female,67,65-69,20
25,1,0,0,1,2021-08-04,Male,48,45-54,5
25,1,2,0,3,2021-08-07,Male,66,65-69,5
25,0,0,0,0,2021-08-04,Male,12,10-14,10
25,1,3,0,4,2021-08-11,Female,24,20-24,5
25,0,0,0,0,2021-08-07,Female,38,35-44,9
25,0,0,0,0,2021-08-13,Male,46,45-54,5
25,0,1,0,1,2021-08-09,Female,72,70-74,22
25,2,1,0,3,2021-08-08,Female,72,70-74,21
25,1,2,0,3,2021-08-08,Female,50,45-54,23
25,3,0,0,3,2021-08-07,Female,59,55-64,21
25,0,0,0,0,2021-08-06,Female,34,25-34,20
25,0,0,0,0,2021-08-11,Male,27,25-34,1
25,2,0,0,2,2021-08-08,Female,2,1-4,16
25,0,0,0,0,2021-08-04,Female,53,45-54,5
25,0,0,0,0,2021-08-05,Male,22,20-24,23
25,1,0,0,1,2021-08-11,Male,8,5-9,1
25,0,0,0,0,2021-08-05,Male,55,55-64,24
25,0,0,0,0,2021-08-09,Female,44,35-44,4
25,0,0,0,0,2021-08-07,Male,53,45-54,18
25,0,0,0,0,2021-08-09,Female,37,35-44,23
25,3,19,0,22,2021-08-10,Female,5,5-9,21
25,1,0,0,1,2021-08-05,Male,55,55-64,21
25,1,3,0,4,2021-08-09,Male,64,55-64,5
25,2,4,0,6,2021-08-07,Male,62,55-64,21
25,0,0,0,0,2021-08-08,Male,41,35-44,10
25,1,0,0,1,2021-08-09,Female,57,55-64,20
25,1,0,0,1,2021-08-07,Female,68,65-69,20
25,0,0,0,0,2021-08-08,Female,85,85+,13
25,0,0,0,0,2021-08-08,Female,71,70-74,23
25,1,3,0,4,2021-08-08,Male,74,70-74,25
25,1,0,0,1,2021-08-07,Female,66,65-69,17
25,3,0,0,3,2021-08-06,Male,12,10-14,12
25,0,5,7,12,2021-08-08,Male,74,70-74,21
25,1,1,0,2,2021-08-05,Male,55,55-64,5
25,1,3,0,4,2021-08-11,Male,71,70-74,1
25,1,0,0,1,2021-08-05,Male,59,55-64,5
25,1,4,0,5,2021-08-07,Male,68,65-69,3
25,1,0,0,1,2021-08-05,Female,28,25-34,5
25,0,0,0,0,2021-08-11,Male,62,55-64,1
25,0,0,0,0,2021-08-07,Female,13,10-14,16
25,1,7,0,8,2021-08-08,Male,67,65-69,18
25,1,0,0,1,2021-08-11,Male,44,35-44,1
25,1,0,0,1,2021-08-06,Female,61,55-64,22
25,0,0,0,0,2021-08-09,Male,33,25-34,5
25,1,3,0,4,2021-08-07,Female,67,65-69,17
25,0,0,0,0,2021-08-06,Male,32,25-34,5
25,1,1,0,2,2021-08-07,Male,67,65-69,20
25,4,0,0,4,2021-08-08,Male,23,20-24,3
25,2,2,0,4,2021-08-09,Male,1,1-4,3
25,1,0,0,1,2021-08-10,Male,71,70-74,13
25,1,0,0,1,2021-08-08,Male,42,35-44,2
25,1,0,0,1,2021-08-04,Male,53,45-54,5
25,0,0,0,0,2021-08-10,Female,3,1-4,15
25,0,1,0,1,2021-08-07,Female,66,65-69,5
25,1,0,0,1,2021-08-07,Female,67,65-69,5
25,1,12,0,13,2021-08-06,Male,66,65-69,24
25,0,0,0,0,2021-08-06,Male,32,25-34,19
25,1,3,0,4,2021-08-06,Female,65,65-69,5
25,0,1,0,1,2021-08-08,Female,71,70-74,4
25,1,45,37,83,2021-08-11,Female,45,45-54,1
25,2,3,0,5,2021-08-05,Female,25,25-34,17
25,0,0,0,0,2021-08-09,Male,78,75-79,4
25,1,0,0,1,2021-08-11,Male,59,55-64,1
25,0,0,0,0,2021-08-11,Male,36,35-44,1
25,0,2,0,2,2021-08-08,Female,76,75-79,23
25,0,2,0,2,2021-08-10,Male,60,55-64,2
25,2,0,0,2,2021-08-09,Female,12,10-14,5
25,2,0,0,2,2021-08-09,Male,33,25-34,20
25,0,0,0,0,2021-08-06,Male,34,25-34,17
25,2,1,0,3,2021-08-05,Female,23,20-24,21
25,0,0,0,0,2021-08-07,Male,36,35-44,13
25,0,0,0,0,2021-08-10,Male,15,15-19,21
25,0,0,0,0,2021-08-06,Female,64,55-64,14
25,0,0,0,0,2021-08-08,Female,69,65-69,9
25,1,2,0,3,2021-08-06,Male,66,65-69,23
25,2,2,0,4,2021-08-12,Female,23,20-24,1
25,1,0,0,1,2021-08-05,Female,60,55-64,5
25,1,0,0,1,2021-08-07,Female,13,10-14,25
25,3,3,0,6,2021-08-05,Female,0,<1,3
25,0,2,0,2,2021-08-06,Female,66,65-69,19
25,2,2,0,4,2021-08-08,Female,14,10-14,5
25,1,1,0,2,2021-08-08,Male,55,55-64,20
25,0,0,0,0,2021-08-09,Male,45,45-54,5
25,3,0,0,3,2021-08-11,Female,17,15-19,1
25,0,0,0,0,2021-08-11,Male,78,75-79,3
25,2,4,0,6,2021-08-06,Male,1,1-4,6
25,0,0,0,0,2021-08-08,Male,42,35-44,4
25,1,0,0,1,2021-08-11,Male,22,20-24,1
25,0,0,0,0,2021-08-04,Male,22,20-24,14
25,3,0,0,3,2021-08-10,Female,8,5-9,5
25,0,0,0,0,2021-08-05,Male,30,25-34,7
25,1,0,0,1,2021-08-06,Female,30,25-34,2
25,2,0,0,2,2021-08-06,Male,66,65-69,21
25,2,8,7,17,2021-08-09,Female,22,20-24,9
25,1,0,0,1,2021-08-11,Male,51,45-54,1
25,3,0,0,3,2021-08-08,Male,16,15-19,5
25,1,4,0,5,2021-08-09,Female,66,65-69,5
25,0,0,7,7,2021-08-11,Female,37,35-44,1
25,0,2,0,2,2021-08-11,Female,44,35-44,1
25,1,1,39,41,2021-08-07,Male,68,65-69,13
25,1,0,0,1,2021-08-09,Female,62,55-64,19
25,0,1,0,1,2021-08-11,Female,53,45-54,1
25,2,6,0,8,2021-08-11,Female,25,25-34,1
25,1,0,0,1,2021-08-09,Female,53,45-54,22
25,0,27,17,44,2021-08-11,Male,25,25-34,2
25,1,0,1,2,2021-08-11,Female,52,45-54,2
25,1,0,0,1,2021-08-08,Female,49,45-54,23
25,2,1,0,3,2021-08-11,Male,4,1-4,1
25,1,5,0,6,2021-08-11,Female,29,25-34,1
25,0,1,0,1,2021-08-11,Female,74,70-74,15
25,1,0,0,1,2021-08-06,Female,66,65-69,3
25,0,0,0,0,2021-08-07,Female,67,65-69,5
25,1,1,0,2,2021-08-08,Male,65,65-69,18
25,3,0,0,3,2021-08-05,Male,30,25-34,14
25,0,0,0,0,2021-08-09,Male,45,45-54,4
25,0,0,0,0,2021-08-10,Female,25,25-34,24
25,0,0,0,0,2021-08-12,Male,22,20-24,1
25,1,0,0,1,2021-08-07,Male,41,35-44,22
25,4,0,10,14,2021-08-11,Female,1,1-4,1
25,0,0,0,0,2021-08-08,Female,44,35-44,5
25,0,0,0,0,2021-08-09,Male,34,25-34,18
25,1,1,0,2,2021-08-06,Male,62,55-64,21
25,0,0,0,0,2021-08-07,Female,69,65-69,20
25,1,0,0,1,2021-08-09,Male,41,35-44,5
25,1,0,0,1,2021-08-07,Male,68,65-69,23
25,0,0,0,0,2021-08-04,Male,26,25-34,2
25,2,0,0,2,2021-08-07,Female,36,35-44,6
25,2,0,0,2,2021-08-07,Male,12,10-14,25
25,4,0,0,4,2021-08-04,Female,13,10-14,19
25,1,0,0,1,2021-08-08,Male,71,70-74,20
25,2,3,0,5,2021-08-11,Male,21,20-24,1
25,1,0,0,1,2021-08-05,Male,57,55-64,5
25,0,0,2,2,2021-08-08,Male,41,35-44,4
25,2,0,0,2,2021-08-06,Female,61,55-64,21
25,0,25,45,70,2021-08-07,Male,38,35-44,2
25,1,3,0,4,2021-08-05,Female,28,25-34,4
25,5,0,0,5,2021-08-06,Female,34,25-34,12
25,0,1,0,1,2021-08-08,Male,46,45-54,17
25,1,0,0,1,2021-08-06,Female,58,55-64,3
25,1,0,0,1,2021-08-11,Female,24,20-24,1
25,1,0,0,1,2021-08-04,Male,2,1-4,15
25,1,3,0,4,2021-08-07,Female,68,65-69,14
25,0,0,0,0,2021-08-08,Female,70,70-74,12
25,1,0,0,1,2021-08-04,Female,52,45-54,5
25,1,1,0,2,2021-08-10,Male,46,45-54,17
25,2,0,0,2,2021-08-07,Female,35,35-44,21
25,1,0,0,1,2021-08-05,Male,58,55-64,23
25,2,0,0,2,2021-08-06,Male,64,55-64,24
25,1,0,1,2,2021-08-06,Female,63,55-64,23
25,1,0,0,1,2021-08-09,Female,64,55-64,22
25,0,0,0,0,2021-08-07,Female,66,65-69,5
25,1,0,0,1,2021-08-11,Female,32,25-34,1
25,0,0,0,0,2021-08-08,Female,31,25-34,2
25,1,0,0,1,2021-08-05,Female,58,55-64,5
25,1,1,0,2,2021-08-07,Female,69,65-69,23
25,1,0,0,1,2021-08-04,Male,53,45-54,20
25,2,0,0,2,2021-08-08,Male,50,45-54,23
25,1,0,0,1,2021-08-10,Male,36,35-44,5
25,1,3,0,4,2021-08-11,Male,35,35-44,1
25,1,0,0,1,2021-08-09,Female,68,65-69,23
25,2,0,0,2,2021-08-09,Male,59,55-64,22
25,1,2,0,3,2021-08-06,Female,64,55-64,5
25,0,1,0,1,2021-08-07,Male,13,10-14,13
25,0,0,0,0,2021-08-06,Male,33,25-34,22
25,0,0,0,0,2021-08-13,Female,32,25-34,4
25,1,0,0,1,2021-08-05,Male,58,55-64,3
25,1,0,0,1,2021-08-11,Female,29,25-34,1
25,3,0,0,3,2021-08-08,Male,9,5-9,9
25,0,0,0,0,2021-08-11,Female,27,25-34,1
25,2,0,0,2,2021-08-05,Female,12,10-14,4
25,1,0,0,1,2021-08-08,Female,45,45-54,5
25,0,0,0,0,2021-08-09,Male,33,25-34,4
25,2,0,0,2,2021-08-12,Male,24,20-24,1
25,0,3,0,3,2021-08-06,Female,65,65-69,19
25,1,0,0,1,2021-08-05,Female,54,45-54,4
25,1,0,0,1,2021-08-06,Female,36,35-44,5
25,1,4,0,5,2021-08-07,Male,68,65-69,25
25,0,0,0,0,2021-08-07,Male,14,10-14,22
25,2,0,0,2,2021-08-10,Male,77,75-79,18
25,0,0,0,0,2021-08-07,Male,68,65-69,5
25,0,0,0,0,2021-08-07,Male,37,35-44,5
25,1,1,0,2,2021-08-06,Female,59,55-64,23
25,0,0,0,0,2021-08-09,Female,26,25-34,12
25,2,0,0,2,2021-08-11,Female,30,25-34,1
25,0,0,0,0,2021-08-11,Female,34,25-34,1
25,4,0,0,4,2021-08-11,Female,17,15-19,1
25,1,0,0,1,2021-08-13,Male,33,25-34,5
25,3,0,0,3,2021-08-05,Female,19,15-19,24
25,0,0,0,0,2021-08-09,Male,70,70-74,6
25,0,0,0,0,2021-08-06,Female,3,1-4,4
25,1,0,0,1,2021-08-11,Female,29,25-34,1
25,1,0,0,1,2021-08-11,Female,67,65-69,12
25,0,1,0,1,2021-08-08,Female,69,65-69,16
25,2,0,0,2,2021-08-08,Male,11,10-14,21
25,1,1,0,2,2021-08-09,Male,48,45-54,5
25,1,0,0,1,2021-08-08,Female,72,70-74,4
25,1,2,0,3,2021-08-08,Male,77,75-79,5
25,2,0,0,2,2021-08-04,Male,24,20-24,16
25,0,3,0,3,2021-08-11,Female,29,25-34,1
25,0,1,0,1,2021-08-09,Female,40,35-44,16
25,2,0,0,2,2021-08-08,Male,15,15-19,19
25,0,3,0,3,2021-08-05,Female,56,55-64,5
25,1,11,0,12,2021-08-04,Male,53,45-54,5
25,2,1,0,3,2021-08-04,Male,52,45-54,21
25,0,0,0,0,2021-08-09,Female,68,65-69,4
25,0,0,0,0,2021-08-08,Male,51,45-54,5
25,0,0,0,0,2021-08-09,Female,34,25-34,4
25,2,1,0,3,2021-08-08,Male,65,65-69,5
25,0,2,0,2,2021-08-08,Male,40,35-44,21
25,1,0,0,1,2021-08-06,Male,27,25-34,2
25,0,0,0,0,2021-08-06,Female,35,35-44,23
25,1,0,0,1,2021-08-04,Female,3,1-4,3
25,0,0,0,0,2021-08-07,Female,68,65-69,12
25,5,2,0,7,2021-08-05,Female,19,15-19,12
25,2,0,0,2,2021-08-04,Male,0,<1,4
25,0,10,0,10,2021-08-09,Male,46,45-54,21
25,0,4,0,4,2021-08-08,Female,66,65-69,21
25,0,0,0,0,2021-08-10,Male,69,65-69,3
25,0,0,0,0,2021-08-09,Female,77,75-79,11
25,4,6,0,10,2021-08-10,Male,14,10-14,5
25,0,0,0,0,2021-08-04,Female,53,45-54,21
25,0,21,0,21,2021-08-05,Female,29,25-34,12
25,2,0,0,2,2021-08-07,Male,40,35-44,4
25,0,12,15,27,2021-08-11,Male,51,45-54,1
25,3,21,0,24,2021-08-10,Female,14,10-14,14
25,2,11,0,13,2021-08-13,Male,46,45-54,1
25,2,0,0,2,2021-08-04,Male,15,15-19,16
25,0,0,0,0,2021-08-07,Female,68,65-69,21
25,0,0,0,0,2021-08-09,Female,69,65-69,23
25,1,0,0,1,2021-08-04,Male,19,15-19,5
25,3,5,0,8,2021-08-06,Female,20,20-24,10
25,2,2,0,4,2021-08-11,Male,0,<1,1
25,1,2,0,3,2021-08-11,Male,43,35-44,1
25,0,1,0,1,2021-08-09,Female,42,35-44,4
25,0,0,0,0,2021-08-08,Male,76,75-79,5
25,1,0,0,1,2021-08-06,Male,65,65-69,5
25,1,0,0,1,2021-08-04,Female,16,15-19,4
25,5,0,0,5,2021-08-06,Male,13,10-14,22
25,1,0,0,1,2021-08-12,Female,23,20-24,1
25,2,16,0,18,2021-08-11,Female,4,1-4,1
25,1,2,1,4,2021-08-07,Male,70,70-74,5
25,3,0,0,3,2021-08-06,Female,3,1-4,5
25,2,3,0,5,2021-08-05,Female,55,55-64,20
25,0,2,1,3,2021-08-09,Female,28,25-34,14
25,0,16,0,16,2021-08-11,Female,33,25-34,1
25,0,2,5,7,2021-08-07,Male,61,55-64,4
25,0,0,0,0,2021-08-07,Female,38,35-44,18
25,1,0,0,1,2021-08-08,Female,69,65-69,4
25,0,0,0,0,2021-08-08,Female,79,75-79,5
25,1,1,0,2,2021-08-06,Female,66,65-69,5
25,1,0,0,1,2021-08-04,Male,54,45-54,18
25,2,0,0,2,2021-08-09,Male,68,65-69,14
25,1,0,0,1,2021-08-11,Female,19,15-19,1
25,0,0,0,0,2021-08-08,Female,71,70-74,5
25,1,2,0,3,2021-08-07,Female,69,65-69,5
25,0,1,0,1,2021-08-09,Male,49,45-54,21
25,2,0,0,2,2021-08-08,Female,74,70-74,7
25,0,0,0,0,2021-08-07,Male,40,35-44,5
25,1,1,0,2,2021-08-11,Female,33,25-34,1
25,0,3,0,3,2021-08-06,Male,62,55-64,7
25,1,0,0,1,2021-08-07,Male,33,25-34,21
25,1,0,0,1,2021-08-07,Female,33,25-34,4
25,0,2,0,2,2021-08-04,Male,53,45-54,3
25,0,1,0,1,2021-08-08,Female,51,45-54,5
25,1,0,0,1,2021-08-11,Female,31,25-34,1
25,1,1,0,2,2021-08-04,Female,53,45-54,4
25,1,2,0,3,2021-08-10,Male,53,45-54,4
25,1,0,0,1,2021-08-06,Female,66,65-69,5
25,1,1,0,2,2021-08-06,Female,52,45-54,12
25,1,0,0,1,2021-08-08,Male,59,55-64,4
25,0,0,0,0,2021-08-04,Female,54,45-54,19
25,2,0,0,2,2021-08-07,Male,69,65-69,23
25,3,0,0,3,2021-08-11,Male,0,<1,1
25,1,0,0,1,2021-08-11,Female,53,45-54,1
25,0,0,0,0,2021-08-08,Male,47,45-54,5
25,2,0,0,2,2021-08-10,Female,48,45-54,21
25,4,0,0,4,2021-08-06,Female,1,1-4,2
25,2,1,0,3,2021-08-07,Female,66,65-69,7
25,2,0,0,2,2021-08-08,Male,85,85+,19
25,0,0,0,0,2021-08-05,Male,57,55-64,5
25,0,0,10,10,2021-08-11,Male,28,25-34,1
25,0,0,0,0,2021-08-09,Male,14,10-14,16
25,1,0,0,1,2021-08-07,Male,67,65-69,5
25,1,1,0,2,2021-08-08,Female,71,70-74,13
25,1,0,0,1,2021-08-11,Female,21,20-24,14
25,0,0,0,0,2021-08-08,Male,48,45-54,18
25,2,0,0,2,2021-08-09,Female,67,65-69,19
25,0,0,0,0,2021-08-08,Male,51,45-54,25
25,0,0,0,0,2021-08-09,Male,45,45-54,5
25,0,0,0,0,2021-08-11,Female,48,45-54,1
25,0,0,0,0,2021-08-05,Female,27,25-34,4
25,0,0,0,0,2021-08-05,Male,29,25-34,19
25,0,0,0,0,2021-08-11,Male,52,45-54,1
25,1,0,0,1,2021-08-10,Female,38,35-44,2
25,3,0,0,3,2021-08-07,Male,38,35-44,5
25,0,0,0,0,2021-08-04,Female,20,20-24,10
25,0,1,0,1,2021-08-10,Female,29,25-34,11
25,2,0,0,2,2021-08-08,Male,75,75-79,22
25,1,1,0,2,2021-08-08,Male,62,55-64,5
25,1,0,10,11,2021-08-05,Male,30,25-34,2
25,0,0,0,0,2021-08-08,Male,43,35-44,21
25,0,0,0,0,2021-08-09,Female,31,25-34,10
25,2,3,0,5,2021-08-11,Female,22,20-24,1
25,0,2,0,2,2021-08-07,Female,66,65-69,5
25,2,1,0,3,2021-08-08,Female,17,15-19,5
25,1,0,0,1,2021-08-12,Male,22,20-24,1
25,1,0,0,1,2021-08-07,Female,70,70-74,23
25,0,0,0,0,2021-08-07,Female,70,70-74,25
25,1,4,0,5,2021-08-08,Male,71,70-74,23
25,3,6,0,9,2021-08-07,Female,66,65-69,5
25,1,0,0,1,2021-08-05,Female,58,55-64,3
25,0,1,0,1,2021-08-05,Female,61,55-64,5
25,1,3,0,4,2021-08-04,Female,53,45-54,4
25,1,0,0,1,2021-08-08,Female,49,45-54,2
25,0,0,0,0,2021-08-11,Male,56,55-64,1
25,0,0,0,0,2021-08-08,Male,14,10-14,16
25,0,0,4,4,2021-08-11,Male,29,25-34,1
25,0,3,0,3,2021-08-09,Male,62,55-64,24
25,1,1,0,2,2021-08-07,Female,70,70-74,5
25,0,12,0,12,2021-08-07,Male,37,35-44,4
25,0,0,0,0,2021-08-09,Male,67,65-69,13
25,0,0,0,0,2021-08-11,Female,22,20-24,1
25,2,0,0,2,2021-08-08,Female,14,10-14,21
25,3,0,0,3,2021-08-08,Male,1,1-4,5
25,3,0,0,3,2021-08-08,Male,10,10-14,21
25,0,0,0,0,2021-08-10,Male,35,35-44,23
25,2,2,0,4,2021-08-04,Male,20,20-24,21
26,1,3,0,4,2021-09-02,Male,69,65-69,20
26,2,0,0,2,2021-09-08,Female,0,<1,2
26,0,0,0,0,2021-09-08,Female,27,25-34,1
26,2,2,44,48,2021-09-06,Male,13,10-14,7
26,1,0,0,1,2021-09-06,Male,31,25-34,3
26,2,0,0,2,2021-09-05,Male,65,65-69,6
26,0,6,0,6,2021-09-02,Female,49,45-54,6
26,0,0,0,0,2021-09-01,Male,60,55-64,2
26,0,0,0,0,2021-09-01,Male,27,25-34,6
26,2,0,0,2,2021-09-05,Female,67,65-69,25
26,0,1,0,1,2021-09-03,Female,72,70-74,22
26,1,0,0,1,2021-09-05,Female,58,55-64,5
26,1,0,0,1,2021-09-03,Male,71,70-74,6
26,0,0,0,0,2021-09-03,Female,33,25-34,4
26,1,0,0,1,2021-09-08,Female,14,10-14,1
26,2,2,0,4,2021-09-08,Female,2,1-4,1
26,2,0,0,2,2021-09-04,Male,6,5-9,2
26,0,0,0,0,2021-09-02,Female,68,65-69,19
26,2,0,0,2,2021-09-09,Female,6,5-9,1
26,2,0,0,2,2021-09-06,Female,58,55-64,5
26,1,0,0,1,2021-09-02,Female,68,65-69,6
26,1,0,0,1,2021-09-08,Female,30,25-34,1
26,3,0,0,3,2021-09-08,Female,17,15-19,1
26,0,0,0,0,2021-09-05,Female,35,35-44,13
26,2,0,0,2,2021-09-03,Female,6,5-9,5
26,1,0,0,1,2021-09-05,Female,60,55-64,21
26,0,7,0,7,2021-09-06,Male,29,25-34,2
26,0,0,0,0,2021-09-07,Male,52,45-54,6
26,1,31,0,32,2021-09-03,Female,62,55-64,16
26,2,4,0,6,2021-09-08,Male,16,15-19,1
26,0,0,0,0,2021-09-04,Male,51,45-54,22
26,2,2,12,16,2021-09-08,Female,3,1-4,1
26,0,1,13,14,2021-09-02,Male,69,65-69,11
26,1,0,0,1,2021-09-03,Male,51,45-54,21
26,3,0,0,3,2021-09-08,Female,5,5-9,1
26,2,0,0,2,2021-09-06,Female,36,35-44,22
26,1,3,0,4,2021-09-05,Female,54,45-54,2
26,1,2,0,3,2021-09-01,Male,41,35-44,2
26,3,0,0,3,2021-09-05,Female,58,55-64,22
26,2,4,0,6,2021-09-02,Female,1,1-4,2
26,0,1,0,1,2021-09-05,Female,66,65-69,6
26,1,0,0,1,2021-09-01,Male,35,35-44,7
26,0,1,0,1,2021-09-02,Male,50,45-54,6
26,3,6,0,9,2021-09-14,Female,6,5-9,1
26,0,1,0,1,2021-09-03,Female,41,35-44,4
26,1,10,0,11,2021-09-08,Male,25,25-34,1
26,1,0,0,1,2021-09-06,Male,57,55-64,5
26,1,4,0,5,2021-09-07,Male,65,65-69,2
26,1,10,0,11,2021-09-08,Male,53,45-54,1
26,1,0,0,1,2021-09-02,Male,67,65-69,18
26,1,0,0,1,2021-09-06,Female,57,55-64,6
26,1,0,0,1,2021-09-01,Male,63,55-64,26
26,1,0,0,1,2021-09-02,Female,50,45-54,6
26,3,0,0,3,2021-09-06,Male,9,5-9,2
26,1,12,0,13,2021-09-08,Male,60,55-64,6
26,0,0,0,0,2021-09-14,Male,20,20-24,1
26,0,4,0,4,2021-09-02,Male,48,45-54,5
26,1,0,0,1,2021-09-06,Male,17,15-19,23
26,0,0,0,0,2021-09-03,Male,49,45-54,23
26,0,1,0,1,2021-09-02,Male,49,45-54,3
26,0,0,0,0,2021-09-05,Male,43,35-44,6
26,1,0,0,1,2021-09-08,Female,54,45-54,1
26,5,0,0,5,2021-09-03,Male,52,45-54,13
26,1,0,0,1,2021-09-07,Male,35,35-44,16
26,1,0,0,1,2021-09-06,Male,35,35-44,6
26,0,0,0,0,2021-09-04,Male,54,45-54,18
26,0,0,0,0,2021-09-08,Female,57,55-64,1
26,1,0,0,1,2021-09-05,Female,72,70-74,6
26,0,0,0,0,2021-09-03,Female,71,70-74,24
26,0,0,0,0,2021-09-02,Male,69,65-69,22
26,0,2,0,2,2021-09-08,Female,66,65-69,2
26,1,0,0,1,2021-09-06,Female,53,45-54,22
26,1,0,0,1,2021-09-14,Female,50,45-54,1
26,1,0,0,1,2021-09-02,Female,31,25-34,2
26,1,0,0,1,2021-09-03,Female,70,70-74,20
26,0,1,0,1,2021-09-08,Female,57,55-64,1
26,0,2,0,2,2021-09-04,Female,78,75-79,6
26,0,0,0,0,2021-09-08,Female,56,55-64,1
26,4,1,0,5,2021-09-02,Male,19,15-19,12
26,1,1,0,2,2021-09-14,Female,49,45-54,1
26,0,0,0,0,2021-09-10,Male,24,20-24,2
26,1,0,0,1,2021-09-08,Female,33,25-34,1
26,1,0,0,1,2021-09-06,Female,57,55-64,26
26,4,16,0,20,2021-09-04,Female,6,5-9,3
26,0,0,6,6,2021-09-07,Female,15,15-19,2
26,1,0,0,1,2021-09-03,Male,52,45-54,23
26,0,4,0,4,2021-09-08,Male,37,35-44,1
26,2,0,0,2,2021-09-05,Male,17,15-19,5
26,0,0,0,0,2021-09-02,Male,30,25-34,3
26,1,0,0,1,2021-09-02,Female,69,65-69,21
26,1,0,0,1,2021-09-03,Female,32,25-34,2
26,2,21,0,23,2021-09-08,Male,12,10-14,1
26,1,0,0,1,2021-09-08,Male,66,65-69,1
26,0,2,0,2,2021-09-05,Male,54,45-54,11
26,0,0,0,0,2021-09-01,Male,62,55-64,2
26,1,4,0,5,2021-09-03,Male,33,25-34,2
26,1,10,0,11,2021-09-01,Male,33,25-34,6
26,0,1,0,1,2021-09-06,Female,70,70-74,6
26,0,3,0,3,2021-09-01,Male,40,35-44,2
26,3,0,0,3,2021-09-01,Female,22,20-24,3
26,1,0,0,1,2021-09-08,Female,69,65-69,1
26,1,0,0,1,2021-09-05,Male,58,55-64,24
26,1,0,0,1,2021-09-08,Female,4,1-4,1
26,0,0,0,0,2021-09-02,Male,68,65-69,24
26,1,0,0,1,2021-09-04,Male,70,70-74,2
26,1,0,0,1,2021-09-14,Female,50,45-54,1
26,0,2,0,2,2021-09-05,Male,36,35-44,6
26,1,0,0,1,2021-09-08,Female,45,45-54,1
26,2,4,0,6,2021-09-14,Female,53,45-54,1
26,2,0,0,2,2021-09-04,Female,19,15-19,5
26,1,0,0,1,2021-09-04,Male,73,70-74,19
26,0,0,0,0,2021-09-04,Male,77,75-79,21
26,0,0,0,0,2021-09-01,Male,27,25-34,13
26,1,0,0,1,2021-09-03,Male,72,70-74,23
26,1,1,0,2,2021-09-08,Male,76,75-79,1
26,1,0,0,1,2021-09-07,Female,14,10-14,4
26,1,0,0,1,2021-09-04,Female,38,35-44,5
26,0,1,0,1,2021-09-04,Female,39,35-44,6
26,0,2,0,2,2021-09-08,Female,51,45-54,2
26,0,0,0,0,2021-09-07,Male,61,55-64,6
26,0,0,0,0,2021-09-06,Male,53,45-54,18
26,3,0,0,3,2021-09-01,Female,18,15-19,4
26,0,1,0,1,2021-09-06,Female,56,55-64,5
26,0,5,0,5,2021-09-05,Male,43,35-44,5
26,1,2,0,3,2021-09-01,Male,39,35-44,6
26,1,0,0,1,2021-09-03,Female,72,70-74,6
26,0,0,0,0,2021-09-05,Female,61,55-64,13
26,1,1,0,2,2021-09-02,Male,67,65-69,6
26,1,3,0,4,2021-09-08,Male,64,55-64,1
26,1,2,0,3,2021-09-01,Male,39,35-44,23
26,2,1,0,3,2021-09-07,Male,70,70-74,20
26,0,3,0,3,2021-09-08,Female,78,75-79,20
26,0,0,0,0,2021-09-03,Male,33,25-34,3
26,0,0,0,0,2021-09-08,Female,68,65-69,1
26,1,0,0,1,2021-09-02,Female,68,65-69,23
26,1,3,1,5,2021-09-06,Male,62,55-64,22
26,0,0,0,0,2021-09-05,Female,78,75-79,2
26,0,5,0,5,2021-09-08,Female,61,55-64,1
26,1,0,0,1,2021-09-05,Female,67,65-69,2
26,0,0,0,0,2021-09-07,Male,56,55-64,6
26,1,1,0,2,2021-09-03,Female,71,70-74,2
26,2,3,0,5,2021-09-14,Female,1,1-4,1
26,0,0,0,0,2021-09-05,Male,85,85+,20
26,2,1,0,3,2021-09-03,Female,72,70-74,21
26,0,0,0,0,2021-09-03,Male,73,70-74,6
26,1,0,0,1,2021-09-08,Female,50,45-54,1
26,0,0,0,0,2021-09-02,Female,22,20-24,12
26,1,0,0,1,2021-09-04,Female,28,25-34,6
26,0,0,0,0,2021-09-05,Female,36,35-44,5
26,2,3,0,5,2021-09-05,Male,55,55-64,25
26,1,2,0,3,2021-09-03,Male,71,70-74,23
26,0,0,0,0,2021-09-06,Female,69,65-69,22
26,1,0,0,1,2021-09-02,Male,67,65-69,16
26,1,0,0,1,2021-09-05,Female,66,65-69,25
26,3,1,0,4,2021-09-05,Male,13,10-14,17
26,2,0,0,2,2021-09-03,Male,67,65-69,24
26,2,0,0,2,2021-09-05,Male,65,65-69,6
26,0,10,0,10,2021-09-09,Female,29,25-34,1
26,4,0,0,4,2021-09-01,Female,4,1-4,7
26,0,1,0,1,2021-09-04,Female,36,35-44,2
26,0,3,0,3,2021-09-04,Female,54,45-54,6
26,1,0,0,1,2021-09-05,Male,58,55-64,3
26,0,0,0,0,2021-09-03,Male,32,25-34,6
26,1,0,0,1,2021-09-06,Female,58,55-64,6
26,1,0,0,1,2021-09-03,Female,72,70-74,4
26,2,0,16,18,2021-09-02,Female,24,20-24,16
26,0,0,0,0,2021-09-06,Male,43,35-44,22
26,1,4,0,5,2021-09-01,Male,39,35-44,2
26,3,0,0,3,2021-09-06,Female,5,5-9,20
26,1,0,0,1,2021-09-01,Female,39,35-44,2
26,2,0,0,2,2021-09-03,Male,13,10-14,6
26,0,0,0,0,2021-09-04,Female,76,75-79,6
26,0,0,0,0,2021-09-08,Male,57,55-64,1
26,1,0,0,1,2021-09-07,Male,69,65-69,5
26,2,0,0,2,2021-09-03,Male,72,70-74,21
26,1,7,0,8,2021-09-04,Male,70,70-74,26
26,0,0,0,0,2021-09-09,Female,28,25-34,5
26,2,0,0,2,2021-09-02,Female,60,55-64,24
26,0,1,0,1,2021-09-14,Male,66,65-69,1
26,0,5,0,5,2021-09-04,Female,53,45-54,23
26,0,0,0,0,2021-09-06,Male,43,35-44,2
26,1,11,0,12,2021-09-05,Male,60,55-64,6
26,1,0,0,1,2021-09-01,Female,61,55-64,7
26,0,0,0,0,2021-09-01,Female,27,25-34,2
26,1,0,0,1,2021-09-14,Female,66,65-69,1
26,1,0,0,1,2021-09-08,Male,72,70-74,1
26,1,1,0,2,2021-09-01,Male,63,55-64,6
26,1,0,0,1,2021-09-06,Female,66,65-69,4
26,2,0,0,2,2021-09-05,Male,35,35-44,5
26,2,0,35,37,2021-09-02,Male,11,10-14,2
26,0,0,0,0,2021-09-08,Female,22,20-24,1
26,1,2,0,3,2021-09-06,Female,31,25-34,25
26,1,0,0,1,2021-09-01,Female,61,55-64,5
26,2,0,0,2,2021-09-09,Female,23,20-24,2
26,1,0,0,1,2021-09-06,Male,52,45-54,6
26,1,0,0,1,2021-09-04,Male,18,15-19,16
26,0,0,0,0,2021-09-01,Female,63,55-64,23
26,1,0,0,1,2021-09-02,Female,30,25-34,2
26,1,1,0,2,2021-09-06,Male,55,55-64,3
26,2,0,0,2,2021-09-01,Female,27,25-34,6
26,0,0,0,0,2021-09-06,Male,69,65-69,15
26,0,3,0,3,2021-09-05,Male,55,55-64,23
26,3,0,0,3,2021-09-08,Female,0,<1,1
26,1,2,0,3,2021-09-07,Male,58,55-64,20
26,0,0,0,0,2021-09-04,Female,74,70-74,18
26,0,0,0,0,2021-09-03,Female,44,35-44,25
26,0,0,0,0,2021-09-05,Male,66,65-69,19
26,1,0,0,1,2021-09-02,Male,69,65-69,6
26,2,0,0,2,2021-09-06,Female,0,<1,6
26,0,0,0,0,2021-09-02,Female,31,25-34,6
26,1,5,0,6,2021-09-08,Male,74,70-74,1
26,2,0,0,2,2021-09-04,Female,31,25-34,20
26,0,4,0,4,2021-09-07,Female,67,65-69,11
26,0,0,0,0,2021-09-08,Female,21,20-24,1
26,0,0,0,0,2021-09-02,Male,47,45-54,6
26,1,5,0,6,2021-09-09,Female,28,25-34,1
26,0,0,0,0,2021-09-07,Male,38,35-44,20
26,1,0,0,1,2021-09-02,Female,68,65-69,6
26,1,12,0,13,2021-09-01,Female,63,55-64,19
26,1,0,0,1,2021-09-01,Female,23,20-24,13
26,1,0,0,1,2021-09-05,Male,66,65-69,21
26,0,0,0,0,2021-09-06,Male,64,55-64,23
26,0,2,0,2,2021-09-03,Male,69,65-69,21
26,0,0,0,0,2021-09-09,Female,30,25-34,1
26,1,0,0,1,2021-09-08,Female,34,25-34,1
26,2,0,0,2,2021-09-05,Male,59,55-64,25
26,1,0,0,1,2021-09-06,Male,65,65-69,4
26,0,0,0,0,2021-09-02,Female,63,55-64,22
26,2,1,0,3,2021-09-08,Male,4,1-4,1
26,1,1,0,2,2021-09-08,Female,27,25-34,1
26,0,0,0,0,2021-09-14,Female,44,35-44,1
26,1,0,0,1,2021-09-05,Male,54,45-54,5
26,2,0,0,2,2021-09-08,Female,1,1-4,1
26,1,2,0,3,2021-09-08,Male,64,55-64,1
26,0,1,0,1,2021-09-05,Female,54,45-54,10
26,2,0,0,2,2021-09-03,Male,70,70-74,17
26,1,2,0,3,2021-09-04,Male,56,55-64,6
26,1,0,0,1,2021-09-05,Male,66,65-69,24
26,0,5,0,5,2021-09-06,Male,53,45-54,2
26,1,0,6,7,2021-09-08,Male,57,55-64,1
26,2,0,0,2,2021-09-06,Female,60,55-64,5
26,3,2,0,5,2021-09-04,Female,54,45-54,2
26,3,0,0,3,2021-09-01,Female,21,20-24,6
26,0,5,0,5,2021-09-02,Male,40,35-44,6
26,0,0,0,0,2021-09-05,Male,32,25-34,5
26,3,0,0,3,2021-09-07,Male,0,<1,5
26,0,0,0,0,2021-09-08,Female,4,1-4,1
26,0,1,0,1,2021-09-01,Male,42,35-44,7
26,1,11,35,47,2021-09-04,Female,55,55-64,6
26,1,0,0,1,2021-09-05,Male,51,45-54,5
26,1,0,0,1,2021-09-06,Male,43,35-44,3
26,1,0,0,1,2021-09-06,Female,80,80-84,21
26,1,11,0,12,2021-09-14,Male,49,45-54,1
26,1,0,0,1,2021-09-07,Female,29,25-34,22
26,1,0,0,1,2021-09-03,Male,52,45-54,9
26,1,6,0,7,2021-09-02,Female,67,65-69,19
26,1,0,0,1,2021-09-01,Male,24,20-24,10
26,1,0,0,1,2021-09-01,Female,64,55-64,6
26,0,4,0,4,2021-09-03,Female,51,45-54,9
26,0,1,0,1,2021-09-07,Female,74,70-74,4
26,1,0,0,1,2021-09-06,Male,53,45-54,20
26,0,0,0,0,2021-09-14,Female,53,45-54,1
26,0,4,0,4,2021-09-08,Male,58,55-64,1
26,0,0,0,0,2021-09-06,Male,27,25-34,6
26,1,0,0,1,2021-09-08,Female,30,25-34,1
26,1,1,0,2,2021-09-03,Male,71,70-74,23
26,1,3,0,4,2021-09-06,Female,59,55-64,26
26,0,0,0,0,2021-09-08,Female,76,75-79,1
26,0,0,0,0,2021-09-08,Female,53,45-54,24
26,1,0,0,1,2021-09-03,Male,34,25-34,5
26,0,0,0,0,2021-09-02,Male,49,45-54,2
26,3,0,0,3,2021-09-03,Male,9,5-9,21
26,1,0,0,1,2021-09-05,Male,55,55-64,6
26,0,0,0,0,2021-09-03,Female,33,25-34,11
26,3,1,0,4,2021-09-06,Male,66,65-69,22
26,1,0,0,1,2021-09-06,Female,28,25-34,4
26,0,0,0,0,2021-09-03,Male,72,70-74,6
26,0,0,0,0,2021-09-05,Female,67,65-69,24
26,1,0,0,1,2021-09-01,Female,61,55-64,22
26,1,0,0,1,2021-09-06,Male,64,55-64,6
26,0,0,0,0,2021-09-02,Female,67,65-69,13
26,1,0,0,1,2021-09-05,Male,45,45-54,6
26,1,0,0,1,2021-09-14,Male,73,70-74,1
26,1,0,0,1,2021-09-08,Female,36,35-44,1
26,0,0,0,0,2021-09-03,Female,72,70-74,21
26,1,0,0,1,2021-09-05,Male,75,75-79,24
26,1,2,0,3,2021-09-02,Female,68,65-69,6
26,0,4,0,4,2021-09-07,Male,60,55-64,5
26,2,1,0,3,2021-09-04,Female,65,65-69,16
26,0,0,0,0,2021-09-03,Male,51,45-54,19
26,2,1,0,3,2021-09-08,Female,18,15-19,1
26,1,0,0,1,2021-09-02,Female,32,25-34,21
26,1,0,0,1,2021-09-14,Female,53,45-54,1
26,0,0,0,0,2021-09-01,Male,39,35-44,13
26,2,0,0,2,2021-09-08,Male,54,45-54,1
26,0,1,0,1,2021-09-06,Female,57,55-64,5
26,0,0,0,0,2021-09-06,Male,51,45-54,5
26,1,9,0,10,2021-09-05,Male,77,75-79,2
26,2,0,0,2,2021-09-02,Male,10,10-14,5
26,0,0,0,0,2021-09-04,Male,54,45-54,22
26,2,0,0,2,2021-09-03,Male,52,45-54,2
26,1,0,0,1,2021-09-07,Female,72,70-74,4
26,0,0,0,0,2021-09-06,Female,65,65-69,8
26,0,0,0,0,2021-09-03,Female,25,25-34,10
26,4,0,0,4,2021-09-06,Female,6,5-9,3
26,2,1,0,3,2021-09-05,Male,69,65-69,8
26,2,0,0,2,2021-09-08,Female,26,25-34,1
26,1,0,0,1,2021-09-03,Female,50,45-54,21
26,1,1,0,2,2021-09-09,Male,8,5-9,1
26,0,0,0,0,2021-09-14,Male,49,45-54,1
26,1,0,9,10,2021-09-04,Female,37,35-44,2
26,0,0,0,0,2021-09-01,Female,24,20-24,2
26,2,0,0,2,2021-09-08,Female,30,25-34,1
26,0,0,0,0,2021-09-01,Male,10,10-14,19
26,1,1,0,2,2021-09-07,Male,15,15-19,22
26,2,0,0,2,2021-09-06,Female,48,45-54,2
26,0,2,0,2,2021-09-08,Male,65,65-69,20
26,1,1,0,2,2021-09-03,Male,69,65-69,23
26,0,0,0,0,2021-09-01,Male,23,20-24,6
26,1,0,0,1,2021-09-07,Female,58,55-64,23
26,0,0,0,0,2021-09-03,Male,10,10-14,2
26,0,0,0,0,2021-09-04,Male,34,25-34,5
26,0,0,0,0,2021-09-02,Male,69,65-69,2
26,0,0,0,0,2021-09-05,Female,50,45-54,3
26,2,2,0,4,2021-09-03,Female,1,1-4,5
26,0,0,0,0,2021-09-02,Male,51,45-54,22
26,2,2,0,4,2021-09-05,Male,16,15-19,6
26,0,0,0,0,2021-09-05,Male,14,10-14,22
26,2,1,0,3,2021-09-03,Female,0,<1,2
26,0,0,0,0,2021-09-03,Male,72,70-74,24
26,2,41,0,43,2021-09-05,Female,58,55-64,5
26,2,0,0,2,2021-09-03,Female,70,70-74,26
26,0,0,0,0,2021-09-01,Male,39,35-44,20
26,0,0,0,0,2021-09-08,Male,45,45-54,1
26,0,1,0,1,2021-09-01,Male,22,20-24,13
26,2,1,0,3,2021-09-03,Female,73,70-74,19
26,0,2,0,2,2021-09-05,Male,52,45-54,20
26,1,0,0,1,2021-09-01,Female,60,55-64,26
26,0,2,0,2,2021-09-08,Male,54,45-54,1
26,2,0,0,2,2021-09-06,Male,63,55-64,13
26,2,1,0,3,2021-09-01,Female,64,55-64,20
26,0,0,0,0,2021-09-06,Male,34,25-34,5
26,1,0,0,1,2021-09-07,Female,55,55-64,5
26,2,0,0,2,2021-09-04,Male,74,70-74,22
26,3,0,0,3,2021-09-06,Male,1,1-4,2
26,2,8,0,10,2021-09-04,Female,53,45-54,24
26,0,0,0,0,2021-09-06,Male,43,35-44,5
26,1,0,0,1,2021-09-08,Female,12,10-14,1
26,1,0,0,1,2021-09-03,Male,69,65-69,21
26,0,0,0,0,2021-09-04,Male,35,35-44,25
26,3,1,0,4,2021-09-03,Female,16,15-19,2
26,0,0,0,0,2021-09-02,Male,49,45-54,20
26,3,2,0,5,2021-09-03,Male,70,70-74,21
26,0,0,0,0,2021-09-02,Female,48,45-54,2
26,2,0,0,2,2021-09-05,Male,56,55-64,6
26,2,0,0,2,2021-09-05,Male,15,15-19,6
26,0,0,0,0,2021-09-09,Female,28,25-34,1
26,0,0,0,0,2021-09-14,Female,72,70-74,1
26,1,0,0,1,2021-09-06,Male,68,65-69,24
26,0,0,0,0,2021-09-06,Female,22,20-24,6
26,2,0,0,2,2021-09-01,Male,39,35-44,2
26,1,0,0,1,2021-09-01,Female,3,1-4,6
26,2,3,0,5,2021-09-05,Female,16,15-19,10
26,0,0,0,0,2021-09-06,Male,63,55-64,2
26,3,6,0,9,2021-09-04,Male,13,10-14,2
26,0,1,0,1,2021-09-05,Female,37,35-44,2
26,0,0,0,0,2021-09-02,Male,28,25-34,6
26,1,0,0,1,2021-09-05,Female,57,55-64,24
26,0,0,0,0,2021-09-05,Female,59,55-64,21
26,0,0,0,0,2021-09-05,Female,67,65-69,22
26,1,3,0,4,2021-09-08,Female,70,70-74,1
26,2,2,0,4,2021-09-03,Female,27,25-34,2
26,1,1,0,2,2021-09-08,Male,54,45-54,1
26,0,0,0,0,2021-09-04,Male,55,55-64,6
26,1,0,0,1,2021-09-06,Female,45,45-54,2
26,0,1,0,1,2021-09-04,Female,76,75-79,6
26,0,0,0,0,2021-09-08,Male,39,35-44,1
26,0,0,0,0,2021-09-10,Male,21,20-24,4
26,1,5,0,6,2021-09-05,Female,56,55-64,6
26,0,10,6,16,2021-09-14,Male,55,55-64,1
26,1,0,0,1,2021-09-08,Female,67,65-69,1
26,0,0,0,0,2021-09-01,Female,64,55-64,20
26,0,4,0,4,2021-09-03,Male,70,70-74,6
26,1,0,0,1,2021-09-06,Male,29,25-34,6
26,1,0,0,1,2021-09-01,Female,61,55-64,26
26,0,0,0,0,2021-09-09,Male,23,20-24,2
26,0,0,0,0,2021-09-08,Male,49,45-54,6
26,1,0,0,1,2021-09-01,Male,61,55-64,11
26,2,0,0,2,2021-09-02,Male,49,45-54,21
26,0,0,0,0,2021-09-09,Female,23,20-24,2
26,0,0,0,0,2021-09-08,Female,0,<1,1
26,1,0,0,1,2021-09-05,Female,54,45-54,26
26,1,1,0,2,2021-09-07,Female,22,20-24,2
26,1,0,0,1,2021-09-14,Female,66,65-69,1
26,0,0,0,0,2021-09-08,Female,33,25-34,1
26,0,1,0,1,2021-09-07,Male,56,55-64,21
26,0,0,0,0,2021-09-05,Female,66,65-69,25
26,3,2,0,5,2021-09-06,Male,6,5-9,19
26,0,0,0,0,2021-09-03,Male,18,15-19,2
26,1,0,0,1,2021-09-04,Male,80,80-84,20
26,0,0,0,0,2021-09-08,Male,37,35-44,1
26,0,1,0,1,2021-09-06,Female,67,65-69,20
26,0,0,10,10,2021-09-08,Female,34,25-34,1
26,2,4,0,6,2021-09-02,Female,15,15-19,19
26,0,0,0,0,2021-09-08,Male,47,45-54,1
26,1,0,0,1,2021-09-03,Female,71,70-74,6
26,1,4,0,5,2021-09-08,Male,75,75-79,1
26,0,0,0,0,2021-09-14,Male,51,45-54,1
26,2,0,0,2,2021-09-08,Male,5,5-9,1
26,0,0,0,0,2021-09-01,Female,18,15-19,2
26,0,1,0,1,2021-09-01,Female,42,35-44,2
26,0,12,0,12,2021-09-04,Male,37,35-44,26
26,0,0,0,0,2021-09-08,Male,54,45-54,1
26,1,0,0,1,2021-09-06,Female,69,65-69,2
26,0,0,0,0,2021-09-08,Female,32,25-34,1
26,2,9,0,11,2021-09-08,Female,43,35-44,1
26,1,6,0,7,2021-09-01,Male,41,35-44,26
26,1,2,0,3,2021-09-07,Male,66,65-69,6
26,2,0,0,2,2021-09-01,Male,63,55-64,25
26,0,0,0,0,2021-09-07,Female,21,20-24,2
26,0,4,0,4,2021-09-05,Female,70,70-74,16
26,1,40,0,41,2021-09-08,Female,32,25-34,1
26,1,1,0,2,2021-09-04,Female,34,25-34,19
26,1,13,0,14,2021-09-14,Male,1,1-4,1
26,1,5,1,7,2021-09-08,Female,37,35-44,1
26,0,0,0,0,2021-09-02,Male,69,65-69,24
26,0,1,1,2,2021-09-02,Male,29,25-34,22
26,0,3,0,3,2021-09-14,Female,74,70-74,1
26,0,0,0,0,2021-09-05,Female,54,45-54,22
26,1,0,0,1,2021-09-06,Male,43,35-44,6
26,0,0,0,0,2021-09-03,Male,31,25-34,13
26,2,5,0,7,2021-09-07,Female,12,10-14,5
26,0,0,0,0,2021-09-14,Male,58,55-64,1
26,0,7,0,7,2021-09-06,Male,35,35-44,2
26,1,0,0,1,2021-09-02,Female,69,65-69,2
26,1,0,0,1,2021-09-03,Male,71,70-74,2
26,0,1,0,1,2021-09-08,Female,28,25-34,1
26,0,1,0,1,2021-09-03,Male,47,45-54,20
26,2,0,31,33,2021-09-02,Female,3,1-4,5
26,1,2,0,3,2021-09-04,Male,53,45-54,23
26,0,1,0,1,2021-09-04,Female,71,70-74,16
26,3,0,0,3,2021-09-03,Male,70,70-74,21
26,1,0,0,1,2021-09-03,Female,34,25-34,19
26,3,0,0,3,2021-09-05,Male,15,15-19,23
26,2,0,0,2,2021-09-05,Male,65,65-69,22
26,0,0,0,0,2021-09-02,Male,50,45-54,23
26,1,0,0,1,2021-09-06,Male,67,65-69,17
26,0,0,0,0,2021-09-14,Male,40,35-44,1
26,1,2,0,3,2021-09-05,Female,67,65-69,16
26,0,1,0,1,2021-09-14,Female,35,35-44,1
26,0,3,0,3,2021-09-02,Female,30,25-34,2
26,1,0,0,1,2021-09-06,Male,22,20-24,4
26,1,0,0,1,2021-09-08,Female,66,65-69,15
26,0,0,0,0,2021-09-02,Male,48,45-54,6
26,2,1,0,3,2021-09-01,Male,0,<1,2
26,1,0,0,1,2021-09-02,Male,67,65-69,24
26,0,0,0,0,2021-09-05,Male,66,65-69,24
26,4,1,0,5,2021-09-08,Male,3,1-4,1
26,0,0,0,0,2021-09-03,Female,30,25-34,6
26,1,0,0,1,2021-09-04,Male,34,25-34,5
26,0,0,0,0,2021-09-14,Male,30,25-34,1
26,1,0,0,1,2021-09-02,Male,68,65-69,24
26,2,3,0,5,2021-09-14,Female,58,55-64,1
26,0,0,0,0,2021-09-06,Male,41,35-44,18
26,1,0,0,1,2021-09-04,Male,76,75-79,16
26,0,1,0,1,2021-09-04,Male,16,15-19,5
26,1,0,0,1,2021-09-07,Male,46,45-54,6
26,1,2,0,3,2021-09-08,Male,68,65-69,2
26,0,0,0,0,2021-09-02,Female,49,45-54,6
26,2,0,0,2,2021-09-02,Female,9,5-9,6
26,0,0,0,0,2021-09-01,Female,27,25-34,8
26,1,0,0,1,2021-09-05,Female,45,45-54,16
26,0,0,0,0,2021-09-06,Female,72,70-74,6
26,1,0,0,1,2021-09-06,Male,57,55-64,6
26,1,3,0,4,2021-09-05,Female,57,55-64,5
26,0,0,0,0,2021-09-05,Male,53,45-54,11
26,2,0,0,2,2021-09-04,Male,71,70-74,18
26,0,2,0,2,2021-09-05,Female,54,45-54,6
26,3,0,0,3,2021-09-05,Male,18,15-19,6
26,2,9,0,11,2021-09-05,Male,8,5-9,2
26,0,0,0,0,2021-09-05,Male,65,65-69,6
26,0,3,0,3,2021-09-03,Male,52,45-54,3
26,1,1,0,2,2021-09-04,Male,55,55-64,6
26,2,0,0,2,2021-09-06,Female,9,5-9,3
26,0,0,0,0,2021-09-03,Female,52,45-54,24
26,0,0,0,0,2021-09-01,Female,60,55-64,20
26,1,8,0,9,2021-09-06,Female,67,65-69,6
26,3,11,0,14,2021-09-08,Female,51,45-54,1
26,1,0,0,1,2021-09-02,Male,26,25-34,6
26,0,0,0,0,2021-09-04,Male,48,45-54,14
26,0,2,0,2,2021-09-04,Male,56,55-64,6
26,0,0,0,0,2021-09-08,Male,73,70-74,4
26,1,1,0,2,2021-09-04,Male,82,80-84,23
26,1,5,0,6,2021-09-02,Female,41,35-44,3
26,1,1,0,2,2021-09-05,Female,71,70-74,5
26,2,1,0,3,2021-09-01,Female,9,5-9,16
26,1,0,0,1,2021-09-05,Male,59,55-64,6
26,0,2,0,2,2021-09-04,Female,51,45-54,12
26,0,0,0,0,2021-09-02,Male,49,45-54,20
26,1,0,0,1,2021-09-05,Male,44,35-44,7
26,2,2,0,4,2021-09-03,Female,15,15-19,6
26,0,1,0,1,2021-09-01,Male,25,25-34,23
26,0,0,0,0,2021-09-02,Male,21,20-24,18
26,0,2,0,2,2021-09-08,Female,45,45-54,5
26,2,0,0,2,2021-09-04,Male,72,70-74,24
26,0,0,0,0,2021-09-04,Male,35,35-44,25
26,3,1,0,4,2021-09-06,Male,15,15-19,4
26,0,0,0,0,2021-09-04,Male,38,35-44,3
26,2,10,0,12,2021-09-08,Female,52,45-54,3
26,1,1,0,2,2021-09-08,Female,60,55-64,1
26,1,0,0,1,2021-09-04,Male,72,70-74,6
26,3,0,0,3,2021-09-01,Male,24,20-24,21
26,1,2,0,3,2021-09-14,Female,45,45-54,2
26,1,0,0,1,2021-09-02,Female,68,65-69,18
26,0,0,0,0,2021-09-14,Female,53,45-54,1
26,3,0,0,3,2021-09-08,Male,2,1-4,1
26,0,0,0,0,2021-09-03,Male,68,65-69,23
26,4,15,0,19,2021-09-08,Male,12,10-14,1
26,2,0,0,2,2021-09-05,Female,0,<1,5
26,2,0,0,2,2021-09-01,Male,42,35-44,26
26,0,0,0,0,2021-09-08,Female,42,35-44,2
26,0,0,0,0,2021-09-03,Male,71,70-74,18
26,2,0,0,2,2021-09-01,Female,39,35-44,6
26,1,0,0,1,2021-09-08,Male,3,1-4,1
26,0,1,0,1,2021-09-05,Male,59,55-64,6
26,2,9,0,11,2021-09-14,Male,0,<1,1
26,0,3,0,3,2021-09-01,Male,39,35-44,2
26,1,0,0,1,2021-09-04,Female,54,45-54,5
26,0,0,0,0,2021-09-03,Male,55,55-64,6
26,3,0,0,3,2021-09-02,Male,13,10-14,12
26,1,0,0,1,2021-09-08,Male,32,25-34,1
26,1,4,0,5,2021-09-14,Male,46,45-54,1
26,2,0,0,2,2021-09-05,Male,55,55-64,21
26,2,40,27,69,2021-09-03,Male,69,65-69,7
26,1,1,0,2,2021-09-14,Male,57,55-64,1
26,2,0,0,2,2021-09-06,Female,18,15-19,2
26,0,0,0,0,2021-09-04,Male,80,80-84,5
26,1,4,0,5,2021-09-06,Female,69,65-69,19
26,2,3,0,5,2021-09-05,Male,65,65-69,18
26,1,0,0,1,2021-09-01,Male,64,55-64,19
26,0,5,0,5,2021-09-08,Male,65,65-69,1
26,1,1,0,2,2021-09-08,Male,63,55-64,1
26,2,0,0,2,2021-09-01,Female,26,25-34,16
26,1,0,0,1,2021-09-03,Male,68,65-69,6
26,1,0,0,1,2021-09-14,Female,57,55-64,1
26,0,1,0,1,2021-09-03,Female,69,65-69,23
26,0,0,0,0,2021-09-02,Female,29,25-34,13
26,0,0,35,35,2021-09-01,Female,1,1-4,2
26,2,1,0,3,2021-09-08,Female,16,15-19,1
26,1,3,2,6,2021-09-06,Male,54,45-54,5
26,0,0,0,0,2021-09-06,Female,67,65-69,19
26,0,0,0,0,2021-09-08,Male,69,65-69,1
26,0,0,0,0,2021-09-01,Female,64,55-64,21
26,0,1,0,1,2021-09-02,Female,8,5-9,2
26,1,0,0,1,2021-09-05,Male,58,55-64,2
26,1,0,0,1,2021-09-08,Female,62,55-64,1
26,1,0,0,1,2021-09-05,Male,59,55-64,6
26,1,0,0,1,2021-09-08,Female,54,45-54,1
26,1,0,0,1,2021-09-08,Female,8,5-9,1
26,0,0,0,0,2021-09-06,Male,29,25-34,3
26,1,0,0,1,2021-09-08,Female,26,25-34,1
26,2,0,0,2,2021-09-05,Female,18,15-19,18
26,0,0,0,0,2021-09-08,Female,85,85+,1
26,1,0,0,1,2021-09-04,Male,56,55-64,2
26,1,0,0,1,2021-09-05,Female,66,65-69,5
26,0,7,0,7,2021-09-08,Female,28,25-34,1
26,0,0,0,0,2021-09-05,Male,54,45-54,6
26,1,0,0,1,2021-09-05,Female,38,35-44,6
26,0,4,0,4,2021-09-06,Female,52,45-54,4
26,1,6,0,7,2021-09-08,Male,51,45-54,1
26,3,0,0,3,2021-09-04,Female,53,45-54,21
26,1,0,2,3,2021-09-14,Male,52,45-54,1
26,0,0,0,0,2021-09-01,Male,27,25-34,2
26,2,0,0,2,2021-09-06,Male,62,55-64,21
26,2,0,0,2,2021-09-04,Female,79,75-79,20
26,0,2,0,2,2021-09-08,Female,66,65-69,1
26,0,1,0,1,2021-09-03,Female,71,70-74,6
26,2,0,0,2,2021-09-06,Male,66,65-69,6
26,0,1,0,1,2021-09-05,Male,58,55-64,5
26,0,1,0,1,2021-09-05,Male,67,65-69,25
26,1,0,0,1,2021-09-07,Male,65,65-69,6
26,0,0,0,0,2021-09-08,Male,42,35-44,16
26,0,3,0,3,2021-09-08,Male,48,45-54,1
26,1,2,0,3,2021-09-03,Female,70,70-74,22
26,0,0,0,0,2021-09-04,Female,77,75-79,24
26,1,0,0,1,2021-09-07,Male,34,25-34,5
26,2,2,0,4,2021-09-04,Female,15,15-19,6
26,3,0,0,3,2021-09-05,Male,38,35-44,21
26,1,0,1,2,2021-09-05,Female,65,65-69,5
26,1,0,0,1,2021-09-02,Female,49,45-54,21
26,2,2,0,4,2021-09-08,Male,52,45-54,1
26,1,1,0,2,2021-09-01,Male,62,55-64,20
26,1,0,0,1,2021-09-05,Female,66,65-69,6
26,1,1,0,2,2021-09-08,Female,26,25-34,1
26,1,6,0,7,2021-09-03,Male,54,45-54,3
26,0,8,0,8,2021-09-08,Female,18,15-19,1
26,1,2,0,3,2021-09-08,Female,69,65-69,1
26,1,1,15,17,2021-09-04,Male,56,55-64,6
26,0,0,0,0,2021-09-01,Female,40,35-44,2
26,0,0,0,0,2021-09-08,Male,5,5-9,1
26,0,5,0,5,2021-09-14,Male,74,70-74,1
26,0,6,0,6,2021-09-08,Female,42,35-44,1
26,1,0,0,1,2021-09-14,Male,69,65-69,1
26,0,0,0,0,2021-09-08,Male,66,65-69,1
26,1,0,0,1,2021-09-04,Male,69,65-69,23
26,2,0,0,2,2021-09-05,Male,57,55-64,16
26,1,0,0,1,2021-09-01,Female,63,55-64,6
26,0,1,0,1,2021-09-01,Male,63,55-64,21
26,0,1,0,1,2021-09-01,Male,61,55-64,6
26,0,0,0,0,2021-09-06,Female,66,65-69,18
26,0,0,0,0,2021-09-04,Male,38,35-44,2
26,1,0,0,1,2021-09-07,Female,33,25-34,16
26,1,0,8,9,2021-09-08,Male,69,65-69,1
26,2,0,0,2,2021-09-02,Male,16,15-19,6
26,1,0,0,1,2021-09-03,Male,52,45-54,6
26,1,0,0,1,2021-09-06,Female,61,55-64,21
26,0,1,0,1,2021-09-03,Male,52,45-54,21
26,0,1,1,2,2021-09-07,Female,63,55-64,6
26,0,0,0,0,2021-09-06,Male,47,45-54,4
26,1,0,0,1,2021-09-01,Male,18,15-19,6
26,0,3,0,3,2021-09-04,Male,75,75-79,24
26,1,1,0,2,2021-09-11,Female,18,15-19,2
26,0,3,0,3,2021-09-02,Female,67,65-69,5
26,1,0,0,1,2021-09-03,Male,52,45-54,6
26,3,0,0,3,2021-09-02,Female,11,10-14,23
26,1,0,0,1,2021-09-03,Female,70,70-74,22
26,0,1,0,1,2021-09-04,Female,81,80-84,12
26,0,1,0,1,2021-09-03,Female,10,10-14,22
26,0,0,0,0,2021-09-09,Female,64,55-64,1
26,0,0,0,0,2021-09-07,Male,31,25-34,2
26,1,0,0,1,2021-09-01,Female,40,35-44,5
26,0,0,0,0,2021-09-05,Female,66,65-69,21
26,1,0,0,1,2021-09-07,Female,27,25-34,23
26,0,0,0,0,2021-09-05,Female,41,35-44,2
26,2,2,0,4,2021-09-05,Male,76,75-79,24
26,1,0,0,1,2021-09-02,Male,68,65-69,6
26,4,0,0,4,2021-09-08,Female,13,10-14,1
26,0,0,0,0,2021-09-01,Male,64,55-64,6
26,2,9,0,11,2021-09-08,Female,34,25-34,1
26,1,0,0,1,2021-09-05,Male,74,70-74,21
26,0,0,0,0,2021-09-01,Female,25,25-34,24
26,1,0,0,1,2021-09-09,Female,23,20-24,14
26,1,0,0,1,2021-09-01,Male,64,55-64,23
26,1,0,0,1,2021-09-07,Male,70,70-74,2
26,4,2,0,6,2021-09-08,Female,7,5-9,1
26,0,4,0,4,2021-09-08,Female,41,35-44,1
26,3,0,0,3,2021-09-06,Male,18,15-19,20
26,0,0,0,0,2021-09-05,Male,51,45-54,6
26,0,0,0,0,2021-09-04,Male,54,45-54,6
26,2,0,0,2,2021-09-04,Male,55,55-64,25
26,1,1,0,2,2021-09-02,Male,68,65-69,4
26,0,0,0,0,2021-09-03,Female,31,25-34,2
26,1,0,0,1,2021-09-08,Female,61,55-64,1
26,0,2,0,2,2021-09-06,Female,66,65-69,11
26,2,0,0,2,2021-09-05,Male,73,70-74,19
26,2,0,0,2,2021-09-04,Male,7,5-9,3
26,1,0,0,1,2021-09-06,Female,53,45-54,24
26,0,0,0,0,2021-09-04,Male,34,25-34,18
26,0,0,0,0,2021-09-02,Female,49,45-54,6
26,1,1,0,2,2021-09-03,Female,72,70-74,6
26,2,0,0,2,2021-09-01,Female,22,20-24,2
26,0,0,0,0,2021-09-06,Female,72,70-74,21
26,1,0,0,1,2021-09-08,Female,51,45-54,1
26,0,0,0,0,2021-09-07,Female,28,25-34,6
26,0,2,0,2,2021-09-02,Male,31,25-34,23
26,1,19,0,20,2021-09-08,Female,28,25-34,1
26,0,1,0,1,2021-09-08,Female,66,65-69,1
26,1,4,0,5,2021-09-08,Female,72,70-74,1
26,0,1,0,1,2021-09-06,Female,57,55-64,25
26,0,0,0,0,2021-09-02,Male,68,65-69,20
26,0,3,0,3,2021-09-02,Female,67,65-69,4
26,0,0,0,0,2021-09-03,Male,52,45-54,22
26,2,3,0,5,2021-09-02,Female,48,45-54,5
26,1,0,0,1,2021-09-06,Male,9,5-9,5
26,0,0,0,0,2021-09-07,Male,27,25-34,5
26,0,6,0,6,2021-09-03,Female,51,45-54,5
26,2,0,0,2,2021-09-02,Male,67,65-69,25
26,2,0,0,2,2021-09-05,Male,9,5-9,6
26,3,13,0,16,2021-09-07,Female,5,5-9,2
26,2,0,0,2,2021-09-03,Female,31,25-34,5
26,0,0,0,0,2021-09-04,Male,29,25-34,5
26,0,0,0,0,2021-09-14,Female,48,45-54,1
26,1,0,0,1,2021-09-08,Female,33,25-34,1
26,2,1,0,3,2021-09-08,Female,5,5-9,1
26,0,1,0,1,2021-09-06,Male,46,45-54,23
26,1,0,0,1,2021-09-06,Female,42,35-44,6
26,1,0,0,1,2021-09-06,Male,57,55-64,6
26,2,0,0,2,2021-09-06,Female,69,65-69,21
26,1,1,0,2,2021-09-02,Male,50,45-54,7
26,2,0,0,2,2021-09-06,Male,35,35-44,7
26,1,3,0,4,2021-09-08,Male,31,25-34,1
26,1,0,0,1,2021-09-07,Male,55,55-64,18
26,1,1,0,2,2021-09-07,Female,48,45-54,19
26,0,3,0,3,2021-09-01,Female,42,35-44,13
26,1,0,0,1,2021-09-01,Male,64,55-64,23
26,0,0,0,0,2021-09-03,Female,53,45-54,8
26,1,1,0,2,2021-09-05,Male,67,65-69,23
26,0,0,0,0,2021-09-08,Male,64,55-64,1
26,0,1,0,1,2021-09-08,Female,46,45-54,1
26,2,0,0,2,2021-09-05,Male,9,5-9,25
26,3,0,0,3,2021-09-06,Female,9,5-9,2
26,1,9,0,10,2021-09-14,Female,64,55-64,1
26,1,0,0,1,2021-09-06,Female,34,25-34,3
26,0,1,0,1,2021-09-06,Female,51,45-54,10
26,0,8,0,8,2021-09-04,Male,74,70-74,25
26,3,2,0,5,2021-09-09,Female,18,15-19,2
26,1,1,0,2,2021-09-05,Female,66,65-69,26
26,1,0,0,1,2021-09-03,Male,52,45-54,18
26,2,30,0,32,2021-09-01,Female,14,10-14,21
26,0,0,0,0,2021-09-08,Male,49,45-54,1
26,0,1,0,1,2021-09-08,Female,40,35-44,2
26,2,0,0,2,2021-09-04,Male,1,1-4,6
26,4,4,0,8,2021-09-04,Male,10,10-14,26
26,0,0,0,0,2021-09-06,Male,75,75-79,25
26,3,0,0,3,2021-09-02,Female,11,10-14,6
26,0,0,0,0,2021-09-02,Female,67,65-69,18
26,0,0,0,0,2021-09-05,Male,71,70-74,14
26,1,3,0,4,2021-09-04,Male,55,55-64,23
26,0,0,0,0,2021-09-04,Female,79,75-79,11
26,0,4,0,4,2021-09-04,Male,78,75-79,21
26,0,0,0,0,2021-09-03,Female,33,25-34,12
26,0,0,0,0,2021-09-05,Male,85,85+,18
26,0,0,0,0,2021-09-09,Male,21,20-24,1
26,2,0,0,2,2021-09-06,Male,54,45-54,6
26,0,0,0,0,2021-09-02,Male,69,65-69,6
26,1,1,0,2,2021-09-02,Female,65,65-69,16
26,1,0,0,1,2021-09-05,Male,60,55-64,25
26,0,0,4,4,2021-09-08,Male,34,25-34,1
26,0,2,0,2,2021-09-04,Male,69,65-69,5
26,0,0,0,0,2021-09-06,Male,37,35-44,2
26,2,9,0,11,2021-09-14,Male,5,5-9,1
26,1,0,0,1,2021-09-04,Male,38,35-44,2
26,0,2,0,2,2021-09-04,Female,71,70-74,5
26,0,0,0,0,2021-09-05,Female,25,25-34,25
26,0,0,0,0,2021-09-05,Male,46,45-54,4
26,1,0,0,1,2021-09-04,Male,79,75-79,2
26,1,3,4,8,2021-09-14,Male,62,55-64,1
26,0,5,0,5,2021-09-02,Male,51,45-54,6
26,0,0,0,0,2021-09-04,Male,29,25-34,22
26,1,0,0,1,2021-09-05,Male,52,45-54,25
26,2,0,0,2,2021-09-03,Male,69,65-69,6
26,2,0,0,2,2021-09-05,Male,10,10-14,4
26,0,3,0,3,2021-09-03,Female,51,45-54,2
26,0,1,0,1,2021-09-07,Female,24,20-24,23
26,1,0,0,1,2021-09-08,Male,74,70-74,1
26,0,1,0,1,2021-09-02,Female,49,45-54,26
26,0,1,0,1,2021-09-01,Male,41,35-44,6
26,0,0,0,0,2021-09-08,Female,21,20-24,4
26,0,0,0,0,2021-09-03,Male,70,70-74,23
26,2,1,0,3,2021-09-03,Male,68,65-69,6
26,2,3,0,5,2021-09-01,Female,64,55-64,25
26,1,5,0,6,2021-09-08,Male,72,70-74,1
26,1,0,0,1,2021-09-03,Male,70,70-74,6
26,0,1,0,1,2021-09-08,Male,69,65-69,1
26,1,0,0,1,2021-09-06,Male,58,55-64,5
26,1,5,0,6,2021-09-01,Male,64,55-64,22
26,2,0,0,2,2021-09-06,Male,44,35-44,6
26,1,0,0,1,2021-09-01,Female,24,20-24,7
26,1,6,12,19,2021-09-05,Male,60,55-64,2
26,0,0,0,0,2021-09-05,Male,38,35-44,17
26,0,3,0,3,2021-09-07,Female,52,45-54,2
26,0,1,0,1,2021-09-03,Male,52,45-54,2
26,3,0,0,3,2021-09-08,Male,51,45-54,1
26,2,2,0,4,2021-09-05,Female,38,35-44,22
26,0,6,0,6,2021-09-08,Male,40,35-44,1
26,0,0,5,5,2021-09-01,Female,23,20-24,13
26,0,2,0,2,2021-09-07,Female,54,45-54,2
26,1,0,0,1,2021-09-05,Female,77,75-79,6
26,1,1,0,2,2021-09-04,Male,54,45-54,5
26,2,4,0,6,2021-09-01,Female,61,55-64,23
26,1,0,0,1,2021-09-08,Female,50,45-54,1
26,0,0,0,0,2021-09-02,Female,58,55-64,6
26,0,2,0,2,2021-09-08,Female,42,35-44,1
26,0,0,0,0,2021-09-14,Female,15,15-19,1
26,1,0,0,1,2021-09-03,Male,3,1-4,6
26,1,0,0,1,2021-09-03,Male,53,45-54,21
26,0,3,0,3,2021-09-05,Female,66,65-69,26
26,1,0,0,1,2021-09-02,Female,47,45-54,4
26,2,0,0,2,2021-09-06,Male,2,1-4,6
26,0,0,0,0,2021-09-08,Female,64,55-64,1
26,0,1,0,1,2021-09-02,Female,67,65-69,2
26,0,1,0,1,2021-09-03,Female,67,65-69,22
26,0,2,0,2,2021-09-06,Female,34,25-34,4
26,0,3,0,3,2021-09-03,Female,70,70-74,19
26,3,0,0,3,2021-09-07,Female,7,5-9,20
26,1,10,10,21,2021-09-14,Male,47,45-54,1
26,0,1,0,1,2021-09-04,Male,54,45-54,20
26,0,0,0,0,2021-09-08,Male,44,35-44,1
26,1,0,0,1,2021-09-05,Male,57,55-64,2
26,3,0,0,3,2021-09-06,Female,18,15-19,2
26,1,1,0,2,2021-09-07,Female,2,1-4,2
26,0,3,0,3,2021-09-06,Male,73,70-74,5
26,2,5,0,7,2021-09-08,Male,53,45-54,1
26,1,7,0,8,2021-09-01,Male,7,5-9,2
26,1,0,0,1,2021-09-06,Male,54,45-54,5
26,3,2,0,5,2021-09-14,Male,0,<1,1
26,0,0,0,0,2021-09-02,Male,61,55-64,4
26,0,0,0,0,2021-09-14,Female,42,35-44,1
26,1,0,0,1,2021-09-05,Male,58,55-64,21
26,2,1,0,3,2021-09-08,Male,10,10-14,1
26,2,2,0,4,2021-09-02,Male,40,35-44,24
26,1,0,0,1,2021-09-03,Female,30,25-34,2
26,1,0,0,1,2021-09-08,Male,63,55-64,1
26,0,2,0,2,2021-09-01,Male,40,35-44,20
26,4,4,0,8,2021-09-08,Male,32,25-34,1
26,1,1,0,2,2021-09-05,Female,59,55-64,2
26,1,0,0,1,2021-09-09,Female,63,55-64,1
26,1,0,0,1,2021-09-08,Female,70,70-74,1
26,1,0,0,1,2021-09-04,Male,56,55-64,2
26,0,0,0,0,2021-09-01,Female,22,20-24,15
26,0,0,7,7,2021-09-02,Female,49,45-54,5
26,3,0,0,3,2021-09-08,Female,11,10-14,1
26,2,2,0,4,2021-09-08,Female,5,5-9,1
26,1,0,0,1,2021-09-08,Male,47,45-54,1
26,1,2,0,3,2021-09-06,Female,66,65-69,6
26,0,5,0,5,2021-09-07,Female,40,35-44,2
26,0,0,0,0,2021-09-03,Male,31,25-34,4
26,1,1,0,2,2021-09-08,Female,44,35-44,1
26,1,1,0,2,2021-09-08,Male,58,55-64,1
26,2,0,0,2,2021-09-08,Female,9,5-9,22
26,1,0,0,1,2021-09-05,Male,67,65-69,24
26,0,3,0,3,2021-09-01,Male,62,55-64,21
26,1,0,0,1,2021-09-06,Male,66,65-69,5
26,0,0,0,0,2021-09-03,Female,19,15-19,10
26,0,0,0,0,2021-09-01,Female,39,35-44,5
26,1,2,0,3,2021-09-01,Female,64,55-64,10
26,0,0,0,0,2021-09-04,Male,73,70-74,21
26,1,0,0,1,2021-09-08,Female,33,25-34,12
26,0,0,0,0,2021-09-05,Female,58,55-64,21
26,1,0,0,1,2021-09-02,Male,49,45-54,6
26,0,0,0,0,2021-09-08,Male,46,45-54,1
26,0,0,0,0,2021-09-02,Female,18,15-19,25
26,1,0,0,1,2021-09-05,Male,65,65-69,2
26,1,2,0,3,2021-09-06,Female,30,25-34,2
26,1,2,0,3,2021-09-03,Female,47,45-54,5
26,3,5,0,8,2021-09-06,Male,20,20-24,6
26,0,0,0,0,2021-09-09,Female,34,25-34,1
26,0,5,0,5,2021-09-08,Male,43,35-44,1
26,2,0,0,2,2021-09-08,Male,77,75-79,13
26,0,3,0,3,2021-09-08,Male,39,35-44,1
26,2,0,9,11,2021-09-07,Male,47,45-54,6
26,1,3,0,4,2021-09-08,Male,69,65-69,1
26,1,0,0,1,2021-09-03,Female,72,70-74,22
26,1,2,0,3,2021-09-04,Male,75,75-79,6
26,0,1,0,1,2021-09-04,Male,52,45-54,15
26,0,1,0,1,2021-09-05,Female,61,55-64,17
26,3,0,0,3,2021-09-05,Male,7,5-9,26
26,2,1,0,3,2021-09-06,Female,56,55-64,24
26,2,0,0,2,2021-09-08,Female,7,5-9,1
26,1,40,5,46,2021-09-08,Male,50,45-54,1
26,1,0,0,1,2021-09-08,Male,37,35-44,1
26,0,0,0,0,2021-09-05,Male,74,70-74,2
26,1,1,0,2,2021-09-03,Male,72,70-74,6
26,2,46,0,48,2021-09-08,Male,5,5-9,1
26,0,4,0,4,2021-09-06,Male,44,35-44,6
26,0,0,0,0,2021-09-04,Female,36,35-44,21
26,0,0,0,0,2021-09-08,Female,33,25-34,1
26,0,1,0,1,2021-09-06,Female,45,45-54,5
26,0,3,0,3,2021-09-05,Male,59,55-64,2
26,0,0,0,0,2021-09-05,Male,59,55-64,5
26,1,0,0,1,2021-09-02,Male,68,65-69,5
26,1,1,0,2,2021-09-05,Female,53,45-54,2
26,0,0,0,0,2021-09-02,Male,48,45-54,5
26,0,1,0,1,2021-09-05,Male,54,45-54,19
26,2,0,0,2,2021-09-05,Female,74,70-74,15
26,3,0,1,4,2021-09-08,Male,10,10-14,1
26,0,0,0,0,2021-09-04,Male,14,10-14,22
26,2,0,0,2,2021-09-06,Male,79,75-79,17
26,1,0,0,1,2021-09-03,Male,69,65-69,5
26,2,4,0,6,2021-09-08,Male,17,15-19,1
26,1,0,0,1,2021-09-06,Male,77,75-79,6
26,2,1,0,3,2021-09-08,Female,2,1-4,6
26,1,0,0,1,2021-09-05,Male,65,65-69,26
26,1,3,0,4,2021-09-07,Female,52,45-54,21
26,1,4,0,5,2021-09-08,Female,34,25-34,1
26,2,0,0,2,2021-09-06,Female,21,20-24,25
26,1,0,0,1,2021-09-06,Female,56,55-64,5
26,1,1,0,2,2021-09-08,Female,65,65-69,1
26,0,2,0,2,2021-09-04,Male,33,25-34,6
26,0,0,0,0,2021-09-04,Female,73,70-74,19
26,1,10,8,19,2021-09-14,Female,55,55-64,1
26,1,0,0,1,2021-09-04,Male,34,25-34,5
26,0,2,0,2,2021-09-02,Male,64,55-64,6
26,0,0,0,0,2021-09-06,Female,36,35-44,16
26,3,0,20,23,2021-09-06,Female,18,15-19,2
26,1,0,0,1,2021-09-06,Male,52,45-54,6
26,0,0,0,0,2021-09-08,Male,44,35-44,1
26,1,0,0,1,2021-09-06,Male,65,65-69,6
26,0,9,0,9,2021-09-14,Female,42,35-44,1
26,1,0,0,1,2021-09-01,Male,61,55-64,6
26,3,0,0,3,2021-09-05,Female,13,10-14,6
26,0,1,0,1,2021-09-08,Female,75,75-79,1
26,2,3,0,5,2021-09-05,Male,56,55-64,24
26,0,1,0,1,2021-09-06,Female,60,55-64,2
26,0,0,0,0,2021-09-06,Male,66,65-69,4
26,3,0,0,3,2021-09-08,Male,19,15-19,1
26,1,0,0,1,2021-09-02,Female,29,25-34,5
26,0,2,0,2,2021-09-05,Female,60,55-64,20
26,1,0,0,1,2021-09-03,Female,32,25-34,2
26,0,11,0,11,2021-09-06,Male,43,35-44,2
26,0,0,0,0,2021-09-07,Female,67,65-69,14
26,0,0,0,0,2021-09-03,Male,52,45-54,2
26,0,0,0,0,2021-09-08,Male,81,80-84,1
26,1,0,0,1,2021-09-08,Male,58,55-64,1
26,3,1,0,4,2021-09-04,Female,0,<1,5
26,1,0,0,1,2021-09-05,Female,66,65-69,6
26,3,0,0,3,2021-09-04,Female,6,5-9,3
26,1,0,0,1,2021-09-04,Male,33,25-34,23
26,1,2,0,3,2021-09-07,Female,34,25-34,3
26,0,0,0,0,2021-09-02,Male,28,25-34,24
26,1,1,0,2,2021-09-08,Male,68,65-69,1
26,2,2,0,4,2021-09-06,Female,18,15-19,2
26,0,0,10,10,2021-09-07,Female,35,35-44,23
26,3,16,0,19,2021-09-08,Male,13,10-14,1
26,0,0,0,0,2021-09-01,Female,41,35-44,26
26,0,0,0,0,2021-09-12,Female,24,20-24,1
26,0,0,0,0,2021-09-08,Male,26,25-34,1
26,1,1,0,2,2021-09-03,Male,69,65-69,23
26,0,5,0,5,2021-09-06,Male,74,70-74,15
26,2,0,0,2,2021-09-05,Female,74,70-74,19
26,2,0,0,2,2021-09-05,Male,67,65-69,23
26,0,11,0,11,2021-09-02,Female,49,45-54,11
26,1,2,0,3,2021-09-04,Female,63,55-64,6
26,1,0,0,1,2021-09-07,Male,34,25-34,22
26,1,0,0,1,2021-09-07,Female,62,55-64,21
26,1,0,0,1,2021-09-02,Male,49,45-54,5
26,2,1,0,3,2021-09-05,Female,66,65-69,19
26,0,0,0,0,2021-09-03,Male,70,70-74,23
26,0,3,0,3,2021-09-04,Female,37,35-44,2
26,0,0,0,0,2021-09-02,Female,31,25-34,22
26,1,0,0,1,2021-09-08,Female,58,55-64,6
26,3,0,0,3,2021-09-08,Male,23,20-24,1
26,2,0,0,2,2021-09-05,Male,13,10-14,3
26,4,0,0,4,2021-09-09,Male,3,1-4,2
26,3,13,0,16,2021-09-02,Female,2,1-4,2
26,3,0,0,3,2021-09-08,Male,8,5-9,1
26,0,5,0,5,2021-09-07,Female,34,25-34,2
26,1,0,0,1,2021-09-08,Female,65,65-69,1
26,0,0,0,0,2021-09-05,Male,57,55-64,5
26,1,0,0,1,2021-09-04,Male,69,65-69,25
26,1,0,0,1,2021-09-05,Female,49,45-54,6
26,0,0,0,0,2021-09-06,Female,52,45-54,3
26,0,2,0,2,2021-09-08,Male,65,65-69,1
26,2,0,0,2,2021-09-06,Male,71,70-74,19
26,0,0,0,0,2021-09-08,Male,60,55-64,21
26,1,1,0,2,2021-09-03,Male,73,70-74,2
26,1,0,0,1,2021-09-14,Female,73,70-74,1
26,1,1,0,2,2021-09-02,Male,67,65-69,20
26,0,0,0,0,2021-09-04,Female,54,45-54,21
26,0,0,0,0,2021-09-07,Male,51,45-54,17
26,3,0,0,3,2021-09-05,Male,4,1-4,22
26,1,0,0,1,2021-09-05,Female,32,25-34,21
26,0,1,0,1,2021-09-01,Male,62,55-64,21
26,1,2,0,3,2021-09-04,Female,70,70-74,20
26,0,0,0,0,2021-09-02,Male,68,65-69,25
26,0,6,0,6,2021-09-08,Female,71,70-74,1
26,0,0,0,0,2021-09-01,Male,61,55-64,6
26,0,2,0,2,2021-09-05,Male,60,55-64,5
26,0,2,0,2,2021-09-01,Male,61,55-64,8
26,0,1,0,1,2021-09-08,Male,63,55-64,1
26,0,0,0,0,2021-09-02,Male,28,25-34,6
26,1,0,0,1,2021-09-08,Female,71,70-74,1
26,1,0,0,1,2021-09-05,Male,44,35-44,4
26,0,0,0,0,2021-09-04,Female,56,55-64,6
26,1,1,0,2,2021-09-04,Female,24,20-24,19
26,1,0,0,1,2021-09-01,Female,64,55-64,13
26,1,1,0,2,2021-09-01,Female,23,20-24,2
26,0,1,0,1,2021-09-06,Male,60,55-64,22
26,0,0,0,0,2021-09-04,Male,37,35-44,24
26,1,10,47,58,2021-09-05,Female,59,55-64,2
26,1,0,0,1,2021-09-05,Male,7,5-9,9
26,1,0,0,1,2021-09-06,Female,37,35-44,6
26,0,0,0,0,2021-09-03,Male,52,45-54,22
26,3,2,0,5,2021-09-03,Male,8,5-9,2
26,1,0,0,1,2021-09-07,Male,30,25-34,18
26,2,0,0,2,2021-09-01,Male,2,1-4,2
26,4,0,0,4,2021-09-01,Female,1,1-4,6
26,1,2,0,3,2021-09-08,Female,62,55-64,1
26,0,0,0,0,2021-09-05,Male,36,35-44,6
26,0,0,0,0,2021-09-05,Female,47,45-54,24
26,3,3,0,6,2021-09-06,Male,21,20-24,2
26,1,1,0,2,2021-09-14,Male,58,55-64,1
26,0,0,0,0,2021-09-05,Male,43,35-44,19
26,1,0,0,1,2021-09-04,Male,56,55-64,23
26,1,0,0,1,2021-09-05,Female,52,45-54,20
26,2,0,0,2,2021-09-08,Male,7,5-9,1
26,3,0,0,3,2021-09-04,Male,15,15-19,23
26,1,0,0,1,2021-09-04,Female,71,70-74,4
26,3,1,0,4,2021-09-03,Female,14,10-14,8
26,0,0,0,0,2021-09-04,Male,55,55-64,23
26,1,1,0,2,2021-09-08,Male,71,70-74,1
26,1,0,0,1,2021-09-05,Male,58,55-64,8
26,3,0,0,3,2021-09-05,Female,60,55-64,20
26,2,2,0,4,2021-09-03,Female,28,25-34,6
26,0,1,0,1,2021-09-01,Male,60,55-64,18
26,1,2,0,3,2021-09-02,Female,63,55-64,6
26,1,1,0,2,2021-09-01,Female,22,20-24,23
26,4,10,0,14,2021-09-08,Male,2,1-4,2
26,3,0,0,3,2021-09-06,Female,56,55-64,18
26,4,2,0,6,2021-09-08,Male,8,5-9,1
26,0,0,0,0,2021-09-04,Male,54,45-54,7
26,0,0,0,0,2021-09-02,Male,29,25-34,6
26,2,0,0,2,2021-09-03,Male,52,45-54,24
26,1,0,0,1,2021-09-05,Female,59,55-64,11
26,0,2,0,2,2021-09-14,Female,54,45-54,1
26,1,0,0,1,2021-09-01,Male,39,35-44,6
26,1,0,0,1,2021-09-02,Male,49,45-54,20
26,0,0,0,0,2021-09-09,Female,30,25-34,1
26,2,0,0,2,2021-09-06,Male,34,25-34,2
26,0,0,0,0,2021-09-05,Male,60,55-64,22
26,0,2,0,2,2021-09-08,Male,60,55-64,6
26,0,1,1,2,2021-09-08,Male,50,45-54,1
26,1,0,0,1,2021-09-14,Female,18,15-19,1
26,1,0,0,1,2021-09-03,Male,70,70-74,21
26,1,4,0,5,2021-09-08,Female,54,45-54,1
26,0,5,0,5,2021-09-02,Male,31,25-34,23
26,0,0,0,0,2021-09-06,Male,37,35-44,22
26,1,0,0,1,2021-09-08,Female,62,55-64,1
26,2,0,0,2,2021-09-02,Female,70,70-74,23
26,0,0,0,0,2021-09-08,Female,62,55-64,3
26,1,1,0,2,2021-09-08,Male,40,35-44,1
26,3,0,52,55,2021-09-14,Female,0,<1,1
26,0,1,0,1,2021-09-06,Female,26,25-34,23
26,1,0,0,1,2021-09-02,Female,61,55-64,22
26,1,0,0,1,2021-09-04,Female,54,45-54,6
26,0,0,0,0,2021-09-05,Male,58,55-64,2
26,1,0,0,1,2021-09-04,Female,73,70-74,6
26,0,2,0,2,2021-09-05,Male,66,65-69,26
26,1,3,0,4,2021-09-07,Male,53,45-54,18
26,3,0,0,3,2021-09-06,Female,9,5-9,5
26,0,7,0,7,2021-09-01,Female,24,20-24,9
26,0,4,0,4,2021-09-08,Female,30,25-34,1
26,1,2,0,3,2021-09-08,Female,32,25-34,1
26,0,0,0,0,2021-09-06,Male,35,35-44,7
26,0,0,0,0,2021-09-08,Male,43,35-44,1
26,1,1,0,2,2021-09-04,Male,70,70-74,23
26,0,1,0,1,2021-09-06,Female,65,65-69,6
26,1,3,0,4,2021-09-05,Male,45,45-54,5
26,0,0,0,0,2021-09-05,Female,66,65-69,22
26,0,0,0,0,2021-09-02,Female,69,65-69,6
26,0,0,0,0,2021-09-08,Female,70,70-74,1
26,0,0,0,0,2021-09-01,Male,64,55-64,5
26,1,1,0,2,2021-09-04,Male,80,80-84,21
26,2,1,0,3,2021-09-04,Male,73,70-74,18
26,0,0,0,0,2021-09-02,Male,68,65-69,20
26,1,13,0,14,2021-09-01,Male,40,35-44,2
26,1,0,0,1,2021-09-08,Female,68,65-69,20
26,0,3,0,3,2021-09-08,Female,65,65-69,1
26,2,0,0,2,2021-09-14,Male,11,10-14,1
26,0,1,2,3,2021-09-04,Female,56,55-64,5
26,3,0,0,3,2021-09-06,Male,13,10-14,6
26,0,3,0,3,2021-09-08,Female,28,25-34,1
26,2,3,0,5,2021-09-09,Female,14,10-14,1
26,2,3,0,5,2021-09-03,Male,70,70-74,25
26,2,0,0,2,2021-09-05,Male,45,45-54,6
26,1,3,6,10,2021-09-08,Female,72,70-74,1
26,1,0,0,1,2021-09-02,Female,46,45-54,5
26,2,0,0,2,2021-09-08,Male,74,70-74,1
26,1,0,0,1,2021-09-04,Female,38,35-44,5
26,0,1,1,2,2021-09-02,Male,51,45-54,2
26,3,0,0,3,2021-09-01,Male,14,10-14,6
26,1,3,0,4,2021-09-05,Male,63,55-64,4
26,2,2,0,4,2021-09-08,Male,19,15-19,1
26,0,0,0,0,2021-09-06,Female,78,75-79,18
26,1,0,0,1,2021-09-01,Female,21,20-24,2
26,1,0,0,1,2021-09-01,Female,64,55-64,21
26,1,0,0,1,2021-09-05,Male,60,55-64,2
26,2,0,0,2,2021-09-03,Female,16,15-19,24
26,0,6,0,6,2021-09-09,Female,34,25-34,3
26,0,0,0,0,2021-09-04,Female,34,25-34,2
26,0,3,0,3,2021-09-06,Female,53,45-54,2
26,2,10,0,12,2021-09-07,Male,16,15-19,5
26,3,0,0,3,2021-09-04,Male,3,1-4,2
26,0,2,0,2,2021-09-07,Female,65,65-69,6
26,0,0,0,0,2021-09-05,Male,78,75-79,18
26,1,0,0,1,2021-09-06,Female,57,55-64,2
26,1,1,0,2,2021-09-04,Female,55,55-64,2
26,0,0,0,0,2021-09-07,Male,41,35-44,23
26,0,0,0,0,2021-09-02,Male,68,65-69,21
26,1,0,0,1,2021-09-06,Female,67,65-69,21
26,1,0,0,1,2021-09-06,Female,69,65-69,25
26,1,0,0,1,2021-09-02,Female,15,15-19,20
26,1,3,0,4,2021-09-14,Male,9,5-9,1
26,0,1,0,1,2021-09-02,Female,29,25-34,24
26,1,0,0,1,2021-09-07,Female,64,55-64,19
26,0,0,0,0,2021-09-01,Female,0,<1,6
26,0,0,0,0,2021-09-06,Female,47,45-54,20
26,1,0,0,1,2021-09-05,Male,66,65-69,19
26,1,0,0,1,2021-09-04,Female,72,70-74,5
26,1,0,0,1,2021-09-08,Female,85,85+,1
26,1,2,0,3,2021-09-07,Male,47,45-54,2
26,1,1,0,2,2021-09-14,Female,63,55-64,1
26,2,0,0,2,2021-09-03,Female,15,15-19,6
26,0,1,0,1,2021-09-01,Male,60,55-64,21
26,1,1,0,2,2021-09-02,Male,68,65-69,6
26,0,0,0,0,2021-09-07,Male,4,1-4,14
26,0,0,0,0,2021-09-05,Female,32,25-34,6
26,1,0,0,1,2021-09-05,Male,60,55-64,22
26,0,3,0,3,2021-09-14,Male,62,55-64,1
26,1,2,0,3,2021-09-06,Male,58,55-64,2
26,0,0,0,0,2021-09-14,Female,54,45-54,1
26,0,0,0,0,2021-09-05,Male,34,25-34,5
26,2,0,0,2,2021-09-01,Male,26,25-34,23
26,0,0,0,0,2021-09-04,Female,34,25-34,2
26,2,0,0,2,2021-09-05,Female,18,15-19,5
26,1,0,0,1,2021-09-08,Male,69,65-69,1
26,0,0,0,0,2021-09-03,Male,48,45-54,8
26,2,0,0,2,2021-09-03,Male,70,70-74,24
26,1,0,0,1,2021-09-01,Male,64,55-64,6
26,0,0,0,0,2021-09-08,Male,81,80-84,1
26,1,0,0,1,2021-09-03,Female,46,45-54,6
26,1,1,0,2,2021-09-01,Male,60,55-64,22
26,0,0,0,0,2021-09-07,Female,52,45-54,6
26,0,0,0,0,2021-09-03,Male,53,45-54,18
26,2,15,100,117,2021-09-06,Male,31,25-34,22
26,1,0,0,1,2021-09-08,Male,61,55-64,1
26,1,0,0,1,2021-09-06,Female,36,35-44,6
26,2,0,0,2,2021-09-05,Male,53,45-54,5
26,3,0,0,3,2021-09-08,Female,1,1-4,1
26,0,0,0,0,2021-09-04,Female,37,35-44,6
26,1,0,0,1,2021-09-01,Female,64,55-64,20
26,0,0,0,0,2021-09-03,Male,51,45-54,5
26,0,2,0,2,2021-09-06,Female,48,45-54,4
26,3,0,0,3,2021-09-08,Female,3,1-4,1
26,3,0,0,3,2021-09-02,Male,5,5-9,5
26,3,0,0,3,2021-09-02,Female,8,5-9,6
26,1,0,0,1,2021-09-08,Male,36,35-44,1
26,0,13,0,13,2021-09-06,Female,33,25-34,2
26,2,0,0,2,2021-09-06,Female,49,45-54,6
26,1,0,0,1,2021-09-02,Male,68,65-69,2
26,0,0,0,0,2021-09-01,Male,61,55-64,8
26,3,0,0,3,2021-09-08,Female,0,<1,1
26,4,0,0,4,2021-09-09,Female,4,1-4,1
26,1,0,0,1,2021-09-05,Male,61,55-64,2
26,1,0,0,1,2021-09-04,Male,52,45-54,24
26,1,0,0,1,2021-09-04,Male,25,25-34,5
26,0,0,0,0,2021-09-08,Male,40,35-44,1
26,0,0,0,0,2021-09-05,Female,56,55-64,19
26,2,1,0,3,2021-09-14,Female,55,55-64,1
26,0,0,0,0,2021-09-04,Male,71,70-74,23
26,0,0,0,0,2021-09-06,Female,65,65-69,6
26,0,0,0,0,2021-09-06,Male,70,70-74,6
26,0,0,0,0,2021-09-01,Female,61,55-64,23
26,0,0,0,0,2021-09-03,Male,34,25-34,6
26,0,3,0,3,2021-09-05,Female,66,65-69,2
26,2,0,0,2,2021-09-08,Female,11,10-14,1
26,1,0,0,1,2021-09-01,Male,41,35-44,21
26,0,0,0,0,2021-09-05,Female,46,45-54,13
26,1,0,0,1,2021-09-05,Male,66,65-69,2
26,0,0,0,0,2021-09-08,Male,6,5-9,1
26,0,0,0,0,2021-09-01,Male,39,35-44,9
26,1,0,0,1,2021-09-14,Female,62,55-64,1
26,0,0,0,0,2021-09-04,Male,54,45-54,21
26,0,0,0,0,2021-09-01,Male,40,35-44,2
26,0,0,0,0,2021-09-04,Male,34,25-34,25
26,0,4,0,4,2021-09-02,Male,47,45-54,20
26,0,0,0,0,2021-09-08,Male,0,<1,1
26,0,0,0,0,2021-09-05,Female,67,65-69,24
26,2,1,0,3,2021-09-07,Female,12,10-14,17
26,0,0,0,0,2021-09-02,Female,68,65-69,21
26,0,0,0,0,2021-09-08,Female,30,25-34,1
26,1,3,0,4,2021-09-07,Male,60,55-64,4
26,0,0,0,0,2021-09-08,Female,27,25-34,1
26,1,0,0,1,2021-09-06,Female,44,35-44,2
26,0,0,0,0,2021-09-07,Female,23,20-24,12
26,2,0,0,2,2021-09-03,Female,15,15-19,2
26,0,0,0,0,2021-09-07,Female,70,70-74,19
26,1,0,0,1,2021-09-05,Male,46,45-54,25
26,0,1,0,1,2021-09-01,Female,60,55-64,13
26,0,0,0,0,2021-09-05,Female,66,65-69,24
26,1,5,0,6,2021-09-02,Female,61,55-64,5
26,0,0,0,0,2021-09-04,Female,74,70-74,6
26,0,0,0,0,2021-09-08,Male,18,15-19,1
26,0,1,0,1,2021-09-05,Male,30,25-34,20
26,0,2,0,2,2021-09-02,Female,47,45-54,6
26,0,4,0,4,2021-09-01,Male,39,35-44,18
26,0,3,0,3,2021-09-03,Male,52,45-54,2
26,1,13,0,14,2021-09-03,Male,68,65-69,23
26,0,0,0,0,2021-09-06,Male,13,10-14,19
26,1,2,0,3,2021-09-08,Female,28,25-34,1
26,0,0,0,0,2021-09-07,Male,18,15-19,2
26,1,0,0,1,2021-09-04,Male,79,75-79,17
26,2,1,0,3,2021-09-07,Male,68,65-69,12
26,3,0,1,4,2021-09-08,Female,14,10-14,1
26,0,0,0,0,2021-09-05,Male,48,45-54,15
26,2,5,0,7,2021-09-07,Male,0,<1,3
26,2,5,0,7,2021-09-08,Male,3,1-4,1
26,0,2,0,2,2021-09-14,Female,39,35-44,1
26,0,1,0,1,2021-09-07,Female,30,25-34,11
26,0,0,0,0,2021-09-06,Male,23,20-24,6
26,5,0,0,5,2021-09-06,Male,17,15-19,18
26,3,3,0,6,2021-09-06,Male,3,1-4,2
26,1,0,0,1,2021-09-02,Female,68,65-69,16
26,1,1,0,2,2021-09-08,Male,56,55-64,1
26,1,0,0,1,2021-09-14,Male,48,45-54,1
26,1,0,0,1,2021-09-05,Male,58,55-64,23
26,0,5,0,5,2021-09-04,Male,43,35-44,22
26,1,0,0,1,2021-09-05,Female,46,45-54,2
26,0,0,0,0,2021-09-08,Female,32,25-34,1
26,1,0,0,1,2021-09-06,Male,53,45-54,6
26,1,1,0,2,2021-09-04,Male,73,70-74,4
26,3,0,0,3,2021-09-05,Male,11,10-14,6
26,0,0,0,0,2021-09-06,Male,66,65-69,22
26,1,0,0,1,2021-09-02,Female,67,65-69,22
26,1,0,0,1,2021-09-03,Female,68,65-69,22
26,1,0,0,1,2021-09-05,Female,22,20-24,4
26,2,2,0,4,2021-09-04,Male,81,80-84,19
26,0,0,0,0,2021-09-06,Male,51,45-54,21
26,0,3,0,3,2021-09-03,Male,51,45-54,6
26,1,1,0,2,2021-09-06,Female,50,45-54,4
26,0,4,0,4,2021-09-02,Female,48,45-54,21
26,0,0,0,0,2021-09-06,Male,3,1-4,23
26,0,0,0,0,2021-09-07,Female,66,65-69,6
26,0,0,0,0,2021-09-02,Male,28,25-34,21
26,0,0,0,0,2021-09-08,Male,62,55-64,1
26,1,0,3,4,2021-09-08,Male,69,65-69,1
26,1,0,0,1,2021-09-01,Female,63,55-64,24
26,1,1,0,2,2021-09-03,Female,53,45-54,18
26,0,0,0,0,2021-09-06,Male,66,65-69,25
26,0,0,0,0,2021-09-05,Male,58,55-64,17
26,3,0,0,3,2021-09-01,Female,50,45-54,3
26,0,0,0,0,2021-09-02,Male,67,65-69,24
26,1,5,0,6,2021-09-01,Female,62,55-64,6
26,1,0,0,1,2021-09-06,Male,31,25-34,16
26,1,1,0,2,2021-09-09,Male,61,55-64,1
26,0,2,0,2,2021-09-08,Female,27,25-34,1
26,0,0,0,0,2021-09-03,Male,34,25-34,6
26,1,0,0,1,2021-09-04,Male,73,70-74,24
26,0,2,0,2,2021-09-08,Female,30,25-34,1
26,0,4,0,4,2021-09-06,Male,60,55-64,2
26,0,1,0,1,2021-09-01,Female,64,55-64,23
26,2,0,0,2,2021-09-03,Male,71,70-74,21
26,1,0,0,1,2021-09-04,Female,57,55-64,6
26,1,0,0,1,2021-09-03,Male,52,45-54,3
26,3,0,0,3,2021-09-05,Female,66,65-69,25
26,0,0,0,0,2021-09-01,Female,62,55-64,22
26,6,0,0,6,2021-09-08,Female,2,1-4,1
26,1,10,0,11,2021-09-01,Female,60,55-64,6
26,0,1,0,1,2021-09-05,Male,59,55-64,6
26,0,0,0,0,2021-09-08,Male,33,25-34,1
26,0,0,0,0,2021-09-05,Male,44,35-44,2
26,1,0,0,1,2021-09-05,Male,55,55-64,23
26,1,1,0,2,2021-09-07,Male,55,55-64,13
26,1,0,0,1,2021-09-08,Female,31,25-34,1
26,0,0,0,0,2021-09-05,Female,43,35-44,17
26,0,0,0,0,2021-09-02,Male,31,25-34,3
26,0,0,0,0,2021-09-03,Female,32,25-34,5
26,0,4,0,4,2021-09-01,Male,61,55-64,2
26,0,0,0,0,2021-09-04,Male,55,55-64,6
26,3,0,0,3,2021-09-08,Male,8,5-9,1
26,3,2,0,5,2021-09-08,Male,9,5-9,1
26,0,2,0,2,2021-09-01,Female,23,20-24,20
26,0,2,0,2,2021-09-04,Female,18,15-19,6
26,2,0,0,2,2021-09-03,Female,13,10-14,6
26,3,0,0,3,2021-09-08,Female,59,55-64,1
26,1,0,0,1,2021-09-06,Male,56,55-64,19
26,0,0,0,0,2021-09-06,Male,65,65-69,6
26,0,4,0,4,2021-09-02,Male,67,65-69,6
26,1,0,0,1,2021-09-04,Male,76,75-79,4
26,0,0,0,0,2021-09-05,Male,54,45-54,23
26,1,1,0,2,2021-09-03,Female,53,45-54,3
26,0,3,0,3,2021-09-01,Male,40,35-44,22
26,2,1,0,3,2021-09-02,Female,49,45-54,5
26,1,0,0,1,2021-09-05,Male,37,35-44,5
26,0,3,0,3,2021-09-14,Female,62,55-64,1
26,1,0,0,1,2021-09-06,Female,69,65-69,6
26,0,0,0,0,2021-09-02,Male,28,25-34,6
26,2,1,0,3,2021-09-06,Male,66,65-69,14
26,0,0,0,0,2021-09-01,Male,39,35-44,6
26,0,1,0,1,2021-09-03,Male,52,45-54,5
26,1,0,0,1,2021-09-06,Female,67,65-69,22
26,2,1,0,3,2021-09-08,Female,9,5-9,1
26,2,3,0,5,2021-09-05,Female,62,55-64,21
26,0,0,0,0,2021-09-08,Male,38,35-44,1
26,0,2,0,2,2021-09-05,Male,45,45-54,3
26,0,0,0,0,2021-09-03,Male,17,15-19,11
26,1,6,0,7,2021-09-08,Female,32,25-34,1
26,0,0,0,0,2021-09-02,Male,61,55-64,17
26,0,2,0,2,2021-09-01,Female,62,55-64,24
26,0,0,0,0,2021-09-02,Male,51,45-54,20
26,2,0,0,2,2021-09-08,Female,30,25-34,1
26,3,0,0,3,2021-09-08,Female,53,45-54,1
26,1,0,0,1,2021-09-14,Male,63,55-64,1
26,0,0,0,0,2021-09-06,Female,55,55-64,6
26,1,0,0,1,2021-09-07,Female,70,70-74,4
26,1,9,0,10,2021-09-06,Male,73,70-74,2
26,1,1,0,2,2021-09-03,Male,71,70-74,21
26,3,0,0,3,2021-09-03,Male,56,55-64,5
26,0,3,0,3,2021-09-02,Female,68,65-69,19
26,0,10,0,10,2021-09-03,Female,52,45-54,2
26,0,1,0,1,2021-09-04,Female,69,65-69,20
26,1,0,0,1,2021-09-06,Male,70,70-74,22
26,2,1,0,3,2021-09-02,Male,51,45-54,6
26,0,0,0,0,2021-09-01,Male,23,20-24,17
26,1,0,0,1,2021-09-03,Female,67,65-69,6
26,2,0,0,2,2021-09-02,Male,5,5-9,20
26,0,0,0,0,2021-09-06,Female,71,70-74,24
26,2,0,0,2,2021-09-02,Female,44,35-44,2
26,0,0,0,0,2021-09-05,Female,56,55-64,5
26,1,0,0,1,2021-09-02,Male,67,65-69,23
26,0,0,0,0,2021-09-05,Female,58,55-64,17
26,1,2,0,3,2021-09-08,Female,63,55-64,1
26,1,2,0,3,2021-09-05,Male,45,45-54,5
26,1,0,0,1,2021-09-08,Female,55,55-64,1
26,1,0,0,1,2021-09-05,Male,67,65-69,2
26,0,2,65,67,2021-09-06,Male,70,70-74,22
26,1,1,3,5,2021-09-08,Male,73,70-74,1
26,0,0,0,0,2021-09-06,Male,53,45-54,5
26,3,0,0,3,2021-09-02,Female,50,45-54,2
26,0,0,0,0,2021-09-05,Female,65,65-69,6
26,0,4,0,4,2021-09-09,Female,34,25-34,25
26,0,1,0,1,2021-09-05,Female,67,65-69,2
26,1,1,0,2,2021-09-08,Male,53,45-54,1
26,0,0,0,0,2021-09-02,Male,48,45-54,2
26,1,0,0,1,2021-09-02,Male,68,65-69,26
26,1,4,0,5,2021-09-05,Male,54,45-54,8
26,1,0,0,1,2021-09-03,Male,53,45-54,7
26,0,5,0,5,2021-09-04,Female,47,45-54,6
26,2,0,0,2,2021-09-06,Male,22,20-24,10
26,0,0,0,0,2021-09-01,Male,25,25-34,20
26,2,0,6,8,2021-09-05,Male,15,15-19,23
26,1,4,0,5,2021-09-06,Female,30,25-34,9
26,1,2,0,3,2021-09-05,Female,58,55-64,13
26,1,0,0,1,2021-09-04,Female,74,70-74,6
26,0,0,0,0,2021-09-04,Female,52,45-54,6
26,1,6,0,7,2021-09-04,Female,76,75-79,6
26,0,2,0,2,2021-09-14,Male,55,55-64,1
26,1,4,0,5,2021-09-06,Male,65,65-69,5
26,0,8,0,8,2021-09-14,Female,59,55-64,1
26,1,0,0,1,2021-09-03,Female,34,25-34,2
26,1,0,0,1,2021-09-08,Male,59,55-64,1
26,1,0,0,1,2021-09-01,Female,62,55-64,19
26,1,1,0,2,2021-09-01,Female,41,35-44,2
26,2,0,0,2,2021-09-05,Female,18,15-19,5
26,1,0,0,1,2021-09-14,Male,60,55-64,1
26,0,0,0,0,2021-09-08,Female,74,70-74,1
26,2,4,0,6,2021-09-01,Female,61,55-64,6
26,3,0,0,3,2021-09-08,Female,0,<1,1
26,1,1,0,2,2021-09-02,Male,67,65-69,17
26,1,0,0,1,2021-09-03,Male,52,45-54,21
26,1,0,0,1,2021-09-06,Female,44,35-44,2
26,1,0,0,1,2021-09-01,Male,22,20-24,5
26,3,0,0,3,2021-09-05,Female,43,35-44,25
26,1,4,0,5,2021-09-08,Male,65,65-69,1
26,1,0,0,1,2021-09-06,Female,66,65-69,14
26,1,8,0,9,2021-09-03,Male,68,65-69,5
26,0,0,0,0,2021-09-09,Male,33,25-34,5
26,0,0,0,0,2021-09-03,Female,72,70-74,19
26,0,1,0,1,2021-09-06,Male,32,25-34,20
26,0,0,0,0,2021-09-03,Female,65,65-69,26
26,0,0,0,0,2021-09-01,Male,60,55-64,19
26,3,0,0,3,2021-09-06,Male,9,5-9,6
26,3,0,2,5,2021-09-06,Female,37,35-44,14
26,4,0,0,4,2021-09-08,Male,4,1-4,1
26,1,1,0,2,2021-09-08,Female,67,65-69,5
26,1,0,0,1,2021-09-09,Female,33,25-34,1
26,1,0,0,1,2021-09-02,Male,65,65-69,5
26,2,0,0,2,2021-09-03,Female,51,45-54,22
26,0,3,0,3,2021-09-08,Female,40,35-44,1
26,4,4,0,8,2021-09-06,Female,16,15-19,21
26,1,0,0,1,2021-09-08,Male,52,45-54,1
26,1,9,0,10,2021-09-05,Female,33,25-34,2
26,0,0,0,0,2021-09-08,Male,65,65-69,1
26,1,0,0,1,2021-09-03,Male,67,65-69,2
26,2,5,6,13,2021-09-08,Male,14,10-14,1
26,0,0,0,0,2021-09-06,Male,45,45-54,21
26,2,0,0,2,2021-09-04,Male,8,5-9,12
26,0,2,0,2,2021-09-02,Female,68,65-69,22
26,1,0,0,1,2021-09-05,Female,59,55-64,20
26,3,0,0,3,2021-09-08,Female,4,1-4,3
26,0,0,0,0,2021-09-04,Female,55,55-64,24
26,0,0,0,0,2021-09-05,Female,42,35-44,25
26,0,0,0,0,2021-09-01,Male,20,20-24,7
26,0,0,0,0,2021-09-01,Female,25,25-34,8
26,1,0,0,1,2021-09-02,Female,49,45-54,6
26,0,0,0,0,2021-09-05,Male,58,55-64,2
26,1,1,0,2,2021-09-06,Male,67,65-69,6
26,0,0,0,0,2021-09-06,Male,53,45-54,2
26,0,0,0,0,2021-09-06,Female,65,65-69,23
26,0,2,0,2,2021-09-08,Female,30,25-34,1
26,0,0,0,0,2021-09-01,Male,41,35-44,17
26,1,2,0,3,2021-09-09,Female,30,25-34,1
26,1,0,0,1,2021-09-08,Female,29,25-34,1
26,0,0,0,0,2021-09-14,Female,64,55-64,1
26,0,3,0,3,2021-09-01,Male,23,20-24,2
26,1,3,0,4,2021-09-08,Female,27,25-34,1
26,0,0,0,0,2021-09-04,Male,83,80-84,11
26,1,0,0,1,2021-09-08,Female,69,65-69,2
26,1,0,0,1,2021-09-04,Female,53,45-54,25
26,1,0,0,1,2021-09-03,Male,52,45-54,6
26,2,6,0,8,2021-09-08,Female,2,1-4,1
26,1,0,0,1,2021-09-03,Female,49,45-54,5
26,1,0,0,1,2021-09-14,Male,58,55-64,1
26,1,1,0,2,2021-09-01,Male,64,55-64,6
26,1,0,0,1,2021-09-08,Male,70,70-74,1
26,1,0,0,1,2021-09-06,Male,36,35-44,10
26,2,0,0,2,2021-09-08,Female,3,1-4,1
26,2,0,0,2,2021-09-02,Male,21,20-24,22
26,0,1,0,1,2021-09-06,Male,78,75-79,25
26,0,0,0,0,2021-09-02,Female,29,25-34,7
26,0,0,0,0,2021-09-06,Male,44,35-44,19
26,2,0,0,2,2021-09-02,Female,67,65-69,25
26,0,3,0,3,2021-09-05,Female,66,65-69,19
26,1,0,0,1,2021-09-03,Female,52,45-54,8
26,1,8,0,9,2021-09-08,Male,72,70-74,1
26,1,0,0,1,2021-09-08,Male,37,35-44,1
26,2,58,0,60,2021-09-01,Female,21,20-24,1
26,0,0,0,0,2021-09-14,Female,58,55-64,1
26,0,0,0,0,2021-09-07,Male,3,1-4,17
26,0,0,0,0,2021-09-04,Female,36,35-44,6
26,0,0,0,0,2021-09-02,Male,49,45-54,23
26,0,1,0,1,2021-09-01,Male,22,20-24,2
26,0,0,0,0,2021-09-07,Female,30,25-34,6
26,3,0,0,3,2021-09-08,Male,7,5-9,1
26,1,1,0,2,2021-09-09,Male,58,55-64,1
26,3,0,0,3,2021-09-02,Female,6,5-9,6
26,1,0,0,1,2021-09-03,Male,52,45-54,5
26,0,2,0,2,2021-09-01,Male,40,35-44,23
26,1,6,0,7,2021-09-06,Female,66,65-69,26
26,1,4,0,5,2021-09-01,Female,63,55-64,6
26,0,40,0,40,2021-09-01,Male,39,35-44,23
26,1,0,0,1,2021-09-05,Male,61,55-64,6
26,4,3,0,7,2021-09-08,Female,11,10-14,1
26,0,0,0,0,2021-09-02,Male,31,25-34,23
26,0,0,0,0,2021-09-06,Female,54,45-54,22
26,0,0,0,0,2021-09-02,Male,58,55-64,16
26,1,1,0,2,2021-09-02,Female,68,65-69,24
26,3,0,0,3,2021-09-08,Female,5,5-9,16
26,0,0,0,0,2021-09-05,Male,41,35-44,24
26,0,3,4,7,2021-09-08,Male,53,45-54,1
26,1,0,0,1,2021-09-14,Male,71,70-74,1
26,2,0,0,2,2021-09-08,Male,46,45-54,1
26,1,1,0,2,2021-09-05,Male,65,65-69,23
26,0,0,0,0,2021-09-05,Male,59,55-64,11
26,1,0,0,1,2021-09-03,Male,53,45-54,3
26,0,0,0,0,2021-09-01,Male,42,35-44,24
26,4,0,0,4,2021-09-06,Female,13,10-14,17
26,0,10,0,10,2021-09-02,Female,50,45-54,6
26,1,0,0,1,2021-09-09,Female,28,25-34,1
26,1,0,0,1,2021-09-05,Male,67,65-69,6
26,2,2,0,4,2021-09-05,Male,69,65-69,17
26,3,0,5,8,2021-09-08,Male,21,20-24,1
26,0,1,0,1,2021-09-08,Female,63,55-64,1
26,1,0,0,1,2021-09-06,Female,64,55-64,4
26,1,1,0,2,2021-09-02,Male,68,65-69,14
26,1,1,0,2,2021-09-08,Male,38,35-44,2
26,0,0,0,0,2021-09-05,Female,59,55-64,23
26,0,0,0,0,2021-09-08,Female,65,65-69,1
26,0,1,0,1,2021-09-05,Male,54,45-54,2
26,0,0,0,0,2021-09-06,Female,70,70-74,4
26,1,0,0,1,2021-09-07,Female,52,45-54,5
26,0,0,0,0,2021-09-06,Male,57,55-64,10
26,2,0,0,2,2021-09-01,Female,3,1-4,6
26,1,0,0,1,2021-09-07,Female,60,55-64,24
26,0,0,0,0,2021-09-05,Male,13,10-14,23
26,1,0,0,1,2021-09-04,Male,19,15-19,22
26,1,2,0,3,2021-09-05,Female,63,55-64,10
26,1,0,0,1,2021-09-05,Male,66,65-69,22
26,4,0,0,4,2021-09-01,Female,2,1-4,6
26,0,0,0,0,2021-09-01,Female,25,25-34,2
26,2,0,0,2,2021-09-02,Female,17,15-19,23
26,1,0,0,1,2021-09-04,Female,38,35-44,5
26,1,0,0,1,2021-09-05,Male,55,55-64,13
26,1,0,0,1,2021-09-09,Female,33,25-34,2
26,2,0,6,8,2021-09-08,Female,49,45-54,1
26,0,31,0,31,2021-09-06,Male,60,55-64,6
26,2,0,0,2,2021-09-08,Male,2,1-4,1
26,0,0,0,0,2021-09-08,Male,24,20-24,5
26,0,0,0,0,2021-09-05,Male,66,65-69,6
26,0,2,0,2,2021-09-02,Female,29,25-34,2
26,1,1,0,2,2021-09-08,Male,70,70-74,1
26,0,0,0,0,2021-09-01,Female,22,20-24,6
26,0,0,0,0,2021-09-06,Female,22,20-24,21
26,0,1,0,1,2021-09-05,Female,65,65-69,2
26,3,0,0,3,2021-09-08,Female,42,35-44,1
26,1,0,0,1,2021-09-02,Male,69,65-69,5
26,1,0,0,1,2021-09-08,Male,57,55-64,1
26,1,0,0,1,2021-09-08,Female,71,70-74,1
26,0,0,0,0,2021-09-04,Female,77,75-79,6
26,0,0,0,0,2021-09-07,Female,47,45-54,2
26,0,0,10,10,2021-09-01,Male,40,35-44,6
26,1,0,20,21,2021-09-08,Male,73,70-74,1
26,4,1,0,5,2021-09-01,Male,22,20-24,2
26,1,1,0,2,2021-09-04,Male,78,75-79,6
26,0,0,0,0,2021-09-05,Male,57,55-64,5
26,1,1,0,2,2021-09-01,Male,62,55-64,6
26,0,1,0,1,2021-09-07,Female,54,45-54,23
26,0,0,0,0,2021-09-08,Female,36,35-44,1
26,1,0,0,1,2021-09-04,Male,75,75-79,17
26,0,0,0,0,2021-09-01,Male,40,35-44,23
26,1,0,2,3,2021-09-08,Male,66,65-69,1
26,0,3,0,3,2021-09-07,Female,51,45-54,2
26,0,3,0,3,2021-09-08,Male,80,80-84,1
26,1,5,0,6,2021-09-08,Male,33,25-34,1
26,1,2,0,3,2021-09-01,Female,39,35-44,2
26,1,1,0,2,2021-09-07,Female,21,20-24,2
26,3,30,0,33,2021-09-02,Female,36,35-44,6
26,0,0,0,0,2021-09-03,Female,69,65-69,5
26,0,0,0,0,2021-09-04,Female,53,45-54,6
26,0,0,2,2,2021-09-01,Male,43,35-44,5
26,0,2,0,2,2021-09-06,Female,31,25-34,22
26,1,0,0,1,2021-09-07,Male,58,55-64,20
26,1,0,0,1,2021-09-08,Female,30,25-34,1
26,2,0,0,2,2021-09-03,Male,1,1-4,2
26,0,1,0,1,2021-09-07,Male,68,65-69,2
26,1,0,0,1,2021-09-04,Male,77,75-79,5
26,0,0,0,0,2021-09-04,Male,21,20-24,11
26,1,0,0,1,2021-09-04,Female,29,25-34,17
26,2,0,0,2,2021-09-03,Male,10,10-14,19
26,1,0,0,1,2021-09-04,Male,69,65-69,6
26,0,0,0,0,2021-09-01,Male,27,25-34,6
26,2,1,0,3,2021-09-08,Female,2,1-4,1
26,1,0,0,1,2021-09-08,Male,67,65-69,1
26,1,2,0,3,2021-09-05,Male,61,55-64,2
26,0,2,0,2,2021-09-05,Female,59,55-64,5
26,0,1,0,1,2021-09-03,Female,70,70-74,23
26,1,0,0,1,2021-09-06,Female,47,45-54,2
26,2,0,0,2,2021-09-04,Male,74,70-74,22
26,1,2,0,3,2021-09-02,Male,63,55-64,16
26,0,0,0,0,2021-09-07,Female,22,20-24,14
26,0,1,0,1,2021-09-03,Female,52,45-54,2
26,0,0,22,22,2021-09-03,Male,69,65-69,8
26,0,1,0,1,2021-09-08,Female,34,25-34,1
26,0,1,0,1,2021-09-01,Male,63,55-64,19
26,1,0,0,1,2021-09-05,Female,66,65-69,4
26,1,0,85,86,2021-09-02,Male,68,65-69,2
26,0,0,2,2,2021-09-14,Female,47,45-54,1
26,3,0,0,3,2021-09-14,Female,9,5-9,1
26,2,1,0,3,2021-09-02,Male,48,45-54,3
26,0,4,0,4,2021-09-05,Male,45,45-54,22
26,0,8,0,8,2021-09-04,Female,81,80-84,4
26,0,0,0,0,2021-09-03,Female,70,70-74,2
26,1,0,0,1,2021-09-05,Male,55,55-64,20
26,1,4,0,5,2021-09-04,Female,18,15-19,2
26,1,0,0,1,2021-09-04,Female,70,70-74,20
26,1,0,0,1,2021-09-04,Female,81,80-84,6
26,1,11,0,12,2021-09-05,Female,60,55-64,5
26,3,5,0,8,2021-09-08,Male,4,1-4,1
26,2,1,0,3,2021-09-08,Male,67,65-69,1
26,0,2,0,2,2021-09-09,Female,34,25-34,1
26,2,0,0,2,2021-09-06,Female,66,65-69,6
26,2,0,0,2,2021-09-14,Male,19,15-19,1
26,1,0,0,1,2021-09-14,Female,62,55-64,1
26,1,0,0,1,2021-09-02,Female,69,65-69,23
26,2,0,0,2,2021-09-07,Female,53,45-54,3
26,1,1,0,2,2021-09-05,Male,44,35-44,2
26,0,1,0,1,2021-09-05,Male,43,35-44,6
26,2,2,0,4,2021-09-02,Male,15,15-19,2
26,1,5,0,6,2021-09-04,Male,55,55-64,26
26,2,2,0,4,2021-09-08,Female,54,45-54,1
26,1,2,0,3,2021-09-08,Female,81,80-84,2
26,1,0,0,1,2021-09-02,Female,50,45-54,3
26,0,4,0,4,2021-09-01,Female,21,20-24,2
26,0,0,0,0,2021-09-02,Female,62,55-64,25
26,1,4,1,6,2021-09-08,Male,51,45-54,1
26,0,2,0,2,2021-09-06,Female,67,65-69,24
26,0,0,0,0,2021-09-05,Male,45,45-54,7
26,0,0,0,0,2021-09-05,Male,66,65-69,23
26,0,1,0,1,2021-09-01,Female,60,55-64,22
26,0,10,0,10,2021-09-08,Male,43,35-44,1
26,1,2,0,3,2021-09-07,Female,24,20-24,6
26,1,8,0,9,2021-09-05,Female,65,65-69,6
26,1,0,0,1,2021-09-14,Female,65,65-69,1
26,2,0,0,2,2021-09-04,Male,37,35-44,2
26,3,0,0,3,2021-09-01,Female,10,10-14,21
26,2,15,0,17,2021-09-07,Male,13,10-14,20
26,1,3,0,4,2021-09-01,Female,63,55-64,24
26,2,0,0,2,2021-09-05,Male,51,45-54,8
26,0,1,0,1,2021-09-03,Female,53,45-54,24
26,0,2,0,2,2021-09-07,Female,66,65-69,21
26,0,6,0,6,2021-09-08,Male,66,65-69,1
26,2,0,0,2,2021-09-02,Female,48,45-54,23
26,1,0,0,1,2021-09-02,Male,67,65-69,22
26,1,0,0,1,2021-09-03,Male,31,25-34,3
26,2,1,0,3,2021-09-04,Male,8,5-9,5
26,1,0,3,4,2021-09-08,Female,63,55-64,1
26,2,0,19,21,2021-09-08,Male,8,5-9,1
26,0,0,0,0,2021-09-06,Female,45,45-54,22
26,1,0,0,1,2021-09-03,Male,65,65-69,21
26,2,0,0,2,2021-09-06,Female,68,65-69,20
26,3,0,0,3,2021-09-08,Male,53,45-54,1
26,2,2,0,4,2021-09-03,Male,21,20-24,23
26,1,1,0,2,2021-09-02,Female,67,65-69,18
26,1,2,0,3,2021-09-05,Male,59,55-64,25
26,1,3,0,4,2021-09-08,Female,66,65-69,5
26,0,0,0,0,2021-09-02,Male,50,45-54,6
26,1,0,0,1,2021-09-08,Male,2,1-4,1
26,1,0,0,1,2021-09-02,Male,67,65-69,20
26,0,14,0,14,2021-09-07,Female,72,70-74,5
26,3,0,0,3,2021-09-06,Male,8,5-9,22
26,3,0,0,3,2021-09-14,Male,2,1-4,1
26,1,0,0,1,2021-09-02,Female,28,25-34,2
26,1,33,0,34,2021-09-01,Male,64,55-64,6
26,0,0,0,0,2021-09-05,Female,65,65-69,6
26,0,7,0,7,2021-09-08,Female,65,65-69,1
26,0,0,0,0,2021-09-09,Female,27,25-34,1
26,0,0,0,0,2021-09-10,Male,22,20-24,2
26,1,0,0,1,2021-09-07,Female,59,55-64,12
26,1,0,0,1,2021-09-01,Female,63,55-64,6
26,3,0,0,3,2021-09-06,Male,22,20-24,22
26,0,0,0,0,2021-09-02,Male,50,45-54,21
26,0,3,33,36,2021-09-02,Female,26,25-34,25
26,1,0,0,1,2021-09-14,Male,60,55-64,1
26,3,2,0,5,2021-09-02,Male,30,25-34,23
26,1,1,0,2,2021-09-08,Female,31,25-34,1
26,1,3,0,4,2021-09-04,Female,56,55-64,2
26,2,1,0,3,2021-09-05,Female,14,10-14,21
26,1,3,0,4,2021-09-04,Female,70,70-74,23
26,1,0,0,1,2021-09-05,Male,67,65-69,18
26,0,7,0,7,2021-09-02,Male,63,55-64,2
26,1,2,0,3,2021-09-03,Male,52,45-54,5
26,0,0,0,0,2021-09-02,Male,67,65-69,22
26,2,0,0,2,2021-09-02,Female,68,65-69,17
26,0,0,0,0,2021-09-08,Female,67,65-69,22
26,2,0,0,2,2021-09-05,Male,43,35-44,22
26,0,1,0,1,2021-09-04,Female,77,75-79,16
26,1,0,0,1,2021-09-04,Female,73,70-74,6
26,1,2,0,3,2021-09-08,Male,18,15-19,1
26,1,0,0,1,2021-09-04,Male,73,70-74,2
26,0,0,0,0,2021-09-05,Male,41,35-44,17
26,1,2,0,3,2021-09-05,Female,42,35-44,2
26,0,22,0,22,2021-09-08,Female,31,25-34,1
26,0,11,0,11,2021-09-01,Female,61,55-64,6
26,0,3,0,3,2021-09-07,Female,54,45-54,6
26,1,0,0,1,2021-09-02,Male,68,65-69,23
26,1,3,3,7,2021-09-08,Male,71,70-74,1
26,4,2,0,6,2021-09-03,Male,5,5-9,25
26,3,4,0,7,2021-09-08,Female,9,5-9,1
26,0,5,45,50,2021-09-08,Male,66,65-69,6
26,2,0,0,2,2021-09-05,Female,2,1-4,6
26,0,0,0,0,2021-09-08,Female,32,25-34,1
26,0,0,0,0,2021-09-04,Male,32,25-34,5
26,1,0,0,1,2021-09-08,Female,65,65-69,1
26,4,0,0,4,2021-09-05,Female,45,45-54,6
26,0,0,0,0,2021-09-06,Male,24,20-24,7
26,2,0,0,2,2021-09-04,Female,73,70-74,6
26,0,5,0,5,2021-09-08,Male,55,55-64,1
26,1,0,0,1,2021-09-05,Male,57,55-64,6
26,1,10,0,11,2021-09-08,Male,48,45-54,1
26,1,3,0,4,2021-09-03,Female,52,45-54,6
26,0,2,0,2,2021-09-05,Female,2,1-4,20
26,3,0,0,3,2021-09-05,Female,34,25-34,19
26,1,0,0,1,2021-09-14,Female,56,55-64,1
26,0,2,0,2,2021-09-14,Male,72,70-74,1
26,2,0,0,2,2021-09-03,Male,52,45-54,21
26,0,0,6,6,2021-09-06,Male,67,65-69,5
26,6,0,0,6,2021-09-05,Female,7,5-9,2
26,2,11,20,33,2021-09-14,Male,17,15-19,1
26,2,2,0,4,2021-09-01,Male,62,55-64,22
26,0,0,0,0,2021-09-03,Male,51,45-54,5
26,1,6,0,7,2021-09-03,Female,62,55-64,21
26,0,0,0,0,2021-09-08,Female,33,25-34,1
26,3,0,0,3,2021-09-08,Male,4,1-4,1
26,3,0,0,3,2021-09-01,Male,60,55-64,2
26,1,2,0,3,2021-09-06,Male,66,65-69,24
26,3,1,0,4,2021-09-06,Female,23,20-24,4
26,1,3,2,6,2021-09-14,Female,68,65-69,1
26,3,4,0,7,2021-09-03,Male,6,5-9,6
26,1,0,0,1,2021-09-02,Female,40,35-44,20
26,0,0,0,0,2021-09-02,Male,51,45-54,6
26,0,1,0,1,2021-09-06,Female,63,55-64,2
26,1,0,0,1,2021-09-07,Male,59,55-64,3
26,0,0,0,0,2021-09-05,Male,58,55-64,4
26,1,0,2,3,2021-09-02,Male,46,45-54,6
26,0,1,0,1,2021-09-14,Female,66,65-69,1
26,2,5,0,7,2021-09-01,Female,18,15-19,3
26,3,2,0,5,2021-09-05,Male,53,45-54,25
26,1,0,1,2,2021-09-07,Female,65,65-69,4
26,0,2,0,2,2021-09-05,Male,57,55-64,6
26,0,0,0,0,2021-09-03,Male,52,45-54,20
26,0,0,0,0,2021-09-08,Female,29,25-34,1
26,0,3,0,3,2021-09-01,Female,62,55-64,5
26,1,0,0,1,2021-09-03,Male,69,65-69,5
26,0,4,0,4,2021-09-01,Female,61,55-64,20
26,3,1,0,4,2021-09-08,Female,5,5-9,1
26,1,0,0,1,2021-09-03,Female,70,70-74,6
26,0,0,0,0,2021-09-03,Female,7,5-9,3
26,1,0,0,1,2021-09-02,Female,17,15-19,14
26,0,0,0,0,2021-09-02,Female,54,45-54,25
26,0,0,0,0,2021-09-14,Male,56,55-64,1
26,1,0,0,1,2021-09-06,Male,27,25-34,2
26,0,7,0,7,2021-09-02,Female,30,25-34,2
26,0,0,0,0,2021-09-05,Male,67,65-69,18
26,1,0,0,1,2021-09-02,Male,67,65-69,23
26,3,0,0,3,2021-09-04,Male,18,15-19,5
26,0,0,0,0,2021-09-01,Male,41,35-44,23
26,0,0,0,0,2021-09-01,Male,60,55-64,22
26,0,5,0,5,2021-09-01,Male,42,35-44,26
26,0,0,0,0,2021-09-02,Male,67,65-69,25
26,1,0,2,3,2021-09-14,Male,64,55-64,1
26,1,1,0,2,2021-09-08,Male,65,65-69,1
26,1,1,0,2,2021-09-08,Female,69,65-69,1
26,1,0,0,1,2021-09-08,Male,80,80-84,2
26,2,3,0,5,2021-09-04,Female,4,1-4,7
26,1,0,0,1,2021-09-01,Male,64,55-64,21
26,0,0,0,0,2021-09-02,Female,69,65-69,22
26,1,0,0,1,2021-09-08,Female,68,65-69,1
26,2,0,4,6,2021-09-14,Male,61,55-64,1
26,2,4,0,6,2021-09-03,Male,52,45-54,16
26,0,0,0,0,2021-09-02,Male,21,20-24,5
26,4,2,0,6,2021-09-06,Male,4,1-4,23
26,3,0,0,3,2021-09-08,Male,0,<1,1
26,2,43,90,135,2021-09-04,Female,54,45-54,3
26,0,2,0,2,2021-09-05,Female,65,65-69,4
26,1,0,0,1,2021-09-06,Male,48,45-54,21
26,0,0,0,0,2021-09-11,Male,20,20-24,2
26,3,0,0,3,2021-09-03,Male,13,10-14,12
26,1,20,0,21,2021-09-05,Male,66,65-69,2
26,0,1,0,1,2021-09-06,Female,35,35-44,20
26,0,0,0,0,2021-09-08,Male,72,70-74,1
26,0,0,0,0,2021-09-14,Male,16,15-19,1
26,0,1,0,1,2021-09-03,Female,27,25-34,5
26,1,3,0,4,2021-09-04,Male,74,70-74,2
26,1,0,0,1,2021-09-01,Male,62,55-64,25
26,0,3,0,3,2021-09-02,Female,58,55-64,26
26,3,0,0,3,2021-09-05,Male,11,10-14,24
26,1,30,0,31,2021-09-04,Female,38,35-44,5
26,0,0,0,0,2021-09-05,Male,65,65-69,6
26,2,0,2,4,2021-09-04,Male,78,75-79,19
26,0,0,0,0,2021-09-06,Female,39,35-44,2
26,0,0,0,0,2021-09-05,Female,39,35-44,21
26,0,8,0,8,2021-09-08,Female,37,35-44,1
26,1,1,0,2,2021-09-14,Male,67,65-69,1
26,0,10,0,10,2021-09-07,Female,57,55-64,5
26,0,0,0,0,2021-09-03,Male,34,25-34,6
26,1,0,0,1,2021-09-08,Female,69,65-69,1
26,3,0,0,3,2021-09-08,Female,1,1-4,1
26,3,3,0,6,2021-09-04,Female,0,<1,2
26,0,0,0,0,2021-09-04,Male,34,25-34,5
26,1,0,0,1,2021-09-14,Male,60,55-64,1
26,2,0,0,2,2021-09-08,Female,30,25-34,1
26,1,0,0,1,2021-09-02,Male,67,65-69,21
26,4,0,0,4,2021-09-01,Female,18,15-19,16
26,2,0,0,2,2021-09-07,Male,51,45-54,17
26,0,0,0,0,2021-09-09,Male,32,25-34,2
26,2,0,0,2,2021-09-06,Female,66,65-69,20
26,0,0,0,0,2021-09-02,Male,68,65-69,6
26,0,2,0,2,2021-09-05,Female,60,55-64,2
26,0,0,0,0,2021-09-02,Male,28,25-34,22
26,1,0,0,1,2021-09-02,Female,28,25-34,2
26,1,0,0,1,2021-09-03,Female,72,70-74,6
26,3,0,0,3,2021-09-03,Male,3,1-4,7
26,1,0,4,5,2021-09-03,Male,70,70-74,6
26,1,31,0,32,2021-09-14,Female,66,65-69,1
26,0,0,0,0,2021-09-09,Male,34,25-34,6
26,1,2,0,3,2021-09-08,Male,71,70-74,1
26,3,0,0,3,2021-09-09,Female,19,15-19,6
26,0,4,0,4,2021-09-08,Female,48,45-54,1
26,0,0,0,0,2021-09-14,Female,73,70-74,1
26,2,0,0,2,2021-09-03,Female,10,10-14,2
26,0,0,0,0,2021-09-03,Male,52,45-54,23
26,3,0,0,3,2021-09-08,Male,9,5-9,1
26,1,0,0,1,2021-09-05,Male,65,65-69,2
26,2,0,0,2,2021-09-06,Male,24,20-24,19
26,0,1,0,1,2021-09-05,Female,38,35-44,6
26,0,1,0,1,2021-09-05,Female,56,55-64,6
26,0,0,0,0,2021-09-06,Male,55,55-64,3
26,0,0,0,0,2021-09-05,Female,56,55-64,5
26,1,1,0,2,2021-09-04,Female,55,55-64,5
26,2,0,4,6,2021-09-08,Female,71,70-74,1
26,2,0,0,2,2021-09-01,Male,62,55-64,21
26,0,0,0,0,2021-09-06,Female,31,25-34,11
26,0,1,0,1,2021-09-05,Male,58,55-64,3
26,1,0,0,1,2021-09-01,Male,62,55-64,2
26,2,0,0,2,2021-09-03,Male,11,10-14,25
26,1,0,0,1,2021-09-06,Male,71,70-74,10
26,3,0,0,3,2021-09-05,Male,17,15-19,6
26,2,0,0,2,2021-09-01,Female,63,55-64,22
26,0,0,0,0,2021-09-08,Female,24,20-24,1
26,1,4,0,5,2021-09-08,Female,41,35-44,1
26,2,1,0,3,2021-09-02,Female,65,65-69,26
26,1,0,0,1,2021-09-05,Female,49,45-54,24
26,1,2,0,3,2021-09-03,Male,69,65-69,2
26,0,0,0,0,2021-09-01,Male,41,35-44,5
26,2,11,0,13,2021-09-08,Female,0,<1,1
26,0,1,0,1,2021-09-08,Female,28,25-34,1
26,1,0,0,1,2021-09-05,Female,65,65-69,6
26,3,3,2,8,2021-09-14,Female,12,10-14,1
26,0,0,0,0,2021-09-02,Male,68,65-69,4
26,0,3,0,3,2021-09-02,Female,51,45-54,6
26,0,3,0,3,2021-09-07,Male,72,70-74,15
26,0,0,0,0,2021-09-06,Female,54,45-54,20
26,1,0,0,1,2021-09-03,Female,34,25-34,18
26,1,2,0,3,2021-09-02,Female,31,25-34,2
26,0,3,11,14,2021-09-05,Female,65,65-69,2
26,0,0,0,0,2021-09-04,Male,78,75-79,2
26,3,2,0,5,2021-09-08,Male,5,5-9,1
26,2,0,0,2,2021-09-09,Male,55,55-64,1
26,0,0,0,0,2021-09-06,Female,21,20-24,2
26,0,0,9,9,2021-09-09,Female,34,25-34,1
26,1,0,0,1,2021-09-05,Female,51,45-54,22
26,2,0,0,2,2021-09-05,Male,57,55-64,22
26,0,0,0,0,2021-09-03,Male,52,45-54,8
26,0,4,0,4,2021-09-04,Female,63,55-64,18
26,0,0,0,0,2021-09-05,Female,60,55-64,21
26,2,0,0,2,2021-09-06,Male,66,65-69,25
26,2,0,0,2,2021-09-03,Male,71,70-74,14
26,1,0,0,1,2021-09-04,Male,62,55-64,25
26,0,0,0,0,2021-09-05,Male,66,65-69,25
26,0,0,5,5,2021-09-08,Female,26,25-34,2
26,1,0,0,1,2021-09-05,Female,56,55-64,17
26,0,0,0,0,2021-09-07,Male,60,55-64,6
26,0,0,0,0,2021-09-04,Male,34,25-34,20
26,1,1,0,2,2021-09-05,Female,59,55-64,24
26,0,1,0,1,2021-09-04,Male,54,45-54,6
26,2,1,0,3,2021-09-04,Male,74,70-74,21
26,1,0,0,1,2021-09-02,Female,68,65-69,6
26,2,0,0,2,2021-09-02,Male,48,45-54,5
26,2,2,0,4,2021-09-01,Female,2,1-4,6
26,2,0,0,2,2021-09-04,Male,34,25-34,20
26,0,0,0,0,2021-09-04,Female,37,35-44,19
26,0,0,0,0,2021-09-08,Female,31,25-34,1
26,1,0,0,1,2021-09-01,Male,63,55-64,17
26,3,0,0,3,2021-09-09,Female,18,15-19,1
26,1,1,0,2,2021-09-06,Female,48,45-54,17
26,2,2,0,4,2021-09-01,Female,23,20-24,17
26,0,4,0,4,2021-09-07,Female,22,20-24,6
26,0,6,0,6,2021-09-06,Female,69,65-69,21
26,2,1,0,3,2021-09-06,Female,66,65-69,21
26,0,1,0,1,2021-09-08,Male,76,75-79,1
26,0,0,0,0,2021-09-05,Male,54,45-54,23
26,0,8,0,8,2021-09-04,Male,32,25-34,5
26,0,1,0,1,2021-09-07,Female,36,35-44,18
26,1,32,0,33,2021-09-05,Male,18,15-19,2
26,0,1,0,1,2021-09-05,Male,57,55-64,23
26,0,1,0,1,2021-09-05,Female,56,55-64,24
26,0,0,0,0,2021-09-02,Female,27,25-34,5
26,0,3,0,3,2021-09-02,Female,68,65-69,25
26,3,2,0,5,2021-09-01,Male,5,5-9,2
26,2,0,4,6,2021-09-08,Female,2,1-4,1
26,1,0,0,1,2021-09-08,Female,39,35-44,1
26,0,0,0,0,2021-09-02,Female,68,65-69,9
26,1,2,0,3,2021-09-06,Male,73,70-74,19
26,2,0,0,2,2021-09-08,Female,2,1-4,1
26,2,0,0,2,2021-09-08,Female,17,15-19,1
26,1,0,0,1,2021-09-01,Female,25,25-34,12
26,0,0,0,0,2021-09-08,Female,72,70-74,1
26,0,0,0,0,2021-09-08,Male,66,65-69,1
26,1,0,0,1,2021-09-04,Female,73,70-74,18
26,0,0,0,0,2021-09-02,Female,50,45-54,6
26,3,6,0,9,2021-09-06,Male,13,10-14,5
26,0,0,0,0,2021-09-08,Male,44,35-44,2
26,0,3,0,3,2021-09-01,Male,26,25-34,3
26,2,0,0,2,2021-09-05,Female,71,70-74,22
26,2,2,9,13,2021-09-08,Female,4,1-4,1
26,1,2,0,3,2021-09-08,Male,66,65-69,1
26,1,0,0,1,2021-09-14,Male,69,65-69,1
26,0,2,0,2,2021-09-02,Female,60,55-64,5
26,0,2,0,2,2021-09-02,Male,67,65-69,26
26,2,0,0,2,2021-09-04,Male,1,1-4,6
26,2,5,0,7,2021-09-01,Female,54,45-54,3
26,0,0,0,0,2021-09-08,Male,64,55-64,1
26,0,0,0,0,2021-09-01,Female,27,25-34,21
26,1,4,0,5,2021-09-08,Male,81,80-84,20
26,0,0,0,0,2021-09-08,Male,68,65-69,1
26,0,0,0,0,2021-09-08,Female,32,25-34,1
26,1,0,0,1,2021-09-06,Female,54,45-54,23
26,1,0,0,1,2021-09-01,Male,63,55-64,24
26,3,2,0,5,2021-09-02,Male,20,20-24,6
26,1,0,0,1,2021-09-05,Female,67,65-69,6
26,1,0,0,1,2021-09-05,Male,59,55-64,2
26,1,0,0,1,2021-09-07,Female,68,65-69,6
26,1,0,0,1,2021-09-02,Female,29,25-34,24
26,2,1,0,3,2021-09-08,Female,49,45-54,1
26,0,0,0,0,2021-09-02,Male,27,25-34,6
26,0,0,0,0,2021-09-04,Male,54,45-54,22
26,3,0,0,3,2021-09-02,Male,3,1-4,8
26,2,0,0,2,2021-09-04,Male,2,1-4,6
26,2,9,0,11,2021-09-02,Female,1,1-4,2
26,3,1,0,4,2021-09-06,Female,2,1-4,2
26,0,0,0,0,2021-09-07,Female,54,45-54,5
26,1,0,0,1,2021-09-08,Female,64,55-64,6
26,0,0,0,0,2021-09-10,Male,19,15-19,2
26,0,0,0,0,2021-09-05,Male,16,15-19,16
26,0,3,0,3,2021-09-08,Male,52,45-54,1
26,1,2,0,3,2021-09-04,Male,35,35-44,25
26,0,0,0,0,2021-09-06,Female,36,35-44,8
26,0,2,0,2,2021-09-03,Female,72,70-74,24
26,1,0,0,1,2021-09-05,Female,54,45-54,6
26,0,0,0,0,2021-09-08,Female,77,75-79,3
26,0,0,0,0,2021-09-01,Female,63,55-64,13
26,1,0,0,1,2021-09-07,Male,58,55-64,2
26,0,7,0,7,2021-09-07,Female,51,45-54,2
26,1,0,0,1,2021-09-04,Male,33,25-34,21
26,0,0,0,0,2021-09-07,Female,43,35-44,23
26,0,0,0,0,2021-09-05,Male,59,55-64,20
26,1,0,0,1,2021-09-05,Female,55,55-64,6
26,5,0,0,5,2021-09-07,Male,55,55-64,20
26,4,0,0,4,2021-09-06,Female,37,35-44,25
26,1,0,0,1,2021-09-05,Female,60,55-64,24
26,0,0,0,0,2021-09-01,Female,7,5-9,7
26,1,0,0,1,2021-09-03,Male,70,70-74,18
26,1,0,0,1,2021-09-02,Male,67,65-69,24
26,0,0,0,0,2021-09-08,Male,62,55-64,1
26,0,0,0,0,2021-09-05,Male,44,35-44,2
26,0,0,0,0,2021-09-01,Male,60,55-64,6
26,3,0,0,3,2021-09-02,Male,49,45-54,17
26,0,2,0,2,2021-09-07,Male,51,45-54,2
26,0,0,0,0,2021-09-08,Female,74,70-74,1
26,3,6,0,9,2021-09-08,Female,12,10-14,1
26,2,0,0,2,2021-09-08,Female,4,1-4,1
26,0,0,0,0,2021-09-02,Female,49,45-54,6
26,0,0,0,0,2021-09-03,Male,53,45-54,24
26,1,5,0,6,2021-09-05,Female,76,75-79,18
26,2,5,0,7,2021-09-08,Male,1,1-4,1
26,2,0,0,2,2021-09-06,Male,5,5-9,6
26,3,11,0,14,2021-09-08,Female,56,55-64,1
26,1,18,0,19,2021-09-08,Female,33,25-34,1
26,0,0,0,0,2021-09-04,Female,70,70-74,2
26,1,0,0,1,2021-09-08,Female,41,35-44,1
26,2,0,0,2,2021-09-08,Male,3,1-4,2
26,0,0,0,0,2021-09-08,Male,50,45-54,1
26,3,0,0,3,2021-09-04,Male,18,15-19,16
26,1,0,0,1,2021-09-06,Female,43,35-44,5
26,0,0,0,0,2021-09-02,Female,41,35-44,3
26,0,0,0,0,2021-09-02,Female,62,55-64,2
26,0,2,0,2,2021-09-04,Male,75,75-79,20
26,2,0,0,2,2021-09-01,Male,17,15-19,6
26,0,0,0,0,2021-09-02,Male,40,35-44,13
26,0,1,0,1,2021-09-08,Male,54,45-54,1
26,0,0,0,0,2021-09-04,Male,36,35-44,12
26,0,3,0,3,2021-09-05,Male,74,70-74,11
26,0,1,0,1,2021-09-05,Female,67,65-69,25
26,1,2,0,3,2021-09-07,Male,70,70-74,2
26,1,0,0,1,2021-09-08,Female,24,20-24,1
26,0,0,0,0,2021-09-05,Female,55,55-64,20
26,1,4,0,5,2021-09-08,Male,72,70-74,1
26,0,0,0,0,2021-09-04,Male,54,45-54,2
26,0,12,0,12,2021-09-07,Male,52,45-54,2
26,1,0,0,1,2021-09-02,Female,47,45-54,23
26,1,0,0,1,2021-09-02,Female,48,45-54,6
26,0,0,0,0,2021-09-09,Female,21,20-24,6
26,1,0,0,1,2021-09-03,Female,33,25-34,4
26,1,0,0,1,2021-09-04,Male,54,45-54,21
26,0,0,0,0,2021-09-06,Female,27,25-34,2
26,0,0,0,0,2021-09-03,Male,71,70-74,6
26,0,0,0,0,2021-09-02,Female,63,55-64,23
26,0,0,0,0,2021-09-08,Male,50,45-54,1
26,2,0,0,2,2021-09-08,Female,13,10-14,1
26,1,4,0,5,2021-09-14,Female,60,55-64,1
26,1,1,0,2,2021-09-03,Female,71,70-74,25
26,1,1,0,2,2021-09-04,Female,54,45-54,13
26,1,0,0,1,2021-09-09,Female,31,25-34,1
26,2,0,0,2,2021-09-04,Female,63,55-64,13
26,2,3,0,5,2021-09-14,Male,64,55-64,1
26,1,21,5,27,2021-09-05,Male,74,70-74,18
26,3,0,0,3,2021-09-01,Male,61,55-64,6
26,1,0,0,1,2021-09-06,Male,29,25-34,26
26,0,2,0,2,2021-09-07,Female,32,25-34,20
26,0,0,0,0,2021-09-06,Female,65,65-69,20
26,2,0,0,2,2021-09-01,Male,43,35-44,23
26,3,20,0,23,2021-09-04,Female,2,1-4,7
26,0,0,0,0,2021-09-03,Male,71,70-74,24
26,0,2,0,2,2021-09-08,Male,48,45-54,1
26,2,0,0,2,2021-09-05,Male,43,35-44,2
26,1,0,0,1,2021-09-05,Female,60,55-64,2
26,1,0,0,1,2021-09-02,Male,52,45-54,5
26,0,0,0,0,2021-09-03,Female,69,65-69,26
26,1,1,0,2,2021-09-06,Male,67,65-69,6
26,1,0,0,1,2021-09-04,Female,80,80-84,6
26,0,0,0,0,2021-09-06,Male,45,45-54,2
26,1,3,0,4,2021-09-05,Male,73,70-74,11
26,1,0,0,1,2021-09-06,Male,77,75-79,5
26,0,0,0,0,2021-09-01,Male,61,55-64,20
26,0,0,0,0,2021-09-08,Male,74,70-74,1
26,0,0,0,0,2021-09-01,Male,27,25-34,2
26,1,0,0,1,2021-09-08,Male,60,55-64,1
26,0,0,0,0,2021-09-08,Male,44,35-44,1
26,0,11,0,11,2021-09-01,Female,41,35-44,6
26,0,0,0,0,2021-09-02,Female,35,35-44,22
26,1,0,0,1,2021-09-02,Male,69,65-69,25
26,2,0,0,2,2021-09-06,Female,57,55-64,19
26,0,0,0,0,2021-09-01,Female,41,35-44,13
26,1,0,0,1,2021-09-06,Male,65,65-69,6
26,0,4,0,4,2021-09-05,Male,69,65-69,24
26,3,0,0,3,2021-09-02,Male,18,15-19,19
26,0,0,0,0,2021-09-06,Male,36,35-44,3
26,0,0,0,0,2021-09-05,Female,57,55-64,25
26,0,3,0,3,2021-09-08,Female,62,55-64,5
26,1,0,0,1,2021-09-03,Male,25,25-34,6
26,1,0,0,1,2021-09-05,Male,56,55-64,20
26,3,0,0,3,2021-09-02,Male,5,5-9,20
26,1,4,0,5,2021-09-05,Male,44,35-44,5
26,1,0,0,1,2021-09-05,Male,43,35-44,19
26,1,0,0,1,2021-09-04,Male,38,35-44,5
26,0,0,0,0,2021-09-04,Female,54,45-54,18
26,1,5,0,6,2021-09-04,Male,72,70-74,6
26,0,0,0,0,2021-09-06,Female,55,55-64,17
26,0,0,0,0,2021-09-01,Female,60,55-64,26
26,3,0,0,3,2021-09-05,Female,4,1-4,22
26,1,0,0,1,2021-09-02,Female,60,55-64,20
26,3,0,0,3,2021-09-06,Male,4,1-4,6
26,2,0,0,2,2021-09-08,Female,68,65-69,1
26,2,0,0,2,2021-09-03,Male,72,70-74,5
26,0,0,0,0,2021-09-05,Male,58,55-64,5
26,4,0,0,4,2021-09-04,Female,55,55-64,20
26,0,1,0,1,2021-09-05,Male,66,65-69,6
26,2,0,0,2,2021-09-06,Female,57,55-64,22
26,1,0,0,1,2021-09-05,Male,59,55-64,4
26,0,0,0,0,2021-09-02,Female,21,20-24,6
26,1,1,0,2,2021-09-01,Female,61,55-64,25
26,0,0,0,0,2021-09-01,Female,41,35-44,6
26,0,1,0,1,2021-09-03,Male,70,70-74,25
26,1,0,0,1,2021-09-06,Male,48,45-54,17
26,0,4,0,4,2021-09-08,Female,29,25-34,1
26,0,0,0,0,2021-09-05,Female,55,55-64,20
26,0,0,0,0,2021-09-04,Male,34,25-34,10
26,0,0,0,0,2021-09-06,Female,26,25-34,4
26,1,0,0,1,2021-09-01,Male,62,55-64,17
26,2,0,0,2,2021-09-05,Male,3,1-4,6
26,1,0,0,1,2021-09-05,Female,52,45-54,24
26,1,1,0,2,2021-09-05,Male,65,65-69,5
26,3,0,0,3,2021-09-03,Female,14,10-14,6
26,0,1,0,1,2021-09-02,Male,40,35-44,3
26,1,6,0,7,2021-09-03,Female,69,65-69,2
26,3,0,0,3,2021-09-03,Male,72,70-74,21
26,1,0,0,1,2021-09-02,Female,30,25-34,2
26,1,0,0,1,2021-09-02,Male,68,65-69,6
26,0,1,0,1,2021-09-05,Female,68,65-69,5
26,0,0,0,0,2021-09-08,Male,70,70-74,1
26,2,1,0,3,2021-09-01,Male,13,10-14,6
26,3,0,0,3,2021-09-08,Female,8,5-9,1
26,0,0,0,0,2021-09-08,Female,25,25-34,2
26,2,0,0,2,2021-09-02,Female,30,25-34,2
26,2,0,0,2,2021-09-04,Male,52,45-54,19
26,0,12,0,12,2021-09-04,Male,56,55-64,6
26,1,0,0,1,2021-09-05,Male,65,65-69,2
26,0,1,0,1,2021-09-06,Male,52,45-54,22
26,2,2,0,4,2021-09-08,Male,53,45-54,2
26,1,1,0,2,2021-09-01,Female,41,35-44,6
26,0,0,0,0,2021-09-03,Female,70,70-74,6
26,2,0,0,2,2021-09-14,Female,67,65-69,1
26,1,0,0,1,2021-09-05,Female,66,65-69,25
26,0,20,4,24,2021-09-14,Female,69,65-69,1
26,2,0,0,2,2021-09-04,Female,38,35-44,21
26,1,1,0,2,2021-09-05,Male,66,65-69,2
26,0,0,0,0,2021-09-08,Male,36,35-44,3
26,0,3,0,3,2021-09-06,Male,33,25-34,3
26,0,0,0,0,2021-09-05,Female,43,35-44,6
26,1,0,0,1,2021-09-09,Male,60,55-64,1
26,2,0,0,2,2021-09-06,Male,18,15-19,2
26,1,1,0,2,2021-09-14,Female,50,45-54,1
26,0,0,0,0,2021-09-08,Male,47,45-54,1
26,2,1,0,3,2021-09-14,Male,5,5-9,1
26,2,1,34,37,2021-09-04,Male,12,10-14,6
26,1,0,5,6,2021-09-06,Male,54,45-54,3
26,1,0,0,1,2021-09-03,Female,52,45-54,6
26,1,1,0,2,2021-09-09,Female,20,20-24,1
26,2,10,3,15,2021-09-14,Female,58,55-64,1
26,1,0,25,26,2021-09-02,Female,49,45-54,17
26,0,0,0,0,2021-09-06,Female,18,15-19,4
26,0,0,0,0,2021-09-07,Male,67,65-69,2
26,0,0,0,0,2021-09-05,Male,60,55-64,19
26,0,0,0,0,2021-09-01,Female,56,55-64,23
26,0,0,0,0,2021-09-07,Male,65,65-69,22
26,2,4,0,6,2021-09-02,Female,48,45-54,5
26,2,2,0,4,2021-09-06,Female,54,45-54,12
26,1,10,0,11,2021-09-03,Male,18,15-19,13
26,2,0,0,2,2021-09-01,Male,64,55-64,20
26,1,0,0,1,2021-09-05,Male,52,45-54,17
26,0,0,0,0,2021-09-04,Male,75,75-79,17
26,2,3,0,5,2021-09-06,Male,10,10-14,2
26,0,0,0,0,2021-09-08,Male,34,25-34,1
26,1,2,0,3,2021-09-06,Female,74,70-74,16
26,1,0,0,1,2021-09-03,Female,16,15-19,22
26,0,4,0,4,2021-09-07,Male,62,55-64,22
26,2,0,0,2,2021-09-05,Male,19,15-19,13
26,1,2,0,3,2021-09-03,Male,51,45-54,13
26,3,0,0,3,2021-09-03,Male,32,25-34,6
26,0,40,0,40,2021-09-01,Female,41,35-44,5
26,0,2,0,2,2021-09-03,Female,69,65-69,2
26,2,0,1,3,2021-09-08,Male,66,65-69,1
26,1,0,0,1,2021-09-01,Male,18,15-19,2
26,1,0,0,1,2021-09-04,Male,54,45-54,17
26,0,1,0,1,2021-09-08,Male,43,35-44,1
26,1,0,0,1,2021-09-05,Male,52,45-54,12
26,4,1,0,5,2021-09-09,Male,3,1-4,1
26,1,0,0,1,2021-09-05,Male,65,65-69,6
26,1,5,9,15,2021-09-01,Female,23,20-24,2
26,1,0,0,1,2021-09-04,Male,54,45-54,21
26,0,1,0,1,2021-09-05,Male,57,55-64,2
26,1,4,0,5,2021-09-08,Male,65,65-69,1
26,2,0,0,2,2021-09-05,Female,66,65-69,24
26,0,0,0,0,2021-09-08,Male,27,25-34,1
26,1,0,0,1,2021-09-01,Male,62,55-64,23
26,0,0,0,0,2021-09-05,Male,42,35-44,6
26,0,1,0,1,2021-09-01,Male,64,55-64,6
26,3,0,6,9,2021-09-04,Male,19,15-19,21
26,2,0,0,2,2021-09-01,Male,18,15-19,15
26,0,1,0,1,2021-09-05,Male,53,45-54,21
26,1,0,0,1,2021-09-01,Female,62,55-64,6
26,1,0,0,1,2021-09-04,Female,51,45-54,19
26,0,0,0,0,2021-09-01,Female,61,55-64,22
26,3,0,0,3,2021-09-04,Male,10,10-14,25
26,1,0,4,5,2021-09-02,Female,27,25-34,13
26,1,3,0,4,2021-09-08,Female,65,65-69,1
26,2,0,0,2,2021-09-09,Female,58,55-64,1
26,1,14,0,15,2021-09-14,Male,59,55-64,1
26,0,40,0,40,2021-09-02,Male,41,35-44,19
26,3,0,0,3,2021-09-08,Female,1,1-4,1
26,0,0,0,0,2021-09-01,Male,40,35-44,6
26,2,0,0,2,2021-09-01,Female,24,20-24,3
26,1,0,0,1,2021-09-06,Female,51,45-54,6
26,1,2,0,3,2021-09-06,Female,34,25-34,2
26,1,4,0,5,2021-09-08,Male,72,70-74,1
26,0,0,0,0,2021-09-02,Male,68,65-69,6
26,1,0,0,1,2021-09-02,Male,39,35-44,6
26,0,0,0,0,2021-09-05,Female,41,35-44,6
26,0,0,0,0,2021-09-05,Female,67,65-69,24
26,0,0,0,0,2021-09-01,Female,39,35-44,5
26,0,0,0,0,2021-09-05,Male,64,55-64,15
26,2,0,0,2,2021-09-06,Male,68,65-69,14
26,0,0,0,0,2021-09-06,Male,38,35-44,22
26,1,2,0,3,2021-09-07,Male,56,55-64,7
26,0,0,0,0,2021-09-08,Male,65,65-69,1
26,2,2,0,4,2021-09-01,Male,8,5-9,2
26,1,0,0,1,2021-09-07,Female,64,55-64,19
26,0,0,0,0,2021-09-02,Female,68,65-69,25
26,0,0,0,0,2021-09-01,Male,61,55-64,6
26,1,6,0,7,2021-09-06,Male,59,55-64,6
26,0,0,0,0,2021-09-05,Female,44,35-44,17
26,0,1,0,1,2021-09-06,Male,65,65-69,6
26,1,0,0,1,2021-09-02,Male,46,45-54,6
26,0,1,0,1,2021-09-02,Female,68,65-69,23
26,1,1,0,2,2021-09-08,Male,65,65-69,1
26,1,0,35,36,2021-09-03,Male,13,10-14,3
26,1,0,0,1,2021-09-08,Female,33,25-34,1
26,1,0,0,1,2021-09-08,Female,38,35-44,16
26,0,0,0,0,2021-09-03,Female,5,5-9,11
26,0,1,0,1,2021-09-08,Male,46,45-54,1
26,0,0,0,0,2021-09-09,Male,18,15-19,1
26,4,0,18,22,2021-09-08,Male,10,10-14,1
26,1,0,0,1,2021-09-06,Female,52,45-54,25
26,2,0,0,2,2021-09-06,Female,50,45-54,2
26,0,0,0,0,2021-09-05,Female,44,35-44,21
26,1,0,0,1,2021-09-05,Male,67,65-69,17
26,2,0,0,2,2021-09-01,Female,63,55-64,23
26,1,5,0,6,2021-09-04,Male,78,75-79,5
26,1,0,0,1,2021-09-02,Male,62,55-64,6
26,1,0,0,1,2021-09-05,Female,73,70-74,20
26,0,0,0,0,2021-09-01,Male,27,25-34,6
26,1,0,0,1,2021-09-01,Female,26,25-34,2
26,1,0,0,1,2021-09-04,Male,79,75-79,21
26,4,0,0,4,2021-09-02,Female,13,10-14,6
26,1,0,0,1,2021-09-04,Male,31,25-34,6
26,2,1,0,3,2021-09-02,Male,69,65-69,23
26,2,1,0,3,2021-09-01,Female,62,55-64,17
26,1,0,0,1,2021-09-07,Female,32,25-34,2
26,1,2,4,7,2021-09-01,Female,62,55-64,21
26,1,0,0,1,2021-09-03,Male,68,65-69,19
26,2,0,0,2,2021-09-03,Female,48,45-54,6
26,1,0,0,1,2021-09-06,Male,65,65-69,26
26,1,0,0,1,2021-09-05,Male,65,65-69,5
26,2,0,0,2,2021-09-05,Male,74,70-74,23
26,0,0,0,0,2021-09-08,Female,40,35-44,1
26,0,0,0,0,2021-09-07,Female,30,25-34,2
26,1,0,0,1,2021-09-05,Female,65,65-69,22
26,2,0,0,2,2021-09-04,Male,55,55-64,21
26,1,1,9,11,2021-09-06,Male,71,70-74,4
26,3,1,0,4,2021-09-05,Male,14,10-14,2
26,0,2,0,2,2021-09-03,Female,67,65-69,21
26,1,0,0,1,2021-09-03,Male,48,45-54,6
26,1,0,0,1,2021-09-05,Male,66,65-69,6
26,0,0,0,0,2021-09-01,Male,12,10-14,11
26,1,0,0,1,2021-09-14,Male,72,70-74,1
26,0,0,0,0,2021-09-04,Female,38,35-44,10
26,2,5,0,7,2021-09-03,Female,72,70-74,22
26,1,4,0,5,2021-09-06,Female,50,45-54,24
26,3,0,0,3,2021-09-05,Female,59,55-64,22
26,0,0,0,0,2021-09-04,Female,34,25-34,21
26,0,7,20,27,2021-09-08,Female,59,55-64,1
26,1,0,0,1,2021-09-08,Male,80,80-84,1
26,2,0,0,2,2021-09-05,Female,4,1-4,17
26,0,1,0,1,2021-09-03,Female,53,45-54,6
26,1,2,0,3,2021-09-02,Male,22,20-24,24
26,1,0,0,1,2021-09-06,Male,9,5-9,2
26,0,0,0,0,2021-09-04,Male,56,55-64,25
26,0,0,0,0,2021-09-06,Female,44,35-44,5
26,0,0,0,0,2021-09-02,Male,53,45-54,19
26,0,0,0,0,2021-09-05,Female,37,35-44,24
26,2,0,0,2,2021-09-05,Female,9,5-9,22
26,1,0,0,1,2021-09-05,Male,55,55-64,22
26,1,0,0,1,2021-09-01,Male,64,55-64,6
26,2,4,0,6,2021-09-08,Female,32,25-34,1
26,2,2,0,4,2021-09-01,Male,63,55-64,22
26,0,0,0,0,2021-09-04,Male,41,35-44,11
26,1,1,0,2,2021-09-05,Female,57,55-64,21
26,1,0,0,1,2021-09-02,Female,68,65-69,21
26,0,0,0,0,2021-09-05,Female,85,85+,14
26,1,1,0,2,2021-09-06,Male,74,70-74,26
26,1,1,0,2,2021-09-05,Female,67,65-69,18
26,3,2,0,5,2021-09-05,Male,10,10-14,13
26,0,4,0,4,2021-09-05,Male,74,70-74,22
26,0,5,0,5,2021-09-08,Male,49,45-54,1
26,1,1,0,2,2021-09-04,Male,55,55-64,6
26,1,1,0,2,2021-09-03,Male,71,70-74,2
26,2,0,0,2,2021-09-08,Female,1,1-4,1
26,1,0,0,1,2021-09-05,Male,59,55-64,6
26,1,10,0,11,2021-09-08,Male,53,45-54,1
26,3,14,0,17,2021-09-08,Male,1,1-4,1
26,1,2,0,3,2021-09-03,Male,68,65-69,4
26,0,0,0,0,2021-09-01,Male,62,55-64,2
26,2,0,0,2,2021-09-05,Female,11,10-14,17
26,1,1,0,2,2021-09-02,Male,67,65-69,19
26,1,0,0,1,2021-09-06,Male,44,35-44,2
26,3,1,0,4,2021-09-10,Male,24,20-24,1
26,1,0,0,1,2021-09-01,Female,61,55-64,23
26,1,5,0,6,2021-09-03,Female,67,65-69,18
26,0,0,0,0,2021-09-03,Male,32,25-34,6
26,1,0,0,1,2021-09-05,Male,67,65-69,21
26,4,15,0,19,2021-09-01,Male,23,20-24,4
26,0,0,0,0,2021-09-09,Male,58,55-64,1
26,1,7,0,8,2021-09-06,Male,72,70-74,14
26,1,0,0,1,2021-09-01,Male,42,35-44,3
26,1,0,0,1,2021-09-03,Male,53,45-54,6
26,0,1,0,1,2021-09-06,Female,66,65-69,6
26,1,6,0,7,2021-09-05,Female,67,65-69,6
26,1,32,0,33,2021-09-08,Male,81,80-84,1
26,1,30,0,31,2021-09-05,Male,66,65-69,25
26,1,0,0,1,2021-09-08,Female,31,25-34,1
26,0,0,0,0,2021-09-03,Male,32,25-34,20
26,1,2,0,3,2021-09-05,Female,66,65-69,6
26,0,3,0,3,2021-09-06,Female,71,70-74,5
26,1,8,0,9,2021-09-05,Female,45,45-54,2
26,0,2,0,2,2021-09-05,Female,25,25-34,18
26,1,0,0,1,2021-09-04,Male,78,75-79,5
26,1,0,0,1,2021-09-05,Male,59,55-64,2
26,0,0,0,0,2021-09-05,Male,36,35-44,2
26,0,1,0,1,2021-09-04,Female,76,75-79,24
26,2,16,0,18,2021-09-01,Female,13,10-14,6
26,0,0,0,0,2021-09-04,Male,33,25-34,21
26,0,5,0,5,2021-09-08,Female,27,25-34,1
26,2,0,0,2,2021-09-03,Female,23,20-24,22
26,1,1,0,2,2021-09-08,Male,57,55-64,1
26,1,0,0,1,2021-09-01,Female,64,55-64,15
26,0,2,0,2,2021-09-08,Female,69,65-69,10
26,1,0,0,1,2021-09-14,Female,52,45-54,1
26,1,1,0,2,2021-09-05,Male,66,65-69,24
26,1,0,0,1,2021-09-05,Female,61,55-64,6
26,2,7,100,109,2021-09-01,Female,11,10-14,26
26,3,4,0,7,2021-09-06,Female,0,<1,4
26,0,5,0,5,2021-09-05,Female,66,65-69,20
26,2,2,0,4,2021-09-05,Female,13,10-14,6
26,1,1,0,2,2021-09-04,Male,55,55-64,21
26,0,0,0,0,2021-09-05,Male,46,45-54,6
26,0,0,0,0,2021-09-01,Female,17,15-19,2
26,0,0,0,0,2021-09-04,Male,78,75-79,4
26,2,1,0,3,2021-09-08,Male,3,1-4,7
26,0,0,0,0,2021-09-05,Male,42,35-44,5
26,1,0,0,1,2021-09-09,Male,22,20-24,2
26,1,1,0,2,2021-09-01,Male,57,55-64,15
26,2,2,0,4,2021-09-08,Male,4,1-4,1
26,0,0,0,0,2021-09-02,Male,30,25-34,8
26,2,0,0,2,2021-09-05,Male,66,65-69,22
26,1,6,0,7,2021-09-05,Male,51,45-54,2
26,0,2,0,2,2021-09-08,Male,67,65-69,1
26,0,11,0,11,2021-09-08,Female,54,45-54,1
26,1,0,0,1,2021-09-06,Female,66,65-69,6
26,0,0,0,0,2021-09-07,Female,37,35-44,2
26,0,8,0,8,2021-09-05,Female,44,35-44,2
26,1,1,69,71,2021-09-07,Male,68,65-69,14
26,1,2,0,3,2021-09-05,Female,62,55-64,20
26,0,0,0,0,2021-09-04,Female,53,45-54,2
26,1,0,0,1,2021-09-08,Male,77,75-79,1
26,1,1,0,2,2021-09-08,Female,70,70-74,1
26,1,4,0,5,2021-09-04,Female,54,45-54,23
26,1,0,0,1,2021-09-08,Female,50,45-54,1
26,1,0,4,5,2021-09-08,Male,0,<1,1
26,1,0,0,1,2021-09-06,Female,52,45-54,3
26,1,0,0,1,2021-09-02,Female,49,45-54,24
26,2,1,0,3,2021-09-06,Male,1,1-4,2
26,1,0,0,1,2021-09-08,Male,79,75-79,1
26,0,0,0,0,2021-09-06,Female,74,70-74,16
26,1,0,0,1,2021-09-05,Female,66,65-69,4
26,1,0,0,1,2021-09-08,Female,29,25-34,1
26,0,0,0,0,2021-09-08,Female,27,25-34,1
26,2,2,0,4,2021-09-09,Male,56,55-64,1
26,0,0,0,0,2021-09-06,Female,67,65-69,6
26,3,1,0,4,2021-09-02,Male,31,25-34,15
26,1,0,0,1,2021-09-08,Female,49,45-54,1
26,0,10,0,10,2021-09-07,Male,45,45-54,5
26,0,0,0,0,2021-09-04,Female,26,25-34,25
26,0,0,0,0,2021-09-09,Male,22,20-24,2
26,1,0,0,1,2021-09-01,Male,41,35-44,23
26,0,1,0,1,2021-09-06,Female,44,35-44,6
26,1,4,0,5,2021-09-05,Male,62,55-64,22
26,0,12,1,13,2021-09-08,Male,60,55-64,1
26,0,1,0,1,2021-09-03,Female,69,65-69,21
26,1,2,0,3,2021-09-08,Male,62,55-64,1
26,1,1,0,2,2021-09-08,Male,27,25-34,1
26,1,0,0,1,2021-09-06,Male,68,65-69,24
26,0,0,0,0,2021-09-01,Male,26,25-34,3
26,0,2,0,2,2021-09-08,Female,73,70-74,1
26,0,11,0,11,2021-09-08,Male,58,55-64,1
26,2,0,0,2,2021-09-04,Female,36,35-44,7
26,2,0,0,2,2021-09-04,Male,11,10-14,26
26,4,3,0,7,2021-09-03,Female,10,10-14,20
26,1,1,0,2,2021-09-07,Male,71,70-74,21
26,1,0,0,1,2021-09-08,Male,76,75-79,1
26,1,0,0,1,2021-09-05,Male,57,55-64,6
26,0,0,0,0,2021-09-06,Male,41,35-44,5
26,2,0,0,2,2021-09-01,Female,61,55-64,22
26,0,0,0,0,2021-09-04,Male,38,35-44,3
26,1,3,0,4,2021-09-07,Female,28,25-34,5
26,5,0,0,5,2021-09-06,Female,34,25-34,13
26,1,1,13,15,2021-09-06,Female,24,20-24,2
26,1,0,0,1,2021-09-01,Male,2,1-4,16
26,1,0,0,1,2021-09-03,Female,52,45-54,6
26,0,0,0,0,2021-09-08,Male,62,55-64,1
26,1,0,0,1,2021-09-02,Male,46,45-54,18
26,2,0,0,2,2021-09-05,Female,35,35-44,22
26,0,0,0,0,2021-09-06,Male,58,55-64,24
26,1,3,0,4,2021-09-08,Male,72,70-74,1
26,2,1,0,3,2021-09-01,Male,64,55-64,25
26,1,0,1,2,2021-09-01,Female,63,55-64,24
26,1,10,0,11,2021-09-08,Male,30,25-34,1
26,1,0,0,1,2021-09-01,Female,64,55-64,23
26,4,0,0,4,2021-09-08,Male,14,10-14,1
26,1,0,0,1,2021-09-06,Female,33,25-34,2
26,1,0,0,1,2021-09-07,Female,31,25-34,3
26,1,0,4,5,2021-09-06,Female,58,55-64,6
26,1,0,0,1,2021-09-02,Female,69,65-69,24
26,1,0,0,1,2021-09-04,Male,53,45-54,21
26,2,0,0,2,2021-09-02,Male,51,45-54,24
26,1,0,0,1,2021-09-04,Male,36,35-44,6
26,1,2,0,3,2021-09-02,Female,68,65-69,24
26,2,0,0,2,2021-09-05,Male,59,55-64,23
26,1,3,0,4,2021-09-01,Female,65,65-69,6
26,0,0,0,0,2021-09-03,Male,34,25-34,23
26,1,0,0,1,2021-09-02,Female,29,25-34,2
26,2,0,0,2,2021-09-06,Female,11,10-14,5
26,1,0,0,1,2021-09-06,Female,48,45-54,6
26,0,0,0,0,2021-09-05,Male,33,25-34,5
26,1,0,0,1,2021-09-08,Male,69,65-69,1
26,0,0,0,0,2021-09-05,Female,65,65-69,20
26,1,0,0,1,2021-09-04,Female,54,45-54,5
26,1,5,0,6,2021-09-02,Male,69,65-69,26
26,0,0,0,0,2021-09-02,Male,14,10-14,23
26,0,0,0,0,2021-09-14,Male,51,45-54,1
26,2,0,0,2,2021-09-07,Male,77,75-79,19
26,0,0,0,0,2021-09-02,Male,68,65-69,6
26,0,0,0,0,2021-09-04,Male,37,35-44,6
26,0,0,0,0,2021-09-01,Female,26,25-34,13
26,1,0,0,1,2021-09-08,Female,34,25-34,1
26,2,1,0,3,2021-09-02,Female,30,25-34,2
26,0,0,0,0,2021-09-07,Female,34,25-34,2
26,4,0,0,4,2021-09-05,Female,15,15-19,2
26,1,0,0,1,2021-09-08,Male,71,70-74,1
26,1,7,0,8,2021-09-03,Male,70,70-74,7
26,0,0,0,0,2021-09-05,Female,2,1-4,5
26,1,0,0,1,2021-09-05,Female,67,65-69,13
26,0,2,0,2,2021-09-04,Female,69,65-69,17
26,1,3,0,4,2021-09-08,Female,57,55-64,1
26,2,0,0,2,2021-09-07,Male,11,10-14,22
26,1,1,0,2,2021-09-02,Male,48,45-54,6
26,1,0,0,1,2021-09-03,Female,72,70-74,5
26,1,1,0,2,2021-09-04,Male,77,75-79,6
26,0,1,0,1,2021-09-08,Female,65,65-69,1
26,2,0,0,2,2021-09-01,Male,24,20-24,17
26,0,0,2,2,2021-09-02,Female,29,25-34,2
26,0,2,0,2,2021-09-03,Female,40,35-44,17
26,1,0,0,1,2021-09-07,Female,51,45-54,20
26,0,2,0,2,2021-09-06,Female,56,55-64,6
26,1,2,0,3,2021-09-05,Male,53,45-54,6
26,2,0,0,2,2021-09-03,Male,52,45-54,22
26,0,2,0,2,2021-09-02,Female,68,65-69,5
26,1,2,0,3,2021-09-08,Male,75,75-79,1
26,0,1,0,1,2021-09-03,Male,51,45-54,6
26,0,1,3,4,2021-09-04,Female,34,25-34,5
26,2,0,0,2,2021-09-06,Male,65,65-69,6
26,0,3,0,3,2021-09-02,Male,50,45-54,22
26,1,0,0,1,2021-09-05,Male,27,25-34,3
26,0,0,0,0,2021-09-04,Female,35,35-44,24
26,1,0,0,1,2021-09-09,Female,59,55-64,1
26,1,0,0,1,2021-09-01,Female,1,1-4,4
26,0,0,0,0,2021-09-08,Female,44,35-44,1
26,4,0,0,4,2021-09-06,Female,19,15-19,13
26,2,0,0,2,2021-09-01,Male,0,<1,5
26,0,0,0,0,2021-09-06,Male,46,45-54,22
26,0,1,0,1,2021-09-02,Male,69,65-69,4
26,0,0,0,0,2021-09-06,Female,77,75-79,12
26,3,3,8,14,2021-09-01,Male,10,10-14,6
26,1,4,0,5,2021-09-08,Female,61,55-64,1
26,1,0,0,1,2021-09-08,Male,37,35-44,1
26,0,0,0,0,2021-09-07,Female,53,45-54,22
26,0,2,0,2,2021-09-06,Female,29,25-34,13
26,2,0,0,2,2021-09-01,Male,40,35-44,5
26,0,2,0,2,2021-09-07,Male,51,45-54,2
26,1,2,0,3,2021-09-14,Male,72,70-74,1
26,3,0,0,3,2021-09-08,Male,4,1-4,1
26,3,2,0,5,2021-09-07,Female,14,10-14,15
26,0,4,0,4,2021-09-08,Female,65,65-69,1
26,2,0,0,2,2021-09-05,Male,46,45-54,2
26,1,0,0,1,2021-09-08,Male,55,55-64,1
26,2,0,0,2,2021-09-06,Male,15,15-19,17
26,0,0,0,0,2021-09-06,Female,70,70-74,24
26,1,0,0,1,2021-09-01,Male,19,15-19,6
26,2,0,0,2,2021-09-07,Female,29,25-34,11
26,1,0,0,1,2021-09-05,Male,76,75-79,6
26,1,0,0,1,2021-09-05,Male,65,65-69,6
26,1,0,0,1,2021-09-06,Female,16,15-19,5
26,5,0,0,5,2021-09-06,Male,10,10-14,23
26,0,0,0,0,2021-09-08,Male,47,45-54,3
26,2,3,0,5,2021-09-02,Female,1,1-4,2
26,3,0,0,3,2021-09-04,Female,2,1-4,6
26,2,3,0,5,2021-09-06,Female,55,55-64,21
26,0,3,0,3,2021-09-05,Female,28,25-34,15
26,1,0,0,1,2021-09-07,Male,61,55-64,5
26,0,0,0,0,2021-09-08,Female,38,35-44,19
26,1,0,2,3,2021-09-04,Female,69,65-69,5
26,0,0,0,0,2021-09-04,Female,79,75-79,6
26,1,0,0,1,2021-09-08,Female,34,25-34,1
26,1,0,0,1,2021-09-06,Female,66,65-69,6
26,0,0,0,0,2021-09-04,Male,54,45-54,19
26,2,0,0,2,2021-09-02,Male,68,65-69,15
26,0,0,0,0,2021-09-01,Female,19,15-19,2
26,0,0,0,0,2021-09-03,Female,71,70-74,6
26,1,0,0,1,2021-09-02,Female,69,65-69,6
26,0,1,0,1,2021-09-03,Male,49,45-54,22
26,2,9,0,11,2021-09-08,Male,4,1-4,1
26,1,4,0,5,2021-09-06,Female,33,25-34,2
26,0,2,0,2,2021-09-01,Male,62,55-64,8
26,1,0,0,1,2021-09-14,Female,53,45-54,1
26,1,0,0,1,2021-09-04,Male,36,35-44,22
26,1,0,0,1,2021-09-06,Female,34,25-34,5
26,0,0,0,0,2021-09-06,Male,53,45-54,4
26,0,3,0,3,2021-09-08,Female,51,45-54,6
26,2,0,0,2,2021-09-08,Female,12,10-14,1
26,1,0,0,1,2021-09-03,Female,54,45-54,5
26,1,0,0,1,2021-09-08,Male,54,45-54,1
26,1,2,0,3,2021-09-06,Female,66,65-69,6
26,1,1,0,2,2021-09-07,Female,52,45-54,13
26,0,1,0,1,2021-09-08,Female,71,70-74,1
26,1,0,0,1,2021-09-04,Male,49,45-54,5
26,1,1,0,2,2021-09-04,Female,53,45-54,2
26,0,0,0,0,2021-09-05,Male,47,45-54,6
26,2,0,0,2,2021-09-06,Female,48,45-54,22
26,4,1,0,5,2021-09-02,Female,2,1-4,3
26,2,1,0,3,2021-09-06,Female,66,65-69,8
26,2,0,0,2,2021-09-04,Male,85,85+,20
26,0,0,0,0,2021-09-05,Male,57,55-64,6
26,0,1,0,1,2021-09-14,Female,75,75-79,1
26,2,0,0,2,2021-09-06,Male,10,10-14,17
26,1,0,0,1,2021-09-07,Male,67,65-69,6
26,1,0,0,1,2021-09-06,Female,71,70-74,14
26,2,0,0,2,2021-09-03,Female,21,20-24,15
26,2,3,0,5,2021-09-14,Male,11,10-14,1
26,1,0,0,1,2021-09-08,Male,71,70-74,1
26,0,1,0,1,2021-09-02,Male,48,45-54,19
26,2,2,0,4,2021-09-02,Female,67,65-69,20
26,0,0,0,0,2021-09-03,Male,51,45-54,26
26,0,0,1,1,2021-09-09,Male,18,15-19,1
26,1,0,2,3,2021-09-08,Male,65,65-69,1
26,0,1,0,1,2021-09-06,Male,46,45-54,6
26,0,0,0,0,2021-09-07,Female,48,45-54,2
26,0,0,0,0,2021-09-02,Female,32,25-34,5
26,0,0,0,0,2021-09-07,Male,29,25-34,20
26,0,0,0,0,2021-09-03,Male,52,45-54,2
26,2,0,0,2,2021-09-08,Male,59,55-64,1
26,0,0,0,0,2021-09-01,Female,20,20-24,11
26,0,1,15,16,2021-09-08,Female,29,25-34,12
26,2,0,0,2,2021-09-05,Male,75,75-79,23
26,2,0,0,2,2021-09-01,Male,62,55-64,6
26,0,0,0,0,2021-09-08,Male,48,45-54,1
26,0,0,0,0,2021-09-05,Male,43,35-44,22
26,0,0,0,0,2021-09-06,Female,32,25-34,11
26,2,0,0,2,2021-09-01,Female,22,20-24,2
26,0,5,0,5,2021-09-05,Female,66,65-69,6
26,0,0,0,0,2021-09-08,Female,16,15-19,6
26,1,2,0,3,2021-09-03,Female,70,70-74,24
26,0,0,0,0,2021-09-03,Female,70,70-74,26
26,1,0,0,1,2021-09-06,Male,71,70-74,24
26,3,7,0,10,2021-09-06,Female,66,65-69,6
26,0,1,0,1,2021-09-01,Female,61,55-64,6
26,1,7,0,8,2021-09-03,Female,53,45-54,5
26,1,0,0,1,2021-09-02,Female,49,45-54,3
26,0,0,0,0,2021-09-06,Male,11,10-14,17
26,1,0,0,1,2021-09-08,Male,26,25-34,1
26,0,11,0,11,2021-09-06,Male,62,55-64,25
26,1,1,3,5,2021-09-04,Female,70,70-74,6
26,0,1,0,1,2021-09-04,Male,37,35-44,5
26,0,1,0,1,2021-09-06,Male,67,65-69,14
26,1,5,0,6,2021-09-06,Female,22,20-24,2
26,1,0,0,1,2021-09-08,Female,52,45-54,1
26,3,0,0,3,2021-09-05,Female,13,10-14,22
26,0,1,0,1,2021-09-08,Male,44,35-44,1
26,3,0,0,3,2021-09-07,Male,1,1-4,6
26,3,0,0,3,2021-09-05,Male,11,10-14,22
26,0,0,0,0,2021-09-05,Male,35,35-44,24
26,1,5,0,6,2021-09-08,Male,14,10-14,1
26,1,0,0,1,2021-09-14,Female,57,55-64,1
26,0,0,0,0,2021-09-08,Male,50,45-54,1
26,2,5,0,7,2021-09-08,Female,10,10-14,1
26,0,10,0,10,2021-09-14,Male,49,45-54,1
26,2,0,0,2,2021-09-01,Male,20,20-24,22
27,0,0,0,0,2021-09-23,Male,65,65-69,4
27,1,7,0,8,2021-09-23,Male,69,65-69,21
27,2,2,0,4,2021-09-24,Female,59,55-64,13
27,1,0,0,1,2021-09-23,Female,70,70-74,17
27,2,0,0,2,2021-09-23,Male,14,10-14,8
27,0,0,0,0,2021-10-06,Female,73,70-74,1
27,2,0,0,2,2021-09-23,Male,65,65-69,7
27,0,10,0,10,2021-09-23,Female,49,45-54,7
27,0,0,0,0,2021-09-23,Male,29,25-34,7
27,1,12,0,13,2021-09-25,Female,55,55-64,3
27,0,1,0,1,2021-09-24,Female,72,70-74,23
27,1,2,3,6,2021-09-23,Male,61,55-64,2
27,1,0,0,1,2021-09-28,Female,4,1-4,8
27,1,0,0,1,2021-09-23,Female,58,55-64,6
27,1,0,0,1,2021-09-22,Female,73,70-74,25
27,1,1,0,2,2021-09-25,Male,72,70-74,7
27,1,0,0,1,2021-10-06,Male,70,70-74,1
27,0,0,0,0,2021-10-06,Female,42,35-44,1
27,1,0,0,1,2021-09-23,Female,10,10-14,2
27,2,0,0,2,2021-09-23,Male,5,5-9,3
27,2,0,0,2,2021-09-23,Female,7,5-9,2
27,2,0,0,2,2021-09-25,Female,58,55-64,6
27,2,0,0,2,2021-09-27,Male,14,10-14,1
27,0,0,0,0,2021-09-28,Female,35,35-44,14
27,1,5,0,6,2021-09-28,Female,67,65-69,1
27,0,0,0,0,2021-09-24,Female,60,55-64,22
27,0,0,0,0,2021-09-23,Male,52,45-54,7
27,1,6,5,12,2021-09-25,Female,62,55-64,17
27,2,6,0,8,2021-09-23,Male,17,15-19,2
27,2,1,27,30,2021-09-23,Female,1,1-4,2
27,0,0,0,0,2021-09-24,Male,69,65-69,12
27,1,0,0,1,2021-09-23,Male,51,45-54,22
27,2,0,0,2,2021-09-23,Female,36,35-44,23
27,2,4,0,6,2021-10-06,Male,50,45-54,1
27,1,0,0,1,2021-09-23,Male,41,35-44,3
27,3,0,0,3,2021-09-23,Female,45,45-54,5
27,1,0,0,1,2021-10-06,Male,82,80-84,1
27,3,3,0,6,2021-09-23,Female,58,55-64,23
27,2,0,0,2,2021-09-23,Female,2,1-4,3
27,3,0,0,3,2021-09-23,Male,7,5-9,5
27,1,0,0,1,2021-10-06,Male,58,55-64,1
27,0,0,0,0,2021-09-25,Male,33,25-34,4
27,0,0,0,0,2021-09-23,Male,50,45-54,7
27,3,1,0,4,2021-09-23,Female,9,5-9,2
27,1,9,0,10,2021-09-29,Female,19,15-19,5
27,2,0,0,2,2021-09-23,Female,13,10-14,20
27,0,5,8,13,2021-09-25,Female,41,35-44,5
27,3,0,0,3,2021-09-27,Male,12,10-14,1
27,1,10,0,11,2021-09-23,Male,57,55-64,6
27,1,1,0,2,2021-10-06,Male,58,55-64,1
27,1,0,0,1,2021-09-23,Male,53,45-54,2
27,1,4,0,5,2021-09-24,Male,67,65-69,19
27,1,0,0,1,2021-09-23,Female,57,55-64,7
27,1,1,0,2,2021-09-23,Male,63,55-64,27
27,1,2,0,3,2021-09-23,Female,50,45-54,7
27,1,1,0,2,2021-09-24,Male,60,55-64,7
27,0,4,0,4,2021-09-23,Male,48,45-54,6
27,1,0,0,1,2021-09-23,Male,18,15-19,24
27,0,2,0,2,2021-09-23,Male,49,45-54,24
27,0,1,0,1,2021-09-23,Male,49,45-54,4
27,0,3,20,23,2021-09-23,Male,43,35-44,7
27,1,5,0,6,2021-09-23,Female,54,45-54,2
27,1,0,0,1,2021-09-24,Male,35,35-44,17
27,0,1,0,1,2021-09-25,Male,54,45-54,19
27,0,4,0,4,2021-10-06,Female,37,35-44,1
27,0,0,0,0,2021-09-23,Female,71,70-74,25
27,0,7,0,7,2021-09-24,Female,66,65-69,3
27,1,0,0,1,2021-09-23,Female,53,45-54,23
27,1,1,0,2,2021-09-23,Female,70,70-74,21
27,1,0,0,1,2021-10-06,Female,40,35-44,1
27,0,0,0,0,2021-09-23,Female,57,55-64,2
27,0,0,0,0,2021-09-23,Male,42,35-44,24
27,2,0,5,7,2021-09-23,Female,57,55-64,4
27,1,2,0,3,2021-09-23,Female,49,45-54,2
27,1,4,0,5,2021-09-28,Female,67,65-69,1
27,1,2,0,3,2021-09-23,Female,57,55-64,27
27,0,0,0,0,2021-10-06,Female,18,15-19,1
27,2,0,0,2,2021-09-23,Male,85,85+,22
27,0,4,59,63,2021-09-23,Male,37,35-44,2
27,2,16,22,40,2021-09-24,Male,18,15-19,6
27,0,0,0,0,2021-09-23,Male,30,25-34,4
27,1,0,0,1,2021-09-23,Female,69,65-69,22
27,1,1,0,2,2021-09-23,Female,32,25-34,3
27,2,20,0,22,2021-09-23,Male,13,10-14,2
27,1,0,0,1,2021-09-23,Male,66,65-69,2
27,3,1,0,4,2021-09-23,Male,1,1-4,12
27,0,3,0,3,2021-09-23,Male,54,45-54,12
27,2,0,0,2,2021-09-23,Male,15,15-19,16
27,0,0,0,0,2021-09-23,Male,62,55-64,3
27,1,0,0,1,2021-09-23,Male,33,25-34,7
27,0,9,0,9,2021-09-28,Female,40,35-44,1
27,0,0,0,0,2021-09-26,Female,70,70-74,7
27,0,4,0,4,2021-09-23,Male,40,35-44,3
27,3,0,2,5,2021-09-23,Female,22,20-24,4
27,1,2,0,3,2021-09-23,Female,69,65-69,2
27,1,0,0,1,2021-09-23,Male,58,55-64,25
27,0,1,0,1,2021-10-06,Male,62,55-64,1
27,0,0,0,0,2021-09-23,Female,3,1-4,2
27,0,0,0,0,2021-09-23,Male,68,65-69,25
27,1,10,0,11,2021-09-23,Female,50,45-54,2
27,0,0,0,0,2021-09-27,Male,61,55-64,1
27,0,0,0,0,2021-09-27,Female,71,70-74,1
27,1,0,0,1,2021-09-23,Female,45,45-54,2
27,2,0,0,2,2021-09-23,Female,18,15-19,6
27,1,1,0,2,2021-09-22,Male,73,70-74,20
27,0,2,0,2,2021-09-22,Male,77,75-79,22
27,0,0,0,0,2021-09-23,Male,27,25-34,14
27,1,0,0,1,2021-09-22,Male,76,75-79,2
27,1,0,0,1,2021-09-23,Female,10,10-14,5
27,0,2,25,27,2021-09-28,Female,77,75-79,1
27,1,0,0,1,2021-09-23,Female,38,35-44,6
27,0,0,0,0,2021-10-06,Male,68,65-69,1
27,0,20,0,20,2021-09-23,Female,51,45-54,3
27,1,0,0,1,2021-09-27,Female,60,55-64,1
27,0,0,0,0,2021-09-23,Male,61,55-64,7
27,0,0,0,0,2021-09-23,Male,53,45-54,19
27,3,0,0,3,2021-09-22,Female,18,15-19,5
27,2,1,0,3,2021-09-28,Male,66,65-69,1
27,2,10,0,12,2021-09-28,Female,52,45-54,1
27,0,4,0,4,2021-09-24,Female,56,55-64,6
27,0,11,0,11,2021-09-24,Male,43,35-44,6
27,3,4,0,7,2021-09-25,Male,44,35-44,15
27,1,3,0,4,2021-09-23,Male,39,35-44,7
27,1,2,0,3,2021-09-28,Female,53,45-54,1
27,0,0,0,0,2021-09-23,Female,61,55-64,14
27,0,0,0,0,2021-09-28,Female,85,85+,1
27,1,0,0,1,2021-09-23,Male,39,35-44,24
27,2,2,0,4,2021-09-23,Male,70,70-74,21
27,0,0,0,0,2021-09-23,Male,33,25-34,4
27,1,1,8,10,2021-09-28,Female,64,55-64,1
27,0,2,0,2,2021-09-23,Female,52,45-54,14
27,1,0,0,1,2021-09-27,Male,69,65-69,1
27,1,1,0,2,2021-09-23,Male,68,65-69,23
27,1,0,0,1,2021-10-06,Female,43,35-44,1
27,0,3,0,3,2021-10-06,Male,71,70-74,1
27,0,4,0,4,2021-09-28,Male,73,70-74,1
27,0,2,0,2,2021-10-06,Female,65,65-69,1
27,0,2,0,2,2021-09-23,Female,78,75-79,3
27,1,0,0,1,2021-10-06,Male,68,65-69,1
27,1,0,0,1,2021-09-24,Female,60,55-64,6
27,0,1,0,1,2021-09-23,Male,85,85+,21
27,2,1,0,3,2021-09-23,Female,72,70-74,22
27,0,1,0,1,2021-09-22,Male,73,70-74,7
27,0,0,0,0,2021-09-24,Female,22,20-24,13
27,1,0,0,1,2021-09-24,Female,28,25-34,7
27,2,2,0,4,2021-09-23,Male,55,55-64,26
27,1,0,0,1,2021-09-23,Male,71,70-74,24
27,0,0,0,0,2021-09-23,Female,69,65-69,23
27,1,0,0,1,2021-09-23,Male,67,65-69,17
27,1,1,0,2,2021-09-24,Female,66,65-69,26
27,3,2,0,5,2021-09-23,Male,13,10-14,18
27,2,0,0,2,2021-09-23,Male,67,65-69,25
27,4,0,0,4,2021-09-23,Female,2,1-4,8
27,0,1,0,1,2021-09-23,Female,36,35-44,3
27,3,0,0,3,2021-09-28,Male,10,10-14,1
27,1,0,0,1,2021-09-28,Male,66,65-69,1
27,0,0,0,0,2021-09-23,Female,54,45-54,7
27,4,11,0,15,2021-09-24,Female,11,10-14,15
27,1,0,0,1,2021-09-23,Male,68,65-69,20
27,2,0,0,2,2021-10-03,Male,4,1-4,5
27,1,0,0,1,2021-09-23,Female,58,55-64,7
27,0,0,0,0,2021-09-24,Male,32,25-34,5
27,1,0,0,1,2021-09-24,Female,72,70-74,5
27,2,0,0,2,2021-10-06,Male,2,1-4,1
27,0,0,0,0,2021-09-23,Male,43,35-44,23
27,3,0,0,3,2021-09-23,Female,5,5-9,21
27,1,0,0,1,2021-09-24,Female,39,35-44,3
27,0,0,0,0,2021-09-22,Female,76,75-79,7
27,1,6,0,7,2021-09-23,Male,70,70-74,27
27,1,3,0,4,2021-10-06,Male,68,65-69,1
27,4,0,0,4,2021-09-23,Female,2,1-4,19
27,0,1,8,9,2021-09-27,Female,18,15-19,1
27,0,0,0,0,2021-09-23,Female,60,55-64,25
27,3,0,0,3,2021-09-23,Male,19,15-19,21
27,0,0,0,0,2021-09-24,Male,66,65-69,2
27,1,0,0,1,2021-09-23,Male,43,35-44,3
27,0,1,0,1,2021-09-24,Female,27,25-34,3
27,1,0,0,1,2021-09-22,Male,72,70-74,2
27,2,0,0,2,2021-09-23,Male,63,55-64,7
27,0,0,0,0,2021-09-27,Male,62,55-64,1
27,1,10,0,11,2021-09-27,Male,64,55-64,1
27,0,0,0,0,2021-09-28,Female,19,15-19,1
27,2,0,0,2,2021-09-25,Male,35,35-44,6
27,2,0,0,2,2021-09-23,Male,12,10-14,3
27,1,0,0,1,2021-09-28,Female,39,35-44,1
27,8,0,0,8,2021-09-23,Female,1,1-4,2
27,3,0,0,3,2021-09-28,Female,53,45-54,3
27,1,0,0,1,2021-09-23,Female,61,55-64,6
27,1,0,0,1,2021-09-23,Male,52,45-54,7
27,1,0,0,1,2021-09-23,Male,17,15-19,17
27,1,0,0,1,2021-09-23,Female,63,55-64,24
27,1,0,0,1,2021-09-23,Male,31,25-34,3
27,1,0,0,1,2021-09-23,Male,55,55-64,4
27,2,0,0,2,2021-09-23,Female,27,25-34,7
27,0,0,0,0,2021-09-23,Male,69,65-69,16
27,0,1,0,1,2021-09-28,Male,55,55-64,24
27,0,0,0,0,2021-09-26,Male,34,25-34,17
27,3,7,24,34,2021-09-28,Male,13,10-14,1
27,1,0,0,1,2021-09-28,Male,70,70-74,1
27,0,1,0,1,2021-09-23,Male,32,25-34,26
27,0,0,0,0,2021-09-23,Male,66,65-69,20
27,2,12,0,14,2021-10-06,Female,6,5-9,1
27,1,1,0,2,2021-09-23,Male,69,65-69,7
27,2,0,0,2,2021-09-24,Female,0,<1,7
27,1,1,0,2,2021-10-06,Male,12,10-14,1
27,2,2,0,4,2021-10-06,Female,9,5-9,1
27,1,3,2,6,2021-09-22,Male,74,70-74,2
27,1,2,0,3,2021-10-06,Male,54,45-54,1
27,0,0,0,0,2021-09-23,Female,31,25-34,21
27,0,0,0,0,2021-09-24,Female,67,65-69,12
27,0,0,0,0,2021-09-27,Male,67,65-69,1
27,2,0,0,2,2021-09-23,Female,21,20-24,2
27,2,5,28,35,2021-10-06,Male,18,15-19,1
27,1,0,0,1,2021-09-23,Female,68,65-69,7
27,1,2,0,3,2021-09-27,Female,63,55-64,20
27,2,14,0,16,2021-09-24,Male,12,10-14,5
27,1,1,0,2,2021-09-28,Female,23,20-24,14
27,1,2,0,3,2021-09-23,Male,66,65-69,22
27,0,0,0,0,2021-09-23,Male,64,55-64,24
27,0,0,0,0,2021-09-28,Female,41,35-44,1
27,0,0,0,0,2021-09-23,Female,44,35-44,5
27,0,2,0,2,2021-09-23,Male,69,65-69,22
27,0,0,0,0,2021-09-24,Female,68,65-69,15
27,2,0,0,2,2021-09-23,Male,59,55-64,26
27,0,0,0,0,2021-09-23,Female,63,55-64,23
27,1,0,1,2,2021-09-27,Male,72,70-74,1
27,0,0,0,0,2021-09-23,Male,34,25-34,3
27,0,0,0,0,2021-09-24,Male,30,25-34,2
27,0,0,0,0,2021-10-06,Male,74,70-74,1
27,0,0,0,0,2021-09-23,Female,44,35-44,2
27,2,0,0,2,2021-09-26,Female,4,1-4,2
27,0,0,0,0,2021-09-23,Male,70,70-74,20
27,1,0,0,1,2021-09-23,Male,64,55-64,2
27,0,1,0,1,2021-09-27,Male,52,45-54,1
27,0,0,0,0,2021-09-24,Female,54,45-54,11
27,3,5,0,8,2021-09-23,Female,17,15-19,18
27,1,0,0,1,2021-09-23,Male,66,65-69,25
27,0,10,0,10,2021-09-23,Male,53,45-54,3
27,1,0,0,1,2021-09-23,Male,57,55-64,2
27,2,0,0,2,2021-09-23,Female,60,55-64,6
27,1,2,0,3,2021-10-06,Female,41,35-44,1
27,2,3,0,5,2021-09-23,Female,54,45-54,3
27,1,0,0,1,2021-09-28,Female,38,35-44,1
27,1,0,0,1,2021-10-06,Female,71,70-74,1
27,3,2,0,5,2021-09-23,Female,21,20-24,7
27,1,4,0,5,2021-09-23,Male,40,35-44,7
27,0,0,0,0,2021-09-23,Male,32,25-34,6
27,3,0,0,3,2021-09-23,Male,0,<1,6
27,0,0,2,2,2021-09-23,Male,1,1-4,2
27,0,1,0,1,2021-09-23,Male,42,35-44,8
27,1,0,0,1,2021-09-23,Female,54,45-54,7
27,1,0,0,1,2021-10-06,Female,69,65-69,1
27,1,1,0,2,2021-09-23,Male,43,35-44,4
27,1,0,0,1,2021-09-23,Male,49,45-54,6
27,1,0,0,1,2021-09-24,Male,57,55-64,19
27,0,0,0,0,2021-09-28,Male,60,55-64,1
27,1,8,0,9,2021-09-23,Male,49,45-54,2
27,1,0,0,1,2021-09-28,Male,41,35-44,1
27,1,0,0,1,2021-09-23,Male,52,45-54,10
27,1,1,0,2,2021-09-23,Female,67,65-69,20
27,1,1,0,2,2021-09-28,Male,70,70-74,1
27,1,0,0,1,2021-09-23,Female,64,55-64,7
27,0,0,0,0,2021-09-23,Female,51,45-54,10
27,1,0,0,1,2021-09-27,Male,53,45-54,1
27,0,0,0,0,2021-09-23,Female,43,35-44,5
27,3,0,0,3,2021-09-27,Male,12,10-14,1
27,0,1,0,1,2021-09-22,Female,74,70-74,5
27,0,2,0,2,2021-09-23,Male,68,65-69,4
27,1,4,0,5,2021-09-28,Female,40,35-44,1
27,1,0,0,1,2021-09-25,Female,47,45-54,21
27,2,2,0,4,2021-09-23,Female,53,45-54,2
27,0,3,0,3,2021-09-22,Female,81,80-84,6
27,1,0,0,1,2021-09-28,Female,47,45-54,1
27,0,8,0,8,2021-09-23,Male,58,55-64,2
27,1,0,0,1,2021-09-23,Male,27,25-34,7
27,1,0,0,1,2021-09-23,Female,30,25-34,2
27,1,6,0,7,2021-09-23,Female,69,65-69,27
27,0,0,0,0,2021-09-23,Male,49,45-54,3
27,3,15,0,18,2021-09-23,Male,5,5-9,22
27,1,0,0,1,2021-09-24,Male,55,55-64,7
27,2,0,0,2,2021-09-23,Male,66,65-69,23
27,3,0,0,3,2021-10-06,Female,18,15-19,1
27,1,0,0,1,2021-09-27,Male,73,70-74,1
27,0,0,0,0,2021-09-28,Male,41,35-44,1
27,1,3,0,4,2021-09-24,Female,20,20-24,3
27,1,4,0,5,2021-09-23,Male,64,55-64,5
27,1,0,0,1,2021-09-24,Female,49,45-54,4
27,1,0,0,1,2021-09-23,Male,64,55-64,7
27,0,1,0,1,2021-09-23,Male,71,70-74,25
27,1,0,60,61,2021-09-23,Female,36,35-44,2
27,0,0,0,0,2021-09-23,Female,72,70-74,22
27,0,2,0,2,2021-09-28,Male,77,75-79,1
27,1,0,0,1,2021-09-22,Male,75,75-79,25
27,0,0,0,0,2021-09-23,Male,51,45-54,20
27,1,0,0,1,2021-09-27,Female,69,65-69,1
27,1,0,0,1,2021-09-23,Female,32,25-34,22
27,0,0,0,0,2021-09-23,Male,39,35-44,14
27,0,2,0,2,2021-10-06,Female,67,65-69,1
27,1,0,0,1,2021-09-22,Male,77,75-79,3
27,3,5,0,8,2021-09-28,Female,37,35-44,1
27,0,0,0,0,2021-09-23,Male,54,45-54,23
27,1,0,0,1,2021-09-23,Female,72,70-74,5
27,0,2,0,2,2021-09-27,Female,65,65-69,9
27,4,0,0,4,2021-09-23,Female,7,5-9,4
27,1,2,0,3,2021-09-27,Male,69,65-69,9
27,0,0,0,0,2021-09-23,Female,30,25-34,5
27,2,0,0,2,2021-09-28,Male,13,10-14,1
27,1,0,0,1,2021-09-23,Female,50,45-54,22
27,1,11,47,59,2021-09-29,Male,7,5-9,2
27,2,0,0,2,2021-09-26,Male,19,15-19,3
27,0,0,0,0,2021-09-23,Male,49,45-54,2
27,1,3,7,11,2021-10-06,Female,41,35-44,1
27,1,1,0,2,2021-09-22,Male,72,70-74,2
27,1,2,0,3,2021-09-23,Female,37,35-44,3
27,2,0,0,2,2021-09-23,Female,30,25-34,2
27,1,2,0,3,2021-10-06,Female,54,45-54,1
27,0,0,0,0,2021-09-23,Male,16,15-19,20
27,0,32,0,32,2021-09-28,Female,70,70-74,1
27,2,0,0,2,2021-09-23,Female,48,45-54,3
27,0,0,0,0,2021-09-23,Male,53,45-54,2
27,1,2,0,3,2021-09-23,Male,69,65-69,24
27,0,3,0,3,2021-09-24,Male,23,20-24,7
27,0,1,0,1,2021-10-06,Female,50,45-54,1
27,0,0,0,0,2021-09-23,Male,69,65-69,3
27,0,1,0,1,2021-09-25,Female,50,45-54,4
27,2,1,0,3,2021-09-23,Female,39,35-44,5
27,1,2,0,3,2021-09-23,Female,53,45-54,2
27,0,0,0,0,2021-09-23,Male,51,45-54,23
27,2,6,0,8,2021-09-23,Male,17,15-19,7
27,0,3,0,3,2021-09-27,Male,75,75-79,1
27,0,0,0,0,2021-09-23,Male,12,10-14,23
27,1,10,0,11,2021-09-28,Female,51,45-54,1
27,2,0,0,2,2021-09-23,Female,0,<1,3
27,1,0,0,1,2021-09-28,Male,75,75-79,3
27,1,5,0,6,2021-09-26,Female,54,45-54,6
27,2,12,0,14,2021-09-23,Female,58,55-64,6
27,0,0,0,0,2021-09-24,Male,39,35-44,21
27,2,0,0,2,2021-10-06,Male,13,10-14,1
27,0,4,0,4,2021-10-06,Female,62,55-64,1
27,0,0,0,0,2021-09-28,Male,72,70-74,1
27,2,0,0,2,2021-09-23,Male,22,20-24,14
27,0,0,0,0,2021-09-24,Male,52,45-54,21
27,1,0,0,1,2021-09-23,Female,60,55-64,27
27,0,0,0,0,2021-09-23,Male,34,25-34,6
27,2,0,0,2,2021-09-23,Male,74,70-74,23
27,3,18,0,21,2021-09-24,Male,1,1-4,3
27,0,0,0,0,2021-09-23,Male,43,35-44,6
27,1,0,0,1,2021-09-24,Male,69,65-69,22
27,0,0,0,0,2021-10-06,Male,75,75-79,1
27,0,0,0,0,2021-09-23,Male,35,35-44,26
27,3,0,0,3,2021-09-23,Male,70,70-74,22
27,0,2,0,2,2021-09-23,Female,48,45-54,3
27,0,11,0,11,2021-09-23,Male,17,15-19,7
27,0,0,0,0,2021-09-23,Female,28,25-34,2
27,0,0,0,0,2021-09-27,Female,62,55-64,1
27,0,0,2,2,2021-09-27,Male,70,70-74,1
27,0,0,0,0,2021-09-23,Female,72,70-74,2
27,0,12,0,12,2021-09-23,Male,62,55-64,19
27,2,0,0,2,2021-09-23,Male,39,35-44,3
27,1,1,0,2,2021-09-24,Male,71,70-74,17
27,1,0,0,1,2021-09-26,Female,2,1-4,7
27,2,0,0,2,2021-09-23,Male,21,20-24,4
27,0,3,0,3,2021-09-23,Male,63,55-64,3
27,2,0,0,2,2021-09-27,Male,7,5-9,1
27,0,0,0,0,2021-09-27,Female,62,55-64,1
27,3,0,0,3,2021-09-23,Male,14,10-14,3
27,0,2,0,2,2021-09-23,Male,28,25-34,7
27,0,0,0,0,2021-09-23,Female,57,55-64,25
27,0,0,0,0,2021-09-23,Female,59,55-64,22
27,0,0,0,0,2021-09-23,Female,67,65-69,23
27,0,0,0,0,2021-09-23,Female,58,55-64,3
27,2,0,0,2,2021-09-23,Female,27,25-34,3
27,1,0,0,1,2021-09-23,Male,54,45-54,2
27,0,4,0,4,2021-09-23,Male,55,55-64,7
27,0,2,0,2,2021-10-06,Male,63,55-64,1
27,1,0,0,1,2021-09-23,Female,45,45-54,3
27,0,2,0,2,2021-09-22,Female,76,75-79,7
27,1,3,0,4,2021-09-24,Female,56,55-64,7
27,2,1,0,3,2021-10-04,Female,23,20-24,3
27,0,3,0,3,2021-09-24,Female,64,55-64,21
27,0,0,0,0,2021-09-23,Male,70,70-74,7
27,0,0,0,0,2021-10-06,Female,60,55-64,1
27,1,1,0,2,2021-09-23,Female,61,55-64,27
27,0,0,0,0,2021-09-23,Male,49,45-54,7
27,1,0,0,1,2021-09-23,Male,61,55-64,12
27,0,2,0,2,2021-09-27,Male,12,10-14,1
27,2,0,0,2,2021-09-23,Male,49,45-54,22
27,1,5,0,6,2021-09-23,Female,54,45-54,27
27,1,0,0,1,2021-09-25,Female,22,20-24,3
27,1,3,0,4,2021-09-23,Female,66,65-69,2
27,0,0,2,2,2021-10-06,Male,73,70-74,1
27,2,11,0,13,2021-10-06,Female,2,1-4,1
27,0,1,0,1,2021-09-23,Male,56,55-64,22
27,0,0,0,0,2021-09-23,Female,66,65-69,26
27,1,2,0,3,2021-09-28,Male,62,55-64,1
27,1,0,0,1,2021-09-22,Male,80,80-84,21
27,0,1,7,8,2021-09-23,Male,37,35-44,2
27,0,0,0,0,2021-09-24,Female,67,65-69,21
27,2,0,0,2,2021-09-23,Female,15,15-19,20
27,1,1,13,15,2021-09-27,Male,44,35-44,1
27,1,1,0,2,2021-09-24,Female,71,70-74,7
27,1,2,0,3,2021-09-27,Female,64,55-64,1
27,0,3,0,3,2021-10-06,Female,59,55-64,1
27,1,5,0,6,2021-09-22,Male,75,75-79,2
27,0,0,0,0,2021-09-24,Male,51,45-54,2
27,0,0,0,0,2021-09-23,Female,42,35-44,3
27,0,3,0,3,2021-09-24,Male,37,35-44,27
27,0,0,0,0,2021-09-28,Male,76,75-79,1
27,0,1,5,6,2021-09-27,Female,73,70-74,1
27,1,1,0,2,2021-09-26,Female,52,45-54,4
27,0,0,0,0,2021-09-24,Male,54,45-54,2
27,0,3,17,20,2021-10-06,Male,73,70-74,1
27,2,1,0,3,2021-09-25,Female,50,45-54,13
27,2,8,0,10,2021-09-24,Female,43,35-44,2
27,1,0,0,1,2021-09-28,Male,74,70-74,1
27,0,1,0,1,2021-09-27,Female,18,15-19,1
27,2,12,0,14,2021-09-23,Female,54,45-54,2
27,1,1,0,2,2021-09-24,Male,66,65-69,7
27,2,0,0,2,2021-09-23,Male,63,55-64,26
27,0,0,0,0,2021-09-23,Female,70,70-74,17
27,1,0,0,1,2021-09-23,Male,69,65-69,16
27,1,1,0,2,2021-09-24,Female,34,25-34,20
27,1,0,0,1,2021-09-27,Female,71,70-74,13
27,1,4,0,5,2021-09-23,Female,37,35-44,2
27,0,1,0,1,2021-09-23,Male,69,65-69,25
27,0,2,0,2,2021-10-01,Male,29,25-34,23
27,0,0,0,0,2021-10-06,Male,69,65-69,1
27,0,2,0,2,2021-09-22,Female,74,70-74,2
27,1,1,0,2,2021-09-23,Male,14,10-14,6
27,2,0,0,2,2021-10-06,Male,66,65-69,1
27,1,0,0,1,2021-09-23,Male,43,35-44,7
27,3,2,0,5,2021-09-24,Male,5,5-9,20
27,0,0,0,0,2021-09-23,Male,31,25-34,14
27,2,6,0,8,2021-09-25,Female,12,10-14,6
27,0,0,0,0,2021-09-24,Male,58,55-64,2
27,0,2,0,2,2021-09-23,Male,35,35-44,3
27,0,15,0,15,2021-09-23,Female,28,25-34,2
27,0,2,0,2,2021-09-24,Male,47,45-54,21
27,1,2,0,3,2021-09-23,Male,53,45-54,24
27,0,3,0,3,2021-09-23,Female,71,70-74,17
27,3,0,0,3,2021-09-23,Male,70,70-74,22
27,2,34,0,36,2021-10-06,Female,4,1-4,1
27,2,0,0,2,2021-09-23,Male,65,65-69,23
27,0,1,0,1,2021-09-23,Male,50,45-54,24
27,1,6,0,7,2021-09-27,Male,66,65-69,5
27,1,0,0,1,2021-09-23,Male,67,65-69,18
27,1,2,0,3,2021-09-28,Male,54,45-54,1
27,1,0,0,1,2021-10-06,Male,60,55-64,1
27,1,4,0,5,2021-09-23,Female,30,25-34,3
27,0,0,0,0,2021-09-28,Male,40,35-44,1
27,2,0,0,2,2021-09-28,Female,54,45-54,1
27,0,0,0,0,2021-09-23,Male,66,65-69,25
27,4,0,0,4,2021-09-23,Male,1,1-4,2
27,0,0,0,0,2021-09-23,Female,31,25-34,7
27,1,0,0,1,2021-09-24,Male,34,25-34,6
27,0,0,0,0,2021-09-23,Male,33,25-34,2
27,2,0,0,2,2021-10-06,Male,6,5-9,1
27,0,0,0,0,2021-09-27,Female,45,45-54,1
27,3,2,0,5,2021-09-24,Female,58,55-64,2
27,0,0,0,0,2021-09-23,Male,41,35-44,19
27,1,0,0,1,2021-09-22,Male,76,75-79,17
27,1,2,0,3,2021-10-06,Male,62,55-64,1
27,2,0,0,2,2021-09-28,Female,66,65-69,1
27,1,10,15,26,2021-09-24,Male,68,65-69,3
27,0,0,0,0,2021-09-26,Female,49,45-54,7
27,0,0,0,0,2021-10-06,Female,54,45-54,1
27,1,0,0,1,2021-10-06,Male,73,70-74,1
27,1,0,0,1,2021-09-23,Female,45,45-54,17
27,1,0,0,1,2021-10-06,Male,65,65-69,1
27,1,0,0,1,2021-10-06,Female,53,45-54,1
27,1,0,0,1,2021-09-23,Male,57,55-64,7
27,1,2,0,3,2021-09-24,Female,57,55-64,6
27,1,2,0,3,2021-09-27,Male,70,70-74,1
27,1,0,0,1,2021-10-06,Female,58,55-64,1
27,2,0,0,2,2021-09-24,Male,71,70-74,19
27,0,0,0,0,2021-09-23,Female,54,45-54,7
27,2,2,0,4,2021-09-23,Male,9,5-9,3
27,0,2,0,2,2021-09-25,Male,52,45-54,4
27,2,2,0,4,2021-09-27,Female,5,5-9,4
27,1,0,0,1,2021-09-28,Female,60,55-64,1
27,0,1,0,1,2021-09-25,Female,60,55-64,21
27,1,3,0,4,2021-09-23,Female,67,65-69,7
27,1,0,0,1,2021-10-06,Male,70,70-74,1
27,2,2,0,4,2021-10-06,Male,7,5-9,1
27,3,11,0,14,2021-09-23,Female,51,45-54,2
27,0,0,0,0,2021-09-26,Male,48,45-54,15
27,0,1,0,1,2021-09-23,Male,56,55-64,7
27,2,15,24,41,2021-10-06,Female,10,10-14,1
27,1,3,0,4,2021-09-27,Female,41,35-44,4
27,0,0,0,0,2021-10-06,Male,56,55-64,1
27,1,0,0,1,2021-09-24,Female,71,70-74,6
27,3,2,0,5,2021-09-23,Female,5,5-9,17
27,1,0,0,1,2021-10-06,Male,70,70-74,1
27,0,0,0,0,2021-09-28,Female,11,10-14,1
27,0,0,0,0,2021-09-23,Female,59,55-64,17
27,1,1,0,2,2021-09-23,Male,59,55-64,7
27,1,11,0,12,2021-10-06,Female,37,35-44,1
27,0,0,0,0,2021-09-24,Female,51,45-54,13
27,2,10,20,32,2021-09-25,Female,16,15-19,7
27,1,10,6,17,2021-09-23,Male,57,55-64,3
27,0,2,0,2,2021-09-23,Male,25,25-34,24
27,2,0,0,2,2021-09-23,Male,72,70-74,25
27,0,0,0,0,2021-09-26,Male,35,35-44,26
27,1,0,0,1,2021-09-28,Male,52,45-54,1
27,2,0,0,2,2021-09-25,Female,22,20-24,12
27,3,10,0,13,2021-09-23,Female,52,45-54,4
27,1,3,0,4,2021-09-23,Female,60,55-64,2
27,1,0,0,1,2021-09-23,Male,72,70-74,7
27,3,0,0,3,2021-09-23,Male,24,20-24,22
27,1,2,0,3,2021-09-24,Female,45,45-54,3
27,1,0,0,1,2021-09-23,Female,68,65-69,19
27,0,0,0,0,2021-09-23,Male,68,65-69,24
27,1,0,0,1,2021-09-26,Male,64,55-64,5
27,2,0,0,2,2021-09-23,Female,0,<1,6
27,2,0,0,2,2021-09-23,Male,42,35-44,27
27,2,1,0,3,2021-09-28,Female,67,65-69,1
27,0,0,0,0,2021-09-24,Female,22,20-24,4
27,0,0,0,0,2021-09-28,Female,10,10-14,1
27,2,0,0,2,2021-09-23,Female,39,35-44,7
27,0,2,0,2,2021-09-24,Female,63,55-64,2
27,0,3,0,3,2021-09-24,Male,59,55-64,7
27,2,0,0,2,2021-09-23,Female,40,35-44,6
27,2,4,0,6,2021-09-27,Male,0,<1,2
27,0,0,0,0,2021-09-23,Male,39,35-44,3
27,1,30,0,31,2021-09-23,Female,54,45-54,6
27,4,0,0,4,2021-09-28,Male,59,55-64,1
27,0,0,0,0,2021-09-23,Male,53,45-54,7
27,1,0,0,1,2021-09-23,Male,12,10-14,13
27,0,1,0,1,2021-09-23,Male,46,45-54,2
27,2,0,0,2,2021-09-23,Male,55,55-64,22
27,1,0,0,1,2021-09-28,Male,68,65-69,1
27,2,12,11,25,2021-09-23,Male,69,65-69,8
27,2,0,0,2,2021-09-23,Female,16,15-19,3
27,0,1,0,1,2021-09-22,Male,80,80-84,6
27,0,1,0,1,2021-09-23,Female,65,65-69,6
27,1,0,0,1,2021-09-23,Female,69,65-69,20
27,2,0,0,2,2021-09-23,Male,65,65-69,19
27,1,0,0,1,2021-09-23,Male,64,55-64,20
27,1,2,0,3,2021-09-23,Female,68,65-69,4
27,2,0,0,2,2021-09-23,Female,26,25-34,17
27,1,1,0,2,2021-09-24,Female,57,55-64,2
27,0,1,0,1,2021-09-23,Female,69,65-69,24
27,0,0,0,0,2021-09-23,Female,29,25-34,14
27,0,0,0,0,2021-09-23,Female,3,1-4,3
27,1,0,0,1,2021-09-27,Male,57,55-64,1
27,2,3,6,11,2021-10-06,Male,67,65-69,1
27,0,0,1,1,2021-09-23,Female,64,55-64,22
27,1,0,0,1,2021-09-28,Male,39,35-44,1
27,0,0,0,0,2021-09-23,Male,25,25-34,3
27,1,0,0,1,2021-09-23,Male,58,55-64,3
27,1,0,0,1,2021-09-23,Male,69,65-69,22
27,0,0,0,0,2021-09-24,Female,62,55-64,2
27,0,12,0,12,2021-10-06,Female,42,35-44,1
27,1,0,0,1,2021-09-23,Male,59,55-64,7
27,0,1,0,1,2021-09-27,Female,34,25-34,19
27,1,1,0,2,2021-09-23,Male,41,35-44,2
27,1,3,0,4,2021-09-24,Female,51,45-54,3
27,0,4,0,4,2021-10-06,Male,60,55-64,1
27,1,2,0,3,2021-09-28,Female,41,35-44,1
27,2,11,0,13,2021-09-23,Male,3,1-4,6
27,0,0,0,0,2021-09-23,Female,85,85+,2
27,1,0,0,1,2021-09-23,Male,56,55-64,3
27,0,0,0,0,2021-09-23,Female,28,25-34,2
27,0,0,0,0,2021-09-24,Male,54,45-54,7
27,0,2,0,2,2021-09-24,Female,72,70-74,17
27,1,0,0,1,2021-10-06,Male,57,55-64,1
27,1,0,0,1,2021-09-23,Female,38,35-44,7
27,4,4,0,8,2021-09-24,Female,24,20-24,4
27,3,0,0,3,2021-09-23,Female,53,45-54,22
27,1,0,0,1,2021-09-23,Male,52,45-54,2
27,1,11,0,12,2021-09-28,Female,52,45-54,1
27,2,0,0,2,2021-09-27,Female,67,65-69,18
27,2,0,0,2,2021-09-23,Female,79,75-79,21
27,1,0,0,1,2021-09-23,Male,57,55-64,5
27,0,2,0,2,2021-09-23,Female,66,65-69,2
27,0,0,0,0,2021-09-23,Female,71,70-74,7
27,1,0,0,1,2021-10-06,Female,46,45-54,1
27,2,1,0,3,2021-09-24,Male,66,65-69,7
27,0,1,0,1,2021-09-24,Male,58,55-64,6
27,0,1,0,1,2021-09-24,Male,67,65-69,26
27,0,0,0,0,2021-09-23,Male,42,35-44,17
27,0,2,0,2,2021-09-23,Male,48,45-54,2
27,1,5,0,6,2021-09-23,Female,70,70-74,23
27,0,0,0,0,2021-09-22,Female,77,75-79,25
27,2,0,0,2,2021-09-22,Female,16,15-19,7
27,0,0,0,0,2021-09-24,Male,38,35-44,22
27,1,0,0,1,2021-09-23,Female,65,65-69,6
27,2,0,0,2,2021-10-06,Female,56,55-64,1
27,2,2,0,4,2021-09-23,Male,52,45-54,2
27,1,0,16,17,2021-09-23,Male,62,55-64,21
27,3,0,0,3,2021-10-06,Male,10,10-14,1
27,1,2,0,3,2021-09-23,Female,66,65-69,7
27,1,1,0,2,2021-09-23,Male,54,45-54,4
27,1,0,0,1,2021-09-24,Female,69,65-69,2
27,1,1,0,2,2021-09-23,Male,56,55-64,7
27,0,0,0,0,2021-09-23,Male,6,5-9,2
27,0,0,0,0,2021-09-27,Male,72,70-74,1
27,0,4,0,4,2021-09-23,Female,42,35-44,2
27,3,0,0,3,2021-09-24,Female,19,15-19,13
27,3,13,0,16,2021-10-06,Female,2,1-4,1
27,1,0,0,1,2021-09-23,Male,69,65-69,2
27,1,1,0,2,2021-09-23,Male,69,65-69,24
27,1,1,0,2,2021-09-28,Female,38,35-44,1
27,2,0,0,2,2021-09-24,Male,57,55-64,17
27,1,0,1,2,2021-09-23,Female,63,55-64,7
27,0,0,0,0,2021-09-23,Male,61,55-64,7
27,0,0,0,0,2021-09-23,Female,66,65-69,19
27,0,2,0,2,2021-10-06,Male,57,55-64,1
27,0,0,0,0,2021-09-23,Male,38,35-44,3
27,1,0,1,2,2021-09-23,Male,69,65-69,2
27,1,0,0,1,2021-09-23,Female,44,35-44,5
27,0,0,0,0,2021-09-23,Male,52,45-54,7
27,1,0,0,1,2021-09-24,Female,61,55-64,22
27,0,6,0,6,2021-09-24,Male,52,45-54,22
27,1,0,0,1,2021-09-23,Female,50,45-54,21
27,1,1,0,2,2021-10-03,Female,20,20-24,2
27,0,0,0,0,2021-09-23,Male,47,45-54,5
27,1,0,0,1,2021-09-23,Male,16,15-19,7
27,0,10,2,12,2021-10-06,Female,36,35-44,1
27,0,0,0,0,2021-09-28,Male,53,45-54,1
27,2,0,0,2,2021-09-27,Male,67,65-69,10
27,1,0,0,1,2021-09-28,Female,67,65-69,1
27,0,0,0,0,2021-09-23,Male,64,55-64,7
27,2,0,0,2,2021-09-23,Male,52,45-54,7
27,1,0,0,1,2021-09-23,Female,70,70-74,23
27,3,2,0,5,2021-09-23,Female,10,10-14,23
27,1,0,0,1,2021-09-23,Female,40,35-44,6
27,0,0,0,0,2021-09-23,Female,66,65-69,22
27,0,0,0,0,2021-10-03,Female,27,25-34,24
27,2,1,0,3,2021-09-23,Male,77,75-79,25
27,1,0,0,1,2021-10-06,Male,71,70-74,1
27,3,0,0,3,2021-09-23,Female,10,10-14,2
27,0,0,0,0,2021-09-23,Male,64,55-64,7
27,0,1,0,1,2021-09-23,Female,30,25-34,8
27,1,0,0,1,2021-09-23,Male,74,70-74,22
27,0,0,0,0,2021-09-23,Male,31,25-34,18
27,1,0,0,1,2021-09-24,Female,23,20-24,15
27,1,2,0,3,2021-09-23,Male,42,35-44,2
27,1,1,0,2,2021-09-23,Male,64,55-64,24
27,1,0,0,1,2021-09-23,Male,70,70-74,3
27,0,0,0,0,2021-09-27,Male,64,55-64,1
27,3,4,0,7,2021-09-28,Female,12,10-14,1
27,1,0,0,1,2021-09-23,Female,30,25-34,4
27,0,1,0,1,2021-09-23,Male,64,55-64,21
27,3,0,0,3,2021-09-23,Male,15,15-19,21
27,1,1,10,12,2021-09-28,Female,10,10-14,1
27,0,0,0,0,2021-09-23,Male,51,45-54,7
27,0,0,0,0,2021-09-23,Male,54,45-54,7
27,1,0,0,1,2021-09-28,Male,55,55-64,26
27,0,1,6,7,2021-10-06,Male,64,55-64,1
27,1,3,0,4,2021-09-23,Male,36,35-44,6
27,1,0,0,1,2021-09-23,Male,68,65-69,5
27,0,0,0,0,2021-09-23,Female,31,25-34,3
27,1,1,0,2,2021-09-23,Female,61,55-64,2
27,0,0,0,0,2021-09-23,Female,66,65-69,12
27,1,0,0,1,2021-10-06,Female,48,45-54,1
27,1,0,0,1,2021-09-23,Female,53,45-54,25
27,0,1,1,2,2021-09-24,Female,49,45-54,7
27,1,0,0,1,2021-09-23,Female,72,70-74,7
27,0,0,0,0,2021-09-28,Female,0,<1,1
27,2,0,0,2,2021-09-23,Female,22,20-24,3
27,0,2,0,2,2021-09-22,Female,72,70-74,22
27,1,0,0,1,2021-09-25,Female,51,45-54,2
27,1,0,0,1,2021-10-04,Female,28,25-34,7
27,0,1,0,1,2021-09-27,Male,56,55-64,1
27,0,0,0,0,2021-09-28,Male,11,10-14,13
27,3,5,0,8,2021-10-06,Female,50,45-54,1
27,0,0,0,0,2021-09-24,Male,31,25-34,24
27,0,2,0,2,2021-09-23,Female,66,65-69,2
27,1,0,0,1,2021-09-23,Female,72,70-74,2
27,0,2,0,2,2021-09-24,Female,57,55-64,26
27,0,5,0,5,2021-09-23,Female,67,65-69,5
27,0,0,0,0,2021-09-23,Male,52,45-54,23
27,0,6,0,6,2021-09-26,Male,55,55-64,20
27,2,1,0,3,2021-09-23,Female,48,45-54,6
27,0,0,0,0,2021-09-23,Male,57,55-64,1
27,0,1,0,1,2021-09-23,Female,51,45-54,6
27,0,10,0,10,2021-09-23,Female,38,35-44,5
27,2,0,0,2,2021-09-23,Male,5,5-9,7
27,2,0,0,2,2021-09-23,Female,30,25-34,2
27,0,0,0,0,2021-09-24,Female,48,45-54,2
27,4,0,0,4,2021-09-28,Male,4,1-4,1
27,1,5,0,6,2021-09-28,Female,48,45-54,1
27,1,0,0,1,2021-09-24,Female,42,35-44,7
27,1,0,0,1,2021-09-23,Male,57,55-64,7
27,0,1,0,1,2021-10-06,Female,74,70-74,1
27,2,0,0,2,2021-09-24,Female,69,65-69,22
27,1,0,0,1,2021-09-23,Male,50,45-54,8
27,2,30,0,32,2021-10-06,Female,6,5-9,1
27,3,3,0,6,2021-10-06,Male,3,1-4,1
27,1,10,0,11,2021-09-28,Male,65,65-69,1
27,2,1,0,3,2021-09-24,Male,37,35-44,8
27,0,7,0,7,2021-09-23,Female,39,35-44,2
27,1,0,0,1,2021-09-27,Female,75,75-79,1
27,2,0,0,2,2021-09-23,Male,5,5-9,10
27,1,1,0,2,2021-09-23,Male,64,55-64,24
27,0,0,0,0,2021-09-28,Female,53,45-54,9
27,1,0,0,1,2021-09-26,Male,67,65-69,24
27,1,0,0,1,2021-10-06,Male,72,70-74,1
27,0,1,0,1,2021-09-23,Male,64,55-64,2
27,2,0,0,2,2021-09-27,Male,11,10-14,1
27,1,0,0,1,2021-09-23,Female,32,25-34,2
27,2,0,0,2,2021-09-28,Female,19,15-19,1
27,1,0,0,1,2021-09-23,Female,64,55-64,2
27,2,3,0,5,2021-09-28,Male,18,15-19,1
27,1,0,0,1,2021-09-24,Female,34,25-34,4
27,0,0,0,0,2021-09-23,Female,51,45-54,11
27,0,1,0,1,2021-09-22,Male,74,70-74,26
27,1,0,0,1,2021-09-23,Male,52,45-54,19
27,0,0,0,0,2021-10-06,Male,50,45-54,1
27,2,20,24,46,2021-09-24,Male,5,5-9,2
27,2,4,0,6,2021-09-24,Female,54,45-54,9
27,2,0,0,2,2021-10-06,Male,56,55-64,1
27,2,32,0,34,2021-09-23,Female,11,10-14,22
27,2,0,0,2,2021-09-22,Female,73,70-74,11
27,0,0,0,0,2021-09-23,Female,61,55-64,2
27,2,2,0,4,2021-09-24,Male,1,1-4,7
27,3,15,0,18,2021-10-06,Male,6,5-9,1
27,4,7,60,71,2021-09-23,Male,14,10-14,27
27,2,10,0,12,2021-09-23,Male,51,45-54,24
27,0,0,0,0,2021-10-06,Female,59,55-64,1
27,1,0,0,1,2021-10-06,Female,45,45-54,1
27,3,0,0,3,2021-09-23,Female,8,5-9,7
27,0,0,0,0,2021-09-25,Male,71,70-74,15
27,1,0,0,1,2021-10-06,Female,49,45-54,1
27,0,3,0,3,2021-09-24,Female,79,75-79,12
27,0,0,0,0,2021-09-22,Male,78,75-79,22
27,0,0,0,0,2021-09-23,Female,33,25-34,13
27,1,0,0,1,2021-10-06,Male,56,55-64,1
27,1,0,0,1,2021-10-06,Male,67,65-69,1
27,2,0,0,2,2021-09-25,Male,54,45-54,7
27,0,0,0,0,2021-09-23,Male,69,65-69,7
27,1,0,5,6,2021-09-23,Male,32,25-34,15
27,1,0,0,1,2021-09-26,Female,65,65-69,17
27,2,1,0,3,2021-10-06,Female,36,35-44,1
27,2,0,0,2,2021-09-23,Male,67,65-69,20
27,1,2,0,3,2021-09-23,Male,60,55-64,26
27,0,6,0,6,2021-09-27,Male,63,55-64,1
27,1,0,0,1,2021-10-06,Female,62,55-64,1
27,1,0,0,1,2021-09-28,Female,70,70-74,1
27,0,0,0,0,2021-09-24,Female,25,25-34,26
27,0,0,2,2,2021-09-23,Male,46,45-54,5
27,1,0,0,1,2021-09-22,Male,79,75-79,3
27,1,1,2,4,2021-09-23,Male,62,55-64,2
27,1,0,0,1,2021-09-24,Male,69,65-69,7
27,1,0,0,1,2021-09-27,Male,59,55-64,1
27,0,0,0,0,2021-10-06,Female,60,55-64,1
27,0,1,0,1,2021-09-23,Female,51,45-54,3
27,0,2,0,2,2021-09-23,Female,24,20-24,24
27,1,6,0,7,2021-09-23,Male,74,70-74,2
27,0,0,0,0,2021-10-06,Male,60,55-64,1
27,0,1,0,1,2021-09-23,Female,49,45-54,27
27,0,0,0,0,2021-09-23,Male,70,70-74,24
27,2,2,0,4,2021-09-24,Male,68,65-69,7
27,1,3,0,4,2021-09-23,Male,72,70-74,2
27,2,0,0,2,2021-09-26,Male,44,35-44,7
27,1,2,0,3,2021-09-23,Male,60,55-64,3
27,0,0,0,0,2021-09-24,Male,38,35-44,18
27,0,1,0,1,2021-09-23,Male,52,45-54,3
27,3,15,0,18,2021-09-23,Male,51,45-54,2
27,2,0,0,2,2021-09-28,Male,58,55-64,1
27,2,0,0,2,2021-09-23,Female,38,35-44,23
27,0,0,0,0,2021-09-24,Female,23,20-24,14
27,0,1,0,1,2021-09-25,Female,54,45-54,3
27,1,0,0,1,2021-09-23,Male,54,45-54,6
27,0,0,0,0,2021-10-06,Male,56,55-64,1
27,2,3,0,5,2021-09-23,Female,61,55-64,24
27,1,4,0,5,2021-10-06,Female,67,65-69,1
27,0,0,0,0,2021-09-23,Female,58,55-64,7
27,0,3,0,3,2021-09-24,Female,55,55-64,5
27,2,0,6,8,2021-09-27,Male,4,1-4,1
27,0,1,0,1,2021-09-23,Female,42,35-44,2
27,0,0,0,0,2021-09-23,Female,19,15-19,2
27,2,0,0,2,2021-09-23,Male,3,1-4,7
27,0,6,0,6,2021-09-23,Female,66,65-69,27
27,2,1,0,3,2021-09-23,Male,3,1-4,7
27,0,0,0,0,2021-09-23,Female,67,65-69,3
27,3,0,0,3,2021-09-23,Female,6,5-9,21
27,1,7,0,8,2021-09-24,Female,54,45-54,14
27,1,0,0,1,2021-10-06,Male,50,45-54,1
27,1,0,0,1,2021-09-23,Female,37,35-44,5
27,0,1,0,1,2021-09-23,Male,54,45-54,21
27,0,2,0,2,2021-09-23,Male,57,55-64,3
27,3,0,0,3,2021-09-22,Female,18,15-19,3
27,1,0,0,1,2021-09-27,Male,51,45-54,1
27,1,0,0,1,2021-09-23,Female,1,1-4,3
27,0,1,0,1,2021-09-22,Male,73,70-74,6
27,1,3,0,4,2021-09-23,Male,7,5-9,3
27,0,0,0,0,2021-09-28,Female,43,35-44,1
27,0,0,0,0,2021-09-25,Male,61,55-64,5
27,0,0,0,0,2021-09-23,Female,42,35-44,2
27,2,0,0,2,2021-09-23,Male,40,35-44,25
27,1,3,0,4,2021-09-23,Male,53,45-54,2
27,0,2,0,2,2021-09-23,Male,53,45-54,21
27,1,0,0,1,2021-09-23,Female,59,55-64,3
27,1,0,0,1,2021-09-23,Male,56,55-64,3
27,0,0,0,0,2021-09-23,Female,21,20-24,16
27,4,2,0,6,2021-09-28,Male,10,10-14,1
27,2,0,0,2,2021-09-23,Male,10,10-14,3
27,1,4,0,5,2021-10-06,Female,47,45-54,1
27,0,0,0,0,2021-09-24,Female,49,45-54,6
27,2,3,0,5,2021-09-26,Female,6,5-9,2
27,1,0,0,1,2021-09-24,Male,47,45-54,2
27,1,2,0,3,2021-09-23,Female,66,65-69,7
27,0,2,0,2,2021-09-23,Female,40,35-44,3
27,1,0,0,1,2021-09-26,Female,44,35-44,2
27,1,0,0,1,2021-09-23,Male,58,55-64,2
27,1,2,0,3,2021-09-23,Male,67,65-69,25
27,0,0,0,0,2021-10-06,Male,70,70-74,1
27,1,0,0,1,2021-09-23,Male,46,45-54,6
27,0,2,0,2,2021-09-28,Female,73,70-74,1
27,0,0,0,0,2021-09-23,Female,39,35-44,6
27,1,7,0,8,2021-09-28,Male,53,45-54,1
27,0,1,0,1,2021-09-22,Male,73,70-74,22
27,0,5,3,8,2021-09-23,Male,46,45-54,2
27,1,2,0,3,2021-09-23,Male,71,70-74,23
27,1,0,0,1,2021-09-23,Male,65,65-69,3
27,1,1,0,2,2021-09-23,Male,68,65-69,26
27,1,3,0,4,2021-09-28,Female,49,45-54,1
27,0,0,0,0,2021-10-06,Male,62,55-64,1
27,1,0,0,1,2021-09-24,Female,48,45-54,6
27,1,0,0,1,2021-09-23,Male,20,20-24,7
27,2,16,0,18,2021-10-06,Female,5,5-9,1
27,2,0,0,2,2021-09-22,Male,77,75-79,14
27,3,0,0,3,2021-09-24,Female,3,1-4,3
27,1,0,0,1,2021-09-23,Male,69,65-69,2
27,1,0,0,1,2021-09-23,Female,72,70-74,23
27,1,0,0,1,2021-09-22,Male,75,75-79,7
27,0,1,0,1,2021-09-23,Male,52,45-54,16
27,0,1,0,1,2021-09-23,Female,61,55-64,18
27,3,0,0,3,2021-09-24,Male,6,5-9,27
27,0,0,0,0,2021-10-02,Male,5,5-9,2
27,1,30,0,31,2021-09-23,Male,50,45-54,2
27,0,40,0,40,2021-09-28,Male,47,45-54,1
27,1,0,0,1,2021-10-06,Male,66,65-69,1
27,1,0,0,1,2021-09-25,Female,68,65-69,6
27,1,0,0,1,2021-09-23,Male,72,70-74,7
27,0,2,0,2,2021-09-23,Male,44,35-44,7
27,0,0,0,0,2021-09-23,Female,36,35-44,22
27,1,0,0,1,2021-09-24,Female,33,25-34,2
27,2,4,6,12,2021-09-25,Male,56,55-64,20
27,0,0,0,0,2021-10-06,Female,59,55-64,1
27,2,0,0,2,2021-09-28,Male,53,45-54,1
27,0,0,0,0,2021-09-23,Female,45,45-54,6
27,1,1,0,2,2021-09-23,Male,63,55-64,22
27,0,5,0,5,2021-09-23,Male,59,55-64,3
27,0,0,0,0,2021-09-23,Male,59,55-64,6
27,1,0,0,1,2021-09-23,Male,68,65-69,6
27,0,0,0,0,2021-09-23,Male,48,45-54,6
27,0,1,0,1,2021-09-27,Male,54,45-54,20
27,1,0,0,1,2021-10-06,Female,62,55-64,1
27,0,0,0,0,2021-10-06,Male,61,55-64,1
27,0,0,0,0,2021-09-28,Female,47,45-54,1
27,2,1,0,3,2021-09-23,Female,74,70-74,16
27,0,0,0,0,2021-09-23,Male,11,10-14,23
27,1,0,0,1,2021-09-23,Male,69,65-69,6
27,2,4,0,6,2021-09-23,Male,19,15-19,2
27,1,0,0,1,2021-09-23,Female,66,65-69,21
27,1,0,0,1,2021-09-22,Male,77,75-79,7
27,2,1,0,3,2021-09-23,Female,3,1-4,7
27,1,0,0,1,2021-09-23,Male,65,65-69,27
27,0,4,0,4,2021-09-23,Female,52,45-54,22
27,1,14,0,15,2021-09-24,Female,34,25-34,2
27,1,1,0,2,2021-09-23,Female,22,20-24,26
27,1,0,0,1,2021-09-23,Female,56,55-64,6
27,0,4,0,4,2021-09-22,Female,73,70-74,20
27,1,0,0,1,2021-09-23,Male,34,25-34,6
27,1,1,0,2,2021-10-06,Male,75,75-79,1
27,1,0,0,1,2021-09-28,Male,52,45-54,7
27,0,0,0,0,2021-09-23,Male,44,35-44,2
27,0,1,0,1,2021-09-24,Female,42,35-44,2
27,0,0,0,0,2021-09-23,Male,61,55-64,7
27,0,4,0,4,2021-10-06,Female,62,55-64,1
27,0,0,0,0,2021-09-23,Female,60,55-64,8
27,1,6,0,7,2021-09-24,Male,62,55-64,5
27,1,3,0,4,2021-09-25,Male,70,70-74,5
27,3,0,0,3,2021-09-23,Female,19,15-19,7
27,0,0,0,0,2021-10-06,Female,39,35-44,1
27,2,3,0,5,2021-09-24,Male,56,55-64,25
27,0,1,0,1,2021-09-24,Female,60,55-64,3
27,0,0,0,0,2021-09-27,Male,66,65-69,5
27,0,2,0,2,2021-09-27,Male,39,35-44,1
27,0,0,0,0,2021-09-25,Male,60,55-64,23
27,0,4,0,4,2021-09-23,Female,60,55-64,21
27,1,0,0,1,2021-09-24,Female,32,25-34,3
27,0,0,0,0,2021-09-23,Male,81,80-84,2
27,1,0,0,1,2021-09-24,Male,58,55-64,2
27,1,0,0,1,2021-09-28,Male,72,70-74,1
27,1,0,0,1,2021-09-27,Female,67,65-69,1
27,0,0,0,0,2021-09-27,Male,38,35-44,1
27,1,1,0,2,2021-09-23,Female,66,65-69,7
27,1,0,0,1,2021-09-23,Male,33,25-34,24
27,0,0,0,0,2021-09-23,Male,28,25-34,25
27,1,0,0,1,2021-09-23,Male,68,65-69,2
27,0,1,0,1,2021-09-24,Male,48,45-54,22
27,0,0,0,0,2021-09-24,Female,35,35-44,24
27,3,16,0,19,2021-09-23,Male,11,10-14,2
27,0,0,0,0,2021-09-23,Female,41,35-44,27
27,2,0,0,2,2021-09-26,Female,53,45-54,2
27,1,3,0,4,2021-09-23,Male,69,65-69,24
27,0,22,0,22,2021-09-22,Male,74,70-74,16
27,2,0,0,2,2021-09-22,Female,74,70-74,20
27,2,0,0,2,2021-09-23,Male,13,10-14,11
27,0,2,0,2,2021-09-23,Female,49,45-54,12
27,1,1,0,2,2021-09-24,Female,63,55-64,7
27,1,0,0,1,2021-09-23,Male,34,25-34,23
27,1,0,0,1,2021-09-23,Female,62,55-64,22
27,1,3,0,4,2021-09-23,Male,49,45-54,6
27,2,0,0,2,2021-09-23,Female,66,65-69,20
27,0,3,0,3,2021-10-06,Male,60,55-64,1
27,0,0,0,0,2021-09-23,Male,70,70-74,24
27,0,0,0,0,2021-09-24,Female,31,25-34,23
27,1,0,0,1,2021-09-23,Female,58,55-64,7
27,2,2,0,4,2021-09-24,Male,10,10-14,4
27,0,1,0,1,2021-09-27,Female,43,35-44,1
27,1,0,0,1,2021-09-28,Male,50,45-54,1
27,1,0,0,1,2021-09-27,Female,68,65-69,1
27,3,4,0,7,2021-09-23,Female,2,1-4,3
27,0,1,0,1,2021-10-06,Male,75,75-79,1
27,1,0,0,1,2021-09-24,Female,0,<1,4
27,0,2,0,2,2021-09-27,Female,57,55-64,3
27,0,0,0,0,2021-09-22,Female,74,70-74,21
27,0,0,0,0,2021-09-26,Male,57,55-64,6
27,0,0,0,0,2021-10-06,Female,46,45-54,1
27,1,1,0,2,2021-09-23,Female,49,45-54,7
27,2,4,0,6,2021-09-28,Female,10,10-14,1
27,0,4,0,4,2021-09-23,Male,65,65-69,2
27,2,0,0,2,2021-09-23,Male,71,70-74,20
27,1,1,0,2,2021-09-22,Female,73,70-74,2
27,2,0,0,2,2021-09-27,Female,16,15-19,1
27,1,0,0,1,2021-09-23,Male,67,65-69,21
27,1,0,0,1,2021-10-06,Female,69,65-69,1
27,0,0,0,0,2021-09-23,Female,54,45-54,22
27,0,1,0,1,2021-09-24,Male,51,45-54,18
27,1,0,0,1,2021-09-28,Female,32,25-34,22
27,1,2,0,3,2021-09-24,Female,70,70-74,21
27,0,0,0,0,2021-09-23,Male,68,65-69,26
27,0,1,0,1,2021-09-28,Female,65,65-69,1
27,2,5,0,7,2021-10-06,Male,8,5-9,1
27,0,0,0,0,2021-10-06,Male,65,65-69,1
27,0,73,0,73,2021-09-23,Male,61,55-64,7
27,2,0,27,29,2021-10-06,Male,13,10-14,1
27,0,2,0,2,2021-09-23,Male,61,55-64,9
27,1,0,0,1,2021-09-28,Female,63,55-64,1
27,0,3,0,3,2021-09-24,Male,63,55-64,2
27,3,0,0,3,2021-09-23,Female,67,65-69,16
27,3,0,0,3,2021-09-23,Female,26,25-34,5
27,1,4,0,5,2021-09-28,Female,44,35-44,1
27,3,3,0,6,2021-09-28,Male,11,10-14,1
27,0,0,0,0,2021-09-23,Female,56,55-64,7
27,1,3,0,4,2021-09-24,Female,24,20-24,20
27,1,0,0,1,2021-09-23,Female,64,55-64,14
27,0,1,0,1,2021-10-06,Male,60,55-64,1
27,0,4,0,4,2021-09-28,Male,70,70-74,1
27,1,4,0,5,2021-09-30,Female,23,20-24,3
27,0,1,0,1,2021-10-06,Female,50,45-54,2
27,0,0,0,0,2021-09-23,Male,48,45-54,2
27,0,3,0,3,2021-09-23,Male,60,55-64,23
27,0,0,0,0,2021-09-23,Male,37,35-44,25
27,1,4,0,5,2021-09-24,Female,59,55-64,3
27,1,0,0,1,2021-09-23,Female,37,35-44,7
27,0,1,0,1,2021-09-23,Male,52,45-54,23
27,2,0,0,2,2021-09-27,Male,2,1-4,1
27,1,0,0,1,2021-10-03,Male,30,25-34,19
27,1,0,0,1,2021-10-06,Male,61,55-64,1
27,1,0,0,1,2021-10-06,Male,70,70-74,1
27,1,0,0,1,2021-09-28,Male,66,65-69,1
27,5,0,0,5,2021-09-24,Female,2,1-4,7
27,1,6,11,18,2021-10-06,Male,18,15-19,1
27,1,0,2,3,2021-09-23,Female,62,55-64,2
27,0,0,0,0,2021-10-06,Female,42,35-44,1
27,3,2,0,5,2021-09-23,Male,69,65-69,18
27,0,0,3,3,2021-09-23,Male,43,35-44,20
27,0,4,0,4,2021-09-28,Female,68,65-69,1
27,2,7,0,9,2021-09-28,Female,19,15-19,1
27,1,2,0,3,2021-09-27,Female,64,55-64,1
27,1,0,0,1,2021-10-06,Male,71,70-74,1
27,1,0,0,1,2021-09-23,Male,56,55-64,24
27,1,0,0,1,2021-09-24,Female,52,45-54,21
27,2,0,0,2,2021-09-23,Male,6,5-9,2
27,1,3,0,4,2021-10-06,Female,39,35-44,1
27,0,2,0,2,2021-09-27,Male,81,80-84,1
27,2,2,0,4,2021-09-27,Male,1,1-4,1
27,3,0,0,3,2021-09-25,Male,18,15-19,24
27,3,1,0,4,2021-09-23,Female,13,10-14,9
27,0,3,0,3,2021-09-23,Male,55,55-64,24
27,1,1,0,2,2021-10-06,Male,71,70-74,1
27,0,26,0,26,2021-09-27,Male,61,55-64,1
27,1,0,0,1,2021-09-23,Male,58,55-64,9
27,3,0,0,3,2021-09-23,Female,60,55-64,21
27,2,3,0,5,2021-09-23,Female,28,25-34,7
27,0,0,0,0,2021-09-26,Female,37,35-44,16
27,0,0,0,0,2021-09-24,Male,60,55-64,19
27,1,0,0,1,2021-09-23,Female,63,55-64,7
27,1,1,0,2,2021-09-23,Female,22,20-24,24
27,0,0,0,0,2021-09-23,Male,54,45-54,8
27,0,4,0,4,2021-09-23,Male,58,55-64,7
27,0,10,0,10,2021-09-23,Male,29,25-34,7
27,2,0,0,2,2021-09-25,Male,52,45-54,25
27,1,0,0,1,2021-09-23,Female,59,55-64,12
27,0,1,0,1,2021-09-23,Male,65,65-69,21
27,1,0,0,1,2021-09-23,Male,49,45-54,21
27,0,1,0,1,2021-09-28,Male,41,35-44,1
27,0,0,0,0,2021-09-24,Female,28,25-34,3
27,0,1,0,1,2021-09-23,Male,60,55-64,7
27,0,3,0,3,2021-09-23,Male,50,45-54,2
27,0,0,0,0,2021-09-23,Female,16,15-19,2
27,1,0,0,1,2021-09-23,Male,70,70-74,22
27,1,0,0,1,2021-09-28,Female,71,70-74,1
27,0,3,0,3,2021-09-23,Male,31,25-34,24
27,1,63,100,164,2021-09-24,Female,57,55-64,4
27,1,9,0,10,2021-09-23,Female,30,25-34,10
27,2,0,0,2,2021-09-26,Female,70,70-74,24
27,0,0,0,0,2021-09-23,Female,62,55-64,4
27,3,0,0,3,2021-10-06,Male,4,1-4,1
27,1,2,0,3,2021-09-24,Male,40,35-44,2
27,3,4,0,7,2021-09-23,Female,0,<1,2
27,0,1,0,1,2021-09-23,Female,26,25-34,24
27,2,0,0,2,2021-09-26,Female,55,55-64,9
27,1,2,0,3,2021-10-06,Male,68,65-69,1
27,0,0,0,0,2021-09-28,Female,72,70-74,1
27,1,0,0,1,2021-09-23,Female,54,45-54,7
27,1,0,0,1,2021-09-22,Female,73,70-74,7
27,0,2,0,2,2021-09-23,Male,66,65-69,27
27,1,10,0,11,2021-10-06,Male,62,55-64,1
27,3,2,0,5,2021-09-29,Male,7,5-9,6
27,0,3,0,3,2021-09-26,Female,24,20-24,10
27,0,0,0,0,2021-09-23,Female,30,25-34,2
27,1,7,0,8,2021-10-06,Male,70,70-74,1
27,1,5,0,6,2021-09-25,Female,32,25-34,2
27,0,0,0,0,2021-09-24,Male,35,35-44,8
27,1,0,0,1,2021-10-06,Female,59,55-64,1
27,1,1,0,2,2021-09-25,Male,70,70-74,24
27,1,2,0,3,2021-09-25,Female,72,70-74,11
27,1,2,0,3,2021-09-23,Male,62,55-64,18
27,0,0,1,1,2021-09-23,Male,45,45-54,6
27,0,1,0,1,2021-09-23,Female,66,65-69,23
27,0,0,0,0,2021-09-23,Female,70,70-74,2
27,0,11,0,11,2021-09-23,Male,64,55-64,6
27,3,6,0,9,2021-10-06,Male,4,1-4,1
27,0,0,0,0,2021-10-06,Male,57,55-64,1
27,1,0,0,1,2021-09-22,Male,80,80-84,22
27,2,0,0,2,2021-09-22,Male,73,70-74,19
27,0,0,0,0,2021-09-23,Female,65,65-69,2
27,0,0,0,0,2021-09-24,Female,65,65-69,22
27,0,2,0,2,2021-09-24,Female,41,35-44,3
27,3,0,13,16,2021-09-27,Female,50,45-54,1
27,0,1,0,1,2021-09-23,Female,56,55-64,6
27,2,0,0,2,2021-09-23,Male,10,10-14,7
27,1,0,0,1,2021-09-28,Female,67,65-69,1
27,0,2,0,2,2021-09-23,Female,28,25-34,2
27,2,5,0,7,2021-09-23,Female,12,10-14,2
27,2,0,0,2,2021-09-23,Male,45,45-54,7
27,0,0,0,0,2021-09-23,Female,54,45-54,4
27,1,10,0,11,2021-09-23,Female,46,45-54,6
27,1,0,0,1,2021-09-23,Male,48,45-54,3
27,1,0,1,2,2021-09-23,Male,39,35-44,12
27,2,0,0,2,2021-09-22,Male,74,70-74,2
27,0,4,0,4,2021-09-27,Male,40,35-44,1
27,1,0,0,1,2021-09-23,Female,38,35-44,6
27,1,99,100,200,2021-09-26,Male,73,70-74,21
27,0,1,0,1,2021-09-23,Male,51,45-54,3
27,3,0,0,3,2021-09-22,Male,10,10-14,7
27,0,2,0,2,2021-09-23,Female,78,75-79,19
27,2,1,0,3,2021-09-24,Male,72,70-74,18
27,1,0,0,1,2021-09-23,Female,64,55-64,22
27,1,0,0,1,2021-09-25,Male,60,55-64,3
27,2,0,0,2,2021-09-24,Female,15,15-19,25
27,0,0,0,0,2021-09-28,Female,70,70-74,1
27,0,1,0,1,2021-09-23,Female,34,25-34,3
27,0,7,0,7,2021-09-25,Female,40,35-44,24
27,0,2,0,2,2021-09-25,Female,53,45-54,3
27,0,5,0,5,2021-10-06,Female,61,55-64,1
27,0,0,0,0,2021-10-06,Male,65,65-69,1
27,1,0,0,1,2021-09-23,Female,59,55-64,22
27,3,5,0,8,2021-09-25,Male,19,15-19,6
27,3,0,0,3,2021-09-23,Male,2,1-4,3
27,0,0,0,0,2021-10-06,Female,44,35-44,1
27,0,0,0,0,2021-09-23,Male,53,45-54,24
27,1,0,0,1,2021-09-23,Female,55,55-64,3
27,0,2,0,2,2021-09-23,Male,41,35-44,24
27,0,0,0,0,2021-09-23,Male,68,65-69,22
27,0,0,0,0,2021-09-24,Female,34,25-34,2
27,0,0,0,0,2021-09-24,Male,15,15-19,3
27,1,5,0,6,2021-09-23,Female,69,65-69,26
27,2,21,0,23,2021-09-28,Female,14,10-14,1
27,0,0,0,0,2021-09-28,Female,52,45-54,1
27,1,2,0,3,2021-09-23,Male,7,5-9,2
27,0,1,0,1,2021-09-23,Female,29,25-34,25
27,1,0,0,1,2021-09-23,Female,64,55-64,20
27,1,0,0,1,2021-09-23,Male,66,65-69,20
27,2,9,0,11,2021-09-24,Female,15,15-19,19
27,1,31,0,32,2021-09-23,Female,72,70-74,6
27,1,0,0,1,2021-09-23,Female,63,55-64,2
27,0,1,0,1,2021-09-23,Male,60,55-64,22
27,1,0,0,1,2021-09-23,Male,60,55-64,23
27,0,15,0,15,2021-09-23,Male,62,55-64,2
27,0,1,0,1,2021-10-06,Male,75,75-79,1
27,1,0,0,1,2021-09-23,Male,58,55-64,3
27,1,0,0,1,2021-09-28,Female,60,55-64,1
27,0,0,0,0,2021-09-23,Male,34,25-34,6
27,2,0,0,2,2021-09-23,Male,26,25-34,24
27,2,0,0,2,2021-09-24,Female,17,15-19,6
27,1,1,0,2,2021-09-25,Female,68,65-69,18
27,1,2,0,3,2021-10-06,Female,54,45-54,1
27,1,1,0,2,2021-09-23,Male,69,65-69,2
27,1,0,0,1,2021-10-06,Male,72,70-74,1
27,2,0,0,2,2021-09-23,Male,70,70-74,25
27,1,0,0,1,2021-09-22,Male,81,80-84,2
27,1,0,0,1,2021-09-24,Female,46,45-54,7
27,0,0,0,0,2021-09-23,Male,53,45-54,19
27,1,1,0,2,2021-10-06,Male,66,65-69,1
27,0,0,0,0,2021-09-28,Male,52,45-54,1
27,1,0,0,1,2021-09-23,Male,61,55-64,2
27,0,0,0,0,2021-09-28,Male,54,45-54,6
27,0,0,0,0,2021-09-27,Female,60,55-64,1
27,1,0,0,1,2021-09-23,Female,36,35-44,7
27,2,0,0,2,2021-09-24,Male,53,45-54,6
27,1,0,0,1,2021-09-23,Female,64,55-64,21
27,0,0,0,0,2021-09-26,Male,43,35-44,22
27,2,0,0,2,2021-09-23,Male,35,35-44,6
27,1,0,0,1,2021-09-28,Male,71,70-74,1
27,1,15,0,16,2021-09-24,Male,8,5-9,11
27,3,1,0,4,2021-09-23,Male,5,5-9,6
27,2,21,0,23,2021-09-23,Female,5,5-9,7
27,1,0,0,1,2021-09-23,Male,36,35-44,2
27,3,20,0,23,2021-09-28,Female,6,5-9,1
27,0,13,0,13,2021-09-23,Female,56,55-64,4
27,0,0,0,0,2021-09-23,Female,49,45-54,7
27,1,0,0,1,2021-09-23,Male,68,65-69,3
27,0,0,0,0,2021-09-28,Male,41,35-44,6
27,3,0,0,3,2021-09-23,Female,0,<1,2
27,1,1,0,2,2021-09-23,Male,61,55-64,3
27,1,0,0,1,2021-09-23,Male,51,45-54,22
27,0,0,0,0,2021-09-23,Male,33,25-34,14
27,0,2,0,2,2021-09-23,Female,25,25-34,16
27,1,0,0,1,2021-09-23,Male,52,45-54,25
27,2,0,0,2,2021-09-25,Male,25,25-34,6
27,0,0,0,0,2021-09-24,Male,40,35-44,2
27,0,2,0,2,2021-10-06,Male,73,70-74,1
27,0,1,0,1,2021-09-25,Female,56,55-64,20
27,2,0,0,2,2021-09-23,Female,55,55-64,2
27,1,2,0,3,2021-10-06,Female,49,45-54,1
27,0,0,0,0,2021-09-24,Male,71,70-74,24
27,4,2,0,6,2021-10-06,Male,64,55-64,1
27,0,4,45,49,2021-09-24,Male,70,70-74,7
27,0,0,0,0,2021-09-23,Male,34,25-34,7
27,0,0,0,0,2021-09-26,Female,66,65-69,3
27,0,1,0,1,2021-09-24,Male,41,35-44,22
27,0,0,0,0,2021-09-23,Female,46,45-54,14
27,2,0,0,2,2021-10-06,Male,64,55-64,1
27,0,0,0,0,2021-09-23,Male,39,35-44,10
27,1,0,0,1,2021-09-23,Female,62,55-64,2
27,0,2,0,2,2021-09-24,Female,31,25-34,23
27,4,8,0,12,2021-09-24,Female,3,1-4,11
27,0,1,0,1,2021-09-25,Female,34,25-34,4
27,1,3,0,4,2021-09-24,Male,40,35-44,3
27,0,0,0,0,2021-09-23,Male,34,25-34,26
27,3,0,0,3,2021-10-06,Male,63,55-64,1
27,1,0,0,1,2021-10-06,Male,53,45-54,1
27,0,0,0,0,2021-09-24,Male,47,45-54,21
27,0,0,0,0,2021-09-29,Male,0,<1,2
27,1,0,0,1,2021-10-06,Male,72,70-74,1
27,0,0,0,0,2021-09-23,Female,67,65-69,25
27,2,0,0,2,2021-09-28,Male,12,10-14,1
27,2,15,0,17,2021-09-24,Female,12,10-14,18
27,0,0,0,0,2021-09-23,Female,68,65-69,22
27,1,0,0,1,2021-09-23,Female,30,25-34,2
27,1,1,0,2,2021-10-06,Female,35,35-44,1
27,2,0,0,2,2021-10-06,Female,9,5-9,1
27,0,2,0,2,2021-09-28,Male,47,45-54,1
27,2,0,0,2,2021-09-24,Female,18,15-19,3
27,1,0,0,1,2021-09-23,Female,37,35-44,6
27,1,1,0,2,2021-10-06,Male,71,70-74,1
27,0,0,0,0,2021-09-23,Female,56,55-64,25
27,1,44,0,45,2021-09-23,Female,61,55-64,6
27,0,0,0,0,2021-09-28,Male,46,45-54,1
27,0,0,10,10,2021-09-23,Male,30,25-34,21
27,0,0,0,0,2021-09-23,Male,54,45-54,2
27,0,2,0,2,2021-09-23,Female,47,45-54,7
27,1,0,0,1,2021-10-06,Female,52,45-54,1
27,1,3,0,4,2021-10-06,Female,60,55-64,1
27,0,6,0,6,2021-09-23,Male,39,35-44,19
27,0,0,0,0,2021-09-24,Male,52,45-54,3
27,1,5,0,6,2021-09-24,Male,68,65-69,24
27,0,0,0,0,2021-09-25,Male,10,10-14,20
27,0,0,0,0,2021-09-27,Male,57,55-64,1
27,3,0,0,3,2021-09-26,Female,56,55-64,11
27,0,0,0,0,2021-10-06,Female,9,5-9,1
27,3,0,33,36,2021-09-25,Female,19,15-19,15
27,1,0,0,1,2021-09-22,Male,79,75-79,18
27,1,0,0,1,2021-09-28,Male,81,80-84,1
27,1,0,0,1,2021-09-23,Male,66,65-69,5
27,1,1,2,4,2021-10-06,Female,63,55-64,1
27,2,0,0,2,2021-09-27,Male,68,65-69,13
27,1,2,0,3,2021-09-22,Male,74,70-74,15
27,0,2,0,2,2021-09-24,Male,59,55-64,3
27,0,1,0,1,2021-09-27,Female,35,35-44,1
27,2,0,0,2,2021-09-26,Male,2,1-4,2
27,0,2,0,2,2021-09-23,Female,39,35-44,2
27,5,10,0,15,2021-09-23,Male,16,15-19,19
27,1,0,0,1,2021-09-28,Male,32,25-34,20
27,3,12,0,15,2021-09-23,Male,2,1-4,3
27,1,1,0,2,2021-09-28,Female,46,45-54,1
27,1,0,0,1,2021-09-24,Female,54,45-54,5
27,1,0,0,1,2021-09-23,Male,56,55-64,2
27,0,0,0,0,2021-10-06,Female,54,45-54,1
27,1,0,0,1,2021-09-23,Male,58,55-64,24
27,0,3,0,3,2021-09-22,Male,43,35-44,23
27,0,0,0,0,2021-09-28,Female,78,75-79,1
27,1,1,0,2,2021-09-23,Female,46,45-54,3
27,2,11,5,18,2021-09-28,Male,16,15-19,1
27,0,0,0,0,2021-09-23,Female,32,25-34,2
27,1,0,0,1,2021-09-23,Male,53,45-54,7
27,1,1,0,2,2021-09-28,Female,68,65-69,1
27,0,100,0,100,2021-09-23,Male,73,70-74,5
27,0,0,0,0,2021-09-26,Male,10,10-14,7
27,1,1,0,2,2021-09-23,Female,67,65-69,23
27,1,0,0,1,2021-09-24,Female,68,65-69,23
27,1,0,0,1,2021-09-23,Male,55,55-64,6
27,1,0,0,1,2021-09-23,Female,22,20-24,5
27,2,5,0,7,2021-09-23,Male,81,80-84,20
27,0,0,0,0,2021-09-23,Male,51,45-54,22
27,0,3,0,3,2021-09-23,Male,51,45-54,7
27,3,0,0,3,2021-09-27,Female,72,70-74,1
27,0,5,0,5,2021-09-23,Female,40,35-44,3
27,4,35,0,39,2021-09-25,Female,14,10-14,5
27,0,1,0,1,2021-09-27,Male,49,45-54,3
27,0,0,0,0,2021-09-24,Female,31,25-34,16
27,0,0,0,0,2021-09-23,Male,24,20-24,24
27,0,1,1,2,2021-09-23,Female,66,65-69,7
27,0,0,0,0,2021-09-24,Male,62,55-64,2
27,0,0,0,0,2021-09-24,Male,69,65-69,2
27,1,0,0,1,2021-09-23,Female,63,55-64,25
27,1,0,0,1,2021-09-23,Female,53,45-54,19
27,2,18,27,47,2021-09-28,Female,14,10-14,1
27,0,0,0,0,2021-09-26,Male,58,55-64,18
27,0,0,0,0,2021-09-23,Male,67,65-69,25
27,1,1,0,2,2021-09-23,Male,64,55-64,25
27,1,2,0,3,2021-09-28,Female,79,75-79,1
27,1,0,0,1,2021-09-23,Female,62,55-64,7
27,1,1,0,2,2021-09-23,Male,31,25-34,17
27,1,2,0,3,2021-09-24,Male,61,55-64,2
27,0,1,0,1,2021-09-25,Male,34,25-34,7
27,0,0,0,0,2021-09-30,Female,28,25-34,20
27,1,0,0,1,2021-09-22,Male,73,70-74,25
27,0,3,0,3,2021-09-27,Female,30,25-34,2
27,0,1,0,1,2021-09-24,Female,64,55-64,24
27,2,0,0,2,2021-09-23,Male,71,70-74,22
27,1,0,0,1,2021-09-23,Male,52,45-54,4
27,0,1,0,1,2021-09-28,Female,66,65-69,1
27,5,1,0,6,2021-09-23,Female,16,15-19,22
27,3,3,0,6,2021-09-23,Female,66,65-69,26
27,0,1,0,1,2021-09-23,Female,62,55-64,23
27,3,3,0,6,2021-09-28,Female,40,35-44,1
27,1,0,0,1,2021-09-23,Female,60,55-64,7
27,1,0,0,1,2021-10-06,Male,51,45-54,1
27,0,0,0,0,2021-09-28,Female,66,65-69,1
27,0,0,0,0,2021-09-23,Male,44,35-44,3
27,1,0,0,1,2021-09-23,Male,55,55-64,24
27,1,0,0,1,2021-09-28,Male,71,70-74,1
27,0,4,2,6,2021-10-06,Male,60,55-64,1
27,0,0,0,0,2021-09-23,Female,32,25-34,6
27,3,3,0,6,2021-09-24,Female,4,1-4,4
27,0,2,0,2,2021-10-06,Female,73,70-74,1
27,0,0,0,0,2021-09-28,Female,45,45-54,1
27,1,1,0,2,2021-09-23,Male,55,55-64,7
27,1,1,0,2,2021-10-06,Male,69,65-69,1
27,1,5,0,6,2021-10-06,Female,50,45-54,1
27,1,0,0,1,2021-09-27,Female,77,75-79,1
27,3,0,0,3,2021-09-23,Male,9,5-9,2
27,1,0,0,1,2021-09-23,Female,23,20-24,21
27,2,3,0,5,2021-09-23,Female,18,15-19,7
27,2,0,0,2,2021-09-23,Female,12,10-14,7
27,3,0,0,3,2021-09-23,Female,59,55-64,2
27,1,12,0,13,2021-09-25,Male,56,55-64,20
27,1,6,0,7,2021-09-28,Male,70,70-74,1
27,0,0,0,0,2021-09-24,Male,65,65-69,7
27,0,9,0,9,2021-09-28,Male,69,65-69,1
27,0,0,0,0,2021-09-28,Female,47,45-54,1
27,0,0,0,0,2021-09-28,Male,67,65-69,7
27,1,0,0,1,2021-09-22,Male,76,75-79,5
27,0,0,0,0,2021-09-23,Male,54,45-54,24
27,1,1,1,3,2021-09-23,Female,53,45-54,4
27,0,0,6,6,2021-09-28,Male,61,55-64,1
27,1,0,0,1,2021-09-23,Male,60,55-64,6
27,2,0,0,2,2021-09-23,Female,49,45-54,6
27,1,0,0,1,2021-09-23,Male,37,35-44,6
27,0,3,0,3,2021-09-23,Female,62,55-64,2
27,0,5,0,5,2021-09-28,Male,38,35-44,1
27,1,1,0,2,2021-09-23,Female,69,65-69,7
27,0,6,0,6,2021-10-06,Female,42,35-44,1
27,1,1,0,2,2021-09-28,Female,69,65-69,1
27,3,0,0,3,2021-09-23,Male,20,20-24,17
27,0,1,0,1,2021-09-27,Male,39,35-44,7
27,2,0,0,2,2021-10-06,Female,53,45-54,1
27,1,0,0,1,2021-09-23,Female,67,65-69,23
27,0,0,0,0,2021-09-23,Male,45,45-54,4
27,4,0,0,4,2021-10-06,Male,8,5-9,1
27,0,0,0,0,2021-09-23,Male,15,15-19,12
27,1,2,0,3,2021-09-24,Female,64,55-64,4
27,2,0,0,2,2021-09-23,Female,53,45-54,2
27,0,1,0,1,2021-09-23,Female,55,55-64,7
27,1,0,0,1,2021-09-23,Female,70,70-74,5
27,2,2,0,4,2021-09-27,Female,8,5-9,1
27,0,0,0,0,2021-09-23,Male,73,70-74,3
27,0,0,0,0,2021-09-28,Male,70,70-74,1
27,1,1,0,2,2021-09-23,Male,71,70-74,22
27,3,10,0,13,2021-09-23,Male,57,55-64,6
27,0,2,0,2,2021-09-24,Female,68,65-69,20
27,0,1,0,1,2021-09-23,Female,52,45-54,3
27,1,2,0,3,2021-09-23,Male,28,25-34,3
27,0,1,0,1,2021-09-23,Female,69,65-69,21
27,1,0,0,1,2021-09-23,Male,70,70-74,23
27,1,1,0,2,2021-09-23,Male,51,45-54,7
27,0,0,0,0,2021-10-06,Female,53,45-54,1
27,1,0,4,5,2021-09-23,Male,23,20-24,18
27,0,11,0,11,2021-09-25,Male,44,35-44,2
27,1,0,0,1,2021-09-27,Male,36,35-44,1
27,1,0,0,1,2021-09-23,Female,67,65-69,7
27,2,6,0,8,2021-09-23,Male,5,5-9,21
27,0,3,0,3,2021-09-23,Female,65,65-69,5
27,0,1,0,1,2021-09-23,Female,67,65-69,6
27,0,3,0,3,2021-10-06,Male,50,45-54,1
27,2,0,0,2,2021-09-27,Female,10,10-14,1
27,0,0,0,0,2021-09-23,Female,58,55-64,18
27,1,1,0,2,2021-09-24,Male,45,45-54,6
27,1,0,0,1,2021-09-23,Male,67,65-69,3
27,0,3,25,28,2021-09-23,Male,70,70-74,23
27,1,0,1,2,2021-09-23,Male,73,70-74,2
27,0,3,0,3,2021-09-28,Male,45,45-54,1
27,0,2,0,2,2021-09-27,Male,41,35-44,1
27,3,0,0,3,2021-09-23,Female,50,45-54,3
27,0,2,0,2,2021-09-23,Female,67,65-69,3
27,1,0,0,1,2021-09-23,Male,53,45-54,2
27,0,0,0,0,2021-09-23,Male,48,45-54,3
27,1,0,0,1,2021-09-23,Male,68,65-69,27
27,1,0,0,1,2021-09-22,Male,79,75-79,20
27,0,0,0,0,2021-09-23,Female,47,45-54,7
27,2,16,0,18,2021-10-06,Male,66,65-69,1
27,1,2,5,8,2021-09-27,Female,71,70-74,1
27,0,0,0,0,2021-09-23,Male,25,25-34,21
27,0,0,0,0,2021-09-23,Male,16,15-19,24
27,1,1,0,2,2021-09-22,Female,74,70-74,7
27,0,0,0,0,2021-10-06,Male,72,70-74,1
27,1,3,0,4,2021-09-28,Female,65,65-69,1
27,0,4,0,4,2021-09-23,Female,59,55-64,2
27,1,12,0,13,2021-09-23,Male,59,55-64,2
27,2,0,0,2,2021-09-28,Female,59,55-64,1
27,0,3,0,3,2021-09-24,Female,18,15-19,6
27,1,4,0,5,2021-10-06,Female,51,45-54,1
27,2,3,0,5,2021-09-22,Male,79,75-79,20
27,1,0,0,1,2021-09-23,Male,60,55-64,2
27,1,2,0,3,2021-09-28,Male,54,45-54,1
27,1,2,0,3,2021-09-27,Male,69,65-69,1
27,2,2,0,4,2021-09-23,Female,4,1-4,4
27,1,0,0,1,2021-09-23,Female,44,35-44,3
27,0,0,0,0,2021-09-24,Male,52,45-54,18
27,3,0,0,3,2021-09-23,Female,43,35-44,26
27,0,1,0,1,2021-09-28,Male,52,45-54,1
27,1,1,0,2,2021-09-24,Female,66,65-69,15
27,1,0,0,1,2021-09-23,Male,68,65-69,6
27,1,0,0,1,2021-09-23,Male,25,25-34,24
27,0,2,0,2,2021-09-22,Female,72,70-74,20
27,1,1,0,2,2021-09-24,Male,32,25-34,21
27,0,0,0,0,2021-09-23,Female,65,65-69,27
27,3,21,0,24,2021-09-23,Male,7,5-9,7
27,0,0,0,0,2021-09-25,Female,59,55-64,5
27,2,0,0,2,2021-09-24,Male,13,10-14,22
27,1,0,0,1,2021-09-28,Male,42,35-44,1
27,4,7,0,11,2021-09-23,Male,4,1-4,2
27,2,0,0,2,2021-09-24,Male,25,25-34,15
27,1,0,3,4,2021-09-23,Female,67,65-69,6
27,2,1,0,3,2021-09-24,Female,51,45-54,23
27,2,0,0,2,2021-09-23,Female,14,10-14,2
27,0,1,0,1,2021-10-06,Male,49,45-54,1
27,4,2,0,6,2021-09-24,Female,19,15-19,22
27,1,0,0,1,2021-09-24,Male,52,45-54,2
27,1,2,0,3,2021-09-24,Female,33,25-34,3
27,1,13,7,21,2021-09-27,Male,60,55-64,15
27,0,5,0,5,2021-10-06,Female,43,35-44,1
27,1,0,0,1,2021-09-23,Male,67,65-69,3
27,2,6,0,8,2021-09-23,Male,11,10-14,2
27,0,0,0,0,2021-09-23,Male,45,45-54,22
27,1,0,0,1,2021-09-27,Male,50,45-54,1
27,1,0,0,1,2021-09-23,Female,59,55-64,21
27,3,0,0,3,2021-09-27,Female,6,5-9,4
27,0,1,0,1,2021-09-24,Female,55,55-64,25
27,0,0,0,0,2021-09-24,Female,59,55-64,7
27,3,1,0,4,2021-10-06,Female,50,45-54,1
27,0,0,0,0,2021-09-23,Female,42,35-44,26
27,2,24,36,62,2021-09-28,Male,14,10-14,1
27,1,5,0,6,2021-09-28,Female,69,65-69,1
27,0,0,0,0,2021-09-23,Male,20,20-24,8
27,0,0,0,0,2021-09-24,Female,25,25-34,9
27,0,4,0,4,2021-10-06,Male,74,70-74,1
27,0,0,0,0,2021-09-28,Male,49,45-54,1
27,2,2,0,4,2021-10-06,Female,16,15-19,1
27,0,1,0,1,2021-10-06,Male,69,65-69,1
27,1,1,0,2,2021-09-23,Male,67,65-69,7
27,0,6,0,6,2021-09-24,Male,53,45-54,3
27,1,0,2,3,2021-09-28,Female,67,65-69,1
27,0,0,0,0,2021-09-25,Male,35,35-44,7
27,0,1,0,1,2021-09-24,Female,65,65-69,24
27,1,1,0,2,2021-09-23,Female,30,25-34,2
27,1,1,0,2,2021-09-28,Male,52,45-54,2
27,0,1,0,1,2021-09-26,Male,23,20-24,15
27,0,0,0,0,2021-09-23,Female,64,55-64,2
27,1,0,0,1,2021-09-23,Female,53,45-54,26
27,1,0,0,1,2021-09-23,Male,52,45-54,7
27,0,0,0,0,2021-10-06,Male,63,55-64,1
27,1,0,0,1,2021-09-23,Male,58,55-64,2
27,1,0,0,1,2021-09-22,Male,79,75-79,11
27,1,1,0,2,2021-09-24,Male,64,55-64,7
27,1,2,0,3,2021-09-23,Male,70,70-74,2
27,1,0,0,1,2021-09-23,Male,37,35-44,11
27,5,4,0,9,2021-09-28,Male,22,20-24,5
27,0,0,0,0,2021-09-24,Male,21,20-24,23
27,0,2,0,2,2021-09-23,Male,78,75-79,26
27,0,0,0,0,2021-10-06,Female,39,35-44,1
27,2,3,0,5,2021-09-23,Female,67,65-69,26
27,0,2,0,2,2021-10-06,Male,58,55-64,1
27,0,6,0,6,2021-10-06,Female,42,35-44,1
27,0,0,0,0,2021-09-27,Male,38,35-44,6
27,1,2,0,3,2021-09-22,Male,72,70-74,2
27,0,1,0,1,2021-09-28,Female,46,45-54,1
27,1,0,0,1,2021-09-23,Male,37,35-44,2
27,1,0,0,1,2021-09-23,Female,58,55-64,2
27,0,0,0,0,2021-10-06,Male,79,75-79,1
27,0,2,0,2,2021-09-23,Male,22,20-24,3
27,1,1,0,2,2021-10-06,Male,73,70-74,1
27,1,3,0,4,2021-10-06,Male,49,45-54,1
27,3,1,0,4,2021-09-23,Female,8,5-9,7
27,0,0,0,0,2021-09-23,Male,40,35-44,24
27,1,7,0,8,2021-09-24,Female,66,65-69,27
27,1,4,0,5,2021-09-24,Female,63,55-64,7
27,1,0,0,1,2021-09-23,Male,61,55-64,7
27,2,5,0,7,2021-09-24,Male,14,10-14,5
27,0,0,0,0,2021-09-27,Male,51,45-54,1
27,0,0,0,0,2021-09-23,Male,31,25-34,24
27,4,0,0,4,2021-10-06,Male,4,1-4,1
27,2,0,0,2,2021-09-28,Female,71,70-74,1
27,0,0,0,0,2021-09-23,Female,54,45-54,23
27,1,0,0,1,2021-09-28,Male,56,55-64,1
27,3,15,0,18,2021-09-26,Female,6,5-9,17
27,0,0,0,0,2021-09-22,Male,41,35-44,25
27,0,5,6,11,2021-09-23,Male,53,45-54,2
27,0,0,0,0,2021-09-23,Male,71,70-74,2
27,1,0,0,1,2021-09-23,Male,65,65-69,24
27,0,0,0,0,2021-09-23,Male,59,55-64,12
27,1,13,0,14,2021-09-24,Male,61,55-64,13
27,0,0,0,0,2021-09-23,Male,42,35-44,25
27,4,0,0,4,2021-09-23,Female,11,10-14,18
27,0,1,0,1,2021-09-23,Female,50,45-54,7
27,1,0,0,1,2021-09-23,Male,67,65-69,7
27,2,0,0,2,2021-09-23,Male,69,65-69,18
27,1,0,0,1,2021-10-06,Male,58,55-64,1
27,0,1,0,1,2021-09-24,Female,63,55-64,2
27,1,0,0,1,2021-09-23,Female,64,55-64,5
27,1,1,0,2,2021-09-23,Male,68,65-69,15
27,1,0,0,1,2021-09-24,Male,38,35-44,3
27,0,0,0,0,2021-09-27,Male,65,65-69,1
27,0,0,0,0,2021-09-23,Female,59,55-64,24
27,0,0,0,0,2021-09-23,Female,65,65-69,2
27,0,0,0,0,2021-09-24,Male,54,45-54,3
27,0,0,0,0,2021-10-06,Female,60,55-64,1
27,1,3,0,4,2021-09-23,Female,52,45-54,6
27,2,3,0,5,2021-10-06,Male,68,65-69,2
27,0,0,0,0,2021-09-24,Male,57,55-64,11
27,1,0,0,1,2021-09-23,Female,60,55-64,25
27,1,0,0,1,2021-09-23,Male,16,15-19,23
27,1,0,0,1,2021-09-23,Male,66,65-69,23
27,0,0,0,0,2021-09-23,Female,25,25-34,3
27,2,25,0,27,2021-09-23,Female,17,15-19,24
27,1,0,0,1,2021-09-24,Female,38,35-44,6
27,1,0,0,1,2021-09-23,Male,55,55-64,14
27,1,0,0,1,2021-09-27,Female,33,25-34,3
27,2,0,0,2,2021-09-23,Female,49,45-54,2
27,3,15,0,18,2021-10-06,Male,14,10-14,1
27,0,0,0,0,2021-09-23,Male,60,55-64,7
27,0,5,0,5,2021-09-23,Male,24,20-24,6
27,1,0,0,1,2021-09-23,Female,55,55-64,16
27,0,0,0,0,2021-09-23,Male,66,65-69,7
27,0,3,0,3,2021-09-23,Female,29,25-34,3
27,1,2,0,3,2021-09-27,Female,69,65-69,1
27,1,0,10,11,2021-09-23,Male,70,70-74,2
27,0,10,0,10,2021-09-23,Female,22,20-24,7
27,0,0,0,0,2021-09-23,Female,22,20-24,22
27,0,2,0,2,2021-09-25,Male,44,35-44,15
27,1,0,0,1,2021-10-06,Male,13,10-14,1
27,0,0,0,0,2021-09-23,Female,65,65-69,3
27,0,0,0,0,2021-10-06,Male,72,70-74,1
27,1,0,0,1,2021-09-23,Male,69,65-69,6
27,1,0,0,1,2021-09-27,Male,36,35-44,1
27,1,3,0,4,2021-09-23,Female,71,70-74,2
27,0,0,0,0,2021-09-22,Female,77,75-79,7
27,1,3,14,18,2021-09-23,Male,70,70-74,6
27,0,0,18,18,2021-09-24,Male,40,35-44,7
27,1,0,0,1,2021-09-22,Male,73,70-74,2
27,1,0,0,1,2021-09-26,Male,22,20-24,3
27,1,0,0,1,2021-09-22,Male,78,75-79,7
27,0,0,0,0,2021-09-23,Male,57,55-64,6
27,0,0,0,0,2021-09-24,Female,68,65-69,16
27,1,2,0,3,2021-09-23,Male,62,55-64,7
27,2,0,0,2,2021-09-28,Male,54,45-54,1
27,0,0,0,0,2021-09-24,Female,54,45-54,24
27,1,0,0,1,2021-09-23,Male,75,75-79,18
27,0,1,0,1,2021-09-23,Male,40,35-44,24
27,0,0,0,0,2021-09-27,Male,43,35-44,1
27,2,0,0,2,2021-09-23,Male,18,15-19,18
27,0,0,0,0,2021-09-23,Female,51,45-54,3
27,0,2,0,2,2021-09-22,Male,80,80-84,2
27,1,2,0,3,2021-10-06,Female,63,55-64,1
27,2,2,0,4,2021-09-27,Male,17,15-19,1
27,2,0,0,2,2021-09-23,Female,37,35-44,5
27,1,2,0,3,2021-09-24,Female,39,35-44,3
27,1,0,0,1,2021-09-23,Female,55,55-64,10
27,1,0,0,1,2021-09-28,Male,42,35-44,1
27,1,0,0,1,2021-09-28,Male,71,70-74,1
27,1,0,0,1,2021-09-23,Male,53,45-54,16
27,2,0,0,2,2021-09-24,Female,65,65-69,5
27,0,0,0,0,2021-09-23,Male,53,45-54,25
27,0,2,0,2,2021-09-23,Female,53,45-54,7
27,1,0,0,1,2021-09-24,Female,42,35-44,15
27,1,0,0,1,2021-09-23,Male,40,35-44,6
27,1,0,0,1,2021-09-23,Male,58,55-64,21
27,1,0,0,1,2021-09-22,Female,76,75-79,17
27,2,0,0,2,2021-09-23,Male,3,1-4,3
27,1,0,100,101,2021-09-27,Male,77,75-79,1
27,0,0,0,0,2021-09-23,Male,68,65-69,3
27,1,0,0,1,2021-09-23,Male,77,75-79,6
27,1,0,1,2,2021-09-28,Female,36,35-44,1
27,0,0,0,0,2021-09-27,Male,21,20-24,12
27,1,0,0,1,2021-09-27,Female,29,25-34,18
27,1,11,0,12,2021-09-27,Female,19,15-19,6
27,0,0,0,0,2021-09-23,Male,27,25-34,7
27,1,0,0,1,2021-09-30,Female,31,25-34,5
27,4,8,0,12,2021-10-06,Female,5,5-9,1
27,1,1,0,2,2021-09-24,Male,67,65-69,2
27,1,0,0,1,2021-09-23,Male,61,55-64,3
27,0,1,0,1,2021-09-23,Female,59,55-64,6
27,0,0,0,0,2021-09-23,Female,70,70-74,24
27,2,0,0,2,2021-09-22,Male,74,70-74,23
27,0,1,0,1,2021-09-23,Female,52,45-54,3
27,0,1,20,21,2021-09-23,Male,69,65-69,9
27,0,2,0,2,2021-09-24,Female,34,25-34,2
27,0,1,0,1,2021-10-06,Female,37,35-44,1
27,1,0,0,1,2021-09-23,Female,66,65-69,5
27,1,6,0,7,2021-09-23,Male,68,65-69,3
27,3,0,0,3,2021-09-23,Female,8,5-9,2
27,2,0,0,2,2021-09-23,Male,48,45-54,4
27,0,2,0,2,2021-09-23,Male,45,45-54,23
27,0,3,0,3,2021-09-22,Female,81,80-84,5
27,0,2,0,2,2021-09-24,Female,30,25-34,14
27,2,0,0,2,2021-09-27,Female,14,10-14,1
27,0,0,0,0,2021-09-23,Female,70,70-74,3
27,0,4,0,4,2021-10-06,Male,65,65-69,1
27,0,0,0,0,2021-09-28,Male,75,75-79,1
27,1,1,0,2,2021-09-26,Female,62,55-64,21
27,1,0,0,1,2021-09-23,Male,56,55-64,5
27,1,0,0,1,2021-09-22,Female,18,15-19,3
27,1,2,0,3,2021-09-23,Female,70,70-74,21
27,1,0,0,1,2021-09-22,Female,81,80-84,7
27,1,10,0,11,2021-09-23,Female,60,55-64,6
27,3,4,0,7,2021-09-24,Male,2,1-4,2
27,2,3,0,5,2021-09-23,Male,67,65-69,2
27,2,1,0,3,2021-09-23,Female,66,65-69,7
27,0,0,0,0,2021-09-23,Male,27,25-34,5
27,1,0,0,1,2021-09-23,Male,44,35-44,3
27,0,1,0,1,2021-09-23,Male,43,35-44,7
27,3,0,0,3,2021-09-25,Female,65,65-69,5
27,2,14,0,16,2021-09-23,Male,17,15-19,3
27,1,0,0,1,2021-09-28,Female,11,10-14,1
27,1,0,0,1,2021-09-27,Male,40,35-44,1
27,0,1,0,1,2021-10-06,Female,56,55-64,1
27,2,0,0,2,2021-09-24,Female,54,45-54,2
27,0,0,0,0,2021-09-23,Female,21,20-24,3
27,2,0,0,2,2021-09-26,Female,62,55-64,26
27,1,6,0,7,2021-09-24,Male,53,45-54,25
27,1,2,0,3,2021-09-24,Male,51,45-54,2
27,0,1,42,43,2021-09-24,Female,67,65-69,25
27,0,2,0,2,2021-09-23,Male,45,45-54,8
27,0,0,0,0,2021-09-28,Female,45,45-54,1
27,0,10,0,10,2021-09-23,Male,43,35-44,2
27,3,2,0,5,2021-09-28,Male,5,5-9,1
27,0,0,0,0,2021-09-24,Female,65,65-69,7
27,1,0,0,1,2021-09-23,Female,65,65-69,2
27,2,0,0,2,2021-09-23,Male,37,35-44,3
27,1,2,0,3,2021-10-06,Female,57,55-64,1
27,2,0,0,2,2021-09-26,Male,10,10-14,21
27,1,0,0,1,2021-09-23,Female,63,55-64,25
27,1,2,0,3,2021-09-28,Male,53,45-54,1
27,1,1,0,2,2021-09-23,Male,85,85+,5
27,3,45,0,48,2021-09-28,Male,8,5-9,1
27,2,3,0,5,2021-09-25,Female,61,55-64,5
27,0,1,0,1,2021-09-23,Female,66,65-69,22
27,2,0,0,2,2021-09-28,Male,45,45-54,2
27,0,0,0,0,2021-09-23,Male,66,65-69,2
27,2,0,0,2,2021-09-24,Female,53,45-54,22
27,2,0,0,2,2021-09-23,Female,48,45-54,24
27,1,0,0,1,2021-09-23,Male,67,65-69,23
27,2,0,0,2,2021-09-25,Male,5,5-9,6
27,0,0,15,15,2021-09-23,Male,30,25-34,15
27,1,2,0,3,2021-10-06,Female,54,45-54,1
27,1,4,0,5,2021-10-06,Male,12,10-14,1
27,1,0,0,1,2021-09-23,Male,65,65-69,22
27,2,0,0,2,2021-09-24,Female,68,65-69,21
27,1,0,0,1,2021-09-27,Male,46,45-54,1
27,3,0,0,3,2021-09-23,Male,53,45-54,2
27,1,1,0,2,2021-09-22,Male,73,70-74,16
27,2,3,7,12,2021-09-24,Male,21,20-24,24
27,1,1,0,2,2021-10-06,Male,68,65-69,1
27,0,6,0,6,2021-09-28,Male,61,55-64,1
27,1,2,0,3,2021-09-23,Male,59,55-64,26
27,0,0,0,0,2021-09-23,Male,52,45-54,6
27,0,0,0,0,2021-09-23,Male,50,45-54,7
27,1,2,0,3,2021-09-24,Male,67,65-69,21
27,3,0,0,3,2021-09-24,Male,6,5-9,23
27,3,0,0,3,2021-09-23,Male,1,1-4,2
27,1,2,0,3,2021-09-27,Female,28,25-34,3
27,1,3,0,4,2021-09-23,Male,64,55-64,7
27,0,1,0,1,2021-09-23,Female,65,65-69,7
27,0,0,0,0,2021-09-23,Female,27,25-34,2
27,3,0,0,3,2021-09-27,Female,8,5-9,1
27,1,0,0,1,2021-09-23,Female,63,55-64,7
27,4,29,0,33,2021-09-24,Female,17,15-19,5
27,0,0,0,0,2021-09-23,Female,53,45-54,2
27,0,1,37,38,2021-09-23,Female,26,25-34,26
27,3,1,0,4,2021-09-23,Male,30,25-34,24
27,1,0,0,1,2021-09-23,Female,56,55-64,3
27,2,2,0,4,2021-09-23,Female,12,10-14,22
27,1,2,0,3,2021-09-23,Female,70,70-74,24
27,0,0,0,0,2021-09-28,Male,68,65-69,1
27,1,12,0,13,2021-09-23,Female,37,35-44,3
27,0,1,0,1,2021-09-23,Male,63,55-64,3
27,0,0,0,0,2021-10-06,Male,73,70-74,1
27,2,15,0,17,2021-09-28,Male,12,10-14,1
27,0,1,0,1,2021-09-24,Male,67,65-69,23
27,1,0,0,1,2021-09-23,Female,68,65-69,18
27,2,0,0,2,2021-09-23,Female,20,20-24,2
27,0,0,0,0,2021-09-28,Female,54,45-54,1
27,0,9,0,9,2021-09-22,Female,77,75-79,17
27,1,1,0,2,2021-09-22,Female,73,70-74,7
27,2,0,0,2,2021-09-27,Male,61,55-64,1
27,2,0,0,2,2021-09-23,Male,18,15-19,2
27,1,1,0,2,2021-09-22,Male,73,70-74,3
27,1,2,0,3,2021-09-23,Female,62,55-64,17
27,0,11,0,11,2021-09-23,Female,61,55-64,7
27,0,3,0,3,2021-09-23,Female,54,45-54,7
27,2,0,0,2,2021-09-23,Male,56,55-64,13
27,1,0,0,1,2021-09-23,Male,68,65-69,24
27,1,20,0,21,2021-09-23,Male,71,70-74,2
27,4,2,0,6,2021-09-23,Male,8,5-9,26
27,2,7,0,9,2021-09-28,Male,14,10-14,1
27,1,0,0,1,2021-10-06,Male,71,70-74,1
27,0,9,37,46,2021-09-24,Male,66,65-69,7
27,0,1,0,1,2021-09-23,Female,1,1-4,6
27,2,0,0,2,2021-09-23,Female,3,1-4,7
27,0,0,0,0,2021-10-06,Female,61,55-64,1
27,4,0,0,4,2021-09-22,Female,45,45-54,7
27,0,0,0,0,2021-09-24,Male,24,20-24,8
27,3,0,0,3,2021-09-23,Male,5,5-9,2
27,2,0,0,2,2021-09-22,Female,73,70-74,7
27,0,4,0,4,2021-09-23,Male,55,55-64,2
27,0,2,0,2,2021-09-24,Female,51,45-54,5
27,1,0,0,1,2021-09-23,Male,57,55-64,7
27,1,0,0,1,2021-09-23,Male,48,45-54,2
27,0,2,0,2,2021-09-23,Male,57,55-64,5
27,2,0,0,2,2021-09-23,Male,52,45-54,22
27,1,0,0,1,2021-09-25,Female,69,65-69,17
27,0,0,0,0,2021-09-26,Male,67,65-69,6
27,5,0,0,5,2021-09-23,Female,8,5-9,3
27,0,1,0,1,2021-09-28,Female,66,65-69,2
27,2,1,0,3,2021-09-23,Male,18,15-19,2
27,2,1,0,3,2021-09-23,Male,62,55-64,23
27,0,3,0,3,2021-10-06,Male,50,45-54,1
27,0,3,0,3,2021-09-23,Male,51,45-54,6
27,1,30,0,31,2021-09-28,Female,51,45-54,1
27,1,6,0,7,2021-09-24,Female,62,55-64,22
27,0,1,0,1,2021-09-26,Male,52,45-54,16
27,2,0,0,2,2021-10-06,Male,15,15-19,1
27,1,0,0,1,2021-10-06,Male,68,65-69,1
27,3,0,0,3,2021-09-23,Male,60,55-64,3
27,1,1,0,2,2021-09-24,Male,66,65-69,25
27,1,0,0,1,2021-10-06,Female,52,45-54,1
27,1,0,0,1,2021-09-27,Female,68,65-69,2
27,0,0,0,0,2021-09-23,Male,51,45-54,7
27,0,0,0,0,2021-09-24,Female,63,55-64,3
27,0,2,0,2,2021-09-23,Male,58,55-64,5
27,1,0,11,12,2021-09-23,Male,46,45-54,7
27,1,2,3,6,2021-09-23,Female,56,55-64,5
27,0,2,0,2,2021-09-25,Male,57,55-64,7
27,1,0,0,1,2021-09-29,Female,27,25-34,8
27,0,2,0,2,2021-09-23,Female,62,55-64,6
27,1,1,0,2,2021-09-28,Female,41,35-44,1
27,1,0,0,1,2021-09-23,Male,69,65-69,6
27,0,0,0,0,2021-09-28,Female,70,70-74,1
27,0,0,0,0,2021-10-06,Male,61,55-64,1
27,0,0,0,0,2021-09-23,Female,6,5-9,4
27,1,0,0,1,2021-09-24,Female,54,45-54,26
27,0,0,0,0,2021-10-06,Female,5,5-9,1
27,0,0,0,0,2021-09-23,Male,56,55-64,2
27,1,0,0,1,2021-09-24,Male,27,25-34,3
27,0,2,0,2,2021-09-24,Female,30,25-34,3
27,4,2,0,6,2021-09-24,Female,42,35-44,14
27,2,4,0,6,2021-10-06,Female,39,35-44,1
27,3,5,0,8,2021-09-28,Female,4,1-4,1
27,1,0,0,1,2021-09-23,Male,67,65-69,24
27,3,1,0,4,2021-09-23,Male,16,15-19,6
27,0,0,0,0,2021-09-23,Male,41,35-44,24
27,0,0,0,0,2021-09-23,Male,50,45-54,23
27,0,0,0,0,2021-09-23,Male,67,65-69,26
27,3,3,0,6,2021-09-23,Female,31,25-34,6
27,1,0,0,1,2021-09-23,Male,64,55-64,2
27,1,5,1,7,2021-09-23,Male,65,65-69,2
27,2,0,0,2,2021-09-23,Female,1,1-4,8
27,1,0,0,1,2021-09-23,Male,64,55-64,22
27,0,0,0,0,2021-09-28,Male,41,35-44,1
27,0,0,0,0,2021-09-23,Female,69,65-69,23
27,2,0,0,2,2021-09-23,Male,52,45-54,17
27,0,0,0,0,2021-09-23,Male,18,15-19,6
27,0,2,0,2,2021-09-28,Male,54,45-54,1
27,4,4,0,8,2021-09-24,Female,50,45-54,5
27,0,0,0,0,2021-09-23,Male,56,55-64,18
27,1,10,0,11,2021-09-23,Male,48,45-54,22
27,3,0,0,3,2021-09-23,Male,12,10-14,13
27,1,0,0,1,2021-09-26,Male,66,65-69,3
27,0,1,0,1,2021-09-23,Female,35,35-44,21
27,0,0,0,0,2021-09-23,Male,72,70-74,2
27,0,0,0,0,2021-09-23,Male,40,35-44,2
27,1,3,0,4,2021-10-06,Female,65,65-69,1
27,0,1,0,1,2021-09-24,Female,27,25-34,6
27,1,0,0,1,2021-09-23,Male,62,55-64,26
27,0,7,0,7,2021-09-23,Female,58,55-64,27
27,1,0,0,1,2021-09-28,Male,56,55-64,1
27,2,0,0,2,2021-09-24,Male,59,55-64,10
27,3,10,0,13,2021-09-23,Male,14,10-14,25
27,1,2,0,3,2021-09-23,Female,38,35-44,6
27,0,0,0,0,2021-09-23,Male,65,65-69,7
27,2,0,0,2,2021-09-22,Male,78,75-79,20
27,2,0,0,2,2021-09-27,Female,52,45-54,1
27,1,0,0,1,2021-09-23,Male,67,65-69,2
27,1,0,0,1,2021-09-23,Female,69,65-69,2
27,3,0,0,3,2021-09-23,Female,0,<1,3
27,1,0,0,1,2021-09-23,Male,71,70-74,6
27,1,0,0,1,2021-09-23,Male,60,55-64,2
27,1,0,0,1,2021-09-23,Male,67,65-69,22
27,2,0,0,2,2021-09-24,Female,66,65-69,21
27,1,0,0,1,2021-09-24,Female,27,25-34,2
27,1,0,0,1,2021-09-28,Male,77,75-79,1
27,0,34,0,34,2021-09-23,Female,60,55-64,3
27,2,50,0,52,2021-10-06,Male,5,5-9,1
27,2,15,15,32,2021-10-06,Male,15,15-19,1
27,4,7,0,11,2021-10-06,Male,12,10-14,1
27,1,0,0,1,2021-09-23,Female,72,70-74,7
27,1,0,0,1,2021-09-23,Male,70,70-74,7
27,1,2,0,3,2021-09-23,Male,71,70-74,2
27,0,10,0,10,2021-09-25,Female,48,45-54,2
27,0,0,0,0,2021-09-22,Female,73,70-74,2
27,1,1,0,2,2021-10-06,Male,74,70-74,1
27,2,0,0,2,2021-09-25,Female,13,10-14,3
27,0,0,0,0,2021-09-23,Male,52,45-54,24
27,0,0,0,0,2021-10-06,Female,50,45-54,1
27,1,0,0,1,2021-09-28,Female,71,70-74,1
27,0,0,0,0,2021-09-23,Female,38,35-44,7
27,0,1,0,1,2021-09-27,Female,56,55-64,7
27,0,0,0,0,2021-09-23,Male,55,55-64,4
27,2,3,0,5,2021-09-23,Female,71,70-74,2
27,2,6,0,8,2021-09-23,Female,12,10-14,18
27,0,0,0,0,2021-09-23,Male,62,55-64,22
27,0,2,0,2,2021-09-23,Female,31,25-34,12
27,0,1,0,1,2021-09-23,Male,58,55-64,4
27,1,0,0,1,2021-09-23,Male,62,55-64,3
27,2,0,0,2,2021-09-23,Male,13,10-14,26
27,1,0,0,1,2021-09-23,Male,71,70-74,11
27,2,0,0,2,2021-09-28,Male,70,70-74,1
27,2,1,0,3,2021-09-23,Female,63,55-64,23
27,1,3,0,4,2021-09-23,Female,41,35-44,2
27,1,1,0,2,2021-09-23,Male,69,65-69,3
27,0,0,0,0,2021-09-27,Male,42,35-44,1
27,0,4,0,4,2021-09-23,Male,41,35-44,6
27,2,0,0,2,2021-09-24,Female,2,1-4,2
27,1,0,0,1,2021-09-23,Female,65,65-69,7
27,3,0,0,3,2021-09-23,Female,14,10-14,6
27,0,0,0,0,2021-09-23,Male,68,65-69,5
27,0,1,0,1,2021-09-24,Female,51,45-54,7
27,0,0,0,0,2021-09-23,Female,54,45-54,21
27,1,2,0,3,2021-09-23,Female,34,25-34,19
27,1,0,0,1,2021-10-02,Male,6,5-9,18
27,0,0,0,0,2021-09-24,Female,65,65-69,3
27,0,0,0,0,2021-09-22,Male,78,75-79,3
27,2,0,0,2,2021-09-28,Male,43,35-44,1
27,3,15,0,18,2021-09-24,Male,8,5-9,2
27,2,0,0,2,2021-09-23,Male,55,55-64,2
27,1,4,9,14,2021-09-28,Female,68,65-69,1
27,2,0,0,2,2021-09-23,Male,57,55-64,23
27,0,0,0,0,2021-09-23,Female,30,25-34,2
27,0,2,0,2,2021-09-24,Female,63,55-64,19
27,1,0,0,1,2021-09-23,Male,66,65-69,26
27,1,1,0,2,2021-09-23,Female,55,55-64,13
27,3,1,0,4,2021-09-23,Female,4,1-4,5
27,1,0,0,1,2021-09-27,Male,67,65-69,1
27,0,0,0,0,2021-09-23,Male,66,65-69,26
27,0,6,0,6,2021-09-25,Male,60,55-64,7
27,0,0,0,0,2021-10-06,Female,82,80-84,1
27,0,3,0,3,2021-09-28,Male,53,45-54,1
27,1,1,0,2,2021-09-23,Female,59,55-64,25
27,1,4,2,7,2021-10-06,Male,45,45-54,1
27,2,0,0,2,2021-10-06,Male,5,5-9,1
27,2,2,0,4,2021-09-23,Male,74,70-74,22
27,2,0,0,2,2021-09-23,Male,48,45-54,6
27,1,0,0,1,2021-09-23,Female,31,25-34,6
27,2,0,0,2,2021-09-23,Male,34,25-34,21
27,0,0,10,10,2021-09-24,Female,31,25-34,2
27,0,1,0,1,2021-09-23,Male,63,55-64,21
27,1,0,0,1,2021-09-27,Female,67,65-69,1
27,0,0,0,0,2021-09-25,Female,22,20-24,7
27,0,4,0,4,2021-09-23,Female,69,65-69,22
27,2,1,0,3,2021-09-23,Female,35,35-44,15
27,0,0,0,0,2021-09-24,Male,32,25-34,6
27,1,3,0,4,2021-09-23,Male,19,15-19,3
27,0,0,0,0,2021-09-23,Male,57,55-64,24
27,0,2,0,2,2021-09-23,Female,56,55-64,25
27,2,0,14,16,2021-10-06,Male,16,15-19,1
27,0,2,0,2,2021-09-23,Female,68,65-69,26
27,3,1,0,4,2021-09-23,Female,17,15-19,5
27,1,2,0,3,2021-09-23,Female,39,35-44,2
27,0,0,0,0,2021-09-23,Female,68,65-69,10
27,1,0,0,1,2021-09-23,Male,73,70-74,20
27,2,56,0,58,2021-09-24,Female,19,15-19,2
27,1,0,0,1,2021-09-23,Female,25,25-34,13
27,0,31,0,31,2021-09-23,Female,72,70-74,2
27,0,1,0,1,2021-09-23,Male,66,65-69,2
27,0,0,0,0,2021-09-23,Female,50,45-54,7
27,0,0,0,0,2021-09-28,Female,69,65-69,1
27,0,0,0,0,2021-09-23,Male,72,70-74,18
27,2,0,0,2,2021-09-26,Male,26,25-34,4
27,2,0,0,2,2021-09-23,Female,71,70-74,23
27,1,1,0,2,2021-09-23,Male,66,65-69,2
27,0,0,0,0,2021-09-26,Female,72,70-74,20
27,0,0,70,70,2021-10-06,Female,78,75-79,1
27,0,3,0,3,2021-09-24,Female,60,55-64,6
27,0,3,0,3,2021-09-24,Male,67,65-69,27
27,2,2,0,4,2021-09-22,Male,18,15-19,4
27,0,2,0,2,2021-09-23,Male,64,55-64,2
27,1,11,0,12,2021-09-28,Female,54,45-54,1
27,1,0,0,1,2021-09-23,Female,54,45-54,24
27,1,1,0,2,2021-09-23,Male,63,55-64,25
27,2,1,0,3,2021-09-27,Male,20,20-24,7
27,1,0,0,1,2021-09-23,Male,59,55-64,3
27,1,0,0,1,2021-09-23,Female,68,65-69,7
27,1,1,0,2,2021-09-24,Female,29,25-34,25
27,1,1,0,2,2021-10-06,Male,75,75-79,1
27,1,0,0,1,2021-09-24,Female,10,10-14,21
27,0,0,0,0,2021-09-23,Male,54,45-54,23
27,3,2,0,5,2021-09-24,Male,0,<1,2
27,3,0,0,3,2021-09-23,Male,3,1-4,9
27,3,2,0,5,2021-09-24,Female,3,1-4,3
27,2,0,0,2,2021-09-23,Male,6,5-9,5
27,1,1,0,2,2021-09-24,Female,64,55-64,7
27,2,0,0,2,2021-09-23,Male,17,15-19,17
27,1,9,0,10,2021-09-23,Male,71,70-74,5
27,0,0,0,0,2021-09-23,Male,52,45-54,2
27,1,0,0,1,2021-09-23,Male,35,35-44,26
27,3,1,0,4,2021-09-28,Male,65,65-69,4
27,0,0,0,0,2021-10-06,Female,50,45-54,1
27,0,2,0,2,2021-10-06,Female,47,45-54,1
27,0,2,0,2,2021-09-23,Female,36,35-44,9
27,0,1,0,1,2021-09-22,Female,72,70-74,25
27,0,0,0,0,2021-09-25,Female,77,75-79,4
27,3,3,0,6,2021-09-23,Male,42,35-44,22
27,0,0,0,0,2021-09-23,Female,63,55-64,14
27,1,0,0,1,2021-09-25,Male,58,55-64,3
27,1,2,0,3,2021-09-23,Female,25,25-34,21
27,0,1,0,1,2021-09-24,Female,43,35-44,24
27,1,0,0,1,2021-09-28,Female,68,65-69,1
27,0,0,0,0,2021-10-06,Male,61,55-64,1
27,1,2,0,3,2021-09-28,Male,74,70-74,1
27,1,0,0,1,2021-09-24,Male,55,55-64,21
27,1,0,0,1,2021-10-06,Male,72,70-74,1
27,1,0,0,1,2021-09-23,Female,60,55-64,25
27,1,0,0,1,2021-09-23,Male,70,70-74,19
27,0,0,0,0,2021-10-06,Male,64,55-64,1
27,0,3,0,3,2021-09-23,Male,44,35-44,3
27,0,4,0,4,2021-09-23,Male,60,55-64,7
27,5,0,0,5,2021-09-23,Male,51,45-54,3
27,3,0,0,3,2021-10-06,Male,0,<1,1
27,0,0,0,0,2021-09-22,Female,74,70-74,2
27,3,2,0,5,2021-09-23,Female,17,15-19,2
27,2,0,0,2,2021-09-23,Female,2,1-4,2
27,2,4,0,6,2021-09-23,Female,55,55-64,2
27,2,0,0,2,2021-10-06,Female,12,10-14,1
27,1,1,0,2,2021-09-22,Female,76,75-79,19
27,3,0,0,3,2021-09-24,Male,35,35-44,5
27,1,3,0,4,2021-09-28,Female,58,55-64,1
27,2,16,0,18,2021-09-25,Male,1,1-4,2
27,1,0,0,1,2021-09-28,Male,36,35-44,1
27,3,2,0,5,2021-09-23,Female,56,55-64,2
27,1,7,0,8,2021-09-23,Female,33,25-34,2
27,1,1,0,2,2021-10-06,Female,75,75-79,1
27,0,2,0,2,2021-09-24,Female,70,70-74,3
27,1,0,0,1,2021-09-23,Female,64,55-64,16
27,1,0,0,1,2021-09-24,Female,41,35-44,2
27,2,0,0,2,2021-09-24,Male,3,1-4,3
27,0,0,0,0,2021-09-23,Male,50,45-54,2
27,1,2,0,3,2021-10-06,Male,74,70-74,1
27,3,0,0,3,2021-09-26,Male,17,15-19,17
27,1,0,0,1,2021-09-27,Female,43,35-44,6
27,0,0,0,0,2021-09-24,Female,41,35-44,4
27,0,0,0,0,2021-09-24,Female,68,65-69,3
27,0,2,0,2,2021-09-23,Male,59,55-64,3
27,0,2,0,2,2021-09-22,Male,75,75-79,21
27,2,0,0,2,2021-09-23,Male,15,15-19,7
27,0,1,0,1,2021-09-22,Male,74,70-74,12
27,0,0,0,0,2021-09-24,Male,65,65-69,2
27,0,2,0,2,2021-09-23,Female,67,65-69,26
27,4,1,0,5,2021-09-24,Female,17,15-19,14
27,1,0,0,1,2021-09-23,Female,24,20-24,2
27,1,2,0,3,2021-09-22,Male,72,70-74,2
27,0,0,0,0,2021-09-23,Male,54,45-54,3
27,0,0,0,0,2021-09-24,Male,52,45-54,3
27,1,0,0,1,2021-09-28,Female,42,35-44,1
27,1,0,0,1,2021-09-23,Male,32,25-34,2
27,1,0,0,1,2021-09-23,Female,47,45-54,24
27,1,0,0,1,2021-09-23,Female,48,45-54,7
27,2,7,0,9,2021-09-27,Male,58,55-64,1
27,0,0,0,0,2021-09-28,Male,11,10-14,1
27,1,1,0,2,2021-09-23,Female,33,25-34,5
27,1,0,0,1,2021-09-24,Male,54,45-54,22
27,0,0,0,0,2021-09-25,Female,63,55-64,24
27,1,0,0,1,2021-10-06,Male,66,65-69,1
27,2,0,0,2,2021-09-22,Male,75,75-79,19
27,1,3,0,4,2021-09-23,Female,71,70-74,26
27,1,0,0,1,2021-09-23,Female,54,45-54,14
27,0,0,0,0,2021-09-23,Female,63,55-64,14
27,2,2,0,4,2021-09-23,Male,64,55-64,2
27,1,0,6,7,2021-09-22,Male,74,70-74,19
27,3,0,0,3,2021-09-23,Male,61,55-64,7
27,0,0,0,0,2021-09-23,Female,32,25-34,21
27,2,0,0,2,2021-09-23,Male,43,35-44,24
27,1,0,0,1,2021-10-06,Male,60,55-64,1
27,0,1,0,1,2021-09-23,Male,71,70-74,25
27,3,0,0,3,2021-10-06,Female,7,5-9,1
27,1,0,0,1,2021-09-24,Male,40,35-44,11
27,1,0,0,1,2021-09-27,Female,69,65-69,1
27,4,0,0,4,2021-09-28,Female,14,10-14,1
27,1,0,0,1,2021-09-23,Male,52,45-54,6
27,0,3,0,3,2021-09-23,Female,69,65-69,27
27,0,0,0,0,2021-09-27,Male,40,35-44,1
27,1,2,0,3,2021-09-23,Male,67,65-69,7
27,0,2,0,2,2021-09-28,Female,37,35-44,1
27,1,0,0,1,2021-10-06,Female,59,55-64,1
27,1,0,0,1,2021-09-25,Male,65,65-69,4
27,0,0,0,0,2021-09-24,Male,45,45-54,3
27,1,0,0,1,2021-09-22,Male,77,75-79,6
27,0,0,0,0,2021-09-23,Male,61,55-64,21
27,0,0,0,0,2021-09-24,Male,27,25-34,3
27,0,0,0,0,2021-09-23,Male,44,35-44,2
27,1,0,0,1,2021-09-27,Male,53,45-54,1
27,0,0,0,0,2021-09-23,Male,31,25-34,19
27,1,1,0,2,2021-09-28,Female,73,70-74,1
27,0,0,0,0,2021-09-28,Male,53,45-54,1
27,0,0,0,0,2021-10-06,Male,61,55-64,1
27,0,3,0,3,2021-10-06,Female,42,35-44,1
27,1,2,0,3,2021-09-27,Female,67,65-69,1
27,2,0,0,2,2021-09-23,Female,67,65-69,20
27,0,0,0,0,2021-09-23,Female,41,35-44,14
27,1,0,0,1,2021-09-24,Male,65,65-69,7
27,1,1,0,2,2021-09-23,Male,69,65-69,25
27,0,2,0,2,2021-09-24,Female,57,55-64,26
27,0,2,0,2,2021-09-24,Female,62,55-64,6
27,1,6,0,7,2021-09-24,Male,11,10-14,7
27,3,1,0,4,2021-09-23,Female,54,45-54,20
27,1,5,0,6,2021-09-23,Female,67,65-69,5
27,3,0,0,3,2021-09-24,Male,8,5-9,21
27,1,0,0,1,2021-09-24,Male,38,35-44,6
27,0,1,0,1,2021-09-23,Female,54,45-54,19
27,0,0,0,0,2021-09-23,Female,55,55-64,18
27,0,0,0,0,2021-09-23,Female,60,55-64,27
27,0,0,0,0,2021-09-27,Male,52,45-54,1
27,1,0,0,1,2021-09-23,Female,33,25-34,2
27,3,0,0,3,2021-09-23,Male,2,1-4,7
27,0,0,0,0,2021-09-27,Female,39,35-44,1
27,2,0,0,2,2021-09-23,Female,68,65-69,2
27,0,0,0,0,2021-10-06,Male,63,55-64,1
27,1,2,0,3,2021-09-23,Male,63,55-64,5
27,2,0,0,2,2021-09-22,Male,72,70-74,6
27,0,2,0,2,2021-09-23,Male,58,55-64,6
27,4,0,0,4,2021-09-26,Female,55,55-64,21
27,0,1,0,1,2021-09-27,Female,70,70-74,1
27,0,32,0,32,2021-10-06,Female,56,55-64,1
27,0,1,0,1,2021-09-23,Male,66,65-69,7
27,1,0,0,1,2021-09-23,Male,59,55-64,5
27,0,0,0,0,2021-09-23,Female,21,20-24,7
27,1,0,0,1,2021-09-23,Female,61,55-64,26
27,4,0,0,4,2021-09-23,Male,16,15-19,5
27,1,0,0,1,2021-09-23,Male,48,45-54,18
27,0,2,0,2,2021-09-23,Female,55,55-64,21
27,1,0,0,1,2021-09-27,Male,50,45-54,1
27,0,2,0,2,2021-09-28,Male,37,35-44,1
27,0,1,0,1,2021-09-22,Male,83,80-84,2
27,0,0,0,0,2021-09-23,Female,26,25-34,5
27,1,0,0,1,2021-09-27,Female,37,35-44,1
27,1,0,0,1,2021-09-27,Male,62,55-64,18
27,2,0,0,2,2021-09-23,Male,4,1-4,7
27,1,1,0,2,2021-09-23,Female,52,45-54,25
27,1,1,0,2,2021-09-23,Male,65,65-69,6
27,1,5,0,6,2021-09-24,Female,69,65-69,3
27,3,0,0,3,2021-09-23,Male,70,70-74,19
27,3,0,0,3,2021-09-27,Male,56,55-64,1
27,1,0,0,1,2021-09-23,Male,70,70-74,2
27,3,0,0,3,2021-09-23,Female,5,5-9,2
27,0,0,0,0,2021-09-23,Female,25,25-34,3
27,2,2,0,4,2021-09-23,Female,68,65-69,14
27,0,4,0,4,2021-10-06,Male,60,55-64,1
27,2,1,0,3,2021-09-24,Male,52,45-54,20
27,0,0,0,0,2021-09-23,Male,56,55-64,7
27,1,1,0,2,2021-09-24,Male,70,70-74,20
27,1,0,0,1,2021-09-23,Male,65,65-69,3
27,2,0,0,2,2021-09-27,Male,52,45-54,1
27,1,0,0,1,2021-09-22,Male,81,80-84,4
27,1,1,0,2,2021-09-27,Female,41,35-44,7
27,0,1,0,1,2021-09-24,Female,70,70-74,7
27,2,0,0,2,2021-09-24,Female,67,65-69,2
27,1,0,0,1,2021-09-26,Female,66,65-69,26
27,0,1,0,1,2021-09-23,Female,69,65-69,2
27,0,2,0,2,2021-10-06,Female,54,45-54,1
27,0,0,0,0,2021-09-23,Male,36,35-44,4
27,3,0,0,3,2021-09-26,Female,13,10-14,10
27,0,3,0,3,2021-09-23,Male,33,25-34,4
27,4,0,0,4,2021-09-28,Male,12,10-14,12
27,1,0,0,1,2021-10-06,Female,42,35-44,1
27,0,10,0,10,2021-09-23,Male,47,45-54,2
27,3,1,0,4,2021-09-27,Female,14,10-14,1
27,3,2,30,35,2021-10-06,Male,11,10-14,1
27,0,0,0,0,2021-09-23,Male,72,70-74,4
27,1,11,0,12,2021-09-25,Male,54,45-54,4
27,1,0,0,1,2021-09-23,Female,52,45-54,7
27,1,0,0,1,2021-09-28,Male,47,45-54,1
27,1,0,3,4,2021-09-23,Female,49,45-54,18
27,0,0,0,0,2021-09-26,Male,60,55-64,20
27,0,0,0,0,2021-09-23,Female,56,55-64,24
27,0,0,0,0,2021-09-23,Male,65,65-69,23
27,3,1,0,4,2021-10-06,Male,66,65-69,1
27,2,4,0,6,2021-09-23,Female,48,45-54,6
27,1,10,0,11,2021-09-23,Male,19,15-19,14
27,2,0,0,2,2021-09-23,Male,64,55-64,21
27,1,1,0,2,2021-09-23,Male,52,45-54,18
27,1,1,0,2,2021-10-06,Male,18,15-19,6
27,2,8,12,22,2021-09-24,Male,12,10-14,3
27,1,0,0,1,2021-10-06,Male,57,55-64,1
27,1,0,0,1,2021-09-23,Female,74,70-74,17
27,1,8,0,9,2021-09-28,Male,67,65-69,1
27,0,0,0,0,2021-09-28,Female,54,45-54,1
27,4,0,0,4,2021-10-06,Male,17,15-19,1
27,1,5,0,6,2021-09-23,Female,17,15-19,23
27,0,5,1,6,2021-09-26,Male,62,55-64,23
27,2,1,0,3,2021-09-23,Male,18,15-19,14
27,0,0,0,0,2021-09-28,Male,55,55-64,2
27,1,4,0,5,2021-09-23,Male,51,45-54,14
27,1,4,0,5,2021-09-27,Female,44,35-44,1
27,0,5,0,5,2021-09-23,Female,69,65-69,3
27,0,0,0,0,2021-09-28,Female,44,35-44,1
27,2,0,0,2,2021-09-23,Male,66,65-69,2
27,1,0,0,1,2021-10-06,Male,59,55-64,1
27,3,0,0,3,2021-09-28,Male,16,15-19,1
27,1,0,0,1,2021-09-23,Male,16,15-19,3
27,1,1,0,2,2021-09-23,Male,52,45-54,13
27,4,0,0,4,2021-09-28,Male,2,1-4,2
27,1,0,0,1,2021-09-23,Male,65,65-69,7
27,1,4,0,5,2021-09-25,Female,23,20-24,3
27,1,0,0,1,2021-09-23,Male,54,45-54,22
27,0,0,0,0,2021-09-27,Female,60,55-64,1
27,0,2,0,2,2021-09-23,Male,57,55-64,3
27,2,0,0,2,2021-09-23,Female,66,65-69,25
27,1,2,3,6,2021-09-23,Male,70,70-74,3
27,1,0,0,1,2021-09-22,Male,79,75-79,14
27,0,2,0,2,2021-09-28,Male,45,45-54,1
27,1,1,1,3,2021-09-28,Female,72,70-74,1
27,0,2,0,2,2021-09-23,Male,64,55-64,7
27,0,1,0,1,2021-09-23,Male,19,15-19,16
27,0,0,0,0,2021-10-06,Male,81,80-84,1
27,0,2,0,2,2021-09-23,Male,53,45-54,22
27,1,0,0,1,2021-09-23,Female,62,55-64,7
27,1,0,0,1,2021-10-06,Female,64,55-64,1
27,1,0,0,1,2021-09-23,Female,51,45-54,20
27,3,0,0,3,2021-09-23,Male,14,10-14,26
27,1,2,0,3,2021-09-23,Female,65,65-69,2
27,2,2,0,4,2021-09-23,Female,58,55-64,2
27,2,0,0,2,2021-09-27,Female,12,10-14,1
27,0,20,0,20,2021-09-25,Male,41,35-44,20
27,0,0,0,0,2021-10-06,Female,80,80-84,1
27,1,0,0,1,2021-09-27,Male,72,70-74,1
27,2,0,0,2,2021-09-27,Female,24,20-24,4
27,1,0,0,1,2021-09-23,Female,51,45-54,7
27,0,1,16,17,2021-09-24,Female,34,25-34,3
27,0,0,0,0,2021-09-28,Female,42,35-44,1
27,5,1,0,6,2021-09-28,Female,60,55-64,1
27,0,1,0,1,2021-10-06,Male,59,55-64,1
27,1,9,0,10,2021-09-22,Male,72,70-74,2
27,0,0,0,0,2021-09-23,Male,68,65-69,7
27,0,0,0,0,2021-09-22,Male,64,55-64,16
27,0,0,0,0,2021-09-23,Male,38,35-44,23
27,0,0,0,0,2021-09-23,Male,65,65-69,2
27,1,0,0,1,2021-09-27,Female,51,45-54,1
27,1,0,0,1,2021-09-23,Female,64,55-64,20
27,1,4,0,5,2021-09-28,Male,65,65-69,1
27,0,0,0,0,2021-09-24,Female,68,65-69,26
27,1,4,0,5,2021-09-23,Male,59,55-64,7
27,0,0,0,0,2021-09-23,Female,44,35-44,18
27,0,1,0,1,2021-09-24,Male,65,65-69,7
27,1,0,0,1,2021-09-23,Male,46,45-54,7
27,0,0,0,0,2021-09-23,Female,68,65-69,24
27,1,0,4,5,2021-09-23,Female,33,25-34,2
27,1,1,0,2,2021-09-23,Male,38,35-44,12
27,0,0,0,0,2021-09-23,Female,38,35-44,17
27,0,0,0,0,2021-09-25,Female,7,5-9,12
27,0,1,0,1,2021-09-23,Male,46,45-54,2
27,1,0,0,1,2021-10-06,Male,61,55-64,1
27,0,0,0,0,2021-09-28,Female,65,65-69,1
27,0,0,0,0,2021-10-06,Female,69,65-69,1
27,1,0,0,1,2021-09-23,Female,52,45-54,26
27,2,0,0,2,2021-09-24,Female,50,45-54,3
27,1,3,0,4,2021-10-06,Female,49,45-54,3
27,1,0,0,1,2021-09-27,Male,52,45-54,1
27,1,0,0,1,2021-09-23,Male,67,65-69,18
27,2,0,0,2,2021-09-23,Female,63,55-64,24
27,0,6,0,6,2021-09-24,Female,52,45-54,19
27,1,0,0,1,2021-09-24,Male,62,55-64,7
27,0,9,0,9,2021-10-06,Male,72,70-74,1
27,0,0,0,0,2021-09-23,Female,67,65-69,21
27,1,4,0,5,2021-09-23,Female,26,25-34,3
27,0,0,0,0,2021-09-28,Male,63,55-64,1
27,2,4,2,8,2021-10-06,Male,69,65-69,1
27,1,0,0,1,2021-09-22,Male,79,75-79,22
27,4,6,0,10,2021-09-23,Female,12,10-14,7
27,2,6,0,8,2021-09-23,Female,14,10-14,20
27,1,1,0,2,2021-09-26,Male,44,35-44,15
27,1,0,0,1,2021-09-24,Male,31,25-34,7
27,3,0,0,3,2021-09-27,Female,10,10-14,2
27,2,0,0,2,2021-09-23,Male,69,65-69,24
27,1,1,20,22,2021-09-24,Female,56,55-64,23
27,2,0,0,2,2021-09-23,Female,62,55-64,18
27,0,0,0,0,2021-09-28,Female,68,65-69,1
27,1,0,0,1,2021-09-24,Female,62,55-64,22
27,1,0,0,1,2021-10-06,Female,66,65-69,1
27,0,13,0,13,2021-09-27,Female,59,55-64,1
27,2,0,0,2,2021-09-28,Female,48,45-54,7
27,1,0,0,1,2021-09-23,Male,65,65-69,6
27,0,3,0,3,2021-09-23,Female,30,25-34,6
27,2,0,0,2,2021-09-22,Male,74,70-74,24
27,0,0,0,0,2021-09-27,Female,40,35-44,2
27,2,0,0,2,2021-09-23,Male,55,55-64,22
27,1,0,6,7,2021-09-28,Male,71,70-74,5
27,0,2,0,2,2021-09-24,Female,67,65-69,22
27,1,0,0,1,2021-09-23,Male,53,45-54,7
27,3,1,0,4,2021-10-06,Male,66,65-69,1
27,1,0,0,1,2021-09-23,Male,66,65-69,7
27,1,0,0,1,2021-10-06,Male,50,45-54,1
27,0,0,0,0,2021-09-23,Male,13,10-14,12
27,1,0,0,1,2021-09-22,Male,72,70-74,2
27,0,1,0,1,2021-09-23,Female,72,70-74,23
27,2,0,0,2,2021-09-24,Female,72,70-74,23
27,0,0,0,0,2021-10-06,Male,73,70-74,1
27,3,0,0,3,2021-09-23,Female,59,55-64,23
27,0,2,0,2,2021-09-28,Female,68,65-69,1
27,0,1,0,1,2021-09-22,Male,80,80-84,2
27,2,1,0,3,2021-09-27,Female,65,65-69,1
27,2,0,0,2,2021-09-23,Female,1,1-4,18
27,0,0,0,0,2021-09-23,Female,52,45-54,18
27,1,0,0,1,2021-09-28,Female,71,70-74,1
27,0,0,0,0,2021-10-06,Male,57,55-64,1
27,3,0,0,3,2021-10-06,Female,13,10-14,1
27,1,0,0,1,2021-10-06,Female,61,55-64,1
27,0,2,0,2,2021-09-28,Male,65,65-69,1
27,1,20,0,21,2021-09-25,Male,9,5-9,3
27,0,0,0,0,2021-09-23,Female,44,35-44,6
27,0,0,0,0,2021-09-28,Female,66,65-69,1
27,0,0,0,0,2021-09-24,Female,37,35-44,25
27,3,0,0,3,2021-09-23,Female,7,5-9,23
27,1,2,0,3,2021-09-23,Male,55,55-64,23
27,1,1,0,2,2021-09-28,Female,50,45-54,1
27,1,0,0,1,2021-09-23,Male,64,55-64,7
27,2,4,0,6,2021-09-24,Female,32,25-34,2
27,2,1,0,3,2021-09-23,Male,63,55-64,23
27,1,0,0,1,2021-09-24,Female,57,55-64,22
27,0,0,0,0,2021-09-27,Male,51,45-54,1
27,2,0,0,2,2021-09-23,Female,30,25-34,3
27,3,30,0,33,2021-09-23,Male,14,10-14,14
27,0,5,2,7,2021-09-22,Male,74,70-74,23
27,0,0,0,0,2021-09-24,Male,49,45-54,2
27,0,2,0,2,2021-10-06,Female,43,35-44,1
27,1,2,0,3,2021-09-23,Male,55,55-64,7
27,1,23,0,24,2021-09-23,Male,71,70-74,3
27,0,0,0,0,2021-09-27,Female,53,45-54,1
27,0,0,0,0,2021-09-23,Female,38,35-44,22
27,1,0,1,2,2021-09-28,Male,68,65-69,1
27,1,0,0,1,2021-09-23,Male,59,55-64,7
27,2,10,0,12,2021-09-23,Male,53,45-54,2
27,1,10,0,11,2021-09-24,Male,68,65-69,5
27,1,0,0,1,2021-09-28,Female,77,75-79,1
27,0,0,0,0,2021-09-23,Male,62,55-64,3
27,3,0,12,15,2021-09-23,Male,39,35-44,1
27,2,0,0,2,2021-09-23,Female,13,10-14,18
27,0,0,0,0,2021-09-23,Male,67,65-69,20
27,1,0,0,1,2021-09-26,Male,44,35-44,3
27,1,0,0,1,2021-09-23,Female,61,55-64,24
27,0,8,0,8,2021-09-23,Male,34,25-34,6
27,1,0,0,1,2021-09-24,Female,67,65-69,19
27,1,1,0,2,2021-09-23,Male,67,65-69,22
27,4,0,0,4,2021-09-27,Male,7,5-9,1
27,2,0,0,2,2021-09-28,Female,13,10-14,21
27,4,0,0,4,2021-09-27,Male,23,20-24,5
27,0,0,0,0,2021-09-28,Male,51,45-54,1
27,1,0,0,1,2021-09-23,Male,58,55-64,2
27,0,0,0,0,2021-09-27,Male,42,35-44,1
27,0,2,0,2,2021-09-25,Female,52,45-54,19
27,1,0,0,1,2021-09-23,Male,42,35-44,4
27,1,0,0,1,2021-09-23,Male,53,45-54,7
27,0,0,0,0,2021-09-23,Female,66,65-69,7
27,1,0,0,1,2021-09-27,Female,67,65-69,7
27,1,11,0,12,2021-09-23,Male,66,65-69,26
27,1,0,0,1,2021-09-28,Male,71,70-74,1
27,1,0,0,1,2021-09-26,Female,31,25-34,2
27,0,1,0,1,2021-09-23,Male,32,25-34,21
27,1,1,0,2,2021-09-23,Female,66,65-69,7
27,0,2,0,2,2021-09-23,Female,71,70-74,6
27,1,6,0,7,2021-09-25,Female,45,45-54,3
27,1,0,0,1,2021-09-24,Female,14,10-14,18
27,0,2,0,2,2021-09-26,Female,25,25-34,19
27,0,0,0,0,2021-09-23,Male,36,35-44,3
27,0,2,0,2,2021-09-23,Female,76,75-79,25
27,2,0,0,2,2021-09-26,Female,10,10-14,7
27,2,0,0,2,2021-09-24,Male,33,25-34,22
27,2,1,0,3,2021-09-23,Female,19,15-19,3
27,1,2,0,3,2021-09-23,Male,57,55-64,2
27,0,0,0,0,2021-10-06,Male,71,70-74,3
27,1,0,0,1,2021-09-23,Female,64,55-64,16
27,0,2,0,2,2021-09-24,Female,69,65-69,11
27,1,0,0,1,2021-09-23,Female,52,45-54,2
27,1,3,0,4,2021-09-23,Male,66,65-69,25
27,1,0,0,1,2021-09-23,Female,61,55-64,7
27,2,0,0,2,2021-09-24,Female,16,15-19,27
27,3,2,0,5,2021-09-28,Female,0,<1,5
27,1,0,0,1,2021-09-27,Female,47,45-54,1
27,0,1,0,1,2021-09-28,Female,65,65-69,1
27,2,2,0,4,2021-09-26,Female,14,10-14,7
27,0,0,0,0,2021-09-23,Male,46,45-54,7
27,2,3,0,5,2021-09-24,Male,1,1-4,8
27,2,0,0,2,2021-09-24,Female,6,5-9,6
27,0,0,0,0,2021-09-23,Male,30,25-34,9
27,0,0,0,0,2021-10-06,Male,72,70-74,1
27,2,0,0,2,2021-09-23,Male,66,65-69,23
27,0,0,0,0,2021-09-25,Male,38,35-44,16
27,1,3,0,4,2021-09-23,Male,51,45-54,3
27,0,3,0,3,2021-09-23,Male,67,65-69,2
27,0,1,0,1,2021-09-28,Female,72,70-74,1
27,0,3,15,18,2021-09-23,Female,54,45-54,2
27,1,0,0,1,2021-09-24,Female,66,65-69,7
27,2,0,0,2,2021-10-06,Male,60,55-64,1
27,0,2,0,2,2021-10-06,Male,58,55-64,1
27,0,0,0,0,2021-09-24,Female,44,35-44,3
27,1,1,0,2,2021-09-24,Male,68,65-69,15
27,0,0,0,0,2021-09-23,Female,53,45-54,3
27,1,0,0,1,2021-09-22,Male,77,75-79,2
27,1,0,0,1,2021-09-23,Female,70,70-74,2
27,0,0,0,0,2021-10-06,Male,70,70-74,1
27,2,1,0,3,2021-10-06,Female,49,45-54,1
27,2,9,0,11,2021-09-27,Female,62,55-64,1
27,1,0,0,1,2021-09-28,Male,48,45-54,1
27,0,0,0,0,2021-09-23,Male,75,75-79,10
27,0,0,0,0,2021-09-28,Female,49,45-54,1
27,1,0,0,1,2021-09-23,Female,49,45-54,25
27,3,0,0,3,2021-09-27,Female,11,10-14,1
27,3,2,0,5,2021-09-23,Female,8,5-9,3
27,1,0,0,1,2021-09-26,Female,41,35-44,5
27,1,0,0,1,2021-09-22,Male,63,55-64,2
27,0,0,0,0,2021-09-24,Female,74,70-74,17
27,1,0,0,1,2021-09-23,Female,66,65-69,5
27,1,3,0,4,2021-09-24,Male,56,55-64,2
27,0,0,0,0,2021-09-23,Female,67,65-69,7
27,1,0,0,1,2021-09-23,Male,65,65-69,19
27,3,2,0,5,2021-09-23,Male,31,25-34,16
27,0,0,0,0,2021-09-23,Female,67,65-69,5
27,1,0,0,1,2021-09-28,Male,59,55-64,1
27,1,4,0,5,2021-09-23,Female,49,45-54,2
27,2,2,0,4,2021-10-06,Male,69,65-69,1
27,1,1,0,2,2021-09-23,Male,41,35-44,24
27,1,0,0,1,2021-09-27,Male,64,55-64,1
27,1,1,0,2,2021-10-06,Male,66,65-69,2
27,1,0,0,1,2021-09-28,Male,52,45-54,1
27,0,12,0,12,2021-09-28,Female,41,35-44,1
27,1,0,0,1,2021-09-23,Male,27,25-34,2
27,0,0,0,0,2021-09-25,Female,32,25-34,4
27,1,0,0,1,2021-09-23,Male,68,65-69,25
27,1,2,0,3,2021-09-27,Male,73,70-74,1
27,0,0,0,0,2021-09-23,Male,26,25-34,4
27,0,2,0,2,2021-09-22,Female,73,70-74,2
27,3,1,0,4,2021-09-27,Male,7,5-9,1
27,2,0,0,2,2021-09-23,Female,36,35-44,8
27,1,2,0,3,2021-10-05,Female,25,25-34,14
27,2,2,0,4,2021-09-23,Female,13,10-14,21
27,0,0,0,0,2021-09-28,Male,70,70-74,1
27,2,0,0,2,2021-09-23,Female,61,55-64,23
27,0,0,0,0,2021-09-23,Male,38,35-44,4
27,1,4,0,5,2021-09-23,Female,28,25-34,6
27,0,0,0,0,2021-10-06,Male,61,55-64,1
27,0,5,0,5,2021-09-27,Female,57,55-64,1
27,2,0,0,2,2021-09-28,Male,10,10-14,1
27,3,24,0,27,2021-10-06,Male,5,5-9,1
27,2,2,0,4,2021-09-28,Male,1,1-4,1
27,1,1,0,2,2021-09-23,Male,1,1-4,17
27,1,0,0,1,2021-09-28,Female,41,35-44,1
27,0,0,0,0,2021-09-27,Male,72,70-74,1
27,1,0,0,1,2021-09-28,Male,46,45-54,19
27,0,0,0,0,2021-09-23,Male,58,55-64,25
27,1,1,0,2,2021-09-22,Male,72,70-74,2
27,2,1,0,3,2021-09-23,Male,64,55-64,26
27,0,0,0,0,2021-09-24,Male,66,65-69,6
27,0,0,0,0,2021-09-24,Female,33,25-34,3
27,1,89,0,90,2021-09-23,Male,53,45-54,22
27,2,0,0,2,2021-09-23,Male,51,45-54,25
27,1,1,0,2,2021-09-23,Female,68,65-69,25
27,2,0,0,2,2021-09-23,Male,59,55-64,24
27,1,0,0,1,2021-09-24,Female,65,65-69,7
27,0,0,0,0,2021-09-23,Male,34,25-34,24
27,0,0,0,0,2021-09-24,Female,32,25-34,5
27,0,0,0,0,2021-09-28,Female,68,65-69,1
27,3,2,0,5,2021-09-24,Male,7,5-9,10
27,1,0,0,1,2021-09-27,Female,60,55-64,1
27,1,3,0,4,2021-09-23,Male,69,65-69,2
27,1,1,0,2,2021-10-06,Male,67,65-69,1
27,1,1,0,2,2021-09-23,Female,54,45-54,6
27,1,2,0,3,2021-09-23,Male,69,65-69,27
27,2,1,0,3,2021-09-27,Male,18,15-19,1
27,2,0,0,2,2021-09-22,Male,77,75-79,20
27,0,0,0,0,2021-09-23,Male,68,65-69,7
27,0,0,0,0,2021-09-23,Male,37,35-44,7
27,0,4,10,14,2021-09-28,Female,70,70-74,1
27,0,0,0,0,2021-10-06,Female,73,70-74,1
27,1,1,0,2,2021-09-23,Female,34,25-34,2
27,2,0,0,2,2021-09-28,Female,14,10-14,1
27,2,1,0,3,2021-09-23,Female,30,25-34,3
27,1,0,0,1,2021-09-28,Male,80,80-84,1
27,5,0,0,5,2021-09-23,Female,18,15-19,25
27,2,6,0,8,2021-09-28,Male,8,5-9,1
27,1,0,0,1,2021-09-23,Male,71,70-74,2
27,1,0,0,1,2021-09-23,Male,70,70-74,8
27,2,0,0,2,2021-09-27,Male,10,10-14,23
27,1,1,0,2,2021-09-24,Male,48,45-54,7
27,1,1,0,2,2021-09-22,Female,72,70-74,6
27,1,1,0,2,2021-09-22,Male,77,75-79,7
27,0,4,0,4,2021-09-23,Female,65,65-69,2
27,2,0,0,2,2021-09-23,Male,24,20-24,18
27,0,0,0,0,2021-09-23,Female,56,55-64,7
27,3,3,0,6,2021-09-24,Male,53,45-54,7
27,0,1,0,1,2021-09-23,Female,68,65-69,6
27,1,5,0,6,2021-09-22,Male,75,75-79,2
27,0,0,0,0,2021-09-23,Male,51,45-54,7
27,0,0,0,0,2021-09-23,Female,34,25-34,6
27,2,0,0,2,2021-09-23,Male,65,65-69,7
27,0,2,0,2,2021-09-27,Female,46,45-54,1
27,0,3,0,3,2021-09-23,Male,50,45-54,23
27,0,0,0,0,2021-09-24,Male,27,25-34,4
27,1,0,0,1,2021-09-23,Female,59,55-64,2
27,1,0,0,1,2021-09-23,Female,2,1-4,5
27,0,0,0,0,2021-09-24,Female,19,15-19,7
27,0,1,0,1,2021-09-23,Female,44,35-44,2
27,2,0,0,2,2021-09-23,Male,0,<1,6
27,0,0,0,0,2021-09-23,Male,46,45-54,23
27,0,1,0,1,2021-09-23,Female,66,65-69,22
27,0,0,0,0,2021-09-23,Male,69,65-69,5
27,0,0,0,0,2021-09-22,Female,77,75-79,13
27,3,3,31,37,2021-09-23,Male,14,10-14,7
27,2,2,2,6,2021-09-24,Female,71,70-74,7
27,1,0,0,1,2021-09-28,Male,71,70-74,1
27,1,0,0,1,2021-10-06,Male,61,55-64,1
27,1,5,0,6,2021-09-27,Female,59,55-64,1
27,1,1,0,2,2021-09-23,Female,61,55-64,2
27,1,1,0,2,2021-10-06,Male,63,55-64,1
27,2,0,0,2,2021-09-24,Male,40,35-44,6
27,1,0,0,1,2021-09-23,Male,72,70-74,2
27,3,0,0,3,2021-09-23,Male,2,1-4,2
27,3,0,0,3,2021-09-23,Female,11,10-14,16
27,0,11,0,11,2021-09-23,Female,65,65-69,2
27,1,0,0,1,2021-10-06,Male,65,65-69,1
27,0,0,0,0,2021-09-23,Male,19,15-19,18
27,2,0,0,2,2021-09-23,Female,68,65-69,17
27,3,1,21,25,2021-10-06,Female,12,10-14,1
27,0,1,0,1,2021-09-24,Female,70,70-74,25
27,1,0,0,1,2021-09-28,Male,73,70-74,1
27,0,5,0,5,2021-10-06,Female,56,55-64,1
27,0,2,0,2,2021-09-28,Male,48,45-54,1
27,1,0,0,1,2021-10-06,Male,56,55-64,1
27,0,0,0,0,2021-09-23,Female,42,35-44,5
27,1,0,0,1,2021-10-06,Male,56,55-64,1
27,1,0,0,1,2021-09-23,Male,30,25-34,4
27,1,0,0,1,2021-09-26,Female,19,15-19,6
27,1,0,0,1,2021-09-27,Male,6,5-9,1
27,0,1,0,1,2021-09-23,Male,47,45-54,4
27,1,1,2,4,2021-09-26,Male,70,70-74,6
27,2,3,0,5,2021-09-24,Female,55,55-64,22
27,0,4,0,4,2021-09-26,Female,28,25-34,16
27,0,0,0,0,2021-09-26,Female,38,35-44,20
27,1,0,0,1,2021-09-27,Female,64,55-64,6
27,0,0,0,0,2021-09-28,Female,67,65-69,1
27,0,0,0,0,2021-09-22,Female,79,75-79,7
27,1,1,0,2,2021-09-23,Female,34,25-34,2
27,2,0,0,2,2021-09-23,Male,68,65-69,16
27,1,3,0,4,2021-09-28,Female,74,70-74,1
27,0,0,0,0,2021-09-27,Male,72,70-74,1
27,1,3,1,5,2021-09-28,Male,71,70-74,1
27,1,1,0,2,2021-09-23,Female,69,65-69,7
27,0,0,0,0,2021-09-23,Male,49,45-54,23
27,0,4,0,4,2021-09-28,Female,51,45-54,1
27,2,0,0,2,2021-10-06,Female,49,45-54,1
27,1,2,0,3,2021-09-24,Female,33,25-34,3
27,0,0,0,0,2021-10-06,Female,67,65-69,1
27,1,0,0,1,2021-09-28,Male,49,45-54,1
27,1,1,0,2,2021-10-06,Male,77,75-79,1
27,1,0,0,1,2021-09-30,Female,34,25-34,6
27,0,0,0,0,2021-09-24,Male,53,45-54,7
27,0,1,0,1,2021-09-24,Female,33,25-34,2
27,0,0,0,0,2021-09-23,Female,51,45-54,7
27,1,0,0,1,2021-09-24,Female,54,45-54,6
27,1,9,0,10,2021-09-23,Male,53,45-54,5
27,1,0,0,1,2021-09-23,Male,54,45-54,2
27,3,0,0,3,2021-09-28,Female,14,10-14,1
27,1,3,0,4,2021-09-22,Male,59,55-64,6
27,1,20,46,67,2021-09-27,Male,13,10-14,1
27,2,0,0,2,2021-09-23,Male,69,65-69,24
27,0,0,0,0,2021-09-23,Male,45,45-54,7
27,2,0,0,2,2021-09-26,Female,48,45-54,23
27,3,0,0,3,2021-09-23,Female,4,1-4,4
27,1,0,3,4,2021-10-06,Male,74,70-74,1
27,0,3,0,3,2021-09-23,Male,57,55-64,7
27,1,0,0,1,2021-09-24,Female,71,70-74,15
27,2,0,0,2,2021-09-26,Female,21,20-24,16
27,2,3,0,5,2021-09-27,Male,12,10-14,1
27,2,0,0,2,2021-09-23,Male,13,10-14,2
27,0,0,0,0,2021-09-24,Male,48,45-54,20
27,2,2,0,4,2021-09-23,Female,67,65-69,21
27,0,0,0,0,2021-09-28,Male,46,45-54,1
27,0,0,0,0,2021-09-23,Male,51,45-54,27
27,0,0,0,0,2021-09-28,Male,69,65-69,1
27,1,0,0,1,2021-09-28,Female,53,45-54,1
27,1,0,0,1,2021-09-27,Male,74,70-74,1
27,0,0,0,0,2021-09-24,Male,46,45-54,7
27,1,2,0,3,2021-10-06,Male,70,70-74,1
27,3,1,0,4,2021-09-24,Male,8,5-9,4
27,1,0,0,1,2021-10-06,Male,67,65-69,1
27,2,0,0,2,2021-09-23,Male,59,55-64,2
27,2,0,0,2,2021-09-23,Male,60,55-64,24
27,1,0,0,1,2021-09-23,Male,62,55-64,7
27,1,0,0,1,2021-10-06,Male,70,70-74,1
27,0,0,0,0,2021-09-23,Female,31,25-34,4
27,0,1,0,1,2021-10-06,Female,40,35-44,1
27,0,0,0,0,2021-09-23,Male,48,45-54,2
27,2,0,0,2,2021-09-24,Male,66,65-69,17
27,0,0,0,0,2021-09-23,Male,43,35-44,23
27,0,0,0,0,2021-09-23,Female,32,25-34,12
27,2,9,0,11,2021-09-28,Female,18,15-19,1
27,0,1,0,1,2021-09-23,Female,66,65-69,7
27,2,1,15,18,2021-09-23,Female,80,80-84,20
27,1,3,0,4,2021-09-27,Male,69,65-69,1
27,1,0,0,1,2021-09-28,Male,72,70-74,1
27,1,0,0,1,2021-09-23,Female,70,70-74,25
27,1,4,0,5,2021-09-24,Male,71,70-74,25
27,1,0,0,1,2021-09-23,Female,66,65-69,7
27,0,0,0,0,2021-09-23,Female,61,55-64,7
27,1,3,0,4,2021-09-23,Female,53,45-54,6
27,1,0,0,1,2021-09-24,Female,49,45-54,4
27,0,0,0,0,2021-09-23,Male,10,10-14,18
27,0,0,0,0,2021-09-24,Male,26,25-34,2
27,1,0,2,3,2021-09-23,Female,70,70-74,7
27,0,0,0,0,2021-09-23,Male,67,65-69,15
27,2,0,0,2,2021-09-23,Male,54,45-54,4
27,1,0,0,1,2021-09-26,Female,52,45-54,2
27,0,0,0,0,2021-10-06,Female,43,35-44,1
27,2,0,0,2,2021-09-23,Female,11,10-14,23
27,0,0,0,0,2021-09-26,Male,44,35-44,2
27,0,0,0,0,2021-09-24,Male,14,10-14,23
27,1,6,0,7,2021-10-06,Female,36,35-44,1
27,0,1,0,1,2021-09-23,Male,35,35-44,25
27,0,0,0,0,2021-09-23,Male,50,45-54,2
27,2,0,0,2,2021-09-24,Female,11,10-14,2
27,0,1,0,1,2021-09-23,Male,49,45-54,2
27,2,0,0,2,2021-09-23,Male,20,20-24,23
28,0,0,0,0,2021-10-08,Male,65,65-69,5
28,0,0,0,0,2021-10-12,Female,53,45-54,3
28,2,0,0,2,2021-10-19,Female,34,25-34,1
28,3,20,0,23,2021-10-19,Female,8,5-9,1
28,1,0,0,1,2021-10-12,Male,53,45-54,1
28,2,0,0,2,2021-10-08,Female,27,25-34,2
28,2,1,0,3,2021-10-08,Male,14,10-14,9
28,1,2,0,3,2021-10-19,Male,68,65-69,1
28,3,0,0,3,2021-10-08,Male,2,1-4,5
28,2,0,0,2,2021-10-08,Male,65,65-69,8
28,0,10,0,10,2021-10-08,Female,49,45-54,8
28,0,0,0,0,2021-10-08,Male,60,55-64,3
28,1,0,0,1,2021-10-08,Female,56,55-64,4
28,0,2,0,2,2021-10-19,Female,33,25-34,1
28,2,0,0,2,2021-10-11,Female,3,1-4,9
28,1,0,0,1,2021-10-12,Male,70,70-74,1
28,1,4,0,5,2021-10-09,Male,72,70-74,8
28,0,0,0,0,2021-10-08,Female,33,25-34,5
28,1,0,0,1,2021-10-08,Male,70,70-74,2
28,0,3,1,4,2021-10-08,Female,42,35-44,2
28,1,0,0,1,2021-10-08,Male,14,10-14,3
28,0,0,0,0,2021-10-08,Male,41,35-44,2
28,0,0,0,0,2021-10-08,Female,54,45-54,19
28,1,6,0,7,2021-10-12,Female,57,55-64,1
28,2,0,0,2,2021-10-08,Male,5,5-9,4
28,2,0,0,2,2021-10-08,Female,58,55-64,7
28,2,0,3,5,2021-10-08,Male,19,15-19,2
28,1,3,0,4,2021-10-18,Male,76,75-79,1
28,1,0,0,1,2021-10-08,Female,68,65-69,7
28,1,1,0,2,2021-10-12,Female,74,70-74,1
28,1,5,0,6,2021-10-08,Female,67,65-69,2
28,2,8,0,10,2021-10-12,Female,48,45-54,1
28,0,0,0,0,2021-10-08,Male,52,45-54,8
28,1,4,0,5,2021-10-08,Female,54,45-54,3
28,2,2,0,4,2021-10-08,Male,50,45-54,2
28,1,0,0,1,2021-10-08,Male,82,80-84,2
28,3,0,0,3,2021-10-08,Male,8,5-9,6
28,1,5,0,6,2021-10-08,Male,58,55-64,2
28,0,3,0,3,2021-10-08,Female,66,65-69,7
28,2,0,0,2,2021-10-08,Female,13,10-14,21
28,0,1,0,1,2021-10-11,Female,41,35-44,6
28,1,0,0,1,2021-10-08,Male,25,25-34,2
28,3,0,0,3,2021-10-16,Female,6,5-9,3
28,3,0,6,9,2021-10-08,Male,11,10-14,2
28,0,0,0,0,2021-10-10,Male,43,35-44,18
28,3,0,0,3,2021-10-08,Female,55,55-64,6
28,1,3,0,4,2021-10-08,Male,57,55-64,7
28,1,0,0,1,2021-10-08,Male,58,55-64,2
28,1,0,0,1,2021-10-08,Male,53,45-54,3
28,1,0,0,1,2021-10-19,Male,79,75-79,1
28,1,0,0,1,2021-10-08,Female,57,55-64,8
28,3,0,0,3,2021-10-08,Male,6,5-9,3
28,0,0,0,0,2021-10-08,Male,34,25-34,2
28,1,3,0,4,2021-10-08,Female,62,55-64,8
28,1,1,0,2,2021-10-10,Male,65,65-69,6
28,1,0,0,1,2021-10-09,Female,10,10-14,17
28,0,0,0,0,2021-10-08,Male,50,45-54,5
28,1,0,0,1,2021-10-08,Female,54,45-54,3
28,1,0,0,1,2021-10-11,Male,35,35-44,7
28,2,0,0,2,2021-10-08,Female,37,35-44,2
28,1,0,0,1,2021-10-08,Male,77,75-79,7
28,0,3,0,3,2021-10-15,Female,66,65-69,4
28,1,0,0,1,2021-10-08,Female,50,45-54,2
28,1,0,0,1,2021-10-08,Female,31,25-34,3
28,0,0,0,0,2021-10-09,Male,56,55-64,2
28,0,0,0,0,2021-10-08,Male,42,35-44,25
28,0,3,0,3,2021-10-08,Female,79,75-79,7
28,0,0,0,0,2021-10-09,Female,56,55-64,2
28,1,0,0,1,2021-10-08,Female,57,55-64,5
28,1,1,0,2,2021-10-08,Female,33,25-34,2
28,1,3,0,4,2021-10-08,Female,67,65-69,2
28,4,0,0,4,2021-10-08,Female,8,5-9,4
28,0,2,0,2,2021-10-13,Female,67,65-69,12
28,1,0,0,1,2021-10-08,Female,33,25-34,4
28,3,0,0,3,2021-10-08,Male,1,1-4,13
28,0,1,0,1,2021-10-08,Male,54,45-54,13
28,0,0,0,0,2021-10-08,Male,62,55-64,4
28,0,4,0,4,2021-10-09,Female,40,35-44,2
28,0,0,0,0,2021-10-09,Female,70,70-74,8
28,0,0,0,0,2021-10-08,Male,41,35-44,4
28,1,1,0,2,2021-10-08,Female,69,65-69,3
28,1,8,0,9,2021-10-08,Male,70,70-74,3
28,1,0,0,1,2021-10-08,Female,50,45-54,3
28,0,0,0,0,2021-10-08,Male,61,55-64,2
28,0,0,0,0,2021-10-08,Female,56,55-64,2
28,1,0,0,1,2021-10-08,Female,45,45-54,3
28,2,0,0,2,2021-10-10,Female,53,45-54,2
28,1,0,0,1,2021-10-12,Female,51,45-54,1
28,1,1,0,2,2021-10-08,Female,12,10-14,6
28,0,1,0,1,2021-10-08,Female,78,75-79,2
28,0,0,0,0,2021-10-19,Male,53,45-54,22
28,1,0,0,1,2021-10-19,Male,70,70-74,1
28,1,0,0,1,2021-10-08,Female,38,35-44,7
28,0,0,0,0,2021-10-08,Female,39,35-44,7
28,0,0,0,0,2021-10-08,Male,68,65-69,2
28,1,0,0,1,2021-10-19,Male,14,10-14,1
28,0,1,0,1,2021-10-08,Female,51,45-54,4
28,0,0,0,0,2021-10-08,Male,61,55-64,8
28,1,0,0,1,2021-10-08,Male,44,35-44,16
28,1,0,0,1,2021-10-19,Male,68,65-69,1
28,0,0,0,0,2021-10-12,Female,51,45-54,1
28,2,6,0,8,2021-10-08,Female,52,45-54,2
28,0,0,0,0,2021-10-12,Female,55,55-64,7
28,0,20,0,20,2021-10-09,Female,34,25-34,2
28,0,0,0,0,2021-10-08,Male,43,35-44,7
28,3,2,0,5,2021-10-08,Male,44,35-44,16
28,1,0,0,1,2021-10-08,Female,72,70-74,7
28,0,0,0,0,2021-10-08,Female,61,55-64,15
28,2,0,0,2,2021-10-18,Female,73,70-74,2
28,1,15,40,56,2021-10-19,Male,75,75-79,1
28,1,3,0,4,2021-10-08,Male,67,65-69,7
28,1,0,0,1,2021-10-12,Male,62,55-64,1
28,1,0,0,1,2021-10-08,Male,64,55-64,2
28,3,0,0,3,2021-10-12,Female,49,45-54,1
28,2,0,0,2,2021-10-09,Male,36,35-44,12
28,0,2,0,2,2021-10-12,Female,62,55-64,1
28,0,0,0,0,2021-10-08,Female,78,75-79,21
28,1,0,0,1,2021-10-08,Female,64,55-64,2
28,1,0,0,1,2021-10-19,Male,77,75-79,1
28,3,2,6,11,2021-10-12,Male,3,1-4,9
28,2,0,0,2,2021-10-08,Male,67,65-69,6
28,0,3,0,3,2021-10-08,Female,53,45-54,15
28,2,0,0,2,2021-10-12,Male,8,5-9,1
28,1,4,0,5,2021-10-08,Male,69,65-69,2
28,1,0,0,1,2021-10-12,Female,47,45-54,1
28,1,0,0,1,2021-10-08,Female,43,35-44,2
28,0,2,0,2,2021-10-08,Male,71,70-74,2
28,0,3,0,3,2021-10-09,Male,74,70-74,2
28,0,3,0,3,2021-10-08,Female,65,65-69,2
28,0,0,0,0,2021-10-08,Female,78,75-79,4
28,0,6,0,6,2021-10-15,Male,38,35-44,5
28,1,0,0,1,2021-10-08,Female,67,65-69,3
28,0,0,0,0,2021-10-17,Female,20,20-24,11
28,1,0,0,1,2021-10-08,Male,68,65-69,2
28,0,5,0,5,2021-10-09,Male,56,55-64,7
28,0,1,0,1,2021-10-08,Male,35,35-44,3
28,2,0,0,2,2021-10-12,Female,56,55-64,1
28,1,4,0,5,2021-10-08,Female,71,70-74,3
28,1,0,0,1,2021-10-09,Female,60,55-64,7
28,0,0,0,0,2021-10-08,Male,73,70-74,8
28,1,0,97,98,2021-10-08,Female,50,45-54,2
28,0,0,0,0,2021-10-18,Female,26,25-34,1
28,1,0,0,1,2021-10-09,Female,28,25-34,8
28,0,0,0,0,2021-10-08,Female,36,35-44,6
28,0,4,0,4,2021-10-19,Female,34,25-34,1
28,1,0,0,1,2021-10-08,Male,46,45-54,11
28,2,2,0,4,2021-10-20,Male,14,10-14,1
28,0,0,0,0,2021-10-08,Male,32,25-34,11
28,2,0,0,2,2021-10-08,Male,65,65-69,7
28,0,0,0,0,2021-10-15,Female,29,25-34,2
28,4,0,0,4,2021-10-08,Female,2,1-4,9
28,0,2,0,2,2021-10-09,Female,36,35-44,4
28,2,0,0,2,2021-10-09,Male,70,70-74,16
28,3,0,0,3,2021-10-08,Male,11,10-14,2
28,0,0,0,0,2021-10-19,Female,56,55-64,1
28,1,1,5,7,2021-10-18,Male,78,75-79,1
28,0,4,0,4,2021-10-08,Female,54,45-54,8
28,0,4,0,4,2021-10-18,Male,73,70-74,1
28,1,0,0,1,2021-10-12,Male,68,65-69,21
28,0,0,0,0,2021-10-08,Male,32,25-34,7
28,1,0,0,1,2021-10-08,Female,58,55-64,8
28,2,0,0,2,2021-10-12,Male,55,55-64,1
28,1,0,0,1,2021-10-08,Female,72,70-74,6
28,1,0,0,1,2021-10-10,Female,20,20-24,2
28,0,0,0,0,2021-10-08,Female,22,20-24,17
28,2,0,0,2,2021-10-12,Male,4,1-4,2
28,1,3,0,4,2021-10-08,Male,39,35-44,3
28,2,0,0,2,2021-10-08,Male,11,10-14,7
28,0,0,0,0,2021-10-08,Female,76,75-79,8
28,0,0,0,0,2021-10-14,Female,25,25-34,4
28,0,1,0,1,2021-10-08,Male,58,55-64,2
28,1,0,0,1,2021-10-12,Male,14,10-14,1
28,2,30,0,32,2021-10-11,Male,22,20-24,8
28,1,0,0,1,2021-10-08,Male,68,65-69,2
28,6,0,8,14,2021-10-08,Female,15,15-19,2
28,0,0,0,0,2021-10-08,Female,28,25-34,6
28,9,0,0,9,2021-10-09,Female,19,15-19,2
28,1,0,0,1,2021-10-19,Male,72,70-74,1
28,3,0,0,3,2021-10-08,Male,18,15-19,22
28,0,0,0,0,2021-10-08,Male,66,65-69,3
28,0,0,0,0,2021-10-12,Male,51,45-54,1
28,0,1,0,1,2021-10-08,Male,70,70-74,18
28,3,0,0,3,2021-10-19,Female,12,10-14,1
28,1,1,0,2,2021-10-15,Female,66,65-69,3
28,1,0,0,1,2021-10-18,Male,76,75-79,1
28,1,0,0,1,2021-10-08,Male,44,35-44,4
28,1,6,0,7,2021-10-08,Male,60,55-64,7
28,1,1,0,2,2021-10-08,Female,61,55-64,8
28,0,1,0,1,2021-10-11,Female,27,25-34,4
28,0,0,0,0,2021-10-12,Female,73,70-74,1
28,3,0,0,3,2021-10-10,Female,1,1-4,3
28,2,0,0,2,2021-10-08,Male,63,55-64,8
28,1,0,0,1,2021-10-08,Female,66,65-69,5
28,1,1,0,2,2021-10-10,Male,21,20-24,3
28,1,0,0,1,2021-10-08,Male,64,55-64,2
28,0,1,0,1,2021-10-11,Female,28,25-34,12
28,2,0,30,32,2021-10-08,Male,10,10-14,4
28,2,0,0,2,2021-10-18,Female,31,25-34,1
28,0,3,0,3,2021-10-19,Female,33,25-34,1
28,8,0,0,8,2021-10-08,Female,5,5-9,3
28,3,1,0,4,2021-10-09,Female,53,45-54,4
28,1,0,0,1,2021-10-12,Female,26,25-34,2
28,0,0,0,0,2021-10-09,Male,22,20-24,2
28,1,0,0,1,2021-10-18,Male,33,25-34,1
28,1,0,0,1,2021-10-19,Male,71,70-74,1
28,1,0,0,1,2021-10-08,Female,61,55-64,7
28,1,0,0,1,2021-10-17,Female,24,20-24,3
28,4,0,0,4,2021-10-08,Male,4,1-4,2
28,2,0,0,2,2021-10-11,Female,23,20-24,3
28,0,4,16,20,2021-10-12,Female,45,45-54,1
28,3,0,1,4,2021-10-11,Male,29,25-34,2
28,0,5,0,5,2021-10-12,Male,55,55-64,1
28,0,0,0,0,2021-10-11,Male,15,15-19,14
28,1,0,0,1,2021-10-19,Female,55,55-64,1
28,1,0,0,1,2021-10-08,Male,55,55-64,5
28,2,1,0,3,2021-10-08,Female,28,25-34,8
28,1,0,0,1,2021-10-10,Male,31,25-34,2
28,3,0,0,3,2021-10-08,Male,11,10-14,2
28,0,0,0,0,2021-10-15,Female,74,70-74,19
28,1,0,0,1,2021-10-08,Male,70,70-74,2
28,2,5,0,7,2021-10-08,Female,5,5-9,2
28,1,1,0,2,2021-10-19,Male,73,70-74,1
28,1,0,0,1,2021-10-08,Male,69,65-69,8
28,2,0,0,2,2021-10-08,Female,0,<1,8
28,2,0,0,2,2021-10-20,Male,34,25-34,1
28,0,0,0,0,2021-10-09,Female,31,25-34,7
28,1,2,0,3,2021-10-15,Female,72,70-74,5
28,1,1,0,2,2021-10-08,Male,74,70-74,3
28,1,1,0,2,2021-10-08,Male,41,35-44,2
28,1,0,0,1,2021-10-11,Female,44,35-44,6
28,0,6,2,8,2021-10-19,Male,82,80-84,1
28,2,0,0,2,2021-10-19,Male,62,55-64,1
28,0,0,0,0,2021-10-08,Male,51,45-54,2
28,0,1,0,1,2021-10-08,Male,47,45-54,7
28,1,7,0,8,2021-10-11,Female,28,25-34,2
28,1,0,0,1,2021-10-10,Female,11,10-14,2
28,1,1,0,2,2021-10-08,Female,68,65-69,8
28,1,7,0,8,2021-10-10,Female,63,55-64,21
28,1,0,0,1,2021-10-08,Female,65,65-69,2
28,3,0,0,3,2021-10-12,Female,56,55-64,1
28,0,0,0,0,2021-10-08,Female,30,25-34,2
28,0,0,0,0,2021-10-08,Male,53,45-54,5
28,1,0,0,1,2021-10-08,Male,65,65-69,5
28,4,1,0,5,2021-10-10,Male,22,20-24,4
28,0,0,0,0,2021-10-09,Male,30,25-34,3
28,0,5,0,5,2021-10-08,Male,4,1-4,2
28,0,0,0,0,2021-10-15,Male,74,70-74,2
28,1,0,0,1,2021-10-08,Male,61,55-64,6
28,0,0,0,0,2021-10-08,Female,44,35-44,3
28,1,2,0,3,2021-10-08,Male,54,45-54,6
28,2,0,0,2,2021-10-08,Female,3,1-4,3
28,0,0,0,0,2021-10-08,Male,70,70-74,21
28,0,1,0,1,2021-10-12,Female,85,85+,1
28,1,0,0,1,2021-10-08,Male,64,55-64,3
28,1,0,0,1,2021-10-08,Male,52,45-54,2
28,1,0,0,1,2021-10-12,Male,68,65-69,1
28,2,0,0,2,2021-10-08,Female,6,5-9,6
28,0,31,0,31,2021-10-08,Male,53,45-54,4
28,1,0,0,1,2021-10-11,Male,57,55-64,3
28,0,2,0,2,2021-10-08,Female,66,65-69,3
28,2,3,0,5,2021-10-18,Male,32,25-34,1
28,4,3,0,7,2021-10-09,Female,18,15-19,2
28,2,0,0,2,2021-10-08,Female,60,55-64,7
28,1,0,0,1,2021-10-09,Female,41,35-44,2
28,1,2,0,3,2021-10-08,Female,54,45-54,4
28,1,0,0,1,2021-10-08,Female,38,35-44,2
28,0,3,0,3,2021-10-17,Female,70,70-74,9
28,1,0,0,1,2021-10-08,Female,71,70-74,2
28,1,3,0,4,2021-10-12,Female,67,65-69,1
28,1,4,0,5,2021-10-08,Male,40,35-44,8
28,3,0,0,3,2021-10-15,Male,0,<1,7
28,2,0,0,2,2021-10-09,Male,4,1-4,3
28,0,0,0,0,2021-10-08,Male,42,35-44,9
28,1,0,0,1,2021-10-08,Female,54,45-54,8
28,1,0,0,1,2021-10-18,Male,78,75-79,1
28,1,0,0,1,2021-10-09,Female,25,25-34,8
28,1,0,0,1,2021-10-09,Male,51,45-54,6
28,1,0,0,1,2021-10-09,Female,69,65-69,2
28,1,0,0,1,2021-10-08,Male,43,35-44,5
28,0,0,0,0,2021-10-08,Female,34,25-34,4
28,1,0,0,1,2021-10-08,Male,49,45-54,7
28,1,0,0,1,2021-10-09,Male,57,55-64,20
28,0,3,0,3,2021-10-08,Male,60,55-64,2
28,1,8,0,9,2021-10-08,Male,50,45-54,3
28,1,0,0,1,2021-10-12,Female,61,55-64,1
28,1,1,0,2,2021-10-09,Male,70,70-74,2
28,4,0,0,4,2021-10-09,Male,19,15-19,2
28,1,0,0,1,2021-10-09,Male,24,20-24,11
28,1,0,0,1,2021-10-08,Female,64,55-64,8
28,3,0,0,3,2021-10-12,Male,10,10-14,2
28,1,3,0,4,2021-10-08,Female,34,25-34,3
28,0,0,1,1,2021-10-08,Female,74,70-74,6
28,1,10,0,11,2021-10-08,Female,53,45-54,3
28,0,0,0,0,2021-10-09,Male,37,35-44,2
28,0,0,0,0,2021-10-10,Male,53,45-54,16
28,0,1,0,1,2021-10-09,Female,81,80-84,7
28,0,9,0,9,2021-10-08,Male,58,55-64,3
28,2,0,0,2,2021-10-12,Male,68,65-69,1
28,2,2,0,4,2021-10-12,Male,15,15-19,1
28,0,9,0,9,2021-10-13,Female,26,25-34,2
28,1,1,0,2,2021-10-12,Female,61,55-64,1
28,0,0,0,0,2021-10-08,Male,49,45-54,4
28,0,0,0,0,2021-10-08,Male,31,25-34,5
28,2,0,0,2,2021-10-18,Male,67,65-69,1
28,1,0,0,1,2021-10-11,Male,55,55-64,8
28,0,2,0,2,2021-10-19,Male,66,65-69,1
28,1,2,0,3,2021-10-08,Male,73,70-74,2
28,1,0,0,1,2021-10-09,Male,64,55-64,6
28,2,0,0,2,2021-10-12,Male,13,10-14,1
28,0,0,0,0,2021-10-15,Male,72,70-74,7
28,1,1,0,2,2021-10-10,Male,74,70-74,2
28,1,7,0,8,2021-10-08,Female,68,65-69,7
28,0,0,0,0,2021-10-08,Male,60,55-64,6
28,1,1,4,6,2021-10-19,Male,74,70-74,1
28,0,1,0,1,2021-10-12,Male,59,55-64,1
28,0,0,0,0,2021-10-08,Female,67,65-69,2
28,2,0,0,2,2021-10-11,Male,54,45-54,2
28,1,0,0,1,2021-10-08,Female,65,65-69,6
28,2,0,0,2,2021-10-13,Female,22,20-24,12
28,1,1,0,2,2021-10-08,Male,77,75-79,4
28,2,1,0,3,2021-10-08,Male,12,10-14,6
28,1,0,0,1,2021-10-08,Female,72,70-74,6
28,0,0,0,0,2021-10-08,Female,65,65-69,10
28,0,0,0,0,2021-10-12,Male,57,55-64,1
28,0,0,30,30,2021-10-09,Female,6,5-9,2
28,0,0,0,0,2021-10-09,Female,25,25-34,11
28,4,0,0,4,2021-10-08,Male,7,5-9,5
28,1,1,0,2,2021-10-09,Male,69,65-69,10
28,2,0,0,2,2021-10-09,Male,7,5-9,3
28,2,2,0,4,2021-10-09,Female,26,25-34,2
28,1,3,0,4,2021-10-14,Male,5,5-9,3
28,1,0,0,1,2021-10-08,Female,37,35-44,4
28,0,0,0,0,2021-10-08,Female,24,20-24,3
28,1,2,0,3,2021-10-19,Male,78,75-79,1
28,0,0,0,0,2021-10-12,Female,46,45-54,1
28,0,1,0,1,2021-10-08,Female,70,70-74,2
28,2,0,0,2,2021-10-10,Female,48,45-54,4
28,1,0,0,1,2021-10-12,Female,62,55-64,1
28,0,3,0,3,2021-10-10,Male,23,20-24,8
28,0,0,0,0,2021-10-12,Male,55,55-64,1
28,1,1,0,2,2021-10-12,Female,73,70-74,1
28,0,0,0,0,2021-10-12,Female,61,55-64,1
28,3,0,0,3,2021-10-19,Female,12,10-14,1
28,0,0,0,0,2021-10-09,Male,34,25-34,6
28,0,0,0,0,2021-10-08,Female,50,45-54,5
28,1,0,0,1,2021-10-18,Male,72,70-74,1
28,2,0,0,2,2021-10-13,Female,39,35-44,6
28,2,4,0,6,2021-10-13,Male,12,10-14,1
28,0,0,0,0,2021-10-10,Female,55,55-64,2
28,1,1,0,2,2021-10-12,Female,57,55-64,1
28,0,0,0,0,2021-10-10,Male,11,10-14,3
28,1,0,0,1,2021-10-08,Female,53,45-54,3
28,2,0,0,2,2021-10-08,Male,16,15-19,8
28,2,1,0,3,2021-10-08,Female,0,<1,4
28,1,1,0,2,2021-10-08,Male,75,75-79,4
28,1,0,0,1,2021-10-09,Female,54,45-54,7
28,2,40,0,42,2021-10-08,Female,59,55-64,7
28,0,0,0,0,2021-10-08,Male,45,45-54,2
28,3,0,0,3,2021-10-18,Male,21,20-24,15
28,1,3,0,4,2021-10-10,Female,5,5-9,17
28,0,0,0,0,2021-10-11,Male,29,25-34,3
28,0,0,0,0,2021-10-08,Female,62,55-64,2
28,1,0,0,1,2021-10-19,Male,70,70-74,1
28,0,0,0,0,2021-10-08,Male,44,35-44,23
28,2,0,0,2,2021-10-19,Male,69,65-69,1
28,0,0,0,0,2021-10-08,Male,34,25-34,7
28,1,0,0,1,2021-10-08,Female,55,55-64,6
28,3,2,0,5,2021-10-08,Female,12,10-14,2
28,1,0,0,1,2021-10-19,Male,75,75-79,2
28,0,0,0,0,2021-10-08,Female,21,20-24,4
28,0,0,0,0,2021-10-13,Male,42,35-44,3
28,2,2,0,4,2021-10-08,Male,56,55-64,7
28,0,0,0,0,2021-10-19,Male,68,65-69,1
28,2,0,0,2,2021-10-10,Male,17,15-19,8
28,0,0,0,0,2021-10-11,Female,29,25-34,3
28,2,0,0,2,2021-10-19,Female,30,25-34,1
28,0,0,0,0,2021-10-08,Female,62,55-64,2
28,0,0,0,0,2021-10-15,Male,70,70-74,2
28,0,2,0,2,2021-10-08,Female,73,70-74,3
28,3,0,0,3,2021-10-17,Female,10,10-14,2
28,0,2,0,2,2021-10-08,Male,71,70-74,18
28,1,0,0,1,2021-10-11,Male,69,65-69,4
28,1,3,0,4,2021-10-08,Female,3,1-4,8
28,2,15,0,17,2021-10-09,Female,18,15-19,11
28,0,0,0,0,2021-10-12,Male,44,35-44,17
28,0,0,0,0,2021-10-08,Female,37,35-44,3
28,1,0,0,1,2021-10-09,Female,70,70-74,2
28,0,0,0,0,2021-10-12,Female,63,55-64,2
28,1,0,0,1,2021-10-08,Female,45,45-54,4
28,0,2,0,2,2021-10-08,Female,76,75-79,8
28,0,0,0,0,2021-10-09,Male,39,35-44,2
28,0,2,0,2,2021-10-08,Female,56,55-64,8
28,1,0,0,1,2021-10-12,Female,56,55-64,1
28,0,2,0,2,2021-10-08,Male,70,70-74,8
28,1,0,0,1,2021-10-08,Male,29,25-34,7
28,0,0,2,2,2021-10-08,Male,23,20-24,3
28,1,0,0,1,2021-10-08,Male,61,55-64,13
28,0,0,0,0,2021-10-10,Female,23,20-24,3
28,1,2,0,3,2021-10-08,Female,22,20-24,4
28,0,28,22,50,2021-10-12,Female,48,45-54,1
28,0,0,0,0,2021-10-16,Female,33,25-34,2
28,1,0,0,1,2021-10-10,Female,38,35-44,6
28,1,0,0,1,2021-10-08,Male,62,55-64,2
28,1,0,0,1,2021-10-18,Male,72,70-74,1
28,2,0,0,2,2021-10-09,Female,40,35-44,3
28,0,0,0,0,2021-10-10,Female,25,25-34,4
28,1,2,0,3,2021-10-10,Female,34,25-34,2
28,0,0,0,0,2021-10-08,Female,74,70-74,5
28,0,0,0,0,2021-10-08,Male,47,45-54,2
28,2,0,0,2,2021-10-11,Male,5,5-9,4
28,0,3,0,3,2021-10-08,Female,59,55-64,2
28,2,20,0,22,2021-10-08,Male,18,15-19,19
28,0,0,0,0,2021-10-12,Female,64,55-64,1
28,0,0,0,0,2021-10-08,Male,51,45-54,3
28,0,1,0,1,2021-10-10,Female,33,25-34,9
28,4,0,0,4,2021-10-10,Female,11,10-14,5
28,1,6,0,7,2021-10-15,Female,23,20-24,2
28,0,7,0,7,2021-10-08,Male,76,75-79,2
28,0,0,0,0,2021-10-18,Female,8,5-9,1
28,0,5,0,5,2021-10-08,Female,73,70-74,2
28,1,0,0,1,2021-10-11,Female,52,45-54,5
28,0,1,0,1,2021-10-10,Male,73,70-74,2
28,2,0,0,2,2021-10-08,Male,66,65-69,10
28,0,0,0,0,2021-10-09,Female,62,55-64,2
28,1,1,0,2,2021-10-08,Female,69,65-69,3
28,2,0,0,2,2021-10-09,Female,32,25-34,2
28,1,0,0,1,2021-10-08,Male,74,70-74,2
28,1,6,0,7,2021-10-08,Male,66,65-69,8
28,0,0,0,0,2021-10-08,Male,41,35-44,2
28,1,2,0,3,2021-10-19,Female,65,65-69,1
28,0,0,0,0,2021-10-12,Female,58,55-64,1
28,0,0,0,0,2021-10-09,Female,1,1-4,13
28,0,3,0,3,2021-10-09,Female,71,70-74,18
28,1,12,0,13,2021-10-13,Male,69,65-69,17
28,1,2,15,18,2021-10-19,Male,74,70-74,1
28,1,3,0,4,2021-10-08,Female,37,35-44,3
28,0,0,0,0,2021-10-13,Male,38,35-44,13
28,1,1,0,2,2021-10-12,Female,53,45-54,1
28,3,0,0,3,2021-10-12,Male,13,10-14,1
28,0,0,0,0,2021-10-08,Male,69,65-69,2
28,0,2,0,2,2021-10-08,Female,74,70-74,3
28,1,1,0,2,2021-10-08,Male,14,10-14,7
28,0,2,0,2,2021-10-10,Male,22,20-24,8
28,2,0,0,2,2021-10-08,Male,66,65-69,2
28,3,2,0,5,2021-10-08,Male,8,5-9,21
28,1,11,29,41,2021-10-12,Female,10,10-14,7
28,0,3,0,3,2021-10-18,Female,27,25-34,1
28,0,0,0,0,2021-10-10,Male,77,75-79,16
28,0,0,0,0,2021-10-08,Male,58,55-64,3
28,1,3,0,4,2021-10-11,Male,60,55-64,5
28,1,0,0,1,2021-10-08,Female,69,65-69,3
28,0,0,0,0,2021-10-13,Male,71,70-74,3
28,2,0,0,2,2021-10-08,Female,1,1-4,6
28,0,0,0,0,2021-10-12,Female,71,70-74,18
28,1,0,0,1,2021-10-12,Female,17,15-19,1
28,2,34,0,36,2021-10-09,Female,3,1-4,2
28,0,0,0,0,2021-10-12,Female,49,45-54,1
28,0,0,0,0,2021-10-11,Male,41,35-44,2
28,1,2,0,3,2021-10-08,Male,54,45-54,2
28,1,0,0,1,2021-10-19,Male,71,70-74,1
28,1,3,0,4,2021-10-08,Female,30,25-34,4
28,0,0,0,0,2021-10-09,Male,40,35-44,2
28,1,0,0,1,2021-10-09,Male,23,20-24,5
28,0,0,0,0,2021-10-08,Male,36,35-44,3
28,2,3,0,5,2021-10-08,Female,55,55-64,2
28,1,0,0,1,2021-10-10,Female,66,65-69,16
28,0,0,0,0,2021-10-19,Male,68,65-69,1
28,0,0,0,0,2021-10-08,Male,48,45-54,7
28,1,0,0,1,2021-10-09,Female,18,15-19,5
28,1,0,0,1,2021-10-09,Male,34,25-34,7
28,0,0,0,0,2021-10-09,Female,45,45-54,2
28,3,0,0,3,2021-10-08,Female,58,55-64,3
28,0,1,0,1,2021-10-08,Female,22,20-24,2
28,1,0,0,1,2021-10-19,Male,77,75-79,1
28,1,0,0,1,2021-10-08,Male,76,75-79,18
28,3,0,0,3,2021-10-10,Male,16,15-19,6
28,1,0,0,1,2021-10-09,Male,46,45-54,7
28,1,1,0,2,2021-10-08,Male,62,55-64,2
28,0,0,0,0,2021-10-08,Female,50,45-54,8
28,2,1,0,3,2021-10-08,Female,8,5-9,7
28,1,7,0,8,2021-10-08,Male,73,70-74,2
28,1,0,0,1,2021-10-08,Male,58,55-64,8
28,1,2,0,3,2021-10-08,Female,57,55-64,7
28,1,2,0,3,2021-10-08,Female,58,55-64,2
28,0,0,0,0,2021-10-08,Male,53,45-54,12
28,1,0,0,1,2021-10-18,Female,30,25-34,1
28,0,0,0,0,2021-10-08,Female,54,45-54,8
28,3,0,0,3,2021-10-08,Male,18,15-19,7
28,0,0,0,0,2021-10-08,Male,65,65-69,7
28,1,0,1,2,2021-10-10,Female,42,35-44,4
28,0,0,0,0,2021-10-09,Female,20,20-24,13
28,0,2,0,2,2021-10-08,Male,52,45-54,5
28,1,1,0,2,2021-10-08,Male,55,55-64,7
28,2,2,0,4,2021-10-09,Female,7,5-9,5
28,1,2,0,3,2021-10-15,Female,68,65-69,4
28,0,0,0,0,2021-10-08,Female,60,55-64,2
28,1,1,0,2,2021-10-15,Male,70,70-74,2
28,2,1,0,3,2021-10-08,Male,8,5-9,2
28,1,0,0,1,2021-10-10,Male,26,25-34,7
28,0,3,0,3,2021-10-09,Male,48,45-54,16
28,0,0,0,0,2021-10-09,Male,73,70-74,5
28,0,0,0,0,2021-10-08,Male,56,55-64,2
28,1,0,0,1,2021-10-08,Female,72,70-74,7
28,3,9,0,12,2021-10-08,Female,8,5-9,4
28,1,0,6,7,2021-10-08,Male,70,70-74,2
28,0,0,0,0,2021-10-08,Female,59,55-64,18
28,1,1,0,2,2021-10-08,Male,59,55-64,8
28,1,0,0,1,2021-10-11,Female,37,35-44,2
28,1,0,0,1,2021-10-08,Male,44,35-44,8
28,1,0,0,1,2021-10-09,Female,53,45-54,16
28,2,0,0,2,2021-10-08,Female,15,15-19,8
28,1,0,0,1,2021-10-08,Male,58,55-64,4
28,2,0,0,2,2021-10-09,Female,22,20-24,13
28,1,0,0,1,2021-10-15,Female,35,35-44,17
28,1,9,0,10,2021-10-11,Male,63,55-64,4
28,3,0,0,3,2021-10-08,Male,17,15-19,5
28,0,0,0,0,2021-10-08,Male,38,35-44,4
28,1,0,0,1,2021-10-10,Female,52,45-54,5
28,1,0,0,1,2021-10-11,Female,60,55-64,3
28,1,0,0,1,2021-10-08,Male,72,70-74,8
28,1,0,0,1,2021-10-08,Female,67,65-69,4
28,1,2,0,3,2021-10-08,Female,45,45-54,4
28,0,0,0,0,2021-10-08,Female,53,45-54,2
28,4,0,0,4,2021-10-08,Male,13,10-14,2
28,2,0,0,2,2021-10-19,Male,56,55-64,1
28,2,0,0,2,2021-10-09,Female,0,<1,7
28,0,0,0,0,2021-10-12,Female,63,55-64,1
28,3,1,0,4,2021-10-10,Male,50,45-54,14
28,2,0,0,2,2021-10-08,Female,3,1-4,5
28,2,1,0,3,2021-10-08,Female,68,65-69,2
28,0,0,0,0,2021-10-11,Female,42,35-44,3
28,1,0,0,1,2021-10-12,Female,62,55-64,1
28,2,0,0,2,2021-10-08,Female,39,35-44,8
28,0,2,0,2,2021-10-09,Male,59,55-64,8
28,2,0,0,2,2021-10-08,Female,41,35-44,7
28,1,0,0,1,2021-10-08,Female,54,45-54,7
28,0,0,0,0,2021-10-08,Male,53,45-54,8
28,1,0,0,1,2021-10-11,Male,32,25-34,2
28,1,2,0,3,2021-10-08,Male,46,45-54,3
28,1,0,0,1,2021-10-18,Male,68,65-69,1
28,1,0,0,1,2021-10-15,Male,68,65-69,2
28,2,40,29,71,2021-10-13,Male,69,65-69,9
28,1,12,8,21,2021-10-08,Male,57,55-64,2
28,2,0,0,2,2021-10-08,Female,18,15-19,4
28,0,1,0,1,2021-10-08,Male,80,80-84,7
28,1,2,0,3,2021-10-15,Female,65,65-69,7
28,1,2,0,3,2021-10-08,Female,67,65-69,5
28,0,2,0,2,2021-10-08,Male,65,65-69,2
28,0,2,0,2,2021-10-10,Female,65,65-69,6
28,1,0,0,1,2021-10-08,Male,63,55-64,2
28,2,0,0,2,2021-10-08,Female,27,25-34,18
28,1,0,0,1,2021-10-13,Male,68,65-69,7
28,1,0,0,1,2021-10-12,Female,45,45-54,1
28,0,0,0,0,2021-10-08,Female,6,5-9,4
28,1,0,0,1,2021-10-08,Male,58,55-64,2
28,0,0,0,0,2021-10-08,Male,69,65-69,2
28,0,30,11,41,2021-10-08,Male,39,35-44,2
28,1,0,0,1,2021-10-08,Male,58,55-64,4
28,1,0,0,1,2021-10-19,Female,27,25-34,1
28,1,1,0,2,2021-10-12,Female,53,45-54,1
28,1,1,0,2,2021-10-09,Male,69,65-69,23
28,1,0,0,1,2021-10-08,Male,59,55-64,8
28,0,0,0,0,2021-10-10,Male,14,10-14,11
28,0,0,0,0,2021-10-10,Female,34,25-34,20
28,1,0,0,1,2021-10-15,Female,43,35-44,2
28,0,0,0,0,2021-10-08,Male,29,25-34,4
28,1,0,0,1,2021-10-13,Male,69,65-69,1
28,1,7,0,8,2021-10-09,Female,26,25-34,2
28,1,3,0,4,2021-10-18,Male,28,25-34,1
28,2,0,0,2,2021-10-08,Male,1,1-4,7
28,0,2,0,2,2021-10-08,Female,85,85+,3
28,1,0,0,1,2021-10-19,Male,75,75-79,3
28,1,2,0,3,2021-10-12,Female,8,5-9,1
28,0,0,0,0,2021-10-11,Male,30,25-34,19
28,1,0,0,1,2021-10-08,Female,66,65-69,6
28,0,0,0,0,2021-10-12,Female,52,45-54,1
28,0,0,0,0,2021-10-08,Female,28,25-34,3
28,0,0,0,0,2021-10-12,Male,54,45-54,8
28,0,3,0,3,2021-10-12,Female,58,55-64,1
28,1,8,0,9,2021-10-08,Male,57,55-64,2
28,1,0,0,1,2021-10-08,Female,38,35-44,8
28,0,0,26,26,2021-10-08,Male,52,45-54,2
28,0,0,0,0,2021-10-10,Female,18,15-19,2
28,1,0,0,1,2021-10-08,Male,52,45-54,3
28,1,0,0,1,2021-10-11,Male,21,20-24,12
28,2,0,0,2,2021-10-11,Female,67,65-69,19
28,1,0,0,1,2021-10-12,Female,53,45-54,1
28,3,20,0,23,2021-10-15,Female,18,15-19,3
28,0,4,0,4,2021-10-12,Female,61,55-64,1
28,0,1,0,1,2021-10-08,Female,66,65-69,3
28,0,0,0,0,2021-10-08,Female,71,70-74,8
28,2,4,0,6,2021-10-09,Male,66,65-69,8
28,0,1,0,1,2021-10-08,Male,58,55-64,7
28,0,0,0,0,2021-10-12,Male,77,75-79,1
28,1,0,0,1,2021-10-08,Female,31,25-34,5
28,1,3,0,4,2021-10-19,Female,30,25-34,1
28,1,0,0,1,2021-10-13,Male,65,65-69,7
28,0,0,0,0,2021-10-16,Male,42,35-44,18
28,1,0,0,1,2021-10-08,Female,31,25-34,6
28,2,3,0,5,2021-10-08,Female,16,15-19,8
28,1,0,0,1,2021-10-08,Female,65,65-69,7
28,0,0,0,0,2021-10-13,Male,27,25-34,7
28,2,0,0,2,2021-10-08,Female,56,55-64,2
28,1,0,0,1,2021-10-12,Female,49,45-54,1
28,1,0,0,1,2021-10-08,Female,66,65-69,8
28,0,0,0,0,2021-10-08,Female,26,25-34,2
28,1,0,0,1,2021-10-12,Male,54,45-54,5
28,1,2,0,3,2021-10-08,Female,69,65-69,3
28,0,1,4,5,2021-10-08,Male,56,55-64,8
28,1,1,0,2,2021-10-10,Female,40,35-44,3
28,1,0,0,1,2021-10-16,Female,72,70-74,6
28,0,0,0,0,2021-10-15,Male,72,70-74,2
28,0,5,0,5,2021-10-09,Female,42,35-44,3
28,3,13,0,16,2021-10-08,Female,2,1-4,2
28,1,0,0,1,2021-10-08,Male,69,65-69,3
28,1,0,0,1,2021-10-19,Male,69,65-69,1
28,6,0,0,6,2021-10-08,Female,1,1-4,4
28,3,0,0,3,2021-10-10,Male,21,20-24,2
28,1,5,0,6,2021-10-20,Male,61,55-64,1
28,1,0,0,1,2021-10-08,Female,63,55-64,8
28,0,2,0,2,2021-10-12,Male,57,55-64,1
28,0,0,0,0,2021-10-08,Male,61,55-64,8
28,1,0,0,1,2021-10-08,Male,69,65-69,3
28,0,0,0,0,2021-10-08,Male,18,15-19,7
28,3,0,0,3,2021-10-10,Female,44,35-44,6
28,0,4,0,4,2021-10-08,Female,61,55-64,15
28,0,2,0,2,2021-10-12,Female,66,65-69,6
28,3,0,0,3,2021-10-08,Female,19,15-19,3
28,1,0,0,1,2021-10-08,Female,50,45-54,22
28,1,0,0,1,2021-10-09,Male,18,15-19,8
28,1,0,0,1,2021-10-18,Male,71,70-74,1
28,1,0,0,1,2021-10-08,Female,36,35-44,2
28,0,0,0,0,2021-10-12,Female,49,45-54,1
28,0,0,0,0,2021-10-08,Male,36,35-44,2
28,0,2,0,2,2021-10-08,Male,53,45-54,2
28,0,4,0,4,2021-10-12,Male,74,70-74,1
28,0,8,0,8,2021-10-10,Female,67,65-69,6
28,2,0,41,43,2021-10-08,Male,52,45-54,8
28,1,1,0,2,2021-10-18,Female,27,25-34,1
28,1,1,0,2,2021-10-19,Male,80,80-84,1
28,0,0,0,0,2021-10-08,Female,64,55-64,2
28,0,0,0,0,2021-10-12,Male,30,25-34,3
28,1,0,0,1,2021-10-12,Female,61,55-64,1
28,0,0,0,0,2021-10-08,Female,41,35-44,3
28,1,0,0,1,2021-10-08,Male,68,65-69,7
28,1,4,0,5,2021-10-08,Male,71,70-74,2
28,3,15,0,18,2021-10-09,Female,14,10-14,3
28,0,0,0,0,2021-10-19,Female,55,55-64,1
28,0,4,0,4,2021-10-08,Male,26,25-34,5
28,2,9,0,11,2021-10-10,Female,34,25-34,2
28,0,0,0,0,2021-10-12,Female,55,55-64,1
28,0,0,0,0,2021-10-12,Male,31,25-34,19
28,1,0,0,1,2021-10-11,Female,11,10-14,3
28,0,0,0,0,2021-10-09,Female,44,35-44,11
28,1,0,0,1,2021-10-09,Male,70,70-74,4
28,3,0,0,3,2021-10-08,Male,20,20-24,4
28,4,0,0,4,2021-10-11,Female,9,5-9,2
28,3,0,0,3,2021-10-08,Female,13,10-14,2
28,1,2,0,3,2021-10-12,Female,72,70-74,1
28,0,0,0,0,2021-10-11,Female,30,25-34,5
28,0,1,0,1,2021-10-08,Male,64,55-64,22
28,0,1,0,1,2021-10-09,Male,54,45-54,8
28,3,0,0,3,2021-10-08,Female,22,20-24,4
28,1,0,0,1,2021-10-12,Male,64,55-64,1
28,1,3,0,4,2021-10-19,Male,83,80-84,1
28,0,0,0,0,2021-10-09,Female,8,5-9,22
28,1,2,0,3,2021-10-08,Female,61,55-64,3
28,0,0,3,3,2021-10-08,Female,66,65-69,13
28,1,31,0,32,2021-10-19,Female,66,65-69,1
28,2,0,0,2,2021-10-15,Male,1,1-4,4
28,0,0,0,0,2021-10-10,Female,49,45-54,8
28,1,0,0,1,2021-10-08,Female,72,70-74,8
28,0,0,0,0,2021-10-08,Male,56,55-64,2
28,0,0,0,0,2021-10-09,Male,14,10-14,14
28,1,4,0,5,2021-10-10,Female,28,25-34,2
28,0,0,0,0,2021-10-08,Female,66,65-69,3
28,2,10,0,12,2021-10-12,Female,16,15-19,16
28,1,1,0,2,2021-10-08,Female,72,70-74,3
28,0,1,0,1,2021-10-12,Female,53,45-54,1
28,0,6,20,26,2021-10-12,Female,53,45-54,1
28,0,1,2,3,2021-10-12,Female,48,45-54,1
28,0,2,0,2,2021-10-20,Female,33,25-34,1
28,0,0,0,0,2021-10-09,Male,51,45-54,5
28,1,0,0,1,2021-10-18,Male,84,80-84,1
28,0,0,0,0,2021-10-08,Female,67,65-69,6
28,0,0,0,0,2021-10-12,Female,53,45-54,1
28,2,36,0,38,2021-10-08,Female,48,45-54,7
28,1,0,0,1,2021-10-08,Male,6,5-9,6
28,0,0,0,0,2021-10-17,Male,6,5-9,20
28,0,0,0,0,2021-10-08,Female,51,45-54,7
28,0,0,0,0,2021-10-08,Female,38,35-44,6
28,2,0,0,2,2021-10-16,Male,7,5-9,8
28,3,0,0,3,2021-10-10,Female,6,5-9,3
28,1,0,0,1,2021-10-10,Female,70,70-74,11
28,1,0,0,1,2021-10-08,Female,33,25-34,2
28,1,0,0,1,2021-10-08,Female,42,35-44,8
28,0,0,0,0,2021-10-08,Female,64,55-64,3
28,1,0,0,1,2021-10-08,Male,57,55-64,8
28,0,0,0,0,2021-10-08,Female,74,70-74,2
28,1,0,0,1,2021-10-08,Male,46,45-54,5
28,1,0,0,1,2021-10-08,Male,50,45-54,9
28,3,0,0,3,2021-10-09,Female,7,5-9,2
28,1,0,0,1,2021-10-19,Male,68,65-69,1
28,1,30,0,31,2021-10-18,Female,25,25-34,15
28,1,0,0,1,2021-10-08,Female,75,75-79,2
28,0,0,0,0,2021-10-08,Female,53,45-54,10
28,1,0,0,1,2021-10-08,Male,12,10-14,2
28,1,0,0,1,2021-10-08,Female,32,25-34,3
28,0,10,0,10,2021-10-12,Female,46,45-54,2
28,0,0,0,0,2021-10-20,Female,54,45-54,1
28,2,2,0,4,2021-10-08,Female,18,15-19,2
28,3,16,0,19,2021-10-08,Female,9,5-9,3
28,1,0,0,1,2021-10-09,Female,19,15-19,4
28,2,10,0,12,2021-10-19,Male,61,55-64,18
28,1,1,0,2,2021-10-08,Female,34,25-34,5
28,0,6,0,6,2021-10-08,Female,51,45-54,12
28,3,0,0,3,2021-10-19,Female,18,15-19,1
28,3,0,0,3,2021-10-08,Female,19,15-19,3
28,0,0,0,0,2021-10-10,Female,31,25-34,3
28,1,3,0,4,2021-10-08,Male,7,5-9,11
28,1,0,0,1,2021-10-08,Female,68,65-69,4
28,0,0,0,0,2021-10-08,Male,50,45-54,2
28,2,0,28,30,2021-10-08,Male,5,5-9,3
28,1,3,0,4,2021-10-19,Male,79,75-79,1
28,2,0,0,2,2021-10-08,Male,56,55-64,2
28,0,0,0,0,2021-10-09,Male,49,45-54,2
28,2,0,2,4,2021-10-09,Female,73,70-74,12
28,0,0,0,0,2021-10-09,Female,61,55-64,3
28,4,0,0,4,2021-10-11,Female,2,1-4,3
28,2,2,0,4,2021-10-08,Male,1,1-4,8
28,0,0,0,0,2021-10-10,Female,52,45-54,9
28,0,0,0,0,2021-10-08,Female,59,55-64,2
28,3,0,0,3,2021-10-08,Female,9,5-9,8
28,0,0,0,0,2021-10-08,Female,67,65-69,19
28,1,0,0,1,2021-10-08,Female,49,45-54,2
28,0,3,13,16,2021-10-09,Female,79,75-79,13
28,2,0,0,2,2021-10-12,Female,67,65-69,1
28,0,0,0,0,2021-10-08,Male,85,85+,19
28,1,0,0,1,2021-10-08,Male,56,55-64,2
28,1,0,0,1,2021-10-08,Male,67,65-69,2
28,0,0,0,0,2021-10-10,Female,1,1-4,5
28,2,0,0,2,2021-10-10,Male,54,45-54,8
28,0,0,0,0,2021-10-08,Male,69,65-69,8
28,0,0,0,0,2021-10-10,Male,32,25-34,16
28,2,6,22,30,2021-10-12,Female,15,15-19,1
28,2,0,0,2,2021-10-08,Male,67,65-69,21
28,0,0,0,0,2021-10-12,Male,34,25-34,2
28,0,0,0,0,2021-10-08,Male,69,65-69,6
28,0,2,0,2,2021-10-08,Male,37,35-44,3
28,2,2,0,4,2021-10-15,Male,7,5-9,2
28,1,0,0,1,2021-10-08,Male,38,35-44,3
28,0,5,0,5,2021-10-10,Male,63,55-64,2
28,0,3,5,8,2021-10-18,Male,67,65-69,1
28,1,2,0,3,2021-10-08,Female,70,70-74,2
28,0,0,0,0,2021-10-18,Male,70,70-74,1
28,1,0,0,1,2021-10-08,Male,79,75-79,4
28,0,8,0,8,2021-10-08,Male,51,45-54,7
28,2,1,0,3,2021-10-09,Male,69,65-69,8
28,2,0,0,2,2021-10-08,Male,13,10-14,5
28,1,1,0,2,2021-10-08,Male,60,55-64,2
28,0,1,0,1,2021-10-09,Female,67,65-69,12
28,0,0,0,0,2021-10-08,Female,51,45-54,4
28,1,2,0,3,2021-10-08,Male,74,70-74,3
28,0,0,0,0,2021-10-08,Male,60,55-64,2
28,0,1,2,3,2021-10-19,Female,70,70-74,1
28,0,0,0,0,2021-10-10,Male,41,35-44,17
28,2,2,0,4,2021-10-08,Female,31,25-34,2
28,2,1,0,3,2021-10-08,Male,68,65-69,8
28,1,1,0,2,2021-10-08,Male,72,70-74,3
28,3,0,0,3,2021-10-12,Female,47,45-54,1
28,1,0,0,1,2021-10-15,Male,70,70-74,7
28,0,2,0,2,2021-10-08,Male,69,65-69,2
28,0,0,0,0,2021-10-08,Male,58,55-64,6
28,2,0,0,2,2021-10-08,Male,44,35-44,8
28,1,0,1,2,2021-10-08,Female,24,20-24,8
28,1,6,0,7,2021-10-11,Male,60,55-64,4
28,0,1,0,1,2021-10-08,Male,52,45-54,4
28,3,0,0,3,2021-10-10,Male,51,45-54,3
28,0,0,0,0,2021-10-08,Male,58,55-64,2
28,2,2,0,4,2021-10-16,Male,9,5-9,4
28,1,0,0,1,2021-10-19,Male,71,70-74,1
28,1,0,0,1,2021-10-08,Female,77,75-79,7
28,0,1,0,1,2021-10-19,Male,66,65-69,1
28,1,0,0,1,2021-10-08,Male,54,45-54,7
28,0,0,0,0,2021-10-08,Male,56,55-64,2
28,0,7,0,7,2021-10-12,Female,61,55-64,1
28,1,3,2,6,2021-10-15,Female,67,65-69,2
28,1,0,0,1,2021-10-15,Male,71,70-74,16
28,0,0,0,0,2021-10-08,Female,58,55-64,8
28,1,3,0,4,2021-10-08,Female,58,55-64,17
28,0,0,0,0,2021-10-08,Female,59,55-64,6
28,2,3,0,5,2021-10-09,Male,3,1-4,2
28,0,0,0,0,2021-10-08,Female,42,35-44,3
28,0,0,0,0,2021-10-08,Female,17,15-19,3
28,0,2,0,2,2021-10-08,Female,65,65-69,2
28,0,3,0,3,2021-10-08,Female,68,65-69,4
28,3,0,0,3,2021-10-19,Female,2,1-4,1
28,1,0,0,1,2021-10-08,Male,50,45-54,2
28,0,0,0,0,2021-10-09,Male,44,35-44,2
28,1,1,0,2,2021-10-12,Female,53,45-54,1
28,1,0,0,1,2021-10-08,Male,51,45-54,2
28,1,1,0,2,2021-10-08,Female,2,1-4,4
28,2,7,0,9,2021-10-09,Male,53,45-54,2
28,1,0,0,1,2021-10-10,Male,54,45-54,6
28,0,0,0,0,2021-10-09,Female,43,35-44,3
28,1,1,0,2,2021-10-12,Male,62,55-64,1
28,1,0,0,1,2021-10-18,Male,69,65-69,1
28,0,2,0,2,2021-10-11,Female,42,35-44,3
28,2,0,0,2,2021-10-10,Male,13,10-14,2
28,1,0,0,1,2021-10-08,Female,30,25-34,3
28,1,0,0,1,2021-10-19,Female,31,25-34,1
28,1,8,0,9,2021-10-08,Male,53,45-54,3
28,0,0,0,0,2021-10-08,Male,63,55-64,2
28,1,6,0,7,2021-10-20,Male,77,75-79,1
28,1,0,0,1,2021-10-08,Female,59,55-64,4
28,1,0,0,1,2021-10-08,Female,70,70-74,2
28,1,1,0,2,2021-10-09,Male,56,55-64,4
28,1,1,0,2,2021-10-08,Male,67,65-69,6
28,2,0,0,2,2021-10-08,Female,7,5-9,3
28,1,0,0,1,2021-10-09,Male,47,45-54,3
28,1,2,0,3,2021-10-08,Female,66,65-69,8
28,0,1,0,1,2021-10-18,Female,40,35-44,4
28,0,0,0,0,2021-10-08,Male,31,25-34,5
28,1,0,0,1,2021-10-09,Female,44,35-44,3
28,1,0,0,1,2021-10-08,Male,58,55-64,3
28,2,0,0,2,2021-10-09,Female,5,5-9,23
28,0,3,0,3,2021-10-19,Male,68,65-69,1
28,0,2,0,2,2021-10-19,Female,65,65-69,1
28,1,0,0,1,2021-10-20,Male,66,65-69,7
28,0,4,0,4,2021-10-09,Female,73,70-74,2
28,0,0,0,0,2021-10-08,Female,40,35-44,7
28,1,1,0,2,2021-10-08,Male,49,45-54,7
28,0,1,25,26,2021-10-08,Male,44,35-44,15
28,0,0,0,0,2021-10-08,Female,24,20-24,4
28,1,5,0,6,2021-10-19,Female,62,55-64,1
28,0,0,0,0,2021-10-08,Male,46,45-54,3
28,2,0,0,2,2021-10-08,Male,1,1-4,4
28,1,0,0,1,2021-10-08,Male,66,65-69,4
28,2,0,0,2,2021-10-08,Male,4,1-4,2
28,1,0,0,1,2021-10-12,Female,30,25-34,3
28,0,3,0,3,2021-10-08,Male,43,35-44,2
28,2,15,0,17,2021-10-08,Female,8,5-9,2
28,0,1,0,1,2021-10-08,Male,39,35-44,2
28,3,0,0,3,2021-10-08,Female,1,1-4,4
28,1,0,0,1,2021-10-09,Male,61,55-64,5
28,1,0,0,1,2021-10-08,Male,69,65-69,3
28,1,2,0,3,2021-10-09,Male,75,75-79,8
28,3,24,25,52,2021-10-12,Male,13,10-14,1
28,1,30,0,31,2021-10-08,Male,50,45-54,3
28,0,0,0,0,2021-10-12,Male,58,55-64,1
28,1,3,0,4,2021-10-19,Male,71,70-74,1
28,1,0,0,1,2021-10-08,Male,66,65-69,2
28,2,22,0,24,2021-10-12,Male,14,10-14,1
28,0,0,0,0,2021-10-09,Male,74,70-74,3
28,1,0,0,1,2021-10-08,Female,68,65-69,7
28,3,8,0,11,2021-10-12,Male,19,15-19,1
28,1,1,0,2,2021-10-08,Male,72,70-74,8
28,2,1,0,3,2021-10-08,Male,7,5-9,2
28,0,10,0,10,2021-10-08,Male,44,35-44,8
28,1,0,0,1,2021-10-10,Female,33,25-34,3
28,0,0,0,0,2021-10-08,Female,59,55-64,2
28,0,0,0,0,2021-10-08,Male,53,45-54,2
28,0,4,0,4,2021-10-09,Male,59,55-64,4
28,0,0,0,0,2021-10-08,Male,59,55-64,7
28,0,0,0,0,2021-10-08,Male,66,65-69,15
28,1,0,2,3,2021-10-08,Female,53,45-54,3
28,0,1,0,1,2021-10-14,Female,18,15-19,4
28,1,1,0,2,2021-10-08,Female,62,55-64,2
28,0,0,0,0,2021-10-10,Male,61,55-64,2
28,0,1,0,1,2021-10-09,Female,47,45-54,2
28,0,0,0,0,2021-10-12,Male,10,10-14,2
28,0,0,0,0,2021-10-13,Female,22,20-24,10
28,2,0,0,2,2021-10-18,Male,1,1-4,6
28,3,0,0,3,2021-10-19,Female,0,<1,1
28,1,0,0,1,2021-10-08,Male,69,65-69,7
28,2,3,0,5,2021-10-09,Male,19,15-19,3
28,0,0,0,0,2021-10-13,Female,24,20-24,9
28,1,0,0,1,2021-10-09,Male,77,75-79,8
28,2,0,0,2,2021-10-19,Female,26,25-34,1
28,1,3,0,4,2021-10-14,Male,28,25-34,2
28,0,12,0,12,2021-10-08,Female,35,35-44,3
28,1,3,0,4,2021-10-11,Female,66,65-69,2
28,0,0,0,0,2021-10-08,Male,33,25-34,7
28,1,0,0,1,2021-10-08,Female,48,45-54,4
28,0,0,0,0,2021-10-12,Female,56,55-64,1
28,1,6,0,7,2021-10-11,Male,34,25-34,7
28,0,2,0,2,2021-10-10,Male,64,55-64,7
28,1,5,0,6,2021-10-08,Male,75,75-79,2
28,1,5,0,6,2021-10-19,Male,76,75-79,1
28,1,0,0,1,2021-10-13,Male,65,65-69,7
28,0,0,0,0,2021-10-11,Female,42,35-44,3
28,1,1,0,2,2021-10-08,Female,62,55-64,2
28,1,0,0,1,2021-10-12,Female,51,45-54,1
28,0,0,0,0,2021-10-10,Female,75,75-79,2
28,0,0,0,0,2021-10-08,Female,23,20-24,10
28,0,0,0,0,2021-10-11,Male,66,65-69,6
28,3,15,5,23,2021-10-12,Male,18,15-19,2
28,2,3,8,13,2021-10-09,Male,25,25-34,4
28,2,0,0,2,2021-10-11,Male,15,15-19,6
28,0,1,0,1,2021-10-12,Female,63,55-64,1
28,0,0,0,0,2021-10-08,Male,60,55-64,24
28,1,0,0,1,2021-10-18,Male,71,70-74,1
28,1,0,0,1,2021-10-08,Female,29,25-34,6
28,0,8,0,8,2021-10-08,Female,60,55-64,22
28,1,0,0,1,2021-10-08,Female,32,25-34,4
28,0,0,0,0,2021-10-08,Male,43,35-44,3
28,0,1,0,1,2021-10-15,Female,67,65-69,15
28,1,0,0,1,2021-10-08,Male,52,45-54,3
28,2,2,0,4,2021-10-19,Male,70,70-74,1
28,0,0,0,0,2021-10-19,Female,25,25-34,2
28,0,0,0,0,2021-10-08,Male,81,80-84,3
28,1,2,0,3,2021-10-08,Male,72,70-74,2
28,2,1,0,3,2021-10-08,Female,24,20-24,2
28,3,1,0,4,2021-10-12,Female,0,<1,6
28,0,0,0,0,2021-10-19,Female,24,20-24,6
28,0,0,0,0,2021-10-12,Female,24,20-24,21
28,1,0,0,1,2021-10-08,Female,66,65-69,8
28,3,0,0,3,2021-10-09,Female,5,5-9,4
28,0,2,0,2,2021-10-14,Female,34,25-34,4
28,2,7,0,9,2021-10-12,Male,59,55-64,15
28,1,0,0,1,2021-10-08,Male,68,65-69,3
28,1,0,0,1,2021-10-09,Female,76,75-79,5
28,2,0,0,2,2021-10-08,Female,53,45-54,3
28,1,0,0,1,2021-10-08,Female,64,55-64,8
28,0,0,0,0,2021-10-08,Male,77,75-79,4
28,2,0,0,2,2021-10-12,Male,56,55-64,1
28,0,2,0,2,2021-10-09,Male,23,20-24,5
28,0,1,0,1,2021-10-08,Male,60,55-64,2
28,0,1,0,1,2021-10-17,Female,37,35-44,3
28,1,0,0,1,2021-10-08,Female,29,25-34,2
28,1,31,0,32,2021-10-08,Female,59,55-64,8
28,0,0,6,6,2021-10-08,Female,43,35-44,2
28,1,1,0,2,2021-10-08,Female,68,65-69,2
28,4,3,0,7,2021-10-11,Male,1,1-4,3
28,3,4,0,7,2021-10-08,Female,2,1-4,4
28,0,0,0,0,2021-10-17,Male,75,75-79,2
28,3,0,0,3,2021-10-11,Male,6,5-9,2
28,0,2,0,2,2021-10-09,Female,34,25-34,3
28,0,0,0,0,2021-10-08,Male,57,55-64,7
28,0,0,0,0,2021-10-08,Female,46,45-54,2
28,1,4,0,5,2021-10-08,Female,49,45-54,8
28,0,0,0,0,2021-10-08,Female,52,45-54,4
28,2,1,0,3,2021-10-08,Female,10,10-14,2
28,0,1,0,1,2021-10-08,Male,65,65-69,3
28,2,0,0,2,2021-10-08,Male,71,70-74,21
28,0,0,0,0,2021-10-18,Male,78,75-79,1
28,1,0,0,1,2021-10-08,Male,73,70-74,3
28,1,10,0,11,2021-10-08,Male,59,55-64,20
28,1,0,0,1,2021-10-08,Female,73,70-74,3
28,2,0,0,2,2021-10-08,Female,16,15-19,2
28,1,0,0,1,2021-10-18,Female,69,65-69,2
28,0,1,0,1,2021-10-08,Male,51,45-54,19
28,0,0,0,0,2021-10-18,Male,76,75-79,1
28,0,0,0,0,2021-10-12,Male,65,65-69,2
28,0,3,0,3,2021-10-09,Female,26,25-34,2
28,0,0,0,0,2021-10-08,Male,65,65-69,2
28,0,5,0,5,2021-10-08,Female,71,70-74,2
28,0,2,0,2,2021-10-09,Male,61,55-64,8
28,2,0,0,2,2021-10-09,Male,14,10-14,2
28,2,0,0,2,2021-10-12,Female,19,15-19,1
28,0,0,0,0,2021-10-08,Male,60,55-64,6
28,1,0,0,1,2021-10-09,Female,63,55-64,2
28,3,0,0,3,2021-10-13,Female,67,65-69,17
28,1,0,0,1,2021-10-12,Male,61,55-64,1
28,0,0,0,0,2021-10-08,Male,28,25-34,7
28,1,1,0,2,2021-10-08,Female,71,70-74,2
28,0,1,0,1,2021-10-18,Male,69,65-69,1
28,0,0,0,0,2021-10-12,Male,55,55-64,1
28,1,1,0,2,2021-10-12,Female,53,45-54,1
28,3,16,21,40,2021-10-08,Male,14,10-14,2
28,0,0,0,0,2021-10-15,Female,70,70-74,15
28,0,3,0,3,2021-10-08,Male,70,70-74,2
28,1,0,0,1,2021-10-08,Female,49,45-54,18
28,0,0,0,0,2021-10-08,Male,48,45-54,3
28,1,0,0,1,2021-10-19,Female,55,55-64,10
28,0,0,0,0,2021-10-12,Male,60,55-64,1
28,1,15,100,116,2021-10-08,Female,59,55-64,4
28,1,1,0,2,2021-10-15,Male,73,70-74,6
28,2,0,0,2,2021-10-15,Male,4,1-4,2
28,0,0,0,0,2021-10-08,Male,26,25-34,3
28,1,0,0,1,2021-10-11,Male,61,55-64,2
28,1,2,0,3,2021-10-08,Male,70,70-74,2
28,0,0,0,0,2021-10-09,Female,23,20-24,4
28,1,2,0,3,2021-10-11,Male,18,15-19,2
28,1,1,0,2,2021-10-08,Female,62,55-64,3
28,1,0,0,1,2021-10-12,Female,54,45-54,2
28,0,0,0,0,2021-10-08,Female,42,35-44,2
28,1,3,0,4,2021-10-11,Male,58,55-64,2
28,2,0,0,2,2021-10-12,Female,17,15-19,1
28,0,0,0,0,2021-10-09,Female,34,25-34,3
28,0,0,0,0,2021-10-15,Female,68,65-69,2
28,1,0,0,1,2021-10-12,Male,60,55-64,1
28,2,3,0,5,2021-10-08,Female,16,15-19,2
28,1,3,0,4,2021-10-08,Female,64,55-64,2
28,1,0,0,1,2021-10-08,Male,71,70-74,2
28,1,0,0,1,2021-10-11,Female,42,35-44,14
28,2,0,0,2,2021-10-15,Female,71,70-74,19
28,2,0,0,2,2021-10-08,Male,7,5-9,3
28,1,0,0,1,2021-10-18,Male,69,65-69,1
28,1,5,0,6,2021-10-08,Female,39,35-44,2
28,2,7,0,9,2021-10-08,Male,1,1-4,2
28,1,0,0,1,2021-10-10,Female,71,70-74,5
28,3,29,0,32,2021-10-08,Female,12,10-14,10
28,1,1,0,2,2021-10-08,Male,71,70-74,2
28,1,11,0,12,2021-10-12,Female,50,45-54,1
28,1,1,0,2,2021-10-08,Female,37,35-44,5
28,2,4,0,6,2021-10-08,Female,28,25-34,8
28,1,0,0,1,2021-10-08,Female,37,35-44,17
28,1,0,0,1,2021-10-08,Female,63,55-64,8
28,0,5,0,5,2021-10-16,Male,66,65-69,4
28,1,0,0,1,2021-10-12,Male,32,25-34,3
28,4,10,0,14,2021-10-08,Male,4,1-4,3
28,3,0,0,3,2021-10-08,Female,67,65-69,21
28,0,1,0,1,2021-10-11,Male,54,45-54,9
28,0,4,0,4,2021-10-08,Male,58,55-64,8
28,0,0,0,0,2021-10-08,Male,29,25-34,8
28,1,0,0,1,2021-10-08,Female,60,55-64,13
28,2,0,0,2,2021-10-10,Female,50,45-54,12
28,0,3,0,3,2021-10-10,Female,54,45-54,2
28,1,0,0,1,2021-10-08,Male,39,35-44,7
28,0,7,0,7,2021-10-09,Female,30,25-34,2
28,2,0,0,2,2021-10-08,Male,31,25-34,4
28,0,2,0,2,2021-10-08,Male,60,55-64,8
28,0,5,0,5,2021-10-08,Male,50,45-54,3
28,3,0,0,3,2021-10-12,Male,14,10-14,1
28,1,1,0,2,2021-10-12,Female,71,70-74,2
28,0,0,0,0,2021-10-12,Male,53,45-54,1
28,1,3,0,4,2021-10-08,Female,54,45-54,2
28,2,0,0,2,2021-10-11,Female,4,1-4,4
28,1,2,0,3,2021-10-09,Female,31,25-34,11
28,1,0,0,1,2021-10-08,Female,62,55-64,2
28,2,2,0,4,2021-10-10,Male,24,20-24,4
28,1,0,0,1,2021-10-10,Female,60,55-64,3
28,3,0,0,3,2021-10-16,Male,1,1-4,2
28,1,0,0,1,2021-10-08,Female,55,55-64,8
28,1,0,0,1,2021-10-08,Female,73,70-74,8
28,1,0,0,1,2021-10-08,Female,43,35-44,5
28,0,2,0,2,2021-10-08,Female,30,25-34,3
28,1,0,0,1,2021-10-08,Male,70,70-74,2
28,2,0,0,2,2021-10-08,Male,35,35-44,9
28,0,30,0,30,2021-10-12,Female,53,45-54,1
28,1,2,0,3,2021-10-09,Female,72,70-74,12
28,0,0,0,0,2021-10-10,Female,65,65-69,7
28,1,0,0,1,2021-10-08,Male,63,55-64,19
28,0,0,0,0,2021-10-08,Male,45,45-54,7
28,1,0,0,1,2021-10-12,Female,58,55-64,1
28,0,0,0,0,2021-10-09,Female,69,65-69,7
28,0,1,0,1,2021-10-08,Female,70,70-74,3
28,1,2,0,3,2021-10-17,Female,30,25-34,2
28,0,0,0,0,2021-10-08,Male,57,55-64,2
28,2,7,0,9,2021-10-12,Female,45,45-54,1
28,2,0,0,2,2021-10-08,Female,26,25-34,11
28,0,0,0,0,2021-10-08,Female,65,65-69,3
28,2,0,0,2,2021-10-08,Male,11,10-14,2
28,1,2,0,3,2021-10-19,Male,69,65-69,1
28,0,1,0,1,2021-10-08,Female,56,55-64,7
28,0,0,0,0,2021-10-19,Male,80,80-84,1
28,1,0,0,1,2021-10-19,Male,66,65-69,1
28,3,0,0,3,2021-10-08,Male,11,10-14,8
28,0,5,0,5,2021-10-08,Female,28,25-34,3
28,2,0,0,2,2021-10-08,Male,45,45-54,8
28,1,0,0,1,2021-10-08,Female,72,70-74,2
28,0,4,0,4,2021-10-13,Female,77,75-79,1
28,2,0,0,2,2021-10-10,Female,46,45-54,7
28,2,0,0,2,2021-10-08,Female,69,65-69,3
28,0,0,3,3,2021-10-19,Male,67,65-69,6
28,3,0,0,3,2021-10-10,Female,20,20-24,5
28,1,0,0,1,2021-10-08,Female,38,35-44,7
28,0,0,0,0,2021-10-08,Male,51,45-54,4
28,0,4,0,4,2021-10-19,Male,62,55-64,1
28,1,2,0,3,2021-10-08,Male,63,55-64,5
28,2,1,0,3,2021-10-08,Male,19,15-19,2
28,0,10,0,10,2021-10-12,Female,55,55-64,1
28,1,0,0,1,2021-10-09,Male,60,55-64,4
28,0,1,0,1,2021-10-08,Female,70,70-74,2
28,0,0,0,0,2021-10-08,Female,35,35-44,4
28,0,1,0,1,2021-10-09,Female,61,55-64,2
28,0,0,0,0,2021-10-08,Male,65,65-69,2
28,1,0,0,1,2021-10-09,Female,59,55-64,23
28,3,5,0,8,2021-10-08,Male,17,15-19,7
28,3,0,0,3,2021-10-08,Male,2,1-4,4
28,0,3,0,3,2021-10-08,Female,44,35-44,2
28,0,0,0,0,2021-10-18,Male,77,75-79,1
28,0,0,0,0,2021-10-08,Female,66,65-69,7
28,1,0,0,1,2021-10-08,Female,58,55-64,3
28,2,10,0,12,2021-10-19,Female,2,1-4,1
28,1,0,0,1,2021-10-08,Female,55,55-64,4
28,0,2,5,7,2021-10-12,Female,59,55-64,1
28,1,2,0,3,2021-10-12,Female,58,55-64,1
28,0,0,0,0,2021-10-08,Female,34,25-34,3
28,0,0,0,0,2021-10-12,Male,62,55-64,1
28,1,1,0,2,2021-10-12,Male,68,65-69,1
28,1,0,0,1,2021-10-08,Male,6,5-9,3
28,4,0,0,4,2021-10-11,Female,33,25-34,19
28,0,0,0,0,2021-10-08,Female,0,<1,7
28,0,0,0,0,2021-10-08,Female,22,20-24,11
28,1,0,0,1,2021-10-19,Male,75,75-79,1
28,2,1,0,3,2021-10-08,Female,18,15-19,20
28,1,0,0,1,2021-10-08,Female,73,70-74,7
28,1,0,0,1,2021-10-08,Female,85,85+,2
28,1,0,0,1,2021-10-09,Male,47,45-54,3
28,1,2,0,3,2021-10-08,Female,63,55-64,3
28,2,0,0,2,2021-10-08,Female,16,15-19,7
28,1,0,0,1,2021-10-09,Male,68,65-69,7
28,0,0,0,0,2021-10-09,Female,32,25-34,7
28,0,7,0,7,2021-10-08,Male,62,55-64,3
28,1,1,0,2,2021-10-19,Male,71,70-74,1
28,1,0,0,1,2021-10-08,Male,58,55-64,4
28,0,1,0,1,2021-10-08,Male,35,35-44,3
28,0,1,0,1,2021-10-08,Female,68,65-69,19
28,1,2,0,3,2021-10-08,Female,43,35-44,6
28,1,0,0,1,2021-10-16,Female,41,35-44,5
28,1,0,0,1,2021-10-08,Female,21,20-24,4
28,1,0,0,1,2021-10-08,Male,64,55-64,7
28,0,1,0,1,2021-10-12,Male,60,55-64,1
28,1,0,0,1,2021-10-08,Female,46,45-54,8
28,0,0,0,0,2021-10-08,Female,52,45-54,7
28,1,0,0,1,2021-10-12,Female,54,45-54,2
28,1,0,0,1,2021-10-12,Female,31,25-34,2
28,1,0,0,1,2021-10-10,Female,67,65-69,6
28,1,1,0,2,2021-10-08,Male,61,55-64,3
28,0,0,0,0,2021-10-08,Male,54,45-54,7
28,2,2,0,4,2021-10-14,Male,0,<1,3
28,1,0,0,1,2021-10-08,Female,35,35-44,8
28,1,0,0,1,2021-10-08,Male,53,45-54,7
28,3,0,0,3,2021-10-08,Female,3,1-4,2
28,0,0,0,0,2021-10-08,Male,36,35-44,7
28,0,0,0,0,2021-10-08,Male,51,45-54,6
28,1,0,0,1,2021-10-15,Male,71,70-74,2
28,3,0,8,11,2021-10-08,Female,1,1-4,2
28,3,16,0,19,2021-10-08,Female,6,5-9,8
28,1,0,0,1,2021-10-08,Male,36,35-44,3
28,0,2,0,2,2021-10-08,Female,33,25-34,3
28,0,2,0,2,2021-10-18,Male,78,75-79,1
28,0,0,0,0,2021-10-16,Female,23,20-24,12
28,0,0,0,0,2021-10-10,Female,57,55-64,5
28,1,30,0,31,2021-10-08,Male,68,65-69,4
28,0,4,0,4,2021-10-12,Female,51,45-54,1
28,2,1,0,3,2021-10-10,Female,51,45-54,17
28,4,0,0,4,2021-10-17,Female,1,1-4,2
28,1,0,0,1,2021-10-11,Male,61,55-64,4
28,1,0,0,1,2021-10-09,Male,33,25-34,15
28,1,0,0,1,2021-10-14,Female,23,20-24,6
28,2,0,0,2,2021-10-08,Male,25,25-34,7
28,0,0,0,0,2021-10-10,Male,41,35-44,3
28,1,0,0,1,2021-10-08,Male,36,35-44,2
28,1,2,0,3,2021-10-16,Female,32,25-34,3
28,1,0,0,1,2021-10-18,Male,74,70-74,1
28,1,0,0,1,2021-10-19,Male,66,65-69,1
28,2,0,0,2,2021-10-08,Female,55,55-64,3
28,1,0,0,1,2021-10-10,Female,49,45-54,2
28,0,0,0,0,2021-10-08,Female,65,65-69,7
28,0,0,0,0,2021-10-12,Male,34,25-34,8
28,1,0,2,3,2021-10-11,Female,24,20-24,3
28,0,0,0,0,2021-10-10,Female,66,65-69,4
28,1,0,0,1,2021-10-08,Male,66,65-69,3
28,1,0,0,1,2021-10-12,Female,68,65-69,1
28,1,0,0,1,2021-10-18,Male,76,75-79,1
28,2,0,0,2,2021-10-18,Male,66,65-69,1
28,2,0,0,2,2021-10-08,Male,10,10-14,2
28,2,5,0,7,2021-10-19,Female,29,25-34,1
28,1,5,0,6,2021-10-08,Female,35,35-44,2
28,1,0,0,1,2021-10-19,Female,23,20-24,1
28,2,0,0,2,2021-10-08,Female,18,15-19,4
28,0,0,0,0,2021-10-14,Female,70,70-74,20
28,1,0,0,1,2021-10-12,Male,71,70-74,1
28,1,0,0,1,2021-10-08,Male,71,70-74,2
28,1,5,0,6,2021-10-08,Female,62,55-64,7
28,1,0,0,1,2021-10-19,Male,72,70-74,1
28,0,0,0,0,2021-10-08,Male,47,45-54,2
28,0,1,0,1,2021-10-08,Female,74,70-74,7
28,0,0,0,0,2021-10-12,Female,16,15-19,1
28,1,2,0,3,2021-10-15,Male,85,85+,4
28,0,1,0,1,2021-10-12,Female,48,45-54,8
28,1,0,0,1,2021-10-08,Female,52,45-54,2
28,1,0,0,1,2021-10-08,Female,60,55-64,2
28,1,1,0,2,2021-10-10,Female,28,25-34,2
28,0,0,0,0,2021-10-11,Male,18,15-19,3
28,0,0,0,0,2021-10-12,Female,62,55-64,1
28,0,0,0,0,2021-10-11,Female,6,5-9,2
28,3,15,20,38,2021-10-12,Female,18,15-19,16
28,1,2,0,3,2021-10-08,Male,81,80-84,2
28,1,0,0,1,2021-10-08,Male,66,65-69,6
28,1,0,0,1,2021-10-09,Female,63,55-64,2
28,0,2,0,2,2021-10-11,Male,50,45-54,1
28,1,0,8,9,2021-10-12,Female,47,45-54,1
28,3,0,0,3,2021-10-08,Female,13,10-14,2
28,0,0,0,0,2021-10-11,Male,74,70-74,16
28,0,0,0,0,2021-10-10,Female,35,35-44,2
28,1,0,0,1,2021-10-10,Female,23,20-24,2
28,0,2,0,2,2021-10-08,Female,39,35-44,3
28,0,0,0,0,2021-10-09,Male,25,25-34,3
28,1,0,0,1,2021-10-11,Male,32,25-34,21
28,0,0,0,0,2021-10-20,Male,70,70-74,5
28,3,10,0,13,2021-10-08,Male,2,1-4,4
28,1,1,0,2,2021-10-08,Female,46,45-54,2
28,3,2,0,5,2021-10-19,Male,1,1-4,1
28,1,0,0,1,2021-10-08,Male,56,55-64,3
28,0,0,0,0,2021-10-08,Male,48,45-54,2
28,1,3,0,4,2021-10-12,Male,60,55-64,1
28,1,0,0,1,2021-10-08,Female,54,45-54,2
28,0,0,0,0,2021-10-08,Female,28,25-34,2
28,0,0,0,0,2021-10-08,Female,78,75-79,2
28,1,1,0,2,2021-10-12,Female,64,55-64,1
28,2,1,0,3,2021-10-09,Male,16,15-19,2
28,0,0,0,0,2021-10-08,Female,32,25-34,3
28,1,0,0,1,2021-10-08,Male,53,45-54,8
28,1,0,0,1,2021-10-08,Male,49,45-54,5
28,1,0,0,1,2021-10-11,Female,24,20-24,1
28,1,0,0,1,2021-10-11,Male,60,55-64,2
28,3,2,0,5,2021-10-08,Male,12,10-14,8
28,1,0,0,1,2021-10-09,Male,55,55-64,7
28,0,5,5,10,2021-10-19,Female,27,25-34,1
28,1,2,0,3,2021-10-19,Female,55,55-64,1
28,0,3,0,3,2021-10-08,Male,51,45-54,8
28,1,0,0,1,2021-10-08,Female,50,45-54,5
28,0,0,0,0,2021-10-20,Male,62,55-64,1
28,0,7,0,7,2021-10-08,Female,40,35-44,4
28,4,1,0,5,2021-10-19,Female,14,10-14,6
28,0,1,0,1,2021-10-08,Male,49,45-54,4
28,0,0,0,0,2021-10-19,Female,31,25-34,17
28,0,0,0,0,2021-10-10,Female,66,65-69,8
28,1,1,0,2,2021-10-08,Male,41,35-44,3
28,2,0,0,2,2021-10-12,Female,63,55-64,1
28,0,0,0,0,2021-10-12,Female,52,45-54,1
28,0,0,0,0,2021-10-08,Male,62,55-64,3
28,0,0,0,0,2021-10-08,Male,70,70-74,3
28,2,0,0,2,2021-10-10,Female,10,10-14,2
28,0,0,0,0,2021-10-10,Male,58,55-64,19
28,2,0,0,2,2021-10-08,Female,18,15-19,4
28,1,2,0,3,2021-10-09,Female,79,75-79,2
28,1,5,0,6,2021-10-09,Female,62,55-64,8
28,2,0,0,2,2021-10-08,Female,69,65-69,17
28,0,1,0,1,2021-10-08,Female,27,25-34,2
28,0,2,0,2,2021-10-12,Female,53,45-54,1
28,0,1,0,1,2021-10-11,Female,30,25-34,3
28,2,1,0,3,2021-10-08,Female,47,45-54,11
28,1,0,0,1,2021-10-08,Female,57,55-64,7
28,1,0,0,1,2021-10-08,Male,52,45-54,5
28,0,1,0,1,2021-10-17,Female,66,65-69,2
28,1,0,0,1,2021-10-08,Female,40,35-44,2
28,1,0,0,1,2021-10-08,Female,60,55-64,8
28,0,0,0,0,2021-10-09,Female,66,65-69,2
28,2,4,0,6,2021-10-19,Male,70,70-74,2
28,1,0,0,1,2021-10-10,Male,55,55-64,14
28,1,0,0,1,2021-10-12,Female,31,25-34,2
28,0,0,0,0,2021-10-08,Male,31,25-34,4
28,1,0,0,1,2021-10-08,Male,71,70-74,2
28,1,1,0,2,2021-10-19,Female,77,75-79,1
28,1,0,20,21,2021-10-08,Female,45,45-54,2
28,0,0,0,0,2021-10-08,Male,55,55-64,8
28,1,0,0,1,2021-10-08,Male,69,65-69,2
28,1,2,0,3,2021-10-11,Female,50,45-54,2
28,1,0,0,1,2021-10-08,Female,77,75-79,2
28,0,1,1,2,2021-10-12,Female,58,55-64,1
28,0,1,0,1,2021-10-12,Female,49,45-54,1
28,1,0,0,1,2021-10-12,Male,9,5-9,4
28,2,0,0,2,2021-10-08,Female,13,10-14,8
28,1,15,0,16,2021-10-08,Male,70,70-74,2
28,0,0,0,0,2021-10-08,Male,69,65-69,2
28,1,0,0,1,2021-10-08,Female,54,45-54,5
28,0,2,0,2,2021-10-19,Male,67,65-69,1
28,1,0,0,1,2021-10-18,Male,75,75-79,1
28,0,5,13,18,2021-10-08,Male,61,55-64,2
28,1,0,0,1,2021-10-11,Male,60,55-64,7
28,2,2,0,4,2021-10-08,Female,49,45-54,7
28,1,0,0,1,2021-10-08,Male,85,85+,5
28,0,2,0,2,2021-10-08,Male,42,35-44,5
28,0,0,0,0,2021-10-18,Male,33,25-34,1
28,0,6,0,6,2021-10-08,Female,63,55-64,3
28,1,1,0,2,2021-10-08,Female,69,65-69,8
28,3,0,0,3,2021-10-08,Male,55,55-64,3
28,0,2,0,2,2021-10-09,Female,42,35-44,2
28,1,0,0,1,2021-10-12,Female,14,10-14,1
28,1,2,0,3,2021-10-09,Female,69,65-69,2
28,3,0,0,3,2021-10-08,Male,18,15-19,18
28,0,0,0,0,2021-10-11,Male,54,45-54,2
28,2,1,0,3,2021-10-08,Female,53,45-54,2
28,0,0,0,0,2021-10-08,Male,52,45-54,6
28,0,0,0,0,2021-10-08,Male,38,35-44,2
28,0,2,0,2,2021-10-08,Male,45,45-54,5
28,9,0,0,9,2021-10-15,Male,9,5-9,2
28,1,0,0,1,2021-10-10,Male,54,45-54,6
28,0,0,0,0,2021-10-09,Female,53,45-54,3
28,1,1,0,2,2021-10-19,Male,80,80-84,1
28,0,1,0,1,2021-10-08,Female,55,55-64,8
28,1,0,0,1,2021-10-12,Female,70,70-74,6
28,3,1,0,4,2021-10-08,Male,59,55-64,7
28,0,10,0,10,2021-10-09,Female,52,45-54,4
28,1,3,0,4,2021-10-08,Male,29,25-34,4
28,2,1,0,3,2021-10-08,Male,51,45-54,8
28,1,0,0,1,2021-10-08,Female,53,45-54,2
28,1,0,0,1,2021-10-08,Male,68,65-69,6
28,0,1,0,1,2021-10-10,Male,44,35-44,3
28,1,2,0,3,2021-10-08,Male,36,35-44,2
28,1,0,0,1,2021-10-08,Female,67,65-69,8
28,2,0,0,2,2021-10-08,Male,50,45-54,3
28,0,0,0,0,2021-10-08,Female,65,65-69,6
28,2,0,0,2,2021-10-09,Male,68,65-69,20
28,0,0,0,0,2021-10-08,Male,50,45-54,2
28,1,2,0,3,2021-10-08,Female,13,10-14,2
28,0,0,0,0,2021-10-08,Female,58,55-64,19
28,0,8,0,8,2021-10-11,Female,74,70-74,3
28,1,4,0,5,2021-10-08,Male,45,45-54,7
28,0,0,0,0,2021-10-15,Female,26,25-34,8
28,1,0,0,1,2021-10-12,Female,55,55-64,2
28,1,0,0,1,2021-10-08,Male,68,65-69,4
28,0,0,0,0,2021-10-12,Female,60,55-64,1
28,1,4,0,5,2021-10-12,Female,62,55-64,1
28,0,4,0,4,2021-10-09,Male,41,35-44,2
28,3,0,0,3,2021-10-08,Female,50,45-54,4
28,0,2,0,2,2021-10-09,Female,65,65-69,7
28,1,2,5,8,2021-10-10,Male,50,45-54,4
28,0,1,0,1,2021-10-08,Female,67,65-69,4
28,1,0,0,1,2021-10-08,Male,53,45-54,3
28,0,1,0,1,2021-10-16,Male,35,35-44,19
28,1,0,0,1,2021-10-08,Male,53,45-54,8
28,0,0,0,0,2021-10-12,Male,31,25-34,12
28,0,2,0,2,2021-10-08,Female,47,45-54,8
28,0,0,0,0,2021-10-10,Female,24,20-24,6
28,2,4,0,6,2021-10-14,Male,66,65-69,2
28,0,1,5,6,2021-10-16,Female,71,70-74,2
28,1,1,0,2,2021-10-08,Female,74,70-74,8
28,0,0,0,0,2021-10-08,Male,72,70-74,2
28,0,0,0,0,2021-10-12,Female,62,55-64,1
28,1,0,0,1,2021-10-08,Female,65,65-69,2
28,0,0,0,0,2021-10-08,Female,53,45-54,7
28,1,8,0,9,2021-10-08,Female,76,75-79,7
28,1,0,0,1,2021-10-12,Female,52,45-54,1
28,1,0,0,1,2021-10-08,Female,34,25-34,3
28,0,0,0,0,2021-10-08,Male,59,55-64,3
28,1,40,0,41,2021-10-12,Female,49,45-54,1
28,2,0,0,2,2021-10-10,Female,36,35-44,14
28,1,0,0,1,2021-10-08,Female,41,35-44,3
28,1,0,0,1,2021-10-08,Female,51,45-54,2
28,0,0,0,0,2021-10-19,Male,72,70-74,1
28,1,0,0,1,2021-10-08,Male,60,55-64,3
28,1,2,0,3,2021-10-08,Male,68,65-69,2
28,0,0,0,0,2021-10-08,Female,74,70-74,2
28,1,0,0,1,2021-10-18,Male,72,70-74,1
28,0,2,0,2,2021-10-12,Male,57,55-64,1
28,2,1,0,3,2021-10-08,Male,22,20-24,6
28,3,3,0,6,2021-10-18,Female,4,1-4,1
28,1,3,0,4,2021-10-10,Male,65,65-69,2
28,0,3,0,3,2021-10-08,Male,52,45-54,2
28,1,0,0,1,2021-10-08,Female,71,70-74,20
28,1,0,0,1,2021-10-19,Male,72,70-74,1
28,2,0,0,2,2021-10-19,Female,57,55-64,1
28,3,18,0,21,2021-10-08,Male,5,5-9,8
28,3,0,0,3,2021-10-11,Female,37,35-44,15
28,1,5,0,6,2021-10-16,Female,35,35-44,1
28,0,0,0,0,2021-10-18,Female,30,25-34,1
28,1,3,0,4,2021-10-08,Female,67,65-69,7
28,1,0,0,1,2021-10-08,Female,33,25-34,2
28,1,2,0,3,2021-10-08,Male,40,35-44,3
28,1,0,2,3,2021-10-08,Male,65,65-69,6
28,2,1,0,3,2021-10-08,Male,66,65-69,6
28,2,0,0,2,2021-10-08,Female,14,10-14,3
28,0,0,0,0,2021-10-08,Male,49,45-54,2
28,0,0,0,0,2021-10-18,Female,7,5-9,2
28,0,4,0,4,2021-10-09,Female,40,35-44,2
28,2,0,0,2,2021-10-10,Male,33,25-34,21
28,1,0,0,1,2021-10-08,Male,52,45-54,3
28,1,20,13,34,2021-10-09,Male,60,55-64,16
28,0,0,0,0,2021-10-08,Female,43,35-44,2
28,1,0,0,1,2021-10-08,Male,67,65-69,4
28,1,0,0,1,2021-10-08,Male,50,45-54,2
28,1,7,0,8,2021-10-19,Male,71,70-74,1
28,1,0,0,1,2021-10-08,Female,59,55-64,22
28,2,2,0,4,2021-10-20,Female,1,1-4,1
28,0,0,14,14,2021-10-08,Female,6,5-9,5
28,3,0,0,3,2021-10-18,Male,9,5-9,1
28,3,0,0,3,2021-10-08,Female,50,45-54,2
28,2,2,0,4,2021-10-11,Male,11,10-14,2
28,1,7,0,8,2021-10-08,Female,69,65-69,2
28,1,0,0,1,2021-10-13,Female,32,25-34,3
28,1,0,0,1,2021-10-19,Male,70,70-74,1
28,0,5,0,5,2021-10-08,Male,49,45-54,2
28,0,0,0,0,2021-10-08,Male,69,65-69,2
28,1,3,0,4,2021-10-08,Male,67,65-69,8
28,0,6,0,6,2021-10-12,Male,53,45-54,4
28,1,0,0,1,2021-10-18,Male,65,65-69,1
28,0,2,0,2,2021-10-15,Female,30,25-34,2
28,0,9,0,9,2021-10-12,Female,56,55-64,1
28,1,10,0,11,2021-10-08,Male,53,45-54,3
28,0,0,0,0,2021-10-12,Female,65,65-69,1
28,0,0,0,0,2021-10-10,Male,23,20-24,3
28,0,0,0,0,2021-10-08,Male,83,80-84,12
28,0,0,0,0,2021-10-08,Female,40,35-44,2
28,1,3,0,4,2021-10-19,Male,80,80-84,1
28,1,7,30,38,2021-10-12,Female,63,55-64,1
28,0,0,0,0,2021-10-16,Male,24,20-24,2
28,0,0,0,0,2021-10-08,Male,63,55-64,2
28,2,2,0,4,2021-10-08,Female,1,1-4,2
28,1,0,0,1,2021-10-19,Female,56,55-64,1
28,0,0,0,0,2021-10-09,Female,72,70-74,6
28,1,1,0,2,2021-10-08,Male,79,75-79,12
28,1,1,0,2,2021-10-19,Male,74,70-74,1
28,1,4,0,5,2021-10-08,Male,64,55-64,8
28,1,3,0,4,2021-10-08,Male,70,70-74,3
28,1,0,0,1,2021-10-08,Male,37,35-44,12
28,1,0,0,1,2021-10-11,Male,58,55-64,2
28,0,0,0,0,2021-10-08,Female,29,25-34,8
28,1,0,0,1,2021-10-11,Female,22,20-24,10
28,1,0,0,1,2021-10-08,Male,35,35-44,13
28,0,11,0,11,2021-10-08,Male,58,55-64,2
28,0,0,0,0,2021-10-08,Female,42,35-44,2
28,0,0,0,0,2021-10-08,Male,38,35-44,7
28,1,0,0,1,2021-10-08,Female,52,45-54,9
28,1,1,1,3,2021-10-08,Male,72,70-74,3
28,0,0,0,0,2021-10-08,Female,58,55-64,2
28,1,0,0,1,2021-10-08,Female,58,55-64,3
28,1,0,0,1,2021-10-12,Male,63,55-64,1
28,0,0,0,0,2021-10-10,Male,79,75-79,2
28,0,0,0,0,2021-10-08,Female,37,35-44,7
28,0,0,0,0,2021-10-12,Male,61,55-64,1
28,1,0,0,1,2021-10-17,Male,73,70-74,2
28,3,6,0,9,2021-10-08,Male,6,5-9,2
28,1,0,0,1,2021-10-12,Female,57,55-64,1
28,2,0,0,2,2021-10-11,Male,1,1-4,3
28,0,0,0,0,2021-10-12,Male,63,55-64,1
28,0,0,0,0,2021-10-08,Male,43,35-44,4
28,0,0,0,0,2021-10-10,Female,29,25-34,1
28,1,0,0,1,2021-10-08,Male,61,55-64,8
28,0,1,0,1,2021-10-09,Male,75,75-79,17
28,0,0,15,15,2021-10-10,Male,51,45-54,2
28,5,0,0,5,2021-10-08,Male,2,1-4,2
28,0,0,0,0,2021-10-10,Female,24,20-24,5
28,2,1,0,3,2021-10-08,Female,71,70-74,2
28,2,0,0,2,2021-10-15,Male,40,35-44,3
28,1,0,5,6,2021-10-09,Male,56,55-64,2
28,1,5,0,6,2021-10-18,Male,69,65-69,1
28,0,2,0,2,2021-10-12,Female,64,55-64,1
28,0,2,0,2,2021-10-08,Male,53,45-54,3
28,0,30,8,38,2021-10-08,Male,71,70-74,3
28,0,0,0,0,2021-10-08,Male,46,45-54,2
28,1,0,0,1,2021-10-12,Female,16,15-19,1
28,1,0,0,1,2021-10-08,Male,53,45-54,4
28,0,10,0,10,2021-10-08,Female,50,45-54,8
28,1,0,0,1,2021-10-08,Male,67,65-69,8
28,1,0,0,1,2021-10-08,Male,58,55-64,2
28,0,1,0,1,2021-10-08,Female,63,55-64,3
28,1,0,0,1,2021-10-18,Male,67,65-69,1
28,0,0,0,0,2021-10-08,Male,65,65-69,2
28,0,0,0,0,2021-10-09,Female,53,45-54,19
28,0,2,0,2,2021-10-09,Female,65,65-69,3
28,1,0,0,1,2021-10-08,Female,60,55-64,2
28,1,0,0,1,2021-10-08,Female,35,35-44,18
28,1,6,0,7,2021-10-19,Male,72,70-74,2
28,2,0,0,2,2021-10-08,Female,4,1-4,7
28,1,0,0,1,2021-10-10,Male,40,35-44,5
28,4,0,0,4,2021-10-08,Female,4,1-4,7
28,1,0,0,1,2021-10-11,Male,55,55-64,15
28,3,0,0,3,2021-10-08,Male,12,10-14,2
28,1,0,0,1,2021-10-08,Female,72,70-74,5
28,0,0,0,0,2021-10-09,Male,60,55-64,8
28,0,1,0,1,2021-10-12,Male,24,20-24,7
28,0,5,0,5,2021-10-19,Female,66,65-69,1
28,0,0,0,0,2021-10-08,Male,66,65-69,8
28,1,0,0,1,2021-10-08,Female,34,25-34,3
28,0,3,0,3,2021-10-08,Female,30,25-34,4
28,2,0,0,2,2021-10-08,Male,15,15-19,2
28,0,2,0,2,2021-10-08,Male,44,35-44,16
28,0,0,0,0,2021-10-08,Male,72,70-74,2
28,3,0,0,3,2021-10-09,Female,42,35-44,2
28,1,2,0,3,2021-10-10,Male,69,65-69,7
28,1,0,0,1,2021-10-08,Female,71,70-74,3
28,0,0,0,0,2021-10-08,Female,77,75-79,8
28,0,0,0,0,2021-10-12,Male,60,55-64,1
28,0,10,0,10,2021-10-12,Female,53,45-54,1
28,0,0,0,0,2021-10-08,Male,40,35-44,8
28,1,0,0,1,2021-10-12,Female,69,65-69,3
28,2,1,0,3,2021-10-08,Male,60,55-64,4
28,1,2,0,3,2021-10-08,Male,78,75-79,8
28,0,0,0,0,2021-10-10,Female,68,65-69,17
28,1,1,0,2,2021-10-08,Male,62,55-64,8
28,1,0,0,1,2021-10-12,Female,57,55-64,1
28,0,0,0,0,2021-10-13,Female,66,65-69,3
28,0,2,0,2,2021-10-13,Male,43,35-44,2
28,1,0,0,1,2021-10-12,Female,60,55-64,1
28,1,0,0,1,2021-10-12,Female,57,55-64,1
28,0,1,0,1,2021-10-12,Male,54,45-54,1
28,0,0,0,0,2021-10-19,Male,69,65-69,1
28,1,2,8,11,2021-10-16,Male,66,65-69,2
28,1,0,0,1,2021-10-09,Male,32,25-34,3
28,0,0,0,0,2021-10-08,Female,51,45-54,4
28,0,2,0,2,2021-10-09,Female,66,65-69,20
28,0,1,0,1,2021-10-08,Male,80,80-84,3
28,1,0,0,1,2021-10-08,Male,33,25-34,2
28,1,2,0,3,2021-10-12,Male,64,55-64,1
28,0,0,0,0,2021-10-12,Female,66,65-69,19
28,2,2,0,4,2021-10-09,Male,17,15-19,2
28,1,0,0,1,2021-10-12,Female,58,55-64,1
28,3,0,0,3,2021-10-08,Male,1,1-4,4
28,0,0,0,0,2021-10-10,Female,21,20-24,3
28,0,0,0,0,2021-10-08,Female,36,35-44,7
28,0,0,0,0,2021-10-09,Male,42,35-44,2
28,2,0,0,2,2021-10-10,Female,55,55-64,6
28,1,0,0,1,2021-10-14,Female,68,65-69,15
28,1,5,35,41,2021-10-19,Male,80,80-84,1
28,1,0,0,1,2021-10-11,Female,42,35-44,16
28,2,0,0,2,2021-10-20,Male,7,5-9,1
28,0,0,0,0,2021-10-13,Female,33,25-34,3
28,3,0,0,3,2021-10-18,Male,28,25-34,1
28,1,3,0,4,2021-10-09,Female,30,25-34,2
28,2,0,0,2,2021-10-08,Male,50,45-54,2
28,2,8,0,10,2021-10-12,Male,68,65-69,22
28,1,1,0,2,2021-10-09,Female,77,75-79,18
28,0,0,0,0,2021-10-08,Male,68,65-69,4
28,1,0,0,1,2021-10-08,Male,77,75-79,7
28,1,0,0,1,2021-10-08,Male,40,35-44,7
28,0,0,0,0,2021-10-10,Female,25,25-34,4
28,0,0,0,0,2021-10-14,Male,40,35-44,5
28,1,0,0,1,2021-10-08,Male,69,65-69,7
28,0,0,0,0,2021-10-08,Male,27,25-34,8
28,2,0,0,2,2021-10-12,Female,1,1-4,2
28,1,0,0,1,2021-10-08,Female,56,55-64,3
28,2,2,0,4,2021-10-10,Female,9,5-9,2
28,0,0,100,100,2021-10-10,Male,28,25-34,17
28,0,0,2,2,2021-10-09,Male,25,25-34,3
28,4,18,10,32,2021-10-09,Female,7,5-9,12
28,0,1,0,1,2021-10-08,Female,52,45-54,4
28,0,4,0,4,2021-10-11,Male,69,65-69,10
28,0,0,0,0,2021-10-08,Female,34,25-34,3
28,1,1,0,2,2021-10-08,Female,67,65-69,6
28,1,0,1,2,2021-10-08,Female,52,45-54,6
28,0,3,0,3,2021-10-15,Female,81,80-84,6
28,0,4,0,4,2021-10-08,Female,30,25-34,15
28,0,0,30,30,2021-10-09,Female,13,10-14,2
28,0,1,0,1,2021-10-09,Male,65,65-69,2
28,1,2,0,3,2021-10-08,Female,67,65-69,5
28,2,0,0,2,2021-10-08,Male,15,15-19,21
28,1,0,0,1,2021-10-08,Male,56,55-64,6
28,1,1,0,2,2021-10-19,Female,72,70-74,1
28,3,4,0,7,2021-10-12,Male,10,10-14,1
28,0,0,0,0,2021-10-09,Female,37,35-44,3
28,3,0,0,3,2021-10-11,Male,1,1-4,3
28,2,0,0,2,2021-10-08,Female,66,65-69,8
28,1,0,0,1,2021-10-08,Female,62,55-64,2
28,1,0,0,1,2021-10-12,Female,51,45-54,1
28,2,0,0,2,2021-10-10,Female,53,45-54,4
28,1,0,0,1,2021-10-08,Male,45,45-54,4
28,0,0,0,0,2021-10-08,Male,43,35-44,8
28,1,0,0,1,2021-10-12,Female,55,55-64,3
28,0,1,0,1,2021-10-10,Male,67,65-69,17
28,1,2,0,3,2021-10-18,Male,71,70-74,1
28,2,0,0,2,2021-10-08,Female,54,45-54,3
28,1,0,0,1,2021-10-08,Female,81,80-84,3
28,1,0,0,1,2021-10-09,Female,50,45-54,4
28,1,0,0,1,2021-10-18,Male,66,65-69,1
28,0,0,0,0,2021-10-19,Female,81,80-84,1
28,1,3,0,4,2021-10-10,Male,69,65-69,5
28,0,6,0,6,2021-10-09,Male,51,45-54,3
28,0,8,0,8,2021-10-08,Male,45,45-54,9
28,1,0,0,1,2021-10-19,Male,68,65-69,1
28,1,0,0,1,2021-10-08,Female,46,45-54,2
28,2,0,1,3,2021-10-18,Female,20,20-24,1
28,0,10,0,10,2021-10-08,Male,43,35-44,3
28,1,4,0,5,2021-10-19,Female,67,65-69,1
28,0,0,0,0,2021-10-20,Male,84,80-84,1
28,1,0,0,1,2021-10-08,Male,25,25-34,8
28,3,0,0,3,2021-10-19,Male,7,5-9,2
28,1,0,0,1,2021-10-08,Female,65,65-69,3
28,2,0,0,2,2021-10-08,Male,37,35-44,4
28,1,4,0,5,2021-10-19,Male,85,85+,1
28,0,0,0,0,2021-10-18,Male,71,70-74,1
28,1,0,0,1,2021-10-08,Male,28,25-34,5
28,1,0,0,1,2021-10-19,Male,65,65-69,1
28,1,0,0,1,2021-10-08,Male,31,25-34,4
28,2,1,0,3,2021-10-08,Male,8,5-9,7
28,1,0,0,1,2021-10-08,Female,63,55-64,2
28,0,1,0,1,2021-10-08,Female,31,25-34,11
28,1,2,0,3,2021-10-08,Female,54,45-54,2
28,1,20,20,41,2021-10-12,Male,19,15-19,1
28,1,0,0,1,2021-10-19,Male,69,65-69,1
28,0,0,0,0,2021-10-12,Female,65,65-69,15
28,7,2,0,9,2021-10-08,Female,10,10-14,2
28,1,0,0,1,2021-10-08,Male,46,45-54,2
28,3,0,0,3,2021-10-08,Male,53,45-54,3
28,1,1,1,3,2021-10-08,Male,71,70-74,17
28,0,1,0,1,2021-10-18,Male,77,75-79,1
28,1,1,0,2,2021-10-09,Male,68,65-69,2
28,0,0,0,0,2021-10-08,Male,61,55-64,2
28,0,3,0,3,2021-10-12,Female,59,55-64,1
28,5,0,0,5,2021-10-12,Female,51,45-54,1
28,0,0,0,0,2021-10-08,Male,53,45-54,7
28,0,0,0,0,2021-10-12,Female,45,45-54,1
28,1,2,0,3,2021-10-16,Female,66,65-69,6
28,1,2,0,3,2021-10-12,Male,8,5-9,2
28,0,0,0,0,2021-10-08,Female,23,20-24,2
28,1,0,0,1,2021-10-08,Female,28,25-34,4
28,2,0,0,2,2021-10-11,Female,85,85+,2
28,1,2,0,3,2021-10-08,Male,64,55-64,8
28,0,0,0,0,2021-10-10,Female,52,45-54,6
28,0,0,0,0,2021-10-08,Female,65,65-69,8
28,3,0,0,3,2021-10-09,Female,9,5-9,2
28,0,2,0,2,2021-10-18,Male,30,25-34,1
28,1,0,0,1,2021-10-08,Female,63,55-64,8
28,0,0,0,0,2021-10-08,Male,68,65-69,8
28,1,0,0,1,2021-10-09,Female,67,65-69,6
28,0,0,0,0,2021-10-19,Male,79,75-79,1
28,1,0,0,1,2021-10-10,Male,42,35-44,2
28,0,0,0,0,2021-10-08,Male,68,65-69,2
28,4,11,0,15,2021-10-20,Male,1,1-4,1
28,0,1,0,1,2021-10-08,Male,63,55-64,4
28,0,0,0,0,2021-10-08,Male,73,70-74,2
28,1,0,0,1,2021-10-08,Male,53,45-54,6
28,2,5,0,7,2021-10-09,Male,12,10-14,2
28,1,3,0,4,2021-10-19,Male,68,65-69,1
28,2,0,0,2,2021-10-08,Male,12,10-14,6
28,0,0,0,0,2021-10-10,Female,67,65-69,23
28,0,0,8,8,2021-10-09,Female,2,1-4,18
28,1,0,0,1,2021-10-12,Male,58,55-64,1
28,2,0,3,5,2021-10-09,Male,18,15-19,3
28,1,0,0,1,2021-10-08,Male,73,70-74,4
28,0,0,0,0,2021-10-08,Male,41,35-44,18
28,1,1,0,2,2021-10-08,Female,62,55-64,18
28,1,0,0,1,2021-10-12,Female,54,45-54,1
28,1,0,0,1,2021-10-09,Female,42,35-44,3
28,0,3,0,3,2021-10-12,Female,31,25-34,2
28,0,3,0,3,2021-10-08,Female,54,45-54,8
28,1,0,0,1,2021-10-09,Female,54,45-54,2
28,1,9,0,10,2021-10-17,Female,21,20-24,1
28,2,0,0,2,2021-10-08,Male,46,45-54,14
28,1,2,0,3,2021-10-09,Male,71,70-74,3
28,2,5,0,7,2021-10-09,Male,10,10-14,2
28,1,0,0,1,2021-10-08,Male,71,70-74,2
28,3,0,0,3,2021-10-19,Female,8,5-9,2
28,0,1,0,1,2021-10-11,Male,66,65-69,8
28,0,0,0,0,2021-10-08,Female,61,55-64,2
28,0,0,0,0,2021-10-08,Female,32,25-34,2
28,1,0,0,1,2021-10-10,Male,32,25-34,6
28,0,0,10,10,2021-10-18,Male,30,25-34,1
28,1,0,0,1,2021-10-08,Female,65,65-69,2
28,4,1,0,5,2021-10-08,Male,78,75-79,8
28,1,0,0,1,2021-10-08,Male,5,5-9,3
28,1,0,0,1,2021-10-14,Male,31,25-34,8
28,1,0,0,1,2021-10-11,Female,73,70-74,8
28,0,5,0,5,2021-10-08,Male,55,55-64,3
28,1,2,0,3,2021-10-08,Female,51,45-54,6
28,0,0,0,0,2021-10-19,Female,30,25-34,1
28,1,0,0,1,2021-10-08,Male,57,55-64,8
28,1,0,0,1,2021-10-08,Male,48,45-54,3
28,1,0,0,1,2021-10-08,Female,52,45-54,7
28,0,0,0,0,2021-10-19,Male,73,70-74,1
28,0,2,0,2,2021-10-09,Male,57,55-64,6
28,1,0,0,1,2021-10-13,Female,69,65-69,18
28,0,1,0,1,2021-10-08,Female,66,65-69,3
28,2,0,0,2,2021-10-09,Male,15,15-19,3
28,0,0,0,0,2021-10-10,Female,33,25-34,2
28,1,8,0,9,2021-10-12,Female,51,45-54,1
28,1,0,0,1,2021-10-09,Male,68,65-69,2
28,3,0,0,3,2021-10-09,Male,60,55-64,4
28,1,0,0,1,2021-10-19,Male,68,65-69,1
28,1,0,0,1,2021-10-08,Female,52,45-54,2
28,1,7,0,8,2021-10-09,Female,68,65-69,3
28,3,3,0,6,2021-10-16,Male,9,5-9,7
28,0,0,0,0,2021-10-08,Male,51,45-54,8
28,0,0,0,0,2021-10-18,Female,31,25-34,1
28,0,0,0,0,2021-10-08,Male,59,55-64,6
28,1,0,0,1,2021-10-08,Male,46,45-54,8
28,2,0,0,2,2021-10-11,Female,18,15-19,4
28,0,0,0,0,2021-10-15,Female,65,65-69,6
28,0,30,0,30,2021-10-09,Male,57,55-64,8
28,1,0,0,1,2021-10-09,Male,54,45-54,2
28,1,0,0,1,2021-10-08,Male,69,65-69,7
28,1,4,0,5,2021-10-12,Female,30,25-34,1
28,0,0,0,0,2021-10-09,Female,70,70-74,2
28,1,0,0,1,2021-10-08,Female,70,70-74,7
28,1,0,0,1,2021-10-20,Male,69,65-69,1
28,1,0,0,1,2021-10-11,Female,18,15-19,15
28,0,0,0,0,2021-10-08,Male,41,35-44,2
28,0,0,0,0,2021-10-08,Male,56,55-64,3
28,1,0,0,1,2021-10-12,Female,61,55-64,1
28,4,5,0,9,2021-10-15,Female,42,35-44,15
28,2,0,0,2,2021-10-08,Female,39,35-44,2
28,3,1,0,4,2021-10-08,Male,19,15-19,7
28,0,0,0,0,2021-10-09,Male,55,55-64,11
28,0,1,0,1,2021-10-19,Male,78,75-79,1
28,1,0,0,1,2021-10-08,Male,64,55-64,3
28,0,1,0,1,2021-10-19,Female,30,25-34,1
28,1,3,0,4,2021-10-09,Female,69,65-69,2
28,1,0,0,1,2021-10-08,Male,80,80-84,3
28,1,0,0,1,2021-10-10,Female,35,35-44,21
28,2,13,0,15,2021-10-08,Female,3,1-4,9
28,2,0,0,2,2021-10-19,Male,17,15-19,1
28,0,1,0,1,2021-10-15,Female,65,65-69,5
28,1,2,0,3,2021-10-08,Male,66,65-69,4
28,0,0,0,0,2021-10-08,Male,72,70-74,3
28,1,6,0,7,2021-10-08,Female,65,65-69,2
28,0,12,0,12,2021-10-10,Female,47,45-54,6
28,0,0,0,0,2021-10-08,Male,53,45-54,15
28,0,0,0,0,2021-10-19,Male,77,75-79,1
28,0,0,0,0,2021-10-08,Female,27,25-34,7
28,1,2,0,3,2021-10-08,Male,74,70-74,3
28,1,0,0,1,2021-10-08,Male,56,55-64,2
28,0,0,0,0,2021-10-08,Male,65,65-69,8
28,0,4,0,4,2021-10-12,Female,65,65-69,1
28,0,1,0,1,2021-10-12,Female,45,45-54,1
28,1,0,0,1,2021-10-19,Male,68,65-69,1
28,0,0,0,0,2021-10-08,Female,34,25-34,3
28,0,3,0,3,2021-10-08,Female,37,35-44,2
28,0,0,0,0,2021-10-08,Male,67,65-69,3
28,2,0,0,2,2021-10-08,Male,54,45-54,2
28,0,2,0,2,2021-10-08,Female,57,55-64,6
28,0,0,0,0,2021-10-08,Female,17,15-19,18
28,0,0,0,0,2021-10-08,Male,34,25-34,7
28,1,5,0,6,2021-10-16,Male,66,65-69,5
28,3,2,0,5,2021-10-08,Female,0,<1,4
28,1,0,0,1,2021-10-08,Male,71,70-74,7
28,0,0,0,0,2021-10-09,Male,34,25-34,6
28,1,0,0,1,2021-10-08,Male,60,55-64,3
28,2,4,0,6,2021-10-12,Female,68,65-69,1
28,2,6,0,8,2021-10-08,Female,2,1-4,4
28,1,1,0,2,2021-10-19,Male,75,75-79,1
28,1,0,0,1,2021-10-08,Male,32,25-34,3
28,1,0,0,1,2021-10-12,Male,57,55-64,1
28,1,0,0,1,2021-10-18,Male,69,65-69,1
28,1,0,0,1,2021-10-09,Male,68,65-69,7
28,1,0,0,1,2021-10-09,Male,77,75-79,2
28,2,10,0,12,2021-10-08,Male,6,5-9,2
28,1,10,14,25,2021-10-08,Female,28,25-34,3
28,1,0,0,1,2021-10-15,Female,72,70-74,8
28,3,0,0,3,2021-10-08,Male,3,1-4,8
28,1,0,0,1,2021-10-08,Male,70,70-74,8
28,1,0,0,1,2021-10-15,Female,66,65-69,2
28,2,0,0,2,2021-10-12,Male,11,10-14,1
28,0,5,0,5,2021-10-10,Male,35,35-44,7
28,1,2,0,3,2021-10-08,Male,71,70-74,3
28,3,0,0,3,2021-10-08,Female,19,15-19,7
28,0,1,0,1,2021-10-10,Female,73,70-74,3
28,2,0,0,2,2021-10-09,Female,12,10-14,4
28,0,0,0,0,2021-10-12,Female,22,20-24,3
28,2,0,25,27,2021-10-19,Male,8,5-9,1
28,1,0,0,1,2021-10-08,Male,76,75-79,6
28,1,0,0,1,2021-10-08,Female,71,70-74,2
28,0,0,0,0,2021-10-09,Female,38,35-44,8
28,0,0,0,0,2021-10-08,Male,55,55-64,5
28,3,0,0,3,2021-10-12,Male,15,15-19,1
28,0,1,0,1,2021-10-09,Female,56,55-64,6
28,2,4,30,36,2021-10-12,Male,5,5-9,1
28,1,2,0,3,2021-10-09,Female,55,55-64,6
28,2,0,2,4,2021-10-11,Female,71,70-74,3
28,0,1,0,1,2021-10-08,Male,59,55-64,5
28,1,0,2,3,2021-10-12,Female,61,55-64,1
28,1,0,0,1,2021-10-08,Male,62,55-64,4
28,3,0,0,3,2021-10-08,Male,16,15-19,7
28,2,1,0,3,2021-10-08,Male,48,45-54,2
28,1,11,0,12,2021-10-20,Female,57,55-64,1
28,2,33,33,68,2021-10-12,Female,12,10-14,1
28,3,7,0,10,2021-10-12,Female,4,1-4,1
28,1,0,0,1,2021-10-08,Male,69,65-69,4
28,1,0,0,1,2021-10-08,Female,65,65-69,8
28,3,0,0,3,2021-10-08,Female,14,10-14,7
28,4,1,0,5,2021-10-08,Male,26,25-34,2
28,0,2,0,2,2021-10-08,Female,51,45-54,8
28,0,0,0,0,2021-10-15,Male,78,75-79,16
28,0,0,0,0,2021-10-12,Male,72,70-74,1
28,1,3,0,4,2021-10-08,Female,54,45-54,7
28,1,0,14,15,2021-10-08,Female,12,10-14,2
28,1,0,0,1,2021-10-09,Male,30,25-34,5
28,1,0,0,1,2021-10-10,Female,31,25-34,3
28,0,0,0,0,2021-10-08,Female,65,65-69,4
28,0,0,0,0,2021-10-08,Male,78,75-79,4
28,1,0,0,1,2021-10-08,Male,43,35-44,2
28,3,3,0,6,2021-10-08,Male,7,5-9,3
28,2,0,0,2,2021-10-08,Male,55,55-64,3
28,0,0,0,0,2021-10-10,Female,35,35-44,2
28,1,4,0,5,2021-10-08,Female,68,65-69,2
28,0,0,0,0,2021-10-08,Male,52,45-54,9
28,0,0,0,0,2021-10-11,Female,31,25-34,3
28,1,0,0,1,2021-10-12,Male,63,55-64,1
28,0,0,0,0,2021-10-08,Female,26,25-34,3
28,0,1,0,1,2021-10-08,Male,60,55-64,8
28,0,2,0,2,2021-10-08,Female,82,80-84,2
28,2,0,0,2,2021-10-08,Female,9,5-9,6
28,0,12,0,12,2021-10-09,Male,53,45-54,2
28,0,0,0,0,2021-10-12,Female,58,55-64,1
28,0,0,0,0,2021-10-08,Male,54,45-54,7
28,3,0,0,3,2021-10-12,Male,3,1-4,1
28,1,0,0,1,2021-10-08,Female,68,65-69,7
28,2,0,0,2,2021-10-10,Male,74,70-74,14
28,3,0,0,3,2021-10-08,Female,18,15-19,2
28,0,0,0,0,2021-10-10,Male,26,25-34,13
28,1,0,0,1,2021-10-16,Female,67,65-69,2
28,0,3,0,3,2021-10-10,Male,32,25-34,7
28,1,2,0,3,2021-10-08,Male,18,15-19,4
28,1,0,0,1,2021-10-12,Female,47,45-54,1
28,0,0,0,0,2021-10-08,Female,27,25-34,6
28,1,0,0,1,2021-10-17,Female,11,10-14,4
28,3,0,0,3,2021-10-10,Female,19,15-19,6
28,2,0,0,2,2021-10-12,Female,8,5-9,1
28,2,2,0,4,2021-10-08,Female,3,1-4,2
28,1,0,0,1,2021-10-08,Female,39,35-44,3
28,0,0,0,0,2021-10-08,Female,68,65-69,11
28,1,0,0,1,2021-10-08,Male,73,70-74,21
28,2,0,13,15,2021-10-08,Female,2,1-4,2
28,2,0,0,2,2021-10-10,Female,16,15-19,3
28,5,0,0,5,2021-10-09,Female,23,20-24,2
28,2,7,0,9,2021-10-12,Male,19,15-19,1
28,1,13,0,14,2021-10-19,Female,34,25-34,1
28,1,0,0,1,2021-10-08,Female,25,25-34,2
28,1,0,0,1,2021-10-12,Female,55,55-64,1
28,0,0,0,0,2021-10-08,Female,50,45-54,8
28,0,0,0,0,2021-10-08,Female,69,65-69,2
28,0,0,0,0,2021-10-08,Male,72,70-74,19
28,1,0,0,1,2021-10-09,Male,45,45-54,3
28,1,3,0,4,2021-10-09,Female,56,55-64,13
28,2,7,0,9,2021-10-15,Female,3,1-4,2
28,1,0,0,1,2021-10-09,Male,66,65-69,3
28,0,0,0,0,2021-10-15,Female,78,75-79,2
28,1,0,0,1,2021-10-08,Male,69,65-69,2
28,0,0,0,0,2021-10-11,Male,33,25-34,5
28,1,0,0,1,2021-10-18,Male,77,75-79,1
28,2,0,0,2,2021-10-09,Male,4,1-4,7
28,1,1,0,2,2021-10-12,Female,53,45-54,1
28,0,0,0,0,2021-10-08,Male,65,65-69,3
28,1,0,0,1,2021-10-08,Female,54,45-54,2
28,0,0,0,0,2021-10-12,Female,17,15-19,1
28,0,0,0,0,2021-10-08,Male,68,65-69,2
28,0,0,0,0,2021-10-08,Female,33,25-34,2
28,0,12,0,12,2021-10-08,Female,58,55-64,6
28,0,0,0,0,2021-10-20,Male,65,65-69,1
28,0,2,0,2,2021-10-08,Female,67,65-69,7
28,1,0,0,1,2021-10-08,Male,59,55-64,4
28,0,1,0,1,2021-10-12,Female,68,65-69,17
28,1,0,0,1,2021-10-08,Female,68,65-69,8
28,2,1,0,3,2021-10-11,Female,49,45-54,2
28,0,0,0,0,2021-10-08,Male,27,25-34,7
28,1,0,0,1,2021-10-08,Male,75,75-79,2
28,1,0,0,1,2021-10-18,Male,26,25-34,1
28,2,4,0,6,2021-10-09,Female,4,1-4,3
28,1,0,0,1,2021-10-12,Female,53,45-54,1
28,1,1,0,2,2021-10-11,Female,64,55-64,8
28,1,6,0,7,2021-10-13,Female,65,65-69,1
28,1,3,0,4,2021-10-18,Female,29,25-34,1
28,0,1,0,1,2021-10-08,Male,52,45-54,3
28,3,0,0,3,2021-10-09,Male,65,65-69,5
28,0,2,0,2,2021-10-08,Female,36,35-44,10
28,0,0,0,0,2021-10-17,Female,77,75-79,5
28,1,0,0,1,2021-10-08,Female,25,25-34,22
28,1,0,0,1,2021-10-19,Male,76,75-79,1
28,2,2,0,4,2021-10-15,Female,72,70-74,19
28,1,0,0,1,2021-10-09,Female,68,65-69,2
28,0,0,0,0,2021-10-08,Male,61,55-64,2
28,1,0,0,1,2021-10-08,Female,55,55-64,7
28,3,3,0,6,2021-10-11,Male,7,5-9,20
28,1,0,0,1,2021-10-09,Male,72,70-74,2
28,1,0,0,1,2021-10-15,Male,70,70-74,20
28,0,0,0,0,2021-10-08,Male,62,55-64,2
28,0,5,0,5,2021-10-08,Male,44,35-44,5
28,1,10,0,11,2021-10-18,Male,72,70-74,1
28,2,0,0,2,2021-10-10,Male,8,5-9,6
28,0,0,0,0,2021-10-08,Male,65,65-69,2
28,1,0,0,1,2021-10-08,Female,5,5-9,4
28,0,6,0,6,2021-10-09,Male,60,55-64,8
28,1,0,2,3,2021-10-08,Male,51,45-54,4
28,0,0,0,0,2021-10-10,Female,58,55-64,20
28,0,1,1,2,2021-10-09,Female,50,45-54,11
28,3,0,0,3,2021-10-08,Female,15,15-19,3
28,2,0,0,2,2021-10-10,Female,3,1-4,3
28,1,2,0,3,2021-10-20,Male,71,70-74,1
28,0,0,0,0,2021-10-08,Female,49,45-54,7
28,1,0,0,1,2021-10-12,Male,51,45-54,1
28,1,1,0,2,2021-10-12,Female,67,65-69,1
28,1,0,6,7,2021-10-10,Male,13,10-14,2
28,3,0,0,3,2021-10-08,Male,35,35-44,6
28,0,3,0,3,2021-10-12,Female,58,55-64,2
28,2,0,0,2,2021-10-08,Male,5,5-9,7
28,3,0,0,3,2021-10-08,Male,36,35-44,2
28,3,0,0,3,2021-10-08,Female,56,55-64,3
28,1,9,0,10,2021-10-08,Female,33,25-34,3
28,1,2,3,6,2021-10-19,Female,65,65-69,1
28,1,0,0,1,2021-10-08,Female,26,25-34,2
28,1,1,0,2,2021-10-08,Female,75,75-79,2
28,0,1,0,1,2021-10-08,Female,70,70-74,4
28,1,0,0,1,2021-10-08,Female,64,55-64,17
28,1,0,0,1,2021-10-08,Female,42,35-44,3
28,2,0,0,2,2021-10-08,Male,1,1-4,4
28,0,0,0,0,2021-10-09,Male,50,45-54,3
28,1,8,0,9,2021-10-10,Male,74,70-74,2
28,1,0,0,1,2021-10-11,Female,43,35-44,7
28,3,0,0,3,2021-10-09,Female,16,15-19,16
28,0,0,0,0,2021-10-09,Female,71,70-74,4
28,0,3,4,7,2021-10-08,Male,59,55-64,4
28,2,0,0,2,2021-10-08,Male,15,15-19,8
28,0,0,0,0,2021-10-11,Male,54,45-54,2
28,0,1,0,1,2021-10-08,Male,74,70-74,13
28,0,0,0,0,2021-10-08,Male,70,70-74,3
28,3,0,0,3,2021-10-12,Female,62,55-64,1
28,1,0,0,1,2021-10-08,Male,72,70-74,3
28,0,0,0,0,2021-10-08,Male,54,45-54,4
28,0,3,0,3,2021-10-08,Male,53,45-54,4
28,0,2,0,2,2021-10-12,Female,54,45-54,1
28,1,1,0,2,2021-10-10,Male,32,25-34,3
28,1,2,0,3,2021-10-19,Male,74,70-74,1
28,1,0,0,1,2021-10-08,Female,48,45-54,8
28,1,0,0,1,2021-10-18,Male,74,70-74,1
28,1,0,0,1,2021-10-11,Female,21,20-24,7
28,2,2,0,4,2021-10-08,Male,58,55-64,2
28,0,0,0,0,2021-10-08,Male,11,10-14,2
28,0,2,0,2,2021-10-08,Female,27,25-34,3
28,0,5,0,5,2021-10-08,Male,71,70-74,7
28,0,0,0,0,2021-10-18,Male,69,65-69,1
28,0,0,0,0,2021-10-08,Male,50,45-54,2
28,0,0,0,0,2021-10-09,Female,24,20-24,13
28,2,3,0,5,2021-10-09,Male,2,1-4,2
28,0,1,0,1,2021-10-12,Female,61,55-64,1
28,1,0,0,1,2021-10-08,Female,27,25-34,7
28,2,2,0,4,2021-10-08,Male,75,75-79,20
28,2,0,0,2,2021-10-09,Female,63,55-64,15
28,1,0,0,1,2021-10-12,Male,59,55-64,1
28,2,2,0,4,2021-10-08,Male,64,55-64,3
28,1,0,0,1,2021-10-19,Male,73,70-74,1
28,3,0,0,3,2021-10-12,Female,2,1-4,8
28,1,0,0,1,2021-10-08,Female,58,55-64,2
28,3,0,0,3,2021-10-08,Female,6,5-9,2
28,1,0,0,1,2021-10-09,Male,40,35-44,12
28,1,3,0,4,2021-10-08,Female,68,65-69,2
28,0,0,0,0,2021-10-08,Male,48,45-54,2
28,4,10,10,24,2021-10-08,Female,10,10-14,2
28,1,0,0,1,2021-10-08,Female,60,55-64,3
28,0,0,0,0,2021-10-08,Male,52,45-54,7
28,1,0,0,1,2021-10-08,Male,40,35-44,2
28,1,5,26,32,2021-10-08,Male,67,65-69,8
28,1,7,0,8,2021-10-08,Female,80,80-84,7
28,0,0,0,0,2021-10-19,Female,70,70-74,1
28,1,2,0,3,2021-10-08,Female,59,55-64,2
28,1,1,0,2,2021-10-08,Male,66,65-69,5
28,0,1,0,1,2021-10-08,Male,45,45-54,4
28,0,3,0,3,2021-10-19,Male,72,70-74,1
28,0,0,0,0,2021-10-12,Male,61,55-64,22
28,0,1,1,2,2021-10-08,Male,74,70-74,2
28,1,3,0,4,2021-10-19,Male,67,65-69,6
28,0,0,0,0,2021-10-08,Female,41,35-44,7
28,0,0,0,0,2021-10-10,Male,7,5-9,20
28,1,0,0,1,2021-10-09,Female,73,70-74,2
28,0,0,0,0,2021-10-08,Male,53,45-54,2
28,0,0,0,0,2021-10-08,Female,42,35-44,2
28,2,1,0,3,2021-10-09,Female,67,65-69,21
28,1,0,0,1,2021-10-10,Male,66,65-69,8
28,3,1,0,4,2021-10-11,Male,22,20-24,9
28,2,0,0,2,2021-10-18,Male,72,70-74,1
28,0,3,0,3,2021-10-09,Female,62,55-64,7
28,1,3,0,4,2021-10-08,Male,10,10-14,8
28,3,1,0,4,2021-10-08,Female,54,45-54,21
28,1,0,0,1,2021-10-12,Female,53,45-54,1
28,1,3,0,4,2021-10-09,Female,67,65-69,6
28,1,3,0,4,2021-10-08,Male,44,35-44,6
28,0,0,0,0,2021-10-10,Male,38,35-44,7
28,4,1,0,5,2021-10-19,Male,0,<1,2
28,1,3,0,4,2021-10-09,Male,72,70-74,7
28,1,0,0,1,2021-10-09,Female,68,65-69,3
28,1,0,0,1,2021-10-12,Female,57,55-64,1
28,0,3,0,3,2021-10-08,Female,39,35-44,2
28,2,0,0,2,2021-10-09,Female,68,65-69,3
28,0,0,0,0,2021-10-09,Female,5,5-9,3
28,0,0,0,0,2021-10-10,Male,63,55-64,2
28,1,2,1,4,2021-10-09,Male,63,55-64,6
28,3,4,22,29,2021-10-08,Male,12,10-14,16
28,2,0,0,2,2021-10-08,Male,72,70-74,7
28,0,2,0,2,2021-10-08,Male,58,55-64,7
28,0,2,0,2,2021-10-08,Male,66,65-69,8
28,1,0,0,1,2021-10-08,Male,59,55-64,6
28,5,0,0,5,2021-10-08,Female,41,35-44,7
28,3,3,0,6,2021-10-19,Female,58,55-64,1
28,1,0,0,1,2021-10-09,Male,50,45-54,2
28,0,5,0,5,2021-10-14,Male,37,35-44,2
28,0,2,0,2,2021-10-08,Male,83,80-84,3
28,0,0,0,0,2021-10-08,Male,33,25-34,11
28,1,0,0,1,2021-10-08,Female,37,35-44,2
28,2,4,0,6,2021-10-15,Male,67,65-69,8
28,1,40,25,66,2021-10-15,Female,67,65-69,4
28,1,1,0,2,2021-10-09,Male,65,65-69,7
28,0,0,0,0,2021-10-09,Male,40,35-44,4
28,1,8,0,9,2021-10-08,Female,69,65-69,4
28,1,0,0,1,2021-10-12,Female,30,25-34,3
28,1,0,0,1,2021-10-16,Male,68,65-69,7
28,0,0,0,0,2021-10-09,Female,68,65-69,6
28,3,0,0,3,2021-10-08,Male,56,55-64,2
28,1,0,0,1,2021-10-15,Male,70,70-74,3
28,2,0,0,2,2021-10-08,Male,13,10-14,7
28,3,0,0,3,2021-10-12,Male,15,15-19,9
28,1,0,0,1,2021-10-18,Male,66,65-69,1
28,0,4,0,4,2021-10-08,Male,60,55-64,2
28,0,1,0,1,2021-10-08,Female,63,55-64,5
28,2,0,0,2,2021-10-08,Female,30,25-34,3
28,1,5,0,6,2021-10-08,Male,52,45-54,2
28,1,1,0,2,2021-10-08,Male,81,80-84,5
28,1,5,0,6,2021-10-18,Male,72,70-74,1
28,1,1,0,2,2021-10-12,Female,41,35-44,8
28,2,0,0,2,2021-10-08,Female,67,65-69,3
28,0,3,0,3,2021-10-08,Female,69,65-69,3
28,1,0,0,1,2021-10-12,Female,45,45-54,1
28,1,0,0,1,2021-10-08,Male,66,65-69,3
28,0,0,0,0,2021-10-08,Male,36,35-44,5
28,3,4,0,7,2021-10-08,Female,14,10-14,11
28,0,0,0,0,2021-10-08,Female,43,35-44,7
28,0,0,0,0,2021-10-09,Male,60,55-64,2
28,4,3,0,7,2021-10-11,Male,11,10-14,13
28,0,2,0,2,2021-10-08,Male,58,55-64,18
28,0,0,0,0,2021-10-20,Male,85,85+,1
28,2,0,0,2,2021-10-09,Male,18,15-19,3
28,1,4,0,5,2021-10-08,Female,50,45-54,2
28,3,0,0,3,2021-10-18,Female,33,25-34,1
28,0,3,0,3,2021-10-12,Female,58,55-64,1
28,1,0,0,1,2021-10-11,Female,29,25-34,10
28,3,3,0,6,2021-10-08,Male,10,10-14,2
28,3,0,24,27,2021-10-08,Female,2,1-4,2
28,0,0,0,0,2021-10-15,Male,72,70-74,5
28,2,0,36,38,2021-10-08,Male,14,10-14,7
28,1,4,0,5,2021-10-08,Male,54,45-54,5
28,1,0,0,1,2021-10-11,Female,53,45-54,8
28,2,2,0,4,2021-10-08,Female,58,55-64,2
28,1,0,0,1,2021-10-08,Male,47,45-54,2
28,3,2,39,44,2021-10-08,Female,7,5-9,3
28,0,1,0,1,2021-10-11,Female,18,15-19,5
28,0,0,0,0,2021-10-08,Male,67,65-69,3
28,2,10,0,12,2021-10-15,Male,11,10-14,8
28,2,1,0,3,2021-10-18,Male,32,25-34,1
28,0,0,0,0,2021-10-12,Female,64,55-64,1
28,3,0,0,3,2021-10-10,Male,66,65-69,2
28,0,0,0,0,2021-10-08,Male,37,35-44,17
28,1,3,0,4,2021-10-12,Female,59,55-64,1
28,2,0,0,2,2021-10-08,Male,2,1-4,3
28,2,2,0,4,2021-10-09,Female,48,45-54,7
28,2,0,0,2,2021-10-11,Female,54,45-54,13
28,1,1,0,2,2021-10-11,Male,52,45-54,19
28,1,0,0,1,2021-10-12,Female,61,55-64,1
28,1,2,0,3,2021-10-08,Female,18,15-19,3
28,0,0,0,0,2021-10-10,Male,34,25-34,2
28,1,2,0,3,2021-10-08,Male,63,55-64,5
28,2,1,0,3,2021-10-08,Male,18,15-19,15
28,2,0,0,2,2021-10-10,Female,18,15-19,5
28,0,4,0,4,2021-10-20,Male,60,55-64,1
28,0,0,0,0,2021-10-08,Male,56,55-64,3
28,0,1,0,1,2021-10-08,Female,41,35-44,6
28,1,0,0,1,2021-10-19,Female,61,55-64,1
28,0,1,0,1,2021-10-09,Female,69,65-69,4
28,2,1,0,3,2021-10-08,Male,66,65-69,3
28,1,0,0,1,2021-10-08,Male,59,55-64,2
28,3,1,0,4,2021-10-08,Male,15,15-19,2
28,1,0,0,1,2021-10-09,Male,16,15-19,4
28,0,1,0,1,2021-10-08,Male,43,35-44,2
28,1,0,0,1,2021-10-08,Female,30,25-34,2
28,0,0,0,0,2021-10-18,Male,72,70-74,1
28,0,4,0,4,2021-10-08,Female,60,55-64,2
28,1,19,0,20,2021-10-12,Female,50,45-54,1
28,1,0,0,1,2021-10-08,Male,65,65-69,2
28,1,1,0,2,2021-10-11,Male,70,70-74,4
28,1,0,0,1,2021-10-08,Male,79,75-79,15
28,0,8,0,8,2021-10-08,Male,46,45-54,2
28,1,1,0,2,2021-10-08,Female,72,70-74,2
28,0,0,0,0,2021-10-08,Male,42,35-44,7
28,0,2,0,2,2021-10-08,Male,64,55-64,8
28,2,0,0,2,2021-10-08,Male,17,15-19,22
28,1,0,0,1,2021-10-08,Female,62,55-64,8
28,3,0,0,3,2021-10-08,Female,2,1-4,3
28,2,3,0,5,2021-10-08,Female,11,10-14,2
28,0,0,0,0,2021-10-19,Female,59,55-64,1
28,1,3,1,5,2021-10-19,Male,73,70-74,1
28,3,0,19,22,2021-10-08,Female,1,1-4,2
28,0,4,0,4,2021-10-08,Female,80,80-84,2
28,1,1,0,2,2021-10-15,Male,72,70-74,2
28,0,0,0,0,2021-10-08,Male,40,35-44,7
28,2,0,0,2,2021-10-08,Female,25,25-34,5
28,1,0,4,5,2021-10-12,Male,15,15-19,1
28,3,0,0,3,2021-10-08,Female,60,55-64,11
28,0,10,0,10,2021-10-12,Female,78,75-79,1
28,1,1,0,2,2021-10-08,Male,72,70-74,3
28,0,3,0,3,2021-10-08,Male,68,65-69,8
28,1,0,7,8,2021-10-09,Male,39,35-44,7
28,0,0,0,0,2021-10-09,Female,41,35-44,7
28,1,8,0,9,2021-10-18,Male,31,25-34,1
28,0,0,0,0,2021-10-08,Female,40,35-44,6
28,1,1,0,2,2021-10-09,Male,68,65-69,15
28,2,1,0,3,2021-10-15,Female,3,1-4,2
28,1,0,0,1,2021-10-08,Male,56,55-64,8
28,0,0,0,0,2021-10-08,Male,65,65-69,3
28,0,0,0,0,2021-10-12,Female,57,55-64,1
28,1,0,0,1,2021-10-08,Female,51,45-54,2
28,0,16,0,16,2021-10-09,Female,25,25-34,15
28,1,2,0,3,2021-10-08,Male,65,65-69,2
28,0,0,0,0,2021-10-09,Male,62,55-64,7
28,1,6,0,7,2021-10-12,Female,55,55-64,1
28,1,0,0,1,2021-10-08,Male,59,55-64,8
28,0,1,0,1,2021-10-08,Male,65,65-69,8
28,1,0,0,1,2021-10-10,Female,41,35-44,20
28,1,0,0,1,2021-10-08,Male,46,45-54,8
28,0,0,0,0,2021-10-19,Male,67,65-69,1
28,1,0,0,1,2021-10-11,Male,11,10-14,4
28,1,0,0,1,2021-10-08,Female,33,25-34,3
28,5,5,0,10,2021-10-15,Female,12,10-14,2
28,1,0,0,1,2021-10-08,Female,38,35-44,18
28,0,0,0,0,2021-10-09,Female,7,5-9,13
28,0,0,0,0,2021-10-08,Male,46,45-54,3
28,1,1,0,2,2021-10-19,Male,74,70-74,1
28,1,0,0,1,2021-10-09,Male,61,55-64,2
28,1,0,0,1,2021-10-16,Female,34,25-34,18
28,1,3,0,4,2021-10-19,Male,72,70-74,1
28,0,0,0,0,2021-10-08,Female,65,65-69,2
28,2,0,0,2,2021-10-08,Female,50,45-54,4
28,1,3,0,4,2021-10-08,Female,49,45-54,4
28,1,1,0,2,2021-10-11,Male,52,45-54,2
28,1,2,0,3,2021-10-08,Male,78,75-79,6
28,1,0,0,1,2021-10-08,Male,62,55-64,8
28,0,1,0,1,2021-10-11,Male,43,35-44,9
28,0,6,0,6,2021-10-08,Male,72,70-74,2
28,1,0,0,1,2021-10-12,Female,70,70-74,1
28,0,0,0,0,2021-10-08,Male,27,25-34,7
28,1,0,0,1,2021-10-08,Male,63,55-64,2
28,2,2,0,4,2021-10-09,Male,69,65-69,2
28,1,10,0,11,2021-10-12,Male,53,45-54,1
28,0,0,0,0,2021-10-11,Male,22,20-24,3
28,2,6,0,8,2021-10-08,Female,11,10-14,21
28,1,1,0,2,2021-10-11,Male,44,35-44,16
28,1,0,0,1,2021-10-18,Male,81,80-84,1
28,0,0,0,0,2021-10-11,Male,54,45-54,4
28,0,0,0,0,2021-10-08,Female,68,65-69,2
28,1,4,0,5,2021-10-19,Male,65,65-69,1
28,0,0,0,0,2021-10-08,Female,66,65-69,2
28,0,5,0,5,2021-10-08,Female,59,55-64,2
28,2,0,0,2,2021-10-19,Male,72,70-74,1
28,0,0,0,0,2021-10-18,Female,33,25-34,1
28,1,0,0,1,2021-10-18,Male,67,65-69,1
28,2,0,0,2,2021-10-10,Female,48,45-54,8
28,1,3,0,4,2021-10-09,Male,65,65-69,7
28,1,7,0,8,2021-10-12,Female,47,45-54,1
28,0,2,0,2,2021-10-12,Female,60,55-64,1
28,0,0,0,0,2021-10-09,Female,30,25-34,7
28,0,0,0,0,2021-10-15,Female,40,35-44,3
28,1,1,0,2,2021-10-10,Male,71,70-74,6
28,3,3,0,6,2021-10-11,Male,12,10-14,3
28,1,0,0,1,2021-10-08,Male,58,55-64,8
28,0,0,0,0,2021-10-08,Male,50,45-54,2
28,1,0,0,1,2021-10-08,Male,72,70-74,3
28,0,0,0,0,2021-10-08,Female,38,35-44,11
28,0,0,0,0,2021-10-08,Male,47,45-54,6
28,0,3,0,3,2021-10-08,Male,73,70-74,2
28,0,2,0,2,2021-10-09,Female,68,65-69,2
28,1,0,0,1,2021-10-08,Male,80,80-84,3
28,3,0,0,3,2021-10-19,Male,0,<1,1
28,0,2,0,2,2021-10-15,Female,35,35-44,5
28,0,0,0,0,2021-10-09,Male,27,25-34,2
28,1,2,0,3,2021-10-19,Male,31,25-34,2
28,2,0,0,2,2021-10-08,Female,65,65-69,2
28,1,0,0,1,2021-10-08,Female,71,70-74,2
28,0,5,0,5,2021-10-11,Male,58,55-64,4
28,0,0,0,0,2021-10-08,Male,57,55-64,2
28,1,0,0,1,2021-10-08,Female,61,55-64,2
28,0,2,0,2,2021-10-09,Female,53,45-54,7
28,1,4,0,5,2021-10-09,Male,7,5-9,4
28,0,0,0,0,2021-10-08,Female,44,35-44,7
28,0,0,0,0,2021-10-08,Female,66,65-69,2
28,0,0,0,0,2021-10-19,Female,75,75-79,2
28,1,0,0,1,2021-10-12,Male,60,55-64,1
28,0,0,0,0,2021-10-12,Female,54,45-54,1
28,0,0,0,0,2021-10-19,Male,67,65-69,1
28,1,2,0,3,2021-10-08,Male,64,55-64,8
28,0,0,0,0,2021-10-11,Male,41,35-44,12
28,1,12,0,13,2021-10-19,Male,52,45-54,2
28,0,5,0,5,2021-10-08,Male,49,45-54,3
28,0,1,0,1,2021-10-08,Female,43,35-44,2
28,0,0,0,0,2021-10-16,Female,37,35-44,15
28,0,0,0,0,2021-10-09,Female,3,1-4,2
28,1,0,0,1,2021-10-08,Male,53,45-54,3
28,3,0,0,3,2021-10-13,Male,2,1-4,2
28,1,2,0,3,2021-10-11,Male,68,65-69,6
28,1,0,0,1,2021-10-08,Female,28,25-34,6
28,1,4,0,5,2021-10-08,Female,77,75-79,2
28,1,0,0,1,2021-10-20,Male,72,70-74,1
28,1,0,0,1,2021-10-08,Male,67,65-69,21
28,1,0,0,1,2021-10-08,Male,44,35-44,4
28,3,0,0,3,2021-10-09,Male,24,20-24,2
28,0,0,0,0,2021-10-08,Male,32,25-34,7
28,1,0,0,1,2021-10-18,Female,32,25-34,1
28,4,0,0,4,2021-10-17,Male,5,5-9,2
28,2,0,0,2,2021-10-14,Female,48,45-54,22
28,0,0,0,0,2021-10-09,Female,51,45-54,2
28,1,0,0,1,2021-10-08,Male,53,45-54,8
28,1,0,0,1,2021-10-18,Male,70,70-74,1
28,0,1,0,1,2021-10-09,Female,66,65-69,8
28,1,0,0,1,2021-10-08,Female,67,65-69,8
28,1,0,0,1,2021-10-08,Female,62,55-64,2
28,1,0,0,1,2021-10-11,Male,72,70-74,2
28,1,3,0,4,2021-10-08,Female,66,65-69,8
28,0,1,0,1,2021-10-08,Female,72,70-74,7
28,1,1,0,2,2021-10-08,Female,45,45-54,4
28,1,6,0,7,2021-10-15,Male,74,70-74,2
28,1,0,0,1,2021-10-08,Female,11,10-14,19
28,2,0,0,2,2021-10-08,Male,34,25-34,2
28,0,0,0,0,2021-10-19,Female,68,65-69,1
28,0,0,0,0,2021-10-08,Male,37,35-44,4
28,3,15,71,89,2021-10-12,Female,18,15-19,1
28,2,10,0,12,2021-10-19,Female,3,1-4,1
28,0,0,0,0,2021-10-19,Female,38,35-44,14
28,0,5,0,5,2021-10-12,Female,53,45-54,1
28,0,0,0,0,2021-10-08,Male,35,35-44,18
28,1,0,0,1,2021-10-10,Male,57,55-64,3
28,0,2,0,2,2021-10-08,Male,24,20-24,4
28,0,0,0,0,2021-10-08,Male,71,70-74,4
28,1,2,0,3,2021-10-08,Female,64,55-64,17
28,0,1,0,1,2021-10-09,Female,69,65-69,12
28,1,0,0,1,2021-10-08,Female,52,45-54,3
28,0,0,0,0,2021-10-09,Female,28,25-34,4
28,2,1,0,3,2021-10-18,Female,32,25-34,1
28,1,0,0,1,2021-10-08,Female,41,35-44,2
28,1,2,0,3,2021-10-08,Female,61,55-64,8
28,0,2,0,2,2021-10-08,Female,65,65-69,2
28,0,0,0,0,2021-10-16,Female,18,15-19,2
28,2,2,0,4,2021-10-10,Female,11,10-14,8
28,0,0,0,0,2021-10-08,Female,27,25-34,3
28,0,0,0,0,2021-10-08,Male,45,45-54,8
28,4,3,0,7,2021-10-12,Female,1,1-4,1
28,3,0,0,3,2021-10-09,Female,17,15-19,3
28,0,0,0,0,2021-10-08,Male,78,75-79,5
28,0,0,0,0,2021-10-09,Male,43,35-44,6
28,1,0,0,1,2021-10-08,Male,22,20-24,3
28,2,0,0,2,2021-10-08,Male,53,45-54,2
28,1,0,0,1,2021-10-08,Male,63,55-64,24
28,1,0,0,1,2021-10-11,Male,34,25-34,4
28,2,10,0,12,2021-10-12,Male,19,15-19,1
28,1,0,0,1,2021-10-12,Female,55,55-64,1
28,0,6,0,6,2021-10-08,Female,54,45-54,3
28,3,5,0,8,2021-10-12,Male,10,10-14,1
28,2,0,0,2,2021-10-08,Male,60,55-64,2
28,0,1,0,1,2021-10-09,Male,58,55-64,2
28,0,0,0,0,2021-10-09,Female,44,35-44,4
28,1,0,0,1,2021-10-19,Male,67,65-69,1
28,1,0,0,1,2021-10-12,Male,64,55-64,1
28,1,0,0,1,2021-10-19,Male,78,75-79,1
28,1,1,100,102,2021-10-10,Male,68,65-69,16
28,0,0,0,0,2021-10-09,Female,53,45-54,4
28,2,3,0,5,2021-10-19,Female,26,25-34,2
28,1,0,0,1,2021-10-15,Female,71,70-74,3
28,1,0,0,1,2021-10-20,Male,69,65-69,1
28,1,3,0,4,2021-10-15,Male,70,70-74,2
28,1,0,0,1,2021-10-08,Female,50,45-54,2
28,1,2,0,3,2021-10-08,Male,49,45-54,2
28,0,0,0,0,2021-10-10,Male,75,75-79,11
28,1,0,0,1,2021-10-12,Female,60,55-64,1
28,1,0,0,1,2021-10-08,Female,66,65-69,6
28,1,0,0,1,2021-10-10,Female,29,25-34,2
28,1,0,0,1,2021-10-08,Male,56,55-64,3
28,0,0,0,0,2021-10-08,Female,67,65-69,8
28,1,0,0,1,2021-10-09,Male,66,65-69,20
28,0,4,0,4,2021-10-19,Female,67,65-69,6
28,0,0,0,0,2021-10-09,Male,45,45-54,6
28,0,1,0,1,2021-10-08,Female,22,20-24,19
28,2,0,0,2,2021-10-13,Male,69,65-69,2
28,1,0,0,1,2021-10-10,Male,64,55-64,2
28,0,0,0,0,2021-10-08,Female,44,35-44,7
28,1,0,0,1,2021-10-11,Male,66,65-69,3
28,0,0,0,0,2021-10-09,Female,32,25-34,5
28,1,0,0,1,2021-10-12,Male,51,45-54,6
28,2,2,0,4,2021-10-12,Female,9,5-9,1
28,2,0,0,2,2021-10-19,Male,0,<1,1
28,0,10,0,10,2021-10-12,Male,56,55-64,18
28,0,1,0,1,2021-10-19,Male,75,75-79,1
28,1,0,0,1,2021-10-08,Male,70,70-74,2
28,1,0,0,1,2021-10-08,Male,57,55-64,7
28,0,0,0,0,2021-10-08,Male,41,35-44,6
28,0,0,0,0,2021-10-10,Male,38,35-44,5
28,1,2,0,3,2021-10-08,Female,28,25-34,7
28,0,0,0,0,2021-10-09,Female,57,55-64,2
28,2,0,0,2,2021-10-08,Male,11,10-14,2
28,3,10,0,13,2021-10-12,Female,47,45-54,2
28,3,1,0,4,2021-10-11,Male,7,5-9,2
28,2,5,0,7,2021-10-09,Male,11,10-14,2
28,1,0,0,1,2021-10-12,Female,60,55-64,1
28,0,0,0,0,2021-10-11,Female,67,65-69,4
28,1,0,0,1,2021-10-12,Female,61,55-64,1
28,0,1,0,1,2021-10-09,Female,71,70-74,13
28,1,0,0,1,2021-10-08,Female,52,45-54,7
28,0,1,0,1,2021-10-08,Male,62,55-64,2
28,0,0,0,0,2021-10-08,Male,72,70-74,2
28,0,2,0,2,2021-10-15,Female,26,25-34,4
28,1,0,0,1,2021-10-09,Male,46,45-54,20
28,1,3,0,4,2021-10-11,Male,73,70-74,3
28,2,0,0,2,2021-10-15,Male,4,1-4,5
28,1,0,0,1,2021-10-08,Female,30,25-34,2
28,0,0,0,0,2021-10-19,Female,30,25-34,1
28,4,0,0,4,2021-10-11,Male,10,10-14,2
28,0,0,0,0,2021-10-08,Male,66,65-69,7
28,0,0,0,0,2021-10-09,Female,31,25-34,4
28,1,0,0,1,2021-10-19,Male,65,65-69,1
28,1,0,0,1,2021-10-08,Male,36,35-44,7
28,1,0,0,1,2021-10-08,Female,64,55-64,17
28,3,2,0,5,2021-10-12,Male,14,10-14,14
28,0,0,0,0,2021-10-08,Female,68,65-69,2
28,1,0,0,1,2021-10-08,Female,29,25-34,3
28,0,0,0,0,2021-10-09,Female,28,25-34,2
28,2,20,0,22,2021-10-08,Female,13,10-14,6
28,1,0,0,1,2021-10-08,Female,46,45-54,7
28,0,0,0,0,2021-10-08,Male,33,25-34,6
28,1,0,0,1,2021-10-08,Male,25,25-34,2
28,1,1,0,2,2021-10-09,Male,67,65-69,2
28,3,0,0,3,2021-10-12,Female,36,35-44,6
28,1,0,0,1,2021-10-12,Female,64,55-64,1
28,1,4,0,5,2021-10-12,Female,60,55-64,1
28,1,0,0,1,2021-10-08,Female,39,35-44,5
28,1,1,0,2,2021-10-12,Male,74,70-74,1
28,2,2,0,4,2021-10-08,Male,17,15-19,2
28,0,0,0,0,2021-10-11,Male,51,45-54,2
28,1,0,0,1,2021-10-19,Male,78,75-79,1
28,0,0,0,0,2021-10-08,Female,70,70-74,2
28,0,0,0,0,2021-10-12,Female,72,70-74,1
28,0,0,0,0,2021-10-09,Female,73,70-74,2
28,1,1,0,2,2021-10-08,Female,34,25-34,3
28,1,0,0,1,2021-10-08,Male,80,80-84,2
28,0,0,0,0,2021-10-08,Female,17,15-19,3
28,0,0,3,3,2021-10-12,Female,55,55-64,1
28,1,0,0,1,2021-10-09,Male,33,25-34,6
28,1,0,0,1,2021-10-12,Female,48,45-54,3
28,0,0,0,0,2021-10-08,Male,36,35-44,5
28,1,1,4,6,2021-10-19,Male,70,70-74,1
28,2,18,0,20,2021-10-08,Male,6,5-9,2
28,1,10,0,11,2021-10-08,Female,4,1-4,6
28,1,0,0,1,2021-10-15,Female,67,65-69,14
28,0,1,0,1,2021-10-09,Female,69,65-69,18
28,1,2,0,3,2021-10-08,Female,57,55-64,2
28,1,0,0,1,2021-10-08,Male,48,45-54,8
28,0,0,0,0,2021-10-14,Female,65,65-69,3
28,0,0,0,0,2021-10-13,Female,20,20-24,10
28,0,2,0,2,2021-10-12,Female,64,55-64,1
28,2,0,0,2,2021-10-08,Female,30,25-34,6
28,0,0,0,0,2021-10-13,Male,12,10-14,19
28,0,13,0,13,2021-10-09,Female,56,55-64,8
28,3,0,0,3,2021-10-09,Male,53,45-54,8
28,0,0,0,0,2021-10-12,Female,67,65-69,1
28,0,4,0,4,2021-10-08,Male,47,45-54,13
28,1,1,0,2,2021-10-08,Male,35,35-44,3
28,0,1,0,1,2021-10-08,Male,51,45-54,8
28,0,0,0,0,2021-10-08,Female,34,25-34,7
28,2,0,0,2,2021-10-08,Male,65,65-69,8
28,1,0,0,1,2021-10-08,Male,1,1-4,4
28,1,0,0,1,2021-10-08,Female,59,55-64,3
28,1,0,0,1,2021-10-18,Male,73,70-74,1
28,0,0,0,0,2021-10-18,Female,33,25-34,1
28,0,0,0,0,2021-10-08,Female,77,75-79,14
28,4,9,19,32,2021-10-08,Male,13,10-14,8
28,2,2,0,4,2021-10-16,Female,71,70-74,8
28,1,0,0,1,2021-10-12,Female,54,45-54,1
28,0,0,0,0,2021-10-10,Female,19,15-19,6
28,0,0,0,0,2021-10-19,Male,66,65-69,1
28,1,0,0,1,2021-10-08,Male,71,70-74,2
28,1,0,0,1,2021-10-08,Male,61,55-64,2
28,1,2,0,3,2021-10-08,Female,61,55-64,3
28,1,0,0,1,2021-10-08,Male,37,35-44,2
28,1,5,0,6,2021-10-08,Male,63,55-64,2
28,1,0,0,1,2021-10-19,Female,29,25-34,1
28,0,0,0,0,2021-10-08,Male,51,45-54,3
28,0,0,0,0,2021-10-15,Male,72,70-74,11
28,1,0,0,1,2021-10-09,Male,72,70-74,3
28,3,0,0,3,2021-10-08,Male,4,1-4,3
28,0,5,0,5,2021-10-09,Female,65,65-69,3
28,0,1,0,1,2021-10-08,Female,28,25-34,19
28,0,0,0,0,2021-10-12,Male,70,70-74,1
28,0,0,0,0,2021-10-08,Male,46,45-54,3
28,1,2,0,3,2021-10-10,Male,55,55-64,2
28,1,0,4,5,2021-10-19,Male,20,20-24,1
28,1,0,0,1,2021-10-13,Male,65,65-69,2
28,3,0,0,3,2021-10-08,Female,11,10-14,2
28,0,0,0,0,2021-10-12,Female,64,55-64,1
28,1,1,0,2,2021-10-08,Male,19,15-19,7
28,1,1,0,2,2021-10-19,Male,75,75-79,1
28,1,3,0,4,2021-10-19,Male,76,75-79,1
28,0,0,0,0,2021-10-19,Male,76,75-79,1
28,1,4,0,5,2021-10-12,Male,43,35-44,2
28,1,0,0,1,2021-10-12,Male,32,25-34,2
28,1,0,0,1,2021-10-09,Male,77,75-79,7
28,1,0,0,1,2021-10-08,Male,56,55-64,2
28,1,0,0,1,2021-10-08,Female,63,55-64,7
28,1,6,0,7,2021-10-08,Female,17,15-19,7
28,0,0,0,0,2021-10-08,Male,7,5-9,2
28,1,2,0,3,2021-10-08,Male,70,70-74,7
28,1,7,0,8,2021-10-12,Female,60,55-64,1
28,2,0,0,2,2021-10-08,Male,49,45-54,22
28,0,4,0,4,2021-10-13,Female,33,25-34,2
28,0,0,0,0,2021-10-08,Male,61,55-64,6
28,1,0,0,1,2021-10-12,Female,52,45-54,1
28,2,0,0,2,2021-10-12,Female,16,15-19,1
28,0,0,0,0,2021-10-15,Female,79,75-79,8
28,1,15,0,16,2021-10-08,Female,66,65-69,7
28,1,2,0,3,2021-10-08,Female,74,70-74,2
28,0,0,0,0,2021-10-12,Male,72,70-74,2
28,1,6,0,7,2021-10-08,Male,71,70-74,2
28,1,0,0,1,2021-10-18,Male,70,70-74,1
28,1,1,0,2,2021-10-08,Female,69,65-69,8
28,2,0,0,2,2021-10-08,Female,49,45-54,2
28,0,0,0,0,2021-10-12,Female,69,65-69,1
28,0,0,0,0,2021-10-16,Male,40,35-44,6
28,0,2,12,14,2021-10-20,Female,26,25-34,1
28,1,0,0,1,2021-10-13,Female,33,25-34,4
28,1,0,0,1,2021-10-09,Female,53,45-54,2
28,0,0,0,0,2021-10-08,Female,67,65-69,2
28,0,0,0,0,2021-10-12,Male,28,25-34,12
28,1,0,0,1,2021-10-12,Male,49,45-54,2
28,1,0,0,1,2021-10-14,Female,34,25-34,7
28,0,1,0,1,2021-10-11,Male,53,45-54,5
28,0,0,0,0,2021-10-08,Male,53,45-54,8
28,2,0,0,2,2021-10-13,Male,7,5-9,1
28,0,0,0,0,2021-10-08,Female,51,45-54,8
28,2,0,0,2,2021-10-08,Female,12,10-14,2
28,1,0,0,1,2021-10-09,Female,66,65-69,7
28,0,3,0,3,2021-10-08,Female,72,70-74,2
28,1,5,0,6,2021-10-19,Male,73,70-74,1
28,1,0,0,1,2021-10-18,Female,67,65-69,1
28,1,15,40,56,2021-10-08,Male,14,10-14,2
28,3,2,0,5,2021-10-08,Male,0,<1,2
28,1,2,0,3,2021-10-08,Female,54,45-54,3
28,4,0,0,4,2021-10-08,Female,2,1-4,5
28,1,1,0,2,2021-10-09,Male,74,70-74,2
28,2,1,0,3,2021-10-17,Female,66,65-69,9
28,2,0,0,2,2021-10-08,Male,4,1-4,2
28,0,0,0,0,2021-10-08,Male,57,55-64,8
28,2,0,0,2,2021-10-12,Male,29,25-34,2
28,0,0,0,0,2021-10-08,Female,75,75-79,2
28,0,0,0,0,2021-10-12,Female,58,55-64,1
28,1,0,0,1,2021-10-18,Male,65,65-69,1
28,0,11,0,11,2021-10-12,Female,52,45-54,1
28,1,0,0,1,2021-10-09,Male,71,70-74,2
28,1,0,0,1,2021-10-12,Female,67,65-69,1
28,0,5,0,5,2021-10-08,Male,46,45-54,2
28,0,0,0,0,2021-10-19,Male,65,65-69,1
28,0,0,0,0,2021-10-08,Male,70,70-74,2
28,0,0,0,0,2021-10-11,Male,18,15-19,2
28,1,0,0,1,2021-10-08,Male,24,20-24,15
28,1,0,0,1,2021-10-08,Male,74,70-74,2
28,1,1,0,2,2021-10-08,Male,65,65-69,2
28,0,0,0,0,2021-10-11,Male,34,25-34,4
28,0,0,0,0,2021-10-09,Male,46,45-54,8
28,2,0,0,2,2021-10-14,Female,69,65-69,5
28,3,1,0,4,2021-10-09,Male,8,5-9,5
28,0,0,0,0,2021-10-08,Female,26,25-34,6
28,1,0,0,1,2021-10-08,Male,67,65-69,2
28,0,0,0,0,2021-10-08,Male,38,35-44,6
28,3,0,18,21,2021-10-20,Female,2,1-4,1
28,1,3,0,4,2021-10-12,Male,59,55-64,1
28,1,0,0,1,2021-10-08,Male,59,55-64,3
28,0,0,0,0,2021-10-08,Female,29,25-34,13
28,0,0,0,0,2021-10-12,Female,61,55-64,1
28,2,0,0,2,2021-10-08,Male,62,55-64,8
28,1,0,0,1,2021-10-08,Male,30,25-34,3
28,1,0,0,1,2021-10-08,Male,70,70-74,2
28,0,0,0,0,2021-10-13,Female,31,25-34,5
28,0,0,0,0,2021-10-09,Male,48,45-54,3
28,1,0,0,1,2021-10-12,Male,53,45-54,1
28,2,0,0,2,2021-10-09,Male,66,65-69,18
28,2,3,0,5,2021-10-11,Female,68,65-69,7
28,0,0,0,0,2021-10-10,Female,32,25-34,13
28,0,1,0,1,2021-10-08,Female,66,65-69,8
28,0,0,0,0,2021-10-09,Male,69,65-69,2
28,2,0,0,2,2021-10-09,Female,80,80-84,21
28,1,2,0,3,2021-10-08,Male,69,65-69,2
28,2,0,0,2,2021-10-09,Female,19,15-19,7
28,1,0,0,1,2021-10-08,Male,72,70-74,2
28,1,0,0,1,2021-10-09,Female,58,55-64,4
28,0,1,0,1,2021-10-08,Female,61,55-64,8
28,1,4,0,5,2021-10-09,Female,53,45-54,7
28,0,0,0,0,2021-10-12,Female,71,70-74,1
28,1,0,0,1,2021-10-09,Female,49,45-54,5
28,0,1,0,1,2021-10-15,Male,27,25-34,3
28,0,2,0,2,2021-10-12,Female,59,55-64,1
28,1,0,0,1,2021-10-09,Female,70,70-74,8
28,1,0,0,1,2021-10-12,Female,45,45-54,1
28,0,12,0,12,2021-10-10,Male,37,35-44,6
28,2,0,12,14,2021-10-15,Male,20,20-24,4
28,0,2,0,2,2021-10-09,Male,67,65-69,16
28,0,0,33,33,2021-10-12,Male,58,55-64,1
28,0,0,2,2,2021-10-09,Female,22,20-24,3
28,1,1,0,2,2021-10-09,Female,52,45-54,3
28,0,2,0,2,2021-10-10,Female,43,35-44,2
28,1,4,0,5,2021-10-18,Male,73,70-74,1
28,0,0,0,0,2021-10-08,Male,44,35-44,3
28,1,0,0,1,2021-10-19,Female,57,55-64,1
28,0,0,0,0,2021-10-14,Female,11,10-14,4
28,1,0,0,1,2021-10-10,Female,57,55-64,2
28,0,0,0,0,2021-10-09,Male,50,45-54,3
28,0,1,0,1,2021-10-19,Female,30,25-34,1
28,2,0,0,2,2021-10-08,Male,19,15-19,16
28,1,0,0,1,2021-10-19,Male,82,80-84,1
28,1,8,0,9,2021-10-19,Male,57,55-64,1
29,0,0,0,0,2021-10-26,Female,53,45-54,4
29,2,0,0,2,2021-10-24,Female,34,25-34,2
29,3,0,0,3,2021-10-24,Female,9,5-9,2
29,2,0,0,2,2021-10-25,Female,0,<1,3
29,1,0,0,1,2021-10-22,Female,70,70-74,18
29,0,0,0,0,2021-10-26,Female,73,70-74,2
29,1,0,0,1,2021-10-23,Male,31,25-34,4
29,2,0,0,2,2021-10-23,Male,65,65-69,9
29,0,0,0,0,2021-10-22,Female,49,45-54,9
29,2,1,0,3,2021-11-02,Female,23,20-24,1
29,0,0,0,0,2021-10-22,Male,24,20-24,8
29,0,0,0,0,2021-10-22,Female,15,15-19,2
29,0,0,0,0,2021-10-24,Female,15,15-19,10
29,1,0,0,1,2021-10-29,Male,19,15-19,1
29,1,0,0,1,2021-10-22,Female,56,55-64,5
29,1,0,0,1,2021-10-22,Female,58,55-64,7
29,1,2,0,3,2021-10-23,Male,72,70-74,9
29,0,0,0,0,2021-10-22,Female,33,25-34,6
29,0,2,0,2,2021-10-23,Female,63,55-64,16
29,1,0,0,1,2021-10-23,Male,70,70-74,3
29,0,5,0,5,2021-10-25,Female,42,35-44,3
29,1,0,0,1,2021-10-22,Female,11,10-14,4
29,0,2,0,2,2021-10-23,Male,41,35-44,3
29,2,0,0,2,2021-10-23,Male,9,5-9,5
29,2,0,0,2,2021-10-26,Female,58,55-64,8
29,3,0,0,3,2021-10-24,Male,17,15-19,4
29,1,1,0,2,2021-10-22,Male,76,75-79,2
29,1,2,0,3,2021-10-26,Female,74,70-74,2
29,0,0,0,0,2021-10-22,Female,7,5-9,6
29,1,1,0,2,2021-10-25,Female,67,65-69,3
29,2,7,0,9,2021-10-22,Female,48,45-54,2
29,2,0,0,2,2021-10-22,Female,2,1-4,3
29,2,0,0,2,2021-10-24,Male,14,10-14,2
29,1,0,0,1,2021-10-22,Female,54,45-54,4
29,1,3,0,4,2021-10-23,Male,41,35-44,4
29,2,0,0,2,2021-10-24,Female,46,45-54,6
29,0,4,0,4,2021-10-23,Male,72,70-74,3
29,2,1,0,3,2021-10-23,Female,1,1-4,4
29,3,0,0,3,2021-10-22,Male,7,5-9,7
29,1,0,0,1,2021-10-23,Male,58,55-64,3
29,0,0,0,0,2021-10-22,Female,66,65-69,8
29,0,0,0,0,2021-10-22,Male,50,45-54,8
29,3,0,0,3,2021-10-23,Female,5,5-9,3
29,0,0,0,0,2021-10-22,Female,11,10-14,22
29,0,4,0,4,2021-10-24,Female,41,35-44,7
29,3,0,0,3,2021-10-26,Male,10,10-14,3
29,0,0,0,0,2021-10-24,Male,33,25-34,19
29,3,1,0,4,2021-10-26,Female,55,55-64,7
29,1,11,0,12,2021-10-23,Male,57,55-64,8
29,1,0,0,1,2021-11-02,Female,65,65-69,1
29,0,0,0,0,2021-10-31,Male,20,20-24,1
29,1,1,0,2,2021-10-23,Male,58,55-64,3
29,1,0,0,1,2021-10-22,Male,53,45-54,4
29,1,0,0,1,2021-10-26,Female,57,55-64,9
29,1,8,0,9,2021-10-23,Female,50,45-54,8
29,1,0,0,1,2021-10-25,Male,60,55-64,9
29,0,5,0,5,2021-10-22,Male,48,45-54,7
29,0,1,0,1,2021-10-22,Male,50,45-54,6
29,0,0,0,0,2021-10-25,Male,43,35-44,8
29,1,2,0,3,2021-10-26,Female,54,45-54,4
29,1,0,0,1,2021-10-25,Male,35,35-44,18
29,0,0,0,0,2021-10-26,Male,54,45-54,20
29,2,0,0,2,2021-10-26,Female,37,35-44,3
29,0,2,0,2,2021-10-28,Female,37,35-44,2
29,0,0,0,0,2021-10-26,Female,66,65-69,5
29,1,0,0,1,2021-11-02,Female,58,55-64,1
29,1,10,0,11,2021-10-23,Female,31,25-34,4
29,0,0,0,0,2021-10-23,Male,56,55-64,3
29,1,0,0,1,2021-10-25,Female,40,35-44,2
29,0,0,0,0,2021-10-22,Male,42,35-44,26
29,0,1,0,1,2021-10-22,Female,79,75-79,8
29,1,2,0,3,2021-10-22,Female,49,45-54,3
29,1,2,0,3,2021-10-28,Female,67,65-69,3
29,1,0,0,1,2021-11-01,Male,5,5-9,1
29,0,0,0,0,2021-10-23,Female,18,15-19,2
29,0,0,0,0,2021-10-24,Male,85,85+,23
29,0,0,0,0,2021-10-22,Male,37,35-44,3
29,0,1,0,1,2021-10-22,Male,30,25-34,5
29,1,0,0,1,2021-10-25,Female,33,25-34,5
29,1,0,0,1,2021-10-22,Male,66,65-69,3
29,0,12,0,12,2021-10-29,Female,31,25-34,1
29,0,2,0,2,2021-10-26,Male,54,45-54,14
29,0,0,0,0,2021-10-22,Male,15,15-19,17
29,0,0,0,0,2021-10-23,Male,62,55-64,5
29,1,1,0,2,2021-10-23,Male,33,25-34,8
29,0,0,0,0,2021-11-01,Female,18,15-19,1
29,0,6,0,6,2021-10-22,Female,40,35-44,3
29,0,0,0,0,2021-10-23,Female,70,70-74,9
29,0,3,0,3,2021-10-22,Male,41,35-44,5
29,3,0,0,3,2021-10-24,Female,22,20-24,5
29,1,0,0,1,2021-10-23,Female,69,65-69,4
29,0,1,0,1,2021-10-22,Male,62,55-64,2
29,1,6,0,7,2021-10-22,Female,4,1-4,3
29,1,1,0,2,2021-11-02,Female,54,45-54,1
29,1,0,0,1,2021-10-22,Female,50,45-54,4
29,0,0,0,0,2021-10-23,Male,36,35-44,7
29,0,0,0,0,2021-10-22,Male,61,55-64,3
29,0,0,0,0,2021-10-26,Female,56,55-64,3
29,5,36,37,78,2021-10-30,Male,19,15-19,1
29,1,0,0,1,2021-10-23,Female,45,45-54,4
29,1,0,0,1,2021-10-22,Female,51,45-54,2
29,2,0,0,2,2021-10-26,Female,16,15-19,7
29,1,0,0,1,2021-10-23,Male,76,75-79,3
29,1,0,0,1,2021-10-25,Female,13,10-14,7
29,0,3,10,13,2021-10-23,Female,78,75-79,3
29,1,0,0,1,2021-11-02,Male,61,55-64,1
29,0,1,0,1,2021-10-23,Male,53,45-54,23
29,1,5,0,6,2021-10-23,Male,70,70-74,2
29,1,0,0,1,2021-10-22,Female,38,35-44,8
29,0,0,0,0,2021-10-25,Male,68,65-69,3
29,0,0,0,0,2021-10-23,Female,51,45-54,5
29,1,2,0,3,2021-10-24,Female,60,55-64,2
29,0,0,0,0,2021-10-24,Male,61,55-64,9
29,3,0,0,3,2021-10-22,Female,18,15-19,6
29,0,0,0,0,2021-10-25,Male,68,65-69,2
29,2,2,0,4,2021-10-23,Male,51,45-54,2
29,2,4,8,14,2021-10-23,Female,52,45-54,3
29,0,2,0,2,2021-10-24,Female,56,55-64,8
29,1,1,0,2,2021-10-22,Male,39,35-44,8
29,1,0,0,1,2021-10-22,Female,72,70-74,8
29,0,0,0,0,2021-10-22,Female,61,55-64,16
29,2,0,0,2,2021-10-22,Female,73,70-74,3
29,1,8,42,51,2021-10-27,Male,75,75-79,2
29,3,0,0,3,2021-10-22,Female,49,45-54,2
29,0,2,0,2,2021-10-25,Female,62,55-64,2
29,3,0,25,28,2021-10-24,Male,7,5-9,7
29,0,0,0,0,2021-11-02,Male,27,25-34,1
29,0,0,0,0,2021-10-23,Female,78,75-79,22
29,0,0,0,0,2021-10-22,Male,33,25-34,5
29,1,1,4,6,2021-10-22,Female,64,55-64,3
29,0,0,0,0,2021-10-25,Male,77,75-79,2
29,1,0,0,1,2021-10-23,Male,67,65-69,7
29,0,0,3,3,2021-10-29,Female,0,<1,1
29,0,2,0,2,2021-10-26,Female,53,45-54,16
29,3,0,0,3,2021-10-29,Male,29,25-34,1
29,2,3,0,5,2021-10-24,Male,9,5-9,2
29,1,6,21,28,2021-10-22,Male,69,65-69,3
29,1,0,0,1,2021-10-25,Female,43,35-44,3
29,0,4,0,4,2021-10-23,Male,71,70-74,3
29,0,0,0,0,2021-10-22,Female,65,65-69,3
29,1,0,0,1,2021-11-02,Male,59,55-64,1
29,0,0,0,0,2021-10-25,Female,78,75-79,5
29,0,3,0,3,2021-10-23,Female,61,55-64,2
29,0,4,0,4,2021-10-27,Male,38,35-44,6
29,1,0,0,1,2021-10-25,Male,68,65-69,3
29,0,5,0,5,2021-10-23,Male,56,55-64,8
29,2,0,0,2,2021-10-26,Female,56,55-64,2
29,1,3,0,4,2021-10-26,Female,71,70-74,4
29,1,1,0,2,2021-10-26,Female,60,55-64,8
29,1,7,0,8,2021-11-02,Female,44,35-44,1
29,0,0,0,0,2021-10-26,Male,73,70-74,9
29,1,0,0,1,2021-10-22,Female,50,45-54,3
29,1,2,0,3,2021-10-25,Female,28,25-34,9
29,0,0,0,0,2021-10-22,Female,36,35-44,7
29,0,6,0,6,2021-10-24,Male,34,25-34,3
29,0,0,0,0,2021-10-24,Male,32,25-34,12
29,1,0,0,1,2021-10-23,Male,67,65-69,18
29,1,9,5,15,2021-10-29,Male,30,25-34,1
29,1,0,0,1,2021-10-30,Female,31,25-34,1
29,2,0,0,2,2021-10-22,Male,65,65-69,8
29,0,0,0,0,2021-10-22,Female,29,25-34,3
29,4,0,0,4,2021-10-22,Female,4,1-4,10
29,0,3,0,3,2021-10-25,Female,36,35-44,5
29,0,0,0,0,2021-10-23,Male,70,70-74,17
29,3,0,0,3,2021-10-22,Male,11,10-14,3
29,0,0,0,0,2021-10-23,Female,56,55-64,2
29,1,0,0,1,2021-10-23,Male,78,75-79,2
29,0,5,0,5,2021-10-22,Female,54,45-54,9
29,4,0,0,4,2021-10-25,Female,10,10-14,16
29,0,3,0,3,2021-10-23,Male,73,70-74,2
29,1,0,0,1,2021-10-25,Male,68,65-69,22
29,0,0,0,0,2021-10-24,Male,32,25-34,8
29,1,0,0,1,2021-10-22,Female,58,55-64,9
29,1,0,0,1,2021-10-23,Female,72,70-74,7
29,0,0,0,0,2021-10-23,Female,21,20-24,18
29,2,0,0,2,2021-10-26,Male,2,1-4,3
29,1,0,0,1,2021-10-22,Male,39,35-44,4
29,2,0,0,2,2021-10-23,Male,10,10-14,8
29,0,0,0,0,2021-10-24,Female,75,75-79,9
29,1,3,0,4,2021-11-02,Male,56,55-64,1
29,0,1,0,1,2021-10-22,Male,58,55-64,3
29,1,0,0,1,2021-10-24,Male,68,65-69,3
29,4,0,0,4,2021-10-23,Female,2,1-4,20
29,0,1,0,1,2021-10-23,Female,18,15-19,3
29,3,1,0,4,2021-10-22,Male,17,15-19,23
29,0,0,0,0,2021-10-23,Male,66,65-69,4
29,0,2,0,2,2021-10-23,Male,51,45-54,2
29,0,6,0,6,2021-10-23,Male,70,70-74,19
29,3,0,0,3,2021-10-24,Female,13,10-14,2
29,1,0,0,1,2021-10-22,Female,61,55-64,9
29,0,2,0,2,2021-10-25,Female,27,25-34,5
29,0,0,0,0,2021-10-26,Female,73,70-74,2
29,1,0,0,1,2021-10-23,Male,72,70-74,3
29,2,3,0,5,2021-10-29,Male,30,25-34,1
29,1,0,0,1,2021-10-22,Male,64,55-64,3
29,2,0,0,2,2021-10-22,Female,16,15-19,2
29,2,0,0,2,2021-10-22,Male,35,35-44,7
29,2,0,0,2,2021-10-22,Male,13,10-14,5
29,0,0,0,0,2021-10-22,Female,31,25-34,2
29,0,0,0,0,2021-10-24,Female,33,25-34,2
29,1,0,0,1,2021-10-22,Male,71,70-74,2
29,1,0,0,1,2021-10-30,Male,32,25-34,1
29,1,0,0,1,2021-10-24,Female,61,55-64,8
29,1,0,0,1,2021-10-24,Male,52,45-54,8
29,1,2,0,3,2021-10-23,Female,31,25-34,2
29,0,2,0,2,2021-10-23,Male,55,55-64,2
29,2,0,8,10,2021-10-31,Male,3,1-4,1
29,1,0,0,1,2021-10-25,Female,55,55-64,2
29,1,0,0,1,2021-10-22,Male,55,55-64,6
29,2,0,0,2,2021-10-23,Female,28,25-34,9
29,2,0,0,2,2021-10-29,Male,1,1-4,1
29,0,4,0,4,2021-10-24,Male,69,65-69,17
29,3,0,0,3,2021-10-23,Female,0,<1,2
29,0,0,0,0,2021-10-22,Male,34,25-34,18
29,0,0,0,0,2021-10-23,Male,30,25-34,15
29,2,1,4,7,2021-10-22,Male,11,10-14,3
29,1,0,0,1,2021-10-23,Male,69,65-69,9
29,1,2,0,3,2021-10-23,Male,13,10-14,2
29,2,0,0,2,2021-10-25,Female,8,5-9,2
29,2,0,0,2,2021-10-25,Male,34,25-34,2
29,0,0,0,0,2021-10-22,Female,31,25-34,8
29,1,3,0,4,2021-10-23,Male,74,70-74,4
29,0,1,0,1,2021-10-25,Male,41,35-44,3
29,1,0,0,1,2021-10-25,Female,44,35-44,7
29,0,5,0,5,2021-10-24,Male,82,80-84,2
29,0,0,0,0,2021-10-24,Male,36,35-44,11
29,0,0,0,0,2021-10-25,Male,51,45-54,3
29,0,0,0,0,2021-10-23,Male,47,45-54,8
29,1,0,0,1,2021-10-26,Female,10,10-14,3
29,1,0,0,1,2021-10-23,Female,68,65-69,9
29,1,0,0,1,2021-10-26,Female,65,65-69,3
29,2,0,0,2,2021-10-25,Male,12,10-14,6
29,0,1,0,1,2021-10-22,Female,41,35-44,2
29,0,0,0,0,2021-10-25,Female,44,35-44,6
29,3,0,0,3,2021-10-24,Female,56,55-64,2
29,0,0,0,0,2021-10-27,Male,53,45-54,6
29,0,0,0,0,2021-10-25,Male,30,25-34,4
29,1,0,0,1,2021-10-25,Female,27,25-34,2
29,1,0,0,1,2021-10-22,Male,61,55-64,7
29,1,0,6,7,2021-10-28,Female,31,25-34,5
29,0,3,0,3,2021-10-22,Female,44,35-44,4
29,2,0,0,2,2021-10-24,Female,3,1-4,4
29,0,0,0,0,2021-10-23,Male,70,70-74,22
29,0,4,0,4,2021-10-22,Female,85,85+,2
29,1,44,3,48,2021-10-29,Male,27,25-34,1
29,1,0,0,1,2021-10-22,Male,65,65-69,5
29,1,6,0,7,2021-10-25,Male,64,55-64,4
29,0,0,0,0,2021-10-27,Female,54,45-54,12
29,1,0,0,1,2021-10-23,Male,68,65-69,2
29,1,0,0,1,2021-11-01,Female,27,25-34,1
29,3,0,0,3,2021-10-23,Female,16,15-19,19
29,1,0,0,1,2021-11-02,Male,65,65-69,1
29,0,11,0,11,2021-10-28,Male,53,45-54,5
29,0,2,0,2,2021-10-22,Female,66,65-69,4
29,2,2,0,4,2021-10-24,Male,32,25-34,2
29,1,0,0,1,2021-10-25,Female,41,35-44,3
29,1,3,0,4,2021-10-24,Female,54,45-54,5
29,1,5,0,6,2021-10-22,Female,71,70-74,3
29,3,1,0,4,2021-10-23,Female,19,15-19,8
29,1,2,0,3,2021-10-22,Female,67,65-69,2
29,0,2,0,2,2021-10-22,Male,40,35-44,9
29,0,0,0,0,2021-10-22,Male,32,25-34,7
29,0,0,0,0,2021-10-24,Male,37,35-44,4
29,0,32,2,34,2021-11-02,Female,71,70-74,1
29,0,0,0,0,2021-10-22,Male,42,35-44,10
29,1,0,0,1,2021-10-26,Female,54,45-54,9
29,1,0,0,1,2021-10-26,Female,25,25-34,9
29,1,0,0,1,2021-10-23,Male,51,45-54,7
29,1,0,0,1,2021-10-23,Female,69,65-69,3
29,1,0,0,1,2021-10-24,Male,43,35-44,6
29,0,0,0,0,2021-10-22,Female,34,25-34,5
29,1,0,0,1,2021-10-23,Male,49,45-54,8
29,0,0,0,0,2021-11-02,Male,55,55-64,1
29,0,3,7,10,2021-10-23,Male,60,55-64,3
29,1,8,0,9,2021-10-23,Male,50,45-54,4
29,1,0,0,1,2021-10-24,Female,61,55-64,2
29,1,0,0,1,2021-10-23,Male,70,70-74,3
29,4,0,0,4,2021-10-22,Male,16,15-19,3
29,1,0,0,1,2021-10-22,Male,24,20-24,12
29,0,0,0,0,2021-10-23,Female,57,55-64,18
29,1,0,0,1,2021-10-25,Female,64,55-64,9
29,0,1,0,1,2021-10-23,Female,51,45-54,11
29,0,1,0,1,2021-10-22,Female,43,35-44,6
29,3,20,0,23,2021-10-26,Male,13,10-14,3
29,0,1,0,1,2021-10-22,Female,74,70-74,7
29,1,4,0,5,2021-10-22,Female,40,35-44,2
29,0,0,0,0,2021-10-25,Male,53,45-54,17
29,3,0,0,3,2021-10-22,Female,47,45-54,2
29,0,0,0,0,2021-10-22,Male,58,55-64,4
29,1,0,0,1,2021-10-25,Male,27,25-34,8
29,2,0,0,2,2021-10-23,Male,68,65-69,2
29,1,5,0,6,2021-10-22,Female,30,25-34,3
29,1,0,0,1,2021-10-24,Male,34,25-34,6
29,1,1,0,2,2021-10-23,Female,61,55-64,2
29,0,0,0,0,2021-10-22,Male,49,45-54,5
29,0,0,0,0,2021-10-26,Male,31,25-34,6
29,0,6,0,6,2021-10-25,Male,66,65-69,2
29,3,0,0,3,2021-10-22,Female,18,15-19,2
29,3,0,0,3,2021-11-02,Male,12,10-14,1
29,0,0,0,0,2021-10-28,Male,46,45-54,5
29,1,8,0,9,2021-10-24,Male,73,70-74,3
29,1,0,0,1,2021-11-02,Female,51,45-54,1
29,0,11,0,11,2021-10-25,Male,41,35-44,2
29,1,6,0,7,2021-10-22,Female,20,20-24,4
29,1,0,0,1,2021-10-22,Male,64,55-64,7
29,1,0,0,1,2021-10-22,Female,49,45-54,5
29,1,0,0,1,2021-10-25,Male,64,55-64,8
29,0,0,0,0,2021-10-26,Female,67,65-69,14
29,1,0,0,1,2021-10-22,Male,45,45-54,7
29,0,0,0,0,2021-10-22,Male,77,75-79,2
29,0,1,0,1,2021-10-22,Male,60,55-64,7
29,1,0,0,1,2021-10-29,Female,33,25-34,1
29,0,0,0,0,2021-10-22,Female,53,45-54,2
29,0,1,0,1,2021-10-27,Female,67,65-69,3
29,2,0,0,2,2021-10-23,Male,54,45-54,3
29,0,0,0,0,2021-10-24,Female,65,65-69,7
29,0,1,0,1,2021-10-26,Female,57,55-64,6
29,1,5,0,6,2021-10-23,Male,77,75-79,5
29,3,2,0,5,2021-10-23,Female,37,35-44,2
29,2,3,0,5,2021-10-22,Male,52,45-54,3
29,1,0,0,1,2021-10-22,Female,72,70-74,7
29,0,0,0,0,2021-10-22,Male,57,55-64,2
29,4,0,0,4,2021-10-22,Male,6,5-9,6
29,1,3,0,4,2021-10-23,Male,69,65-69,11
29,2,0,0,2,2021-10-24,Male,5,5-9,4
29,2,0,0,2,2021-10-29,Male,32,25-34,1
29,1,0,0,1,2021-10-31,Male,27,25-34,1
29,3,0,0,3,2021-10-25,Male,18,15-19,4
29,3,4,0,7,2021-10-22,Female,4,1-4,2
29,0,2,0,2,2021-10-22,Male,49,45-54,3
29,0,1,0,1,2021-10-23,Female,34,25-34,2
29,1,1,0,2,2021-10-24,Male,72,70-74,3
29,1,0,0,1,2021-10-23,Female,37,35-44,5
29,0,0,0,0,2021-10-25,Female,30,25-34,3
29,0,2,0,2,2021-10-22,Female,70,70-74,3
29,2,0,0,2,2021-10-22,Female,48,45-54,5
29,3,0,0,3,2021-10-24,Female,19,15-19,4
29,0,1,0,1,2021-10-25,Male,53,45-54,3
29,1,0,0,1,2021-10-22,Male,51,45-54,2
29,1,0,0,1,2021-10-23,Female,62,55-64,2
29,0,0,0,0,2021-10-23,Male,23,20-24,9
29,0,2,0,2,2021-10-24,Male,55,55-64,2
29,0,0,0,0,2021-10-23,Female,50,45-54,2
29,0,0,0,0,2021-10-23,Female,61,55-64,2
29,0,1,0,1,2021-10-27,Male,69,65-69,4
29,0,5,0,5,2021-10-24,Female,50,45-54,6
29,2,0,0,2,2021-10-23,Female,39,35-44,7
29,3,3,0,6,2021-10-29,Female,19,15-19,1
29,1,0,0,1,2021-10-22,Female,53,45-54,4
29,0,0,0,0,2021-10-23,Male,16,15-19,9
29,1,12,0,13,2021-10-24,Female,51,45-54,2
29,2,0,0,2,2021-10-22,Female,0,<1,5
29,1,1,0,2,2021-10-23,Male,75,75-79,5
29,1,0,0,1,2021-10-25,Female,54,45-54,8
29,2,40,0,42,2021-10-22,Female,59,55-64,8
29,0,0,0,0,2021-10-25,Male,45,45-54,3
29,2,20,12,34,2021-10-28,Male,10,10-14,2
29,1,0,0,1,2021-10-23,Female,6,5-9,18
29,0,0,0,0,2021-10-25,Female,62,55-64,3
29,0,0,0,0,2021-10-26,Male,72,70-74,2
29,1,0,0,1,2021-10-23,Male,70,70-74,2
29,0,0,0,0,2021-10-22,Male,44,35-44,24
29,0,3,0,3,2021-10-26,Male,55,55-64,2
29,0,0,0,0,2021-10-22,Male,34,25-34,8
29,0,0,0,0,2021-10-22,Male,43,35-44,7
29,0,0,0,0,2021-10-22,Male,28,25-34,1
29,1,1,0,2,2021-10-23,Male,75,75-79,3
29,3,0,0,3,2021-11-02,Female,17,15-19,3
29,0,2,0,2,2021-10-22,Female,48,45-54,4
29,0,0,0,0,2021-10-22,Male,68,65-69,2
29,1,0,0,1,2021-10-24,Male,66,65-69,21
29,2,3,0,5,2021-10-23,Male,18,15-19,9
29,0,2,0,2,2021-10-23,Female,62,55-64,3
29,0,0,0,0,2021-10-23,Male,70,70-74,3
29,0,2,0,2,2021-10-25,Female,73,70-74,4
29,1,0,0,1,2021-10-23,Female,22,20-24,7
29,2,0,0,2,2021-10-22,Male,39,35-44,4
29,1,0,0,1,2021-10-23,Female,2,1-4,9
29,0,0,0,0,2021-10-25,Male,63,55-64,4
29,2,5,0,7,2021-10-22,Male,5,5-9,2
29,0,0,0,0,2021-10-30,Male,34,25-34,1
29,0,0,0,0,2021-10-24,Male,44,35-44,18
29,0,1,0,1,2021-10-22,Male,13,10-14,4
29,0,3,2,5,2021-10-23,Male,28,25-34,8
29,0,0,0,0,2021-10-24,Female,73,70-74,4
29,1,0,0,1,2021-10-23,Female,70,70-74,3
29,1,0,0,1,2021-10-22,Female,58,55-64,4
29,0,15,0,15,2021-10-25,Female,63,55-64,3
29,2,0,0,2,2021-10-23,Female,27,25-34,4
29,0,17,17,34,2021-10-25,Male,63,55-64,2
29,1,8,0,9,2021-10-24,Female,45,45-54,5
29,0,4,0,4,2021-10-26,Female,56,55-64,9
29,0,0,0,0,2021-10-25,Male,45,45-54,17
29,0,10,0,10,2021-10-26,Male,45,45-54,2
29,0,0,0,0,2021-10-22,Male,22,20-24,3
29,1,0,0,1,2021-10-23,Female,67,65-69,2
29,2,2,0,4,2021-10-25,Female,23,20-24,4
29,1,0,0,1,2021-10-23,Female,56,55-64,2
29,0,4,0,4,2021-10-22,Male,70,70-74,9
29,0,0,0,0,2021-10-24,Female,60,55-64,2
29,1,0,0,1,2021-10-22,Male,29,25-34,8
29,1,0,0,1,2021-10-24,Male,61,55-64,14
29,0,3,0,3,2021-10-24,Male,14,10-14,2
29,1,0,0,1,2021-10-23,Female,22,20-24,5
29,1,1,0,2,2021-10-24,Male,61,55-64,4
29,0,1,3,4,2021-10-22,Male,73,70-74,2
29,0,0,0,0,2021-10-24,Female,33,25-34,3
29,1,0,0,1,2021-10-24,Male,62,55-64,3
29,1,0,0,1,2021-10-26,Male,72,70-74,2
29,0,0,0,0,2021-10-24,Male,37,35-44,3
29,0,0,2,2,2021-10-24,Female,34,25-34,3
29,1,2,0,3,2021-11-01,Male,32,25-34,1
29,1,0,0,1,2021-10-23,Female,71,70-74,8
29,1,0,0,1,2021-10-25,Female,64,55-64,2
29,1,8,0,9,2021-11-02,Female,50,45-54,1
29,0,2,0,2,2021-10-22,Female,59,55-64,3
29,0,0,0,0,2021-10-22,Female,64,55-64,2
29,1,0,0,1,2021-10-23,Male,75,75-79,3
29,4,0,0,4,2021-10-24,Female,14,10-14,6
29,0,0,0,0,2021-10-25,Female,42,35-44,4
29,2,1,0,3,2021-10-24,Female,50,45-54,14
29,1,1,0,2,2021-10-23,Female,69,65-69,4
29,2,0,0,2,2021-10-24,Female,32,25-34,3
29,2,1,0,3,2021-11-01,Male,31,25-34,1
29,1,4,0,5,2021-11-02,Female,41,35-44,1
29,2,0,0,2,2021-10-25,Female,43,35-44,3
29,1,1,0,2,2021-10-22,Male,74,70-74,3
29,1,1,0,2,2021-10-25,Female,19,15-19,2
29,2,17,0,19,2021-10-26,Female,54,45-54,3
29,0,1,0,1,2021-10-22,Male,41,35-44,3
29,1,0,0,1,2021-10-22,Female,65,65-69,2
29,0,0,0,0,2021-10-24,Female,58,55-64,2
29,1,2,0,3,2021-10-23,Male,69,65-69,18
29,0,0,0,0,2021-10-28,Female,32,25-34,2
29,2,0,0,2,2021-10-29,Female,2,1-4,1
29,1,5,0,6,2021-10-22,Female,37,35-44,4
29,0,0,0,0,2021-10-23,Male,69,65-69,3
29,0,0,0,0,2021-10-23,Female,74,70-74,4
29,1,1,0,2,2021-10-26,Male,14,10-14,8
29,0,0,0,0,2021-11-02,Female,26,25-34,1
29,1,0,0,1,2021-10-22,Male,43,35-44,8
29,2,0,0,2,2021-11-02,Male,61,55-64,1
29,0,5,0,5,2021-10-24,Female,27,25-34,2
29,0,0,0,0,2021-10-30,Male,27,25-34,1
29,0,35,0,35,2021-10-22,Male,58,55-64,4
29,0,1,0,1,2021-10-23,Male,35,35-44,4
29,1,0,0,1,2021-10-25,Female,69,65-69,4
29,0,0,0,0,2021-10-22,Female,28,25-34,3
29,0,0,0,0,2021-11-01,Male,42,35-44,4
29,0,0,0,0,2021-10-22,Female,71,70-74,19
29,1,6,0,7,2021-10-29,Female,24,20-24,1
29,1,3,0,4,2021-10-23,Female,69,65-69,11
29,2,0,0,2,2021-11-01,Male,4,1-4,1
29,2,0,0,2,2021-10-24,Female,70,70-74,20
29,0,0,0,0,2021-10-23,Female,49,45-54,2
29,1,1,0,2,2021-10-22,Male,66,65-69,6
29,0,0,0,0,2021-10-22,Male,40,35-44,3
29,0,0,0,0,2021-10-25,Female,35,35-44,2
29,1,2,0,3,2021-10-22,Male,54,45-54,3
29,1,5,0,6,2021-10-22,Female,30,25-34,5
29,0,0,0,0,2021-10-24,Male,16,15-19,12
29,0,0,0,0,2021-10-22,Male,48,45-54,8
29,0,0,0,0,2021-10-22,Male,3,1-4,3
29,0,0,0,0,2021-10-23,Female,31,25-34,8
29,1,0,0,1,2021-10-22,Male,34,25-34,8
29,2,0,0,2,2021-11-02,Male,7,5-9,1
29,0,0,0,0,2021-10-24,Male,26,25-34,3
29,0,10,0,10,2021-10-27,Female,45,45-54,3
29,3,3,0,6,2021-10-23,Female,58,55-64,4
29,3,6,0,9,2021-10-29,Female,3,1-4,1
29,1,0,0,1,2021-10-22,Male,76,75-79,19
29,5,0,0,5,2021-10-24,Female,9,5-9,10
29,3,0,0,3,2021-10-24,Male,16,15-19,7
29,1,0,0,1,2021-10-22,Male,46,45-54,8
29,1,4,0,5,2021-10-22,Male,62,55-64,3
29,3,0,0,3,2021-11-02,Male,5,5-9,1
29,1,1,0,2,2021-10-25,Male,68,65-69,4
29,2,0,0,2,2021-10-26,Female,50,45-54,8
29,0,3,0,3,2021-10-27,Female,54,45-54,2
29,1,2,0,3,2021-10-26,Male,73,70-74,3
29,1,0,2,3,2021-10-22,Male,65,65-69,2
29,1,0,0,1,2021-10-23,Female,53,45-54,2
29,0,0,0,0,2021-11-02,Male,72,70-74,2
29,1,0,0,1,2021-10-23,Male,58,55-64,9
29,1,0,0,1,2021-10-24,Female,57,55-64,8
29,1,0,0,1,2021-10-22,Male,71,70-74,2
29,1,2,0,3,2021-10-24,Female,58,55-64,3
29,0,0,0,0,2021-10-23,Male,53,45-54,13
29,1,0,0,1,2021-10-27,Female,30,25-34,2
29,0,1,0,1,2021-10-23,Female,54,45-54,9
29,1,1,0,2,2021-10-25,Male,33,25-34,4
29,0,6,0,6,2021-10-27,Male,44,35-44,2
29,3,0,0,3,2021-10-22,Male,19,15-19,8
29,0,0,0,0,2021-10-22,Male,65,65-69,8
29,0,2,0,2,2021-10-22,Male,52,45-54,6
29,1,0,0,1,2021-10-25,Male,55,55-64,8
29,2,2,0,4,2021-10-24,Female,6,5-9,6
29,0,0,0,0,2021-10-23,Female,60,55-64,3
29,1,0,0,1,2021-10-23,Male,70,70-74,3
29,1,6,0,7,2021-10-31,Female,22,20-24,1
29,2,0,0,2,2021-10-22,Male,5,5-9,3
29,0,0,0,0,2021-10-29,Male,28,25-34,1
29,3,2,0,5,2021-10-23,Female,51,45-54,3
29,1,0,0,1,2021-10-22,Male,26,25-34,8
29,0,0,0,0,2021-10-24,Male,48,45-54,17
29,0,2,0,2,2021-10-22,Male,56,55-64,8
29,0,0,0,0,2021-10-26,Male,73,70-74,6
29,2,0,0,2,2021-10-24,Female,17,15-19,2
29,1,23,0,24,2021-10-24,Female,41,35-44,5
29,0,0,0,0,2021-10-23,Male,56,55-64,3
29,0,0,0,0,2021-11-02,Male,64,55-64,1
29,1,0,0,1,2021-10-23,Female,72,70-74,8
29,3,25,0,28,2021-10-23,Female,9,5-9,5
29,3,0,0,3,2021-10-24,Male,4,1-4,8
29,1,0,0,1,2021-10-22,Male,70,70-74,3
29,1,0,0,1,2021-10-25,Male,13,10-14,2
29,0,0,0,0,2021-10-23,Female,59,55-64,19
29,1,0,0,1,2021-10-27,Female,37,35-44,3
29,0,1,0,1,2021-11-01,Female,32,25-34,1
29,1,0,0,1,2021-10-23,Male,44,35-44,9
29,2,0,0,2,2021-10-23,Female,18,15-19,9
29,1,0,0,1,2021-10-22,Male,58,55-64,5
29,0,0,0,0,2021-11-02,Female,57,55-64,1
29,0,1,0,1,2021-10-27,Female,45,45-54,6
29,1,0,0,1,2021-10-23,Male,52,45-54,2
29,2,0,0,2,2021-10-22,Female,22,20-24,14
29,1,0,0,1,2021-10-25,Male,63,55-64,5
29,0,0,0,0,2021-10-22,Male,38,35-44,5
29,1,0,0,1,2021-10-25,Female,52,45-54,6
29,1,0,0,1,2021-10-23,Female,60,55-64,4
29,1,0,0,1,2021-10-23,Male,72,70-74,9
29,1,0,0,1,2021-10-22,Female,67,65-69,5
29,3,0,0,3,2021-10-24,Female,24,20-24,22
29,1,2,0,3,2021-10-22,Female,45,45-54,5
29,2,0,0,2,2021-10-22,Female,0,<1,8
29,4,0,0,4,2021-10-29,Female,14,10-14,1
29,0,0,100,100,2021-10-22,Male,23,20-24,16
29,1,0,3,4,2021-10-28,Female,22,20-24,5
29,3,0,0,3,2021-10-25,Female,13,10-14,2
29,0,0,0,0,2021-10-24,Male,59,55-64,9
29,2,0,0,2,2021-10-23,Female,41,35-44,8
29,2,0,0,2,2021-10-23,Male,42,35-44,3
29,0,0,0,0,2021-10-22,Male,39,35-44,4
29,1,0,0,1,2021-10-22,Female,54,45-54,8
29,3,0,0,3,2021-10-25,Male,59,55-64,2
29,0,0,0,0,2021-10-26,Male,53,45-54,9
29,1,0,0,1,2021-10-22,Male,46,45-54,4
29,0,0,0,0,2021-10-23,Female,28,25-34,5
29,1,0,0,1,2021-10-26,Male,68,65-69,3
29,2,5,7,14,2021-10-23,Male,69,65-69,10
29,1,10,0,11,2021-10-26,Male,57,55-64,3
29,2,0,0,2,2021-10-25,Female,18,15-19,5
29,0,0,0,0,2021-10-24,Male,80,80-84,8
29,0,0,0,0,2021-11-02,Female,43,35-44,1
29,1,13,0,14,2021-10-30,Male,4,1-4,1
29,1,0,0,1,2021-10-25,Female,67,65-69,6
29,0,1,0,1,2021-10-22,Male,65,65-69,3
29,0,0,0,0,2021-10-26,Female,65,65-69,7
29,0,0,0,0,2021-10-23,Male,11,10-14,11
29,1,0,0,1,2021-10-25,Male,63,55-64,3
29,2,1,0,3,2021-10-28,Female,27,25-34,19
29,1,0,0,1,2021-10-25,Male,68,65-69,8
29,1,0,0,1,2021-10-25,Female,45,45-54,2
29,1,0,0,1,2021-11-02,Male,74,70-74,1
29,0,2,0,2,2021-10-26,Female,34,25-34,9
29,0,0,0,0,2021-10-22,Female,14,10-14,5
29,1,0,0,1,2021-10-22,Male,58,55-64,3
29,0,1,0,1,2021-10-27,Male,54,45-54,6
29,2,4,0,6,2021-10-22,Male,67,65-69,2
29,3,1,0,4,2021-10-29,Male,3,1-4,1
29,1,0,0,1,2021-10-30,Male,31,25-34,1
29,0,0,0,0,2021-10-23,Male,69,65-69,3
29,2,20,0,22,2021-10-22,Female,8,5-9,4
29,1,0,0,1,2021-10-23,Male,58,55-64,5
29,1,5,0,6,2021-10-23,Female,27,25-34,2
29,1,1,0,2,2021-10-23,Male,69,65-69,24
29,0,5,0,5,2021-10-25,Female,42,35-44,2
29,0,2,0,2,2021-11-02,Male,73,70-74,1
29,1,0,0,1,2021-10-22,Male,59,55-64,9
29,0,0,0,0,2021-10-25,Male,11,10-14,12
29,0,1,0,1,2021-10-25,Female,34,25-34,21
29,0,2,0,2,2021-10-29,Female,4,1-4,2
29,1,0,16,17,2021-10-22,Female,8,5-9,3
29,0,0,0,0,2021-10-24,Male,60,55-64,2
29,1,3,0,4,2021-10-24,Female,41,35-44,2
29,2,0,0,2,2021-10-22,Male,1,1-4,8
29,0,0,0,0,2021-10-24,Female,85,85+,4
29,1,4,0,5,2021-10-23,Female,8,5-9,2
29,0,0,0,0,2021-10-25,Male,30,25-34,20
29,1,0,0,1,2021-10-26,Male,56,55-64,4
29,0,2,0,2,2021-10-23,Female,52,45-54,2
29,0,3,0,3,2021-10-26,Female,58,55-64,2
29,1,5,0,6,2021-10-26,Male,57,55-64,3
29,0,0,0,0,2021-10-25,Female,6,5-9,21
29,1,0,0,1,2021-10-24,Female,38,35-44,9
29,0,0,0,0,2021-10-23,Male,52,45-54,3
29,4,4,0,8,2021-10-22,Female,24,20-24,5
29,1,0,0,1,2021-10-22,Male,52,45-54,4
29,0,0,0,0,2021-10-28,Male,27,25-34,3
29,1,4,0,5,2021-10-23,Female,49,45-54,2
29,0,0,2,2,2021-10-24,Female,18,15-19,13
29,2,0,0,2,2021-10-26,Female,67,65-69,20
29,1,0,0,1,2021-10-26,Female,53,45-54,2
29,1,0,0,1,2021-10-24,Male,58,55-64,6
29,0,0,0,0,2021-10-23,Female,71,70-74,9
29,0,0,0,0,2021-11-02,Female,31,25-34,2
29,0,0,0,0,2021-10-25,Female,46,45-54,2
29,2,15,29,46,2021-11-02,Female,18,15-19,1
29,1,0,0,1,2021-10-26,Male,65,65-69,8
29,0,0,0,0,2021-10-25,Male,42,35-44,19
29,2,4,0,6,2021-10-22,Female,16,15-19,9
29,1,0,0,1,2021-10-22,Male,59,55-64,2
29,2,0,0,2,2021-10-25,Male,52,45-54,3
29,3,1,12,16,2021-10-23,Male,14,10-14,2
29,1,0,0,1,2021-10-26,Female,66,65-69,9
29,2,2,0,4,2021-10-25,Male,54,45-54,6
29,1,0,0,1,2021-10-23,Female,69,65-69,4
29,1,1,0,2,2021-10-25,Male,56,55-64,9
29,0,0,0,0,2021-10-23,Male,7,5-9,3
29,0,0,0,0,2021-10-26,Male,72,70-74,3
29,0,1,0,1,2021-10-25,Female,42,35-44,4
29,3,0,0,3,2021-10-26,Female,19,15-19,14
29,3,2,0,5,2021-10-23,Female,1,1-4,3
29,1,0,0,1,2021-10-26,Male,69,65-69,2
29,6,0,0,6,2021-10-25,Female,1,1-4,5
29,1,5,0,6,2021-10-25,Female,39,35-44,2
29,1,5,0,6,2021-10-23,Male,61,55-64,2
29,0,0,0,0,2021-11-02,Female,22,20-24,1
29,1,0,1,2,2021-10-22,Female,63,55-64,9
29,2,3,0,5,2021-10-25,Female,55,55-64,18
29,0,1,0,1,2021-10-22,Male,61,55-64,9
29,0,0,0,0,2021-10-22,Male,38,35-44,4
29,1,4,6,11,2021-10-22,Male,69,65-69,4
29,0,0,0,0,2021-10-25,Male,16,15-19,8
29,3,0,0,3,2021-10-23,Female,44,35-44,7
29,1,0,0,1,2021-10-22,Male,52,45-54,8
29,0,0,0,0,2021-10-26,Female,66,65-69,7
29,1,0,0,1,2021-10-22,Female,50,45-54,23
29,3,20,0,23,2021-10-30,Female,20,20-24,3
29,0,0,0,0,2021-10-24,Male,47,45-54,6
29,1,0,0,1,2021-10-22,Male,19,15-19,9
29,1,0,0,1,2021-10-22,Female,36,35-44,3
29,0,0,0,0,2021-10-25,Female,49,45-54,2
29,0,0,0,0,2021-10-29,Female,21,20-24,1
29,0,2,0,2,2021-10-22,Male,53,45-54,3
29,1,0,0,1,2021-10-22,Female,67,65-69,2
29,0,0,0,0,2021-10-22,Male,74,70-74,2
29,0,5,0,5,2021-10-22,Male,64,55-64,8
29,2,0,0,2,2021-10-22,Male,52,45-54,9
29,1,1,0,2,2021-10-28,Female,27,25-34,2
29,0,0,0,0,2021-10-22,Female,64,55-64,3
29,1,0,0,1,2021-10-22,Female,40,35-44,7
29,1,0,0,1,2021-10-24,Female,61,55-64,2
29,1,1,0,2,2021-10-22,Female,19,15-19,2
29,1,4,0,5,2021-10-23,Male,71,70-74,3
29,3,0,0,3,2021-10-22,Female,12,10-14,4
29,0,0,0,0,2021-10-25,Male,64,55-64,8
29,0,3,0,3,2021-10-22,Female,30,25-34,9
29,0,0,0,0,2021-10-24,Female,55,55-64,2
29,0,0,0,0,2021-10-22,Female,55,55-64,2
29,0,0,0,0,2021-10-24,Male,31,25-34,20
29,0,0,0,0,2021-10-26,Female,3,1-4,4
29,0,3,0,3,2021-10-22,Male,42,35-44,3
29,1,0,0,1,2021-10-23,Male,70,70-74,5
29,0,8,0,8,2021-10-22,Male,64,55-64,2
29,0,0,0,0,2021-10-30,Female,19,15-19,1
29,1,2,0,3,2021-10-22,Female,72,70-74,2
29,0,0,0,0,2021-10-24,Female,30,25-34,6
29,0,1,0,1,2021-10-23,Male,64,55-64,23
29,0,0,0,0,2021-10-23,Male,51,45-54,8
29,0,0,0,0,2021-10-24,Male,54,45-54,9
29,3,3,0,6,2021-10-22,Female,22,20-24,5
29,1,2,0,3,2021-10-22,Male,36,35-44,7
29,1,2,0,3,2021-10-22,Male,68,65-69,6
29,0,0,0,0,2021-10-22,Female,31,25-34,4
29,0,0,0,0,2021-10-23,Female,7,5-9,23
29,1,0,0,1,2021-10-25,Female,61,55-64,4
29,0,2,0,2,2021-10-27,Female,66,65-69,14
29,1,0,0,1,2021-10-22,Female,48,45-54,2
29,1,0,0,1,2021-10-26,Female,66,65-69,2
29,0,0,0,0,2021-10-22,Female,49,45-54,9
29,1,0,0,1,2021-10-27,Female,72,70-74,9
29,0,0,0,0,2021-10-22,Female,0,<1,2
29,2,0,0,2,2021-10-22,Female,22,20-24,4
29,0,0,0,0,2021-10-23,Male,52,45-54,3
29,1,0,0,1,2021-10-25,Female,51,45-54,3
29,0,0,0,0,2021-10-24,Female,32,25-34,2
29,0,0,0,0,2021-10-23,Male,56,55-64,3
29,3,2,0,5,2021-10-22,Female,50,45-54,2
29,0,1,0,1,2021-10-23,Female,66,65-69,4
29,1,0,0,1,2021-11-02,Male,31,25-34,1
29,1,0,0,1,2021-10-22,Female,72,70-74,4
29,3,4,5,12,2021-11-02,Female,18,15-19,1
29,0,0,0,0,2021-10-26,Female,53,45-54,2
29,0,1,0,1,2021-10-26,Female,33,25-34,2
29,0,2,0,2,2021-10-23,Female,67,65-69,7
29,0,3,0,3,2021-10-26,Male,55,55-64,21
29,2,41,0,43,2021-10-22,Female,48,45-54,8
29,0,0,0,0,2021-10-26,Male,57,55-64,2
29,0,3,0,3,2021-10-23,Female,51,45-54,8
29,2,0,0,2,2021-10-25,Male,8,5-9,9
29,2,0,0,2,2021-10-23,Female,30,25-34,3
29,2,0,0,2,2021-10-24,Male,51,45-54,14
29,4,1,0,5,2021-10-25,Male,2,1-4,2
29,1,0,0,1,2021-10-23,Female,42,35-44,9
29,1,0,0,1,2021-10-23,Male,57,55-64,9
29,0,3,0,3,2021-10-26,Female,74,70-74,3
29,1,7,0,8,2021-10-24,Male,50,45-54,10
29,4,0,0,4,2021-10-29,Female,3,1-4,1
29,2,0,0,2,2021-10-22,Female,8,5-9,3
29,3,21,0,24,2021-10-22,Male,2,1-4,2
29,1,0,0,1,2021-10-25,Male,68,65-69,2
29,1,42,0,43,2021-10-22,Female,39,35-44,3
29,1,1,0,2,2021-10-24,Female,75,75-79,3
29,2,0,24,26,2021-10-29,Female,12,10-14,1
29,0,0,0,0,2021-10-27,Female,53,45-54,11
29,0,0,0,0,2021-10-25,Male,64,55-64,3
29,2,0,0,2,2021-10-22,Male,11,10-14,3
29,0,0,0,0,2021-11-02,Female,76,75-79,1
29,1,0,0,1,2021-10-23,Female,32,25-34,4
29,2,2,0,4,2021-11-01,Male,4,1-4,1
29,2,1,0,3,2021-10-22,Female,17,15-19,3
29,3,10,0,13,2021-10-22,Female,5,5-9,4
29,1,3,0,4,2021-10-25,Female,64,55-64,3
29,2,0,0,2,2021-10-25,Male,17,15-19,2
29,1,0,0,1,2021-10-22,Female,34,25-34,6
29,0,0,0,0,2021-10-22,Female,51,45-54,13
29,1,0,0,1,2021-10-28,Female,31,25-34,4
29,1,1,0,2,2021-10-22,Female,68,65-69,5
29,2,0,0,2,2021-10-25,Male,7,5-9,4
29,1,0,0,1,2021-10-24,Male,79,75-79,2
29,0,0,0,0,2021-10-25,Female,61,55-64,4
29,2,2,0,4,2021-10-23,Male,4,1-4,9
29,3,0,0,3,2021-10-25,Male,9,5-9,2
29,0,0,0,0,2021-10-24,Female,59,55-64,3
29,1,0,0,1,2021-10-22,Female,45,45-54,2
29,3,0,0,3,2021-10-22,Female,9,5-9,9
29,0,1,0,1,2021-10-25,Female,67,65-69,20
29,0,2,0,2,2021-10-23,Female,69,65-69,23
29,0,2,0,2,2021-10-24,Female,79,75-79,14
29,1,0,0,1,2021-10-25,Male,56,55-64,3
29,1,0,0,1,2021-10-26,Male,67,65-69,3
29,2,1,0,3,2021-10-24,Male,54,45-54,9
29,0,0,0,0,2021-10-23,Male,69,65-69,9
29,1,0,0,1,2021-10-30,Male,33,25-34,1
29,1,3,0,4,2021-10-24,Female,24,20-24,2
29,2,1,0,3,2021-10-24,Female,16,15-19,2
29,2,0,0,2,2021-10-23,Male,67,65-69,22
29,0,4,0,4,2021-10-23,Male,69,65-69,7
29,0,4,0,4,2021-10-25,Male,63,55-64,3
29,1,0,0,1,2021-10-23,Female,62,55-64,2
29,1,0,0,1,2021-10-22,Female,70,70-74,3
29,0,3,0,3,2021-10-23,Female,71,70-74,6
29,4,0,0,4,2021-10-29,Female,2,1-4,1
29,1,0,0,1,2021-11-02,Female,63,55-64,1
29,0,0,0,0,2021-10-22,Male,46,45-54,6
29,1,0,0,1,2021-10-24,Male,79,75-79,5
29,1,0,0,1,2021-10-25,Male,62,55-64,3
29,2,0,0,2,2021-10-23,Male,69,65-69,9
29,1,10,0,11,2021-10-22,Male,60,55-64,3
29,0,2,0,2,2021-10-27,Female,67,65-69,13
29,0,0,0,0,2021-10-22,Female,51,45-54,5
29,1,2,0,3,2021-10-25,Male,74,70-74,4
29,0,0,0,0,2021-10-25,Male,41,35-44,7
29,0,8,0,8,2021-10-24,Male,41,35-44,18
29,0,0,0,0,2021-11-02,Female,56,55-64,1
29,2,1,0,3,2021-10-23,Male,68,65-69,9
29,1,3,0,4,2021-10-23,Male,72,70-74,4
29,1,0,0,1,2021-10-24,Male,70,70-74,8
29,0,2,0,2,2021-10-23,Male,69,65-69,3
29,1,2,0,3,2021-10-24,Male,60,55-64,5
29,0,1,0,1,2021-10-23,Male,52,45-54,5
29,3,0,0,3,2021-10-23,Male,51,45-54,4
29,2,0,0,2,2021-10-22,Male,58,55-64,3
29,0,0,0,0,2021-10-22,Male,49,45-54,3
29,0,0,0,0,2021-10-25,Female,23,20-24,15
29,1,0,0,1,2021-10-23,Male,71,70-74,2
29,1,0,0,1,2021-10-23,Female,77,75-79,8
29,0,1,0,1,2021-10-25,Male,66,65-69,2
29,1,1,0,2,2021-10-22,Male,54,45-54,8
29,0,0,0,0,2021-10-22,Male,56,55-64,3
29,1,0,0,1,2021-10-22,Female,50,45-54,2
29,0,6,0,6,2021-10-22,Female,61,55-64,2
29,1,10,0,11,2021-10-23,Female,67,65-69,3
29,0,2,0,2,2021-10-23,Female,65,65-69,7
29,2,0,0,2,2021-10-23,Male,1,1-4,3
29,0,0,0,0,2021-10-22,Female,19,15-19,4
29,2,0,0,2,2021-10-23,Male,4,1-4,8
29,1,0,0,1,2021-11-02,Female,39,35-44,1
29,1,0,0,1,2021-10-25,Female,47,45-54,5
29,2,1,0,3,2021-10-25,Male,1,1-4,8
29,0,0,0,0,2021-10-26,Female,65,65-69,3
29,0,1,0,1,2021-10-25,Female,68,65-69,5
29,0,4,0,4,2021-10-25,Female,34,25-34,5
29,1,0,0,1,2021-11-02,Male,72,70-74,1
29,1,0,0,1,2021-10-22,Male,50,45-54,3
29,1,0,0,1,2021-10-22,Male,47,45-54,2
29,1,0,0,1,2021-10-23,Female,38,35-44,6
29,1,4,0,5,2021-11-01,Male,31,25-34,1
29,0,0,4,4,2021-10-23,Male,44,35-44,3
29,1,0,0,1,2021-10-22,Male,58,55-64,4
29,1,2,0,3,2021-10-22,Female,53,45-54,2
29,3,0,0,3,2021-10-24,Female,18,15-19,4
29,1,0,0,1,2021-10-22,Male,51,45-54,3
29,1,1,0,2,2021-10-23,Female,1,1-4,5
29,0,3,0,3,2021-10-28,Male,73,70-74,7
29,5,0,0,5,2021-10-25,Male,1,1-4,10
29,1,0,0,1,2021-10-22,Male,8,5-9,4
29,0,2,0,2,2021-10-22,Female,52,45-54,2
29,0,0,0,0,2021-10-23,Male,61,55-64,6
29,1,1,0,2,2021-10-22,Male,62,55-64,2
29,1,0,0,1,2021-10-28,Male,69,65-69,2
29,0,1,0,1,2021-10-25,Female,42,35-44,4
29,1,0,0,1,2021-10-29,Female,30,25-34,4
29,1,0,0,1,2021-10-24,Female,31,25-34,2
29,1,7,0,8,2021-10-26,Male,53,45-54,4
29,0,0,0,0,2021-10-25,Male,63,55-64,3
29,1,0,0,1,2021-10-22,Male,77,75-79,2
29,4,1,0,5,2021-10-26,Male,32,25-34,2
29,1,1,0,2,2021-10-23,Female,59,55-64,5
29,1,0,0,1,2021-10-23,Female,70,70-74,3
29,3,13,0,16,2021-10-29,Female,21,20-24,1
29,1,0,0,1,2021-10-22,Female,22,20-24,20
29,1,0,0,1,2021-10-23,Male,56,55-64,5
29,1,0,0,1,2021-10-25,Male,67,65-69,7
29,4,1,10,15,2021-10-22,Male,10,10-14,2
29,2,0,0,2,2021-10-22,Male,12,10-14,4
29,1,0,0,1,2021-10-25,Female,47,45-54,2
29,2,1,0,3,2021-10-22,Female,7,5-9,4
29,1,0,0,1,2021-10-22,Male,47,45-54,4
29,0,2,0,2,2021-10-22,Female,40,35-44,5
29,1,2,0,3,2021-10-22,Female,25,25-34,2
29,1,0,0,1,2021-10-22,Male,58,55-64,4
29,2,0,0,2,2021-10-23,Female,5,5-9,24
29,0,1,0,1,2021-10-23,Male,70,70-74,2
29,0,0,0,0,2021-10-25,Male,68,65-69,2
29,0,3,0,3,2021-10-26,Female,65,65-69,2
29,1,0,0,1,2021-10-25,Male,66,65-69,8
29,2,3,0,5,2021-11-02,Female,3,1-4,1
29,1,0,0,1,2021-10-22,Female,73,70-74,3
29,0,0,0,0,2021-10-22,Female,40,35-44,8
29,1,30,0,31,2021-10-23,Male,53,45-54,2
29,1,30,0,31,2021-10-26,Female,65,65-69,11
29,1,0,0,1,2021-10-26,Female,33,25-34,13
29,1,2,0,3,2021-10-24,Male,49,45-54,8
29,0,0,0,0,2021-10-24,Female,24,20-24,5
29,0,0,0,0,2021-10-22,Male,46,45-54,4
29,2,1,6,9,2021-10-24,Male,30,25-34,5
29,1,0,0,1,2021-10-26,Male,66,65-69,5
29,0,2,0,2,2021-10-22,Male,20,20-24,8
29,0,0,0,0,2021-10-24,Female,23,20-24,2
29,0,2,0,2,2021-10-22,Male,43,35-44,3
29,1,0,0,1,2021-11-01,Male,29,25-34,1
29,2,1,0,3,2021-11-02,Male,25,25-34,1
29,2,0,0,2,2021-10-25,Female,7,5-9,3
29,0,1,0,1,2021-10-26,Male,65,65-69,5
29,3,0,0,3,2021-10-24,Female,4,1-4,5
29,1,0,0,1,2021-11-02,Female,75,75-79,1
29,1,5,0,6,2021-10-23,Male,69,65-69,4
29,1,5,0,6,2021-10-22,Male,75,75-79,9
29,1,30,0,31,2021-10-22,Male,50,45-54,4
29,0,0,0,0,2021-10-26,Male,54,45-54,16
29,1,0,0,1,2021-10-24,Female,35,35-44,2
29,0,40,0,40,2021-10-22,Male,47,45-54,2
29,1,20,0,21,2021-10-24,Male,71,70-74,2
29,2,0,0,2,2021-10-23,Male,14,10-14,2
29,0,0,0,0,2021-10-26,Male,74,70-74,4
29,3,0,0,3,2021-10-22,Male,16,15-19,2
29,0,3,0,3,2021-10-22,Male,44,35-44,9
29,0,0,0,0,2021-10-24,Female,33,25-34,4
29,1,0,0,1,2021-10-23,Male,53,45-54,3
29,0,1,0,1,2021-10-25,Female,45,45-54,7
29,0,5,0,5,2021-10-24,Male,59,55-64,5
29,0,40,0,40,2021-10-23,Male,59,55-64,8
29,0,0,0,0,2021-10-28,Male,66,65-69,16
29,0,0,0,0,2021-10-22,Male,48,45-54,7
29,1,0,0,1,2021-10-23,Female,62,55-64,3
29,0,0,0,0,2021-10-23,Male,61,55-64,3
29,0,0,0,0,2021-10-22,Male,10,10-14,3
29,0,7,0,7,2021-10-30,Female,20,20-24,1
29,3,0,0,3,2021-10-24,Female,0,<1,2
29,1,0,0,1,2021-10-22,Male,69,65-69,8
29,3,4,0,7,2021-10-24,Female,1,1-4,8
29,2,0,0,2,2021-10-22,Female,26,25-34,2
29,1,0,0,1,2021-10-25,Female,35,35-44,4
29,1,0,0,1,2021-10-26,Female,56,55-64,7
29,1,2,0,3,2021-10-26,Female,66,65-69,3
29,1,2,0,3,2021-10-23,Female,48,45-54,5
29,1,0,0,1,2021-10-22,Male,34,25-34,8
29,0,0,0,0,2021-10-22,Female,15,15-19,3
29,1,4,0,5,2021-10-22,Male,75,75-79,3
29,0,0,0,0,2021-10-22,Male,44,35-44,3
29,0,4,0,4,2021-10-22,Female,42,35-44,4
29,1,0,0,1,2021-10-22,Male,61,55-64,8
29,1,0,0,1,2021-10-22,Female,62,55-64,3
29,1,1,0,2,2021-10-22,Female,51,45-54,2
29,1,6,0,7,2021-10-25,Male,62,55-64,6
29,1,2,0,3,2021-10-24,Male,71,70-74,6
29,0,0,0,0,2021-10-22,Female,39,35-44,2
29,0,0,0,0,2021-10-24,Female,60,55-64,4
29,0,0,0,0,2021-10-25,Male,66,65-69,7
29,0,0,0,0,2021-10-29,Female,18,15-19,1
29,0,11,0,11,2021-10-26,Male,39,35-44,2
29,1,0,0,1,2021-10-29,Male,21,20-24,1
29,2,1,0,3,2021-10-22,Male,19,15-19,7
29,0,1,0,1,2021-10-23,Male,60,55-64,25
29,1,2,0,3,2021-10-23,Male,71,70-74,2
29,0,7,0,7,2021-10-22,Female,60,55-64,23
29,0,1,0,1,2021-10-27,Male,43,35-44,4
29,0,1,0,1,2021-10-23,Female,67,65-69,16
29,2,0,0,2,2021-10-23,Male,70,70-74,2
29,1,0,0,1,2021-10-24,Female,25,25-34,3
29,3,0,0,3,2021-10-29,Male,10,10-14,1
29,0,2,0,2,2021-10-22,Male,81,80-84,4
29,1,0,0,1,2021-10-26,Male,72,70-74,3
29,2,0,0,2,2021-10-26,Female,24,20-24,3
29,0,0,0,0,2021-10-22,Male,38,35-44,2
29,1,0,0,1,2021-10-26,Female,66,65-69,9
29,3,0,0,3,2021-10-25,Female,8,5-9,5
29,1,0,0,1,2021-10-26,Female,34,25-34,5
29,2,0,5,7,2021-10-30,Female,6,5-9,1
29,0,0,0,0,2021-10-25,Female,31,25-34,2
29,1,0,0,1,2021-10-22,Male,68,65-69,4
29,1,0,0,1,2021-10-27,Female,76,75-79,6
29,0,0,0,0,2021-10-22,Male,2,1-4,13
29,2,0,0,2,2021-10-22,Male,11,10-14,3
29,0,0,0,0,2021-10-24,Female,24,20-24,2
29,0,0,0,0,2021-10-24,Male,26,25-34,2
29,2,0,0,2,2021-10-27,Female,53,45-54,4
29,1,1,0,2,2021-10-25,Female,64,55-64,9
29,0,0,0,0,2021-10-28,Male,77,75-79,5
29,2,0,0,2,2021-10-22,Male,56,55-64,2
29,1,0,0,1,2021-10-22,Male,49,45-54,7
29,0,2,0,2,2021-10-22,Male,60,55-64,3
29,3,0,0,3,2021-10-28,Male,23,20-24,2
29,2,5,0,7,2021-10-26,Male,14,10-14,5
29,0,1,0,1,2021-10-23,Female,43,35-44,3
29,1,3,0,4,2021-10-23,Male,50,45-54,2
29,4,0,0,4,2021-10-23,Male,3,1-4,4
29,3,16,0,19,2021-10-23,Female,1,1-4,5
29,0,0,0,0,2021-10-22,Male,75,75-79,3
29,1,0,0,1,2021-10-22,Male,9,5-9,2
29,1,0,0,1,2021-10-23,Female,0,<1,5
29,0,20,0,20,2021-10-23,Female,57,55-64,4
29,0,0,0,0,2021-10-23,Male,57,55-64,8
29,0,0,0,0,2021-11-01,Male,19,15-19,1
29,0,0,0,0,2021-10-25,Female,46,45-54,3
29,1,3,0,4,2021-10-22,Female,49,45-54,9
29,0,11,0,11,2021-10-22,Female,52,45-54,5
29,2,0,0,2,2021-10-22,Female,12,10-14,3
29,0,1,0,1,2021-10-22,Male,65,65-69,4
29,2,0,0,2,2021-10-26,Male,71,70-74,22
29,0,0,0,0,2021-10-22,Male,73,70-74,4
29,1,0,0,1,2021-10-22,Male,59,55-64,21
29,1,0,0,1,2021-10-22,Female,73,70-74,4
29,2,0,0,2,2021-10-26,Female,15,15-19,3
29,1,0,0,1,2021-10-23,Female,69,65-69,3
29,0,0,0,0,2021-10-24,Male,76,75-79,2
29,0,0,0,0,2021-10-26,Male,65,65-69,3
29,0,3,0,3,2021-10-31,Male,26,25-34,1
29,2,2,0,4,2021-10-24,Male,8,5-9,2
29,0,2,0,2,2021-10-24,Male,65,65-69,3
29,0,2,0,2,2021-10-22,Female,71,70-74,3
29,0,34,0,34,2021-10-24,Male,61,55-64,9
29,0,0,0,0,2021-11-02,Male,57,55-64,1
29,1,0,0,1,2021-10-24,Male,48,45-54,12
29,2,0,0,2,2021-10-23,Male,11,10-14,3
29,1,0,0,1,2021-10-23,Female,52,45-54,2
29,0,0,0,0,2021-10-24,Male,60,55-64,7
29,0,0,0,0,2021-10-25,Male,63,55-64,3
29,3,0,0,3,2021-10-24,Female,67,65-69,18
29,1,3,0,4,2021-11-01,Male,27,25-34,1
29,1,14,0,15,2021-10-22,Male,39,35-44,2
29,3,0,0,3,2021-10-28,Female,26,25-34,6
29,1,1,0,2,2021-10-22,Female,71,70-74,3
29,0,1,0,1,2021-10-23,Male,69,65-69,2
29,1,0,0,1,2021-10-25,Male,45,45-54,5
29,3,0,0,3,2021-10-22,Male,14,10-14,3
29,0,0,0,0,2021-10-24,Female,56,55-64,8
29,0,0,0,0,2021-10-23,Male,27,25-34,12
29,0,1,0,1,2021-10-22,Male,60,55-64,2
29,0,2,0,2,2021-10-23,Female,70,70-74,16
29,0,3,2,5,2021-10-23,Male,70,70-74,3
29,1,0,0,1,2021-10-23,Female,23,20-24,4
29,0,5,0,5,2021-10-22,Female,50,45-54,3
29,1,12,0,13,2021-10-23,Female,55,55-64,11
29,0,5,0,5,2021-10-24,Male,60,55-64,2
29,1,0,0,1,2021-10-23,Female,37,35-44,8
29,3,0,0,3,2021-10-23,Male,9,5-9,3
29,1,0,0,1,2021-10-26,Male,73,70-74,7
29,1,1,0,2,2021-10-23,Male,71,70-74,3
29,1,0,0,1,2021-10-27,Male,66,65-69,2
29,5,0,0,5,2021-10-24,Female,1,1-4,8
29,1,0,0,1,2021-10-22,Female,62,55-64,4
29,1,0,0,1,2021-10-23,Female,54,45-54,3
29,0,0,0,0,2021-10-25,Female,42,35-44,3
29,3,0,0,3,2021-10-26,Female,21,20-24,3
29,2,0,0,2,2021-10-25,Female,19,15-19,2
29,0,0,0,0,2021-10-25,Female,68,65-69,3
29,0,2,8,10,2021-10-23,Female,17,15-19,3
29,1,3,0,4,2021-10-23,Female,74,70-74,3
29,1,1,0,2,2021-10-24,Male,71,70-74,3
29,2,0,0,2,2021-10-22,Female,71,70-74,20
29,2,0,0,2,2021-10-22,Male,7,5-9,4
29,1,0,0,1,2021-11-02,Male,62,55-64,1
29,1,1,0,2,2021-10-23,Male,69,65-69,2
29,1,1,0,2,2021-10-22,Female,39,35-44,3
29,0,0,0,0,2021-10-25,Male,81,80-84,2
29,2,0,0,2,2021-10-25,Male,3,1-4,3
29,3,1,0,4,2021-10-23,Female,13,10-14,11
29,1,3,3,7,2021-10-24,Male,71,70-74,2
29,1,0,0,1,2021-10-26,Male,71,70-74,3
29,1,0,0,1,2021-10-22,Male,61,55-64,2
29,1,0,0,1,2021-10-23,Female,50,45-54,2
29,1,1,0,2,2021-10-22,Female,37,35-44,6
29,2,4,1,7,2021-10-22,Female,28,25-34,9
29,1,0,0,1,2021-10-22,Female,37,35-44,18
29,1,1,0,2,2021-10-23,Female,63,55-64,9
29,0,3,0,3,2021-10-24,Male,66,65-69,5
29,1,0,0,1,2021-10-28,Male,32,25-34,4
29,4,0,0,4,2021-10-24,Male,3,1-4,4
29,3,0,0,3,2021-10-22,Female,67,65-69,22
29,0,1,0,1,2021-10-23,Male,54,45-54,10
29,0,0,0,0,2021-10-23,Male,29,25-34,9
29,1,8,0,9,2021-11-02,Female,25,25-34,1
29,0,2,0,2,2021-10-27,Female,54,45-54,3
29,1,0,0,1,2021-10-22,Male,39,35-44,8
29,0,0,0,0,2021-10-22,Male,41,35-44,2
29,0,2,0,2,2021-10-22,Male,60,55-64,9
29,0,2,0,2,2021-10-22,Male,50,45-54,4
29,0,0,0,0,2021-10-27,Female,19,15-19,3
29,2,0,0,2,2021-10-24,Female,2,1-4,5
29,1,8,0,9,2021-10-23,Female,31,25-34,12
29,1,0,0,1,2021-10-24,Female,60,55-64,4
29,2,0,0,2,2021-10-23,Female,62,55-64,5
29,1,0,0,1,2021-10-23,Male,40,35-44,3
29,3,15,0,18,2021-10-22,Male,0,<1,3
29,1,8,3,12,2021-10-22,Male,68,65-69,2
29,0,0,0,0,2021-10-26,Female,72,70-74,2
29,0,0,0,0,2021-10-24,Male,58,55-64,3
29,1,0,0,1,2021-10-22,Female,73,70-74,9
29,1,0,0,1,2021-10-28,Female,43,35-44,6
29,1,0,0,1,2021-10-22,Male,62,55-64,2
29,0,4,0,4,2021-10-23,Male,71,70-74,2
29,3,1,0,4,2021-10-27,Female,5,5-9,7
29,0,0,0,0,2021-10-22,Female,30,25-34,4
29,1,0,0,1,2021-10-23,Male,70,70-74,3
29,1,6,0,7,2021-10-23,Female,32,25-34,3
29,1,2,0,3,2021-10-26,Female,72,70-74,13
29,0,2,0,2,2021-10-22,Female,65,65-69,8
29,1,0,0,1,2021-10-26,Male,63,55-64,20
29,0,0,0,0,2021-10-28,Male,45,45-54,8
29,1,0,0,1,2021-10-22,Female,58,55-64,2
29,0,0,0,0,2021-10-23,Female,69,65-69,8
29,0,3,0,3,2021-10-24,Female,70,70-74,4
29,0,2,0,2,2021-10-24,Male,64,55-64,7
29,3,2,0,5,2021-10-22,Male,3,1-4,2
29,0,0,0,0,2021-10-22,Male,57,55-64,3
29,1,0,0,1,2021-10-26,Male,38,35-44,3
29,0,0,0,0,2021-10-23,Male,4,1-4,3
29,1,0,0,1,2021-10-29,Female,34,25-34,2
29,0,1,0,1,2021-10-22,Female,41,35-44,4
29,3,9,0,12,2021-10-22,Female,50,45-54,2
29,1,4,0,5,2021-10-23,Male,69,65-69,2
29,0,0,0,0,2021-10-26,Female,56,55-64,8
29,1,0,0,1,2021-10-23,Male,66,65-69,2
29,1,18,0,19,2021-10-30,Female,8,5-9,1
29,3,0,0,3,2021-10-22,Male,11,10-14,9
29,1,0,0,1,2021-10-22,Female,67,65-69,2
29,2,5,0,7,2021-10-23,Female,11,10-14,3
29,2,2,0,4,2021-10-23,Male,45,45-54,9
29,1,0,0,1,2021-10-26,Female,54,45-54,5
29,0,2,0,2,2021-10-27,Female,77,75-79,2
29,1,0,0,1,2021-10-23,Female,46,45-54,8
29,2,0,0,2,2021-10-26,Male,74,70-74,4
29,0,0,0,0,2021-10-26,Male,67,65-69,7
29,1,0,0,1,2021-10-22,Female,38,35-44,8
29,0,0,0,0,2021-10-22,Male,51,45-54,5
29,3,1,0,4,2021-10-22,Male,14,10-14,8
29,1,2,0,3,2021-10-22,Male,63,55-64,6
29,2,1,0,3,2021-10-22,Male,19,15-19,3
29,2,0,0,2,2021-10-23,Male,72,70-74,19
29,0,2,0,2,2021-10-23,Female,55,55-64,2
29,1,0,0,1,2021-10-22,Male,60,55-64,5
29,0,1,0,1,2021-10-23,Female,70,70-74,3
29,0,0,0,0,2021-10-26,Female,35,35-44,5
29,0,4,0,4,2021-10-26,Female,54,45-54,4
29,0,0,0,0,2021-10-26,Female,61,55-64,3
29,0,0,0,0,2021-10-23,Male,65,65-69,3
29,3,0,0,3,2021-10-24,Male,19,15-19,8
29,3,0,0,3,2021-10-22,Male,3,1-4,5
29,0,4,0,4,2021-10-23,Female,44,35-44,3
29,0,0,0,0,2021-10-24,Male,77,75-79,2
29,0,0,0,0,2021-10-22,Male,53,45-54,25
29,1,0,0,1,2021-10-25,Female,58,55-64,4
29,3,0,0,3,2021-10-25,Female,3,1-4,2
29,1,1,0,2,2021-10-22,Female,55,55-64,5
29,0,0,0,0,2021-10-23,Male,8,5-9,4
29,1,0,0,1,2021-10-22,Female,58,55-64,2
29,0,0,0,0,2021-10-23,Female,34,25-34,4
29,2,1,0,3,2021-10-22,Female,12,10-14,2
29,0,0,0,0,2021-10-24,Female,52,45-54,2
29,1,0,0,1,2021-10-29,Female,22,20-24,1
29,1,0,0,1,2021-10-22,Male,68,65-69,2
29,1,1,0,2,2021-10-26,Male,8,5-9,4
29,0,0,0,0,2021-10-22,Female,0,<1,8
29,0,0,0,0,2021-10-22,Female,17,15-19,21
29,1,0,0,1,2021-10-22,Female,85,85+,3
29,2,0,0,2,2021-10-22,Female,16,15-19,8
29,0,0,0,0,2021-10-23,Female,32,25-34,8
29,1,4,0,5,2021-10-23,Male,62,55-64,4
29,0,0,0,0,2021-10-23,Male,75,75-79,2
29,1,0,0,1,2021-10-24,Male,71,70-74,2
29,1,0,0,1,2021-10-23,Male,58,55-64,5
29,0,0,0,0,2021-10-27,Female,54,45-54,2
29,1,8,0,9,2021-10-23,Female,60,55-64,2
29,0,0,0,0,2021-10-24,Male,34,25-34,7
29,2,0,29,31,2021-10-26,Female,15,15-19,7
29,1,2,0,3,2021-10-25,Female,68,65-69,20
29,1,5,0,6,2021-10-23,Male,69,65-69,3
29,0,0,0,0,2021-10-22,Female,41,35-44,6
29,1,0,0,1,2021-10-25,Male,64,55-64,8
29,1,0,0,1,2021-10-22,Male,81,80-84,3
29,0,1,2,3,2021-10-22,Male,60,55-64,2
29,1,0,0,1,2021-10-25,Female,46,45-54,9
29,1,0,0,1,2021-10-23,Female,52,45-54,8
29,1,2,0,3,2021-10-26,Male,66,65-69,2
29,0,2,0,2,2021-11-01,Female,2,1-4,1
29,1,45,45,91,2021-10-29,Male,8,5-9,1
29,1,0,0,1,2021-10-24,Female,67,65-69,7
29,1,0,0,1,2021-10-23,Male,61,55-64,4
29,2,0,0,2,2021-10-26,Female,5,5-9,2
29,2,2,0,4,2021-10-25,Male,22,20-24,11
29,0,3,0,3,2021-10-26,Male,54,45-54,8
29,0,0,0,0,2021-10-22,Female,60,55-64,2
29,1,0,0,1,2021-10-23,Male,53,45-54,8
29,0,0,0,0,2021-10-22,Male,51,45-54,7
29,1,0,0,1,2021-10-23,Male,35,35-44,7
29,3,0,0,3,2021-10-22,Male,26,25-34,7
29,3,0,0,3,2021-10-22,Female,8,5-9,9
29,0,0,0,0,2021-10-24,Male,36,35-44,4
29,0,5,0,5,2021-10-22,Female,33,25-34,4
29,1,4,0,5,2021-10-23,Female,18,15-19,2
29,0,0,0,0,2021-10-30,Male,28,25-34,1
29,2,3,0,5,2021-10-25,Male,30,25-34,6
29,0,0,0,0,2021-10-25,Female,57,55-64,6
29,0,0,0,0,2021-10-22,Female,49,45-54,8
29,2,16,0,18,2021-10-23,Female,18,15-19,3
29,1,0,0,1,2021-10-27,Female,30,25-34,3
29,2,0,0,2,2021-10-29,Male,0,<1,1
29,3,0,0,3,2021-10-22,Female,0,<1,3
29,0,0,0,0,2021-10-25,Female,43,35-44,2
29,2,1,0,3,2021-10-23,Female,51,45-54,18
29,1,0,0,1,2021-10-22,Male,61,55-64,5
29,0,0,0,0,2021-10-24,Male,33,25-34,16
29,0,0,0,0,2021-10-28,Female,25,25-34,17
29,2,1,0,3,2021-11-02,Female,15,15-19,1
29,2,0,0,2,2021-10-23,Male,25,25-34,8
29,0,0,0,0,2021-10-24,Male,41,35-44,4
29,0,3,0,3,2021-10-22,Male,73,70-74,2
29,1,1,0,2,2021-10-26,Male,66,65-69,2
29,4,0,0,4,2021-10-25,Male,64,55-64,2
29,0,2,0,2,2021-10-27,Male,71,70-74,8
29,0,0,0,0,2021-10-28,Male,34,25-34,9
29,0,6,0,6,2021-11-01,Female,19,15-19,1
29,0,0,0,0,2021-10-26,Female,66,65-69,5
29,2,1,0,3,2021-10-25,Male,64,55-64,2
29,2,3,0,5,2021-10-29,Female,1,1-4,1
29,1,0,0,1,2021-10-25,Female,62,55-64,3
29,0,14,0,14,2021-10-23,Female,31,25-34,24
29,1,1,0,2,2021-10-24,Male,76,75-79,2
29,1,0,0,1,2021-10-24,Male,53,45-54,2
29,1,0,0,1,2021-10-25,Female,2,1-4,3
29,2,0,0,2,2021-10-25,Male,11,10-14,3
29,1,0,0,1,2021-10-23,Female,30,25-34,3
29,1,0,0,1,2021-10-23,Male,60,55-64,5
29,2,4,0,6,2021-10-25,Female,29,25-34,2
29,1,1,0,2,2021-10-23,Female,35,35-44,3
29,2,1,0,3,2021-10-25,Female,43,35-44,2
29,5,1,0,6,2021-11-02,Male,0,<1,1
29,2,0,0,2,2021-11-01,Male,31,25-34,1
29,1,0,0,1,2021-10-23,Female,17,15-19,5
29,0,0,0,0,2021-10-23,Female,70,70-74,21
29,1,0,0,1,2021-10-23,Male,71,70-74,2
29,1,0,0,1,2021-10-24,Female,37,35-44,7
29,1,2,0,3,2021-10-23,Male,71,70-74,3
29,1,3,0,4,2021-10-22,Male,62,55-64,8
29,0,1,0,1,2021-10-25,Female,74,70-74,8
29,0,0,0,0,2021-10-22,Female,16,15-19,2
29,1,0,0,1,2021-10-23,Female,52,45-54,3
29,1,0,0,1,2021-10-23,Female,60,55-64,3
29,0,0,0,0,2021-10-22,Male,52,45-54,4
29,2,0,0,2,2021-10-23,Female,56,55-64,12
29,0,1,0,1,2021-10-23,Female,12,10-14,5
29,3,0,0,3,2021-10-24,Female,15,15-19,17
29,1,0,0,1,2021-10-26,Male,66,65-69,7
29,1,0,0,1,2021-10-23,Female,63,55-64,3
29,1,0,0,1,2021-10-22,Female,47,45-54,2
29,3,0,0,3,2021-10-22,Female,14,10-14,3
29,1,0,0,1,2021-10-26,Male,74,70-74,17
29,0,0,0,0,2021-10-24,Male,59,55-64,4
29,2,2,0,4,2021-10-26,Male,0,<1,4
29,2,0,0,2,2021-10-22,Male,3,1-4,3
29,0,1,0,1,2021-10-22,Female,39,35-44,4
29,0,0,0,0,2021-10-29,Male,23,20-24,7
29,5,10,0,15,2021-10-26,Male,17,15-19,20
29,0,0,0,0,2021-10-24,Male,70,70-74,6
29,3,1,0,4,2021-10-22,Male,4,1-4,5
29,1,0,0,1,2021-10-25,Female,46,45-54,3
29,3,0,0,3,2021-10-25,Male,2,1-4,2
29,1,0,0,1,2021-10-22,Male,56,55-64,4
29,1,0,0,1,2021-10-23,Female,54,45-54,3
29,0,1,5,6,2021-11-02,Female,34,25-34,1
29,2,0,0,2,2021-10-22,Female,30,25-34,11
29,0,0,1,1,2021-10-23,Female,28,25-34,3
29,0,0,0,0,2021-10-28,Female,78,75-79,3
29,1,1,0,2,2021-10-22,Female,64,55-64,2
29,1,0,0,1,2021-10-25,Female,46,45-54,4
29,2,2,0,4,2021-10-22,Male,17,15-19,3
29,0,0,0,0,2021-10-25,Female,32,25-34,4
29,1,0,0,1,2021-10-26,Male,53,45-54,9
29,1,0,0,1,2021-10-23,Male,49,45-54,6
29,0,0,0,0,2021-10-26,Female,24,20-24,2
29,1,0,0,1,2021-10-23,Male,60,55-64,3
29,3,1,0,4,2021-10-22,Male,12,10-14,9
29,1,17,0,18,2021-10-23,Female,10,10-14,3
29,1,0,0,1,2021-10-28,Male,65,65-69,8
29,1,1,0,2,2021-10-28,Female,22,20-24,6
29,0,3,0,3,2021-10-23,Male,51,45-54,9
29,2,11,0,13,2021-11-02,Female,14,10-14,1
29,3,0,0,3,2021-10-22,Female,72,70-74,2
29,0,6,0,6,2021-10-22,Female,40,35-44,5
29,2,2,0,4,2021-10-26,Female,63,55-64,12
29,0,4,0,4,2021-10-22,Male,49,45-54,5
29,0,0,0,0,2021-10-23,Female,31,25-34,18
29,0,0,0,0,2021-10-27,Female,66,65-69,9
29,0,11,0,11,2021-10-23,Female,52,45-54,2
29,0,0,0,0,2021-10-24,Male,70,70-74,4
29,2,0,0,2,2021-10-25,Female,13,10-14,3
29,0,0,0,0,2021-10-24,Male,58,55-64,20
29,1,7,0,8,2021-10-25,Female,62,55-64,9
29,1,1,0,2,2021-10-23,Male,61,55-64,3
29,0,0,0,0,2021-10-22,Female,27,25-34,3
29,1,0,0,1,2021-10-26,Female,31,25-34,2
29,0,0,0,0,2021-10-26,Female,30,25-34,4
29,2,2,0,4,2021-10-28,Female,47,45-54,12
29,0,1,0,1,2021-10-25,Male,46,45-54,9
29,1,0,0,1,2021-10-22,Male,52,45-54,6
29,6,0,0,6,2021-10-22,Female,4,1-4,2
29,1,0,0,1,2021-10-22,Female,60,55-64,9
29,0,1,0,1,2021-10-24,Male,59,55-64,7
29,1,0,0,1,2021-10-25,Male,51,45-54,2
29,0,0,0,0,2021-10-23,Female,66,65-69,3
29,0,2,0,2,2021-10-24,Male,33,25-34,2
29,0,1,0,1,2021-10-23,Male,45,45-54,4
29,2,0,0,2,2021-10-23,Male,70,70-74,3
29,0,0,0,0,2021-10-25,Male,64,55-64,3
29,1,0,0,1,2021-10-22,Female,31,25-34,3
29,1,0,0,1,2021-10-23,Male,71,70-74,3
29,0,0,0,0,2021-10-25,Male,60,55-64,2
29,2,0,0,2,2021-10-23,Female,60,55-64,18
29,0,0,0,0,2021-10-22,Female,32,25-34,7
29,3,0,0,3,2021-10-22,Female,3,1-4,5
29,0,0,0,0,2021-10-22,Female,73,70-74,2
29,1,1,0,2,2021-10-24,Female,77,75-79,2
29,1,0,0,1,2021-10-26,Female,45,45-54,3
29,0,0,0,0,2021-10-22,Male,55,55-64,9
29,1,1,0,2,2021-10-23,Male,69,65-69,3
29,1,3,0,4,2021-10-23,Female,50,45-54,3
29,1,0,0,1,2021-10-22,Female,77,75-79,3
29,0,1,0,1,2021-10-23,Female,49,45-54,2
29,3,3,0,6,2021-10-22,Female,18,15-19,8
29,0,0,0,0,2021-10-22,Male,9,5-9,5
29,2,0,0,2,2021-10-22,Female,12,10-14,9
29,3,0,0,3,2021-10-22,Female,59,55-64,3
29,0,0,0,0,2021-10-26,Male,66,65-69,8
29,0,1,0,1,2021-10-23,Male,69,65-69,3
29,0,0,0,0,2021-10-22,Female,47,45-54,2
29,0,2,0,2,2021-10-23,Male,67,65-69,8
29,1,0,0,1,2021-10-22,Male,76,75-79,6
29,0,0,0,0,2021-10-24,Male,67,65-69,2
29,1,5,0,6,2021-10-22,Male,75,75-79,2
29,0,12,0,12,2021-10-24,Male,61,55-64,3
29,1,0,0,1,2021-10-25,Male,60,55-64,8
29,2,2,0,4,2021-10-22,Female,49,45-54,8
29,1,0,0,1,2021-10-24,Male,85,85+,6
29,0,1,0,1,2021-10-23,Male,42,35-44,6
29,1,0,0,1,2021-10-23,Male,37,35-44,7
29,0,2,0,2,2021-10-22,Female,63,55-64,4
29,0,1,0,1,2021-10-24,Male,38,35-44,2
29,1,0,0,1,2021-10-24,Female,69,65-69,9
29,0,0,0,0,2021-10-22,Female,51,45-54,10
29,0,0,0,0,2021-10-25,Female,42,35-44,3
29,0,0,0,0,2021-10-23,Female,69,65-69,3
29,3,0,0,3,2021-10-23,Male,21,20-24,19
29,2,0,0,2,2021-10-26,Male,66,65-69,15
29,0,1,0,1,2021-10-22,Male,39,35-44,8
29,0,1,2,3,2021-10-31,Male,21,20-24,1
29,2,0,0,2,2021-10-23,Female,53,45-54,3
29,0,0,0,0,2021-10-23,Male,5,5-9,3
29,0,0,0,0,2021-10-26,Male,31,25-34,2
29,0,0,0,0,2021-10-24,Male,5,5-9,2
29,1,0,0,1,2021-10-25,Female,64,55-64,5
29,2,10,0,12,2021-10-22,Female,30,25-34,2
29,0,0,0,0,2021-10-24,Female,53,45-54,4
29,1,0,0,1,2021-10-23,Male,64,55-64,2
29,0,2,0,2,2021-10-22,Female,55,55-64,9
29,2,1,0,3,2021-10-25,Female,9,5-9,2
29,1,0,0,1,2021-10-26,Male,73,70-74,4
29,0,0,0,0,2021-10-23,Male,70,70-74,2
29,1,0,0,1,2021-10-23,Male,60,55-64,8
29,0,10,0,10,2021-10-22,Female,52,45-54,5
29,1,2,0,3,2021-10-27,Male,29,25-34,5
29,1,1,0,2,2021-10-23,Female,53,45-54,3
29,0,0,0,0,2021-10-27,Male,44,35-44,4
29,1,1,0,2,2021-10-27,Male,36,35-44,3
29,1,0,0,1,2021-10-23,Female,67,65-69,9
29,4,0,0,4,2021-11-02,Male,9,5-9,1
29,0,0,0,0,2021-10-23,Female,65,65-69,7
29,0,0,0,0,2021-10-24,Male,50,45-54,3
29,2,0,0,2,2021-10-24,Female,10,10-14,3
29,1,0,6,7,2021-10-25,Female,63,55-64,2
29,1,2,0,3,2021-10-25,Male,45,45-54,8
29,1,0,0,1,2021-10-22,Female,26,25-34,9
29,1,0,0,1,2021-10-25,Male,68,65-69,5
29,3,7,37,47,2021-10-29,Male,2,1-4,1
29,1,2,0,3,2021-10-22,Male,73,70-74,3
29,0,0,0,0,2021-10-29,Female,0,<1,1
29,3,0,0,3,2021-10-22,Female,60,55-64,2
29,0,0,0,0,2021-10-24,Male,45,45-54,2
29,2,0,0,2,2021-11-01,Male,6,5-9,1
29,0,0,0,0,2021-10-26,Male,53,45-54,6
29,0,4,0,4,2021-10-23,Male,41,35-44,3
29,3,1,0,4,2021-10-24,Female,49,45-54,3
29,0,0,0,0,2021-10-22,Female,50,45-54,5
29,0,0,0,0,2021-10-26,Female,65,65-69,8
29,0,0,0,0,2021-10-23,Female,67,65-69,5
29,1,1,0,2,2021-10-26,Male,53,45-54,4
29,2,0,0,2,2021-10-29,Male,0,<1,1
29,0,0,0,0,2021-10-22,Male,48,45-54,4
29,1,0,0,1,2021-10-23,Male,53,45-54,9
29,0,0,0,0,2021-10-28,Female,47,45-54,9
29,0,0,0,0,2021-10-23,Female,24,20-24,7
29,0,0,0,0,2021-10-25,Male,43,35-44,15
29,1,9,0,10,2021-10-23,Female,53,45-54,8
29,1,8,0,9,2021-10-24,Female,76,75-79,8
29,0,7,0,7,2021-10-24,Female,59,55-64,3
29,1,0,0,1,2021-10-24,Female,52,45-54,2
29,1,0,0,1,2021-10-23,Female,34,25-34,4
29,1,4,0,5,2021-10-22,Male,59,55-64,4
29,1,0,0,1,2021-10-25,Female,49,45-54,2
29,1,0,10,11,2021-10-29,Female,31,25-34,1
29,2,0,0,2,2021-11-02,Female,60,55-64,2
29,2,0,0,2,2021-10-24,Female,36,35-44,15
29,2,0,0,2,2021-10-24,Female,18,15-19,7
29,1,0,0,1,2021-10-24,Female,51,45-54,3
29,1,1,0,2,2021-10-26,Male,72,70-74,2
29,1,0,0,1,2021-10-26,Female,24,20-24,2
29,0,0,0,0,2021-10-23,Female,23,20-24,20
29,1,0,0,1,2021-10-24,Male,60,55-64,4
29,1,2,0,3,2021-10-22,Male,54,45-54,2
29,1,2,0,3,2021-10-23,Male,69,65-69,3
29,3,5,0,8,2021-10-26,Female,1,1-4,5
29,2,1,0,3,2021-10-25,Female,61,55-64,7
29,1,0,0,1,2021-10-28,Female,34,25-34,15
29,0,10,0,10,2021-11-02,Female,39,35-44,1
29,0,0,0,0,2021-10-26,Male,72,70-74,2
29,5,3,0,8,2021-10-22,Male,5,5-9,1
29,1,0,0,1,2021-10-22,Female,44,35-44,4
29,0,0,0,0,2021-10-23,Male,57,55-64,2
29,1,0,0,1,2021-10-27,Male,65,65-69,3
29,0,3,0,3,2021-10-22,Male,52,45-54,3
29,1,1,0,2,2021-10-25,Male,68,65-69,7
29,3,1,0,4,2021-10-24,Male,5,5-9,9
29,0,0,0,0,2021-10-24,Female,59,55-64,6
29,0,0,0,0,2021-10-23,Female,30,25-34,2
29,0,0,0,0,2021-10-23,Male,19,15-19,6
29,1,0,0,1,2021-10-25,Male,42,35-44,2
29,4,2,0,6,2021-10-24,Male,6,5-9,3
29,2,0,0,2,2021-10-23,Male,53,45-54,2
29,1,1,0,2,2021-10-22,Female,67,65-69,8
29,1,0,0,1,2021-10-22,Male,40,35-44,4
29,0,4,0,4,2021-11-02,Male,59,55-64,1
29,1,0,0,1,2021-10-25,Male,65,65-69,7
29,2,0,0,2,2021-10-26,Male,66,65-69,7
29,0,3,0,3,2021-10-24,Female,40,35-44,3
29,1,0,0,1,2021-10-23,Male,52,45-54,4
29,1,4,0,5,2021-10-24,Female,34,25-34,4
29,1,2,0,3,2021-10-24,Male,60,55-64,17
29,0,2,0,2,2021-10-25,Female,43,35-44,3
29,1,1,0,2,2021-10-25,Male,67,65-69,5
29,2,15,0,17,2021-10-23,Male,14,10-14,3
29,1,0,0,1,2021-10-24,Male,50,45-54,3
29,1,2,0,3,2021-10-23,Male,71,70-74,2
29,1,0,0,1,2021-10-24,Female,59,55-64,23
29,0,3,0,3,2021-10-22,Female,23,20-24,2
29,0,2,0,2,2021-10-29,Female,26,25-34,1
29,3,0,0,3,2021-10-22,Female,50,45-54,3
29,2,1,0,3,2021-10-28,Male,18,15-19,3
29,1,0,0,1,2021-10-23,Female,69,65-69,3
29,0,0,0,0,2021-10-22,Male,21,20-24,9
29,0,0,0,0,2021-10-22,Female,25,25-34,10
29,1,2,0,3,2021-10-23,Female,49,45-54,7
29,0,2,0,2,2021-10-22,Male,74,70-74,2
29,0,0,0,0,2021-10-23,Male,70,70-74,2
29,0,6,0,6,2021-10-22,Male,49,45-54,3
29,2,0,0,2,2021-10-22,Female,17,15-19,2
29,0,0,0,0,2021-10-23,Male,69,65-69,3
29,1,0,0,1,2021-10-25,Male,67,65-69,9
29,0,0,0,0,2021-10-27,Male,53,45-54,5
29,0,0,0,0,2021-10-22,Male,35,35-44,8
29,1,0,0,1,2021-10-23,Male,65,65-69,2
29,2,4,0,6,2021-10-26,Female,18,15-19,4
29,0,1,0,1,2021-10-22,Female,30,25-34,3
29,0,0,0,0,2021-10-29,Female,29,25-34,4
29,1,8,0,9,2021-10-23,Female,29,25-34,2
29,1,3,0,4,2021-10-27,Male,53,45-54,4
29,0,0,0,0,2021-10-22,Male,23,20-24,16
29,0,0,0,0,2021-10-25,Female,64,55-64,3
29,0,1,1,2,2021-10-26,Female,65,65-69,3
29,1,1,0,2,2021-10-23,Female,69,65-69,3
29,2,9,0,11,2021-10-28,Male,80,80-84,2
29,1,0,0,1,2021-10-22,Male,52,45-54,8
29,1,1,0,2,2021-10-25,Female,63,55-64,2
29,0,1,0,1,2021-10-25,Male,63,55-64,3
29,2,0,0,2,2021-10-22,Female,1,1-4,3
29,1,3,0,4,2021-10-23,Female,49,45-54,6
29,1,0,0,1,2021-10-23,Male,58,55-64,3
29,1,1,0,2,2021-10-26,Male,79,75-79,13
29,0,0,0,0,2021-10-30,Female,19,15-19,1
29,1,3,0,4,2021-10-23,Male,64,55-64,9
29,0,0,0,0,2021-10-25,Female,44,35-44,9
29,1,0,0,1,2021-10-23,Male,70,70-74,4
29,1,0,0,1,2021-11-02,Male,50,45-54,6
29,1,0,0,1,2021-10-25,Male,37,35-44,13
29,5,3,0,8,2021-10-25,Male,22,20-24,6
29,0,0,0,0,2021-10-29,Male,21,20-24,1
29,2,0,0,2,2021-10-24,Female,3,1-4,2
29,0,0,0,0,2021-10-25,Female,39,35-44,2
29,0,1,0,1,2021-10-23,Male,58,55-64,3
29,0,0,0,0,2021-10-24,Female,42,35-44,3
29,0,2,0,2,2021-10-22,Male,38,35-44,8
29,1,0,0,1,2021-10-23,Female,52,45-54,10
29,1,4,0,5,2021-10-22,Male,72,70-74,4
29,0,0,0,0,2021-10-25,Female,58,55-64,3
29,1,0,0,1,2021-10-22,Male,38,35-44,3
29,2,0,0,2,2021-10-22,Female,21,20-24,2
29,1,0,0,1,2021-10-23,Female,58,55-64,4
29,1,0,0,1,2021-10-22,Male,63,55-64,2
29,1,0,0,1,2021-10-29,Female,22,20-24,1
29,3,2,0,5,2021-10-23,Male,22,20-24,4
29,0,0,0,0,2021-10-25,Male,61,55-64,2
29,1,0,0,1,2021-10-25,Male,73,70-74,3
29,3,4,0,7,2021-10-31,Female,20,20-24,1
29,3,5,0,8,2021-10-26,Male,7,5-9,3
29,1,0,1,2,2021-10-22,Female,57,55-64,2
29,0,0,0,0,2021-10-22,Male,58,55-64,2
29,2,0,0,2,2021-10-25,Female,3,1-4,4
29,0,0,0,0,2021-10-25,Male,63,55-64,2
29,3,1,0,4,2021-10-22,Female,5,5-9,8
29,0,0,0,0,2021-10-22,Male,43,35-44,5
29,0,0,0,0,2021-10-23,Male,51,45-54,3
29,2,2,0,4,2021-10-23,Female,62,55-64,20
29,5,0,0,5,2021-10-22,Male,2,1-4,3
29,1,0,0,1,2021-11-02,Female,22,20-24,1
29,2,0,0,2,2021-10-26,Female,71,70-74,3
29,2,4,0,6,2021-10-25,Female,20,20-24,10
29,1,6,0,7,2021-10-23,Male,69,65-69,2
29,0,2,0,2,2021-10-24,Male,53,45-54,4
29,1,0,0,1,2021-10-23,Male,71,70-74,4
29,2,0,0,2,2021-10-25,Female,18,15-19,2
29,0,0,0,0,2021-10-22,Male,59,55-64,13
29,1,2,0,3,2021-10-22,Male,53,45-54,5
29,0,1,0,1,2021-10-22,Female,50,45-54,9
29,1,0,0,1,2021-10-22,Male,58,55-64,3
29,0,1,0,1,2021-10-25,Female,63,55-64,4
29,1,0,0,1,2021-11-02,Male,70,70-74,1
29,1,0,0,1,2021-10-23,Female,64,55-64,6
29,1,0,0,1,2021-10-22,Male,38,35-44,4
29,0,0,0,0,2021-10-22,Male,65,65-69,3
29,2,0,1,3,2021-10-24,Female,53,45-54,20
29,0,0,0,0,2021-10-26,Male,54,45-54,4
29,2,0,0,2,2021-10-24,Female,58,55-64,16
29,1,8,0,9,2021-10-23,Male,63,55-64,3
29,2,0,0,2,2021-10-25,Male,68,65-69,3
29,0,0,0,0,2021-10-24,Female,26,25-34,4
29,0,0,0,0,2021-11-02,Female,58,55-64,1
29,1,0,0,1,2021-10-22,Female,38,35-44,7
29,0,4,0,4,2021-11-02,Male,57,55-64,1
29,1,0,0,1,2021-10-26,Female,33,25-34,4
29,2,0,0,2,2021-10-25,Female,49,45-54,3
29,1,0,0,1,2021-10-26,Female,72,70-74,6
29,0,0,0,0,2021-10-22,Male,60,55-64,9
29,0,2,0,2,2021-10-22,Female,66,65-69,2
29,0,0,0,0,2021-10-23,Male,66,65-69,9
29,0,4,0,4,2021-10-22,Female,30,25-34,5
29,1,12,0,13,2021-10-26,Female,69,65-69,2
29,1,0,0,1,2021-10-22,Male,70,70-74,3
29,0,11,0,11,2021-10-22,Female,22,20-24,8
29,1,0,0,1,2021-10-23,Female,13,10-14,2
29,1,1,0,2,2021-10-29,Female,27,25-34,1
29,0,0,0,0,2021-10-25,Female,65,65-69,4
29,0,0,0,0,2021-10-27,Male,72,70-74,3
29,2,0,0,2,2021-10-26,Female,42,35-44,3
29,2,2,0,4,2021-10-29,Female,5,5-9,1
29,1,0,0,1,2021-10-25,Male,69,65-69,8
29,0,0,0,0,2021-10-22,Male,36,35-44,2
29,1,0,0,1,2021-10-26,Male,57,55-64,2
29,1,1,0,2,2021-10-23,Female,71,70-74,4
29,0,3,0,3,2021-10-24,Male,60,55-64,2
29,2,0,0,2,2021-10-30,Male,0,<1,1
29,0,2,0,2,2021-10-25,Male,29,25-34,2
29,1,1,14,16,2021-10-23,Male,70,70-74,7
29,0,0,0,0,2021-10-22,Male,40,35-44,9
29,1,0,0,1,2021-10-22,Male,73,70-74,4
29,2,0,0,2,2021-10-22,Male,60,55-64,5
29,0,0,0,0,2021-10-22,Male,22,20-24,4
29,1,2,0,3,2021-10-23,Male,78,75-79,9
29,0,0,0,0,2021-10-26,Male,57,55-64,7
29,0,0,0,0,2021-10-26,Female,68,65-69,18
29,1,0,0,1,2021-10-22,Male,62,55-64,9
29,0,0,0,0,2021-10-24,Male,54,45-54,2
29,1,10,5,16,2021-10-26,Female,57,55-64,2
29,0,0,0,0,2021-10-23,Male,36,35-44,2
29,4,0,0,4,2021-11-01,Female,12,10-14,3
29,0,0,0,0,2021-10-26,Female,66,65-69,4
29,0,0,0,0,2021-10-22,Female,60,55-64,2
29,0,2,2,4,2021-10-23,Male,54,45-54,2
29,0,2,3,5,2021-10-23,Female,51,45-54,5
29,0,1,0,1,2021-10-28,Female,66,65-69,21
29,0,1,0,1,2021-10-23,Male,80,80-84,4
29,0,0,0,0,2021-10-27,Female,66,65-69,20
29,2,0,0,2,2021-10-25,Male,16,15-19,3
29,0,0,0,0,2021-10-22,Female,39,35-44,4
29,1,0,0,1,2021-10-22,Female,58,55-64,2
29,0,1,0,1,2021-10-24,Female,81,80-84,6
29,0,0,0,0,2021-10-25,Male,42,35-44,3
29,0,0,0,0,2021-10-23,Female,69,65-69,6
29,0,0,0,0,2021-10-25,Female,34,25-34,4
29,1,0,0,1,2021-10-26,Male,71,70-74,2
29,2,0,0,2,2021-10-26,Female,55,55-64,7
29,1,4,0,5,2021-10-25,Male,80,80-84,2
29,0,0,0,0,2021-10-22,Female,54,45-54,8
29,2,4,0,6,2021-10-23,Male,5,5-9,2
29,0,0,1,1,2021-10-22,Male,38,35-44,7
29,1,0,0,1,2021-10-27,Female,25,25-34,4
29,1,0,0,1,2021-10-29,Male,21,20-24,1
29,1,0,0,1,2021-10-22,Female,30,25-34,3
29,2,15,0,17,2021-10-25,Male,68,65-69,23
29,1,0,0,1,2021-10-24,Female,77,75-79,19
29,2,0,0,2,2021-10-24,Male,3,1-4,4
29,1,1,0,2,2021-10-23,Male,77,75-79,2
29,0,1,0,1,2021-10-24,Male,68,65-69,5
29,1,3,0,4,2021-10-22,Female,19,15-19,7
29,1,1,0,2,2021-10-25,Female,68,65-69,5
29,1,0,0,1,2021-10-24,Female,32,25-34,6
29,0,0,0,0,2021-10-27,Female,71,70-74,12
29,1,4,0,5,2021-10-26,Male,65,65-69,3
29,1,0,0,1,2021-10-24,Female,56,55-64,4
29,1,1,0,2,2021-10-26,Male,61,55-64,4
29,0,2,0,2,2021-10-22,Female,59,55-64,7
29,4,1,0,5,2021-10-23,Female,6,5-9,13
29,1,0,0,1,2021-10-29,Female,34,25-34,1
29,0,1,0,1,2021-10-23,Female,52,45-54,5
29,0,0,26,26,2021-10-25,Male,69,65-69,11
29,0,0,54,54,2021-10-27,Male,6,5-9,10
29,0,0,0,0,2021-10-23,Female,34,25-34,4
29,0,4,0,4,2021-10-23,Female,37,35-44,2
29,1,3,0,4,2021-10-22,Female,67,65-69,7
29,1,0,0,1,2021-10-23,Female,52,45-54,7
29,1,0,0,1,2021-10-22,Male,68,65-69,4
29,2,0,0,2,2021-10-22,Male,48,45-54,5
29,2,0,0,2,2021-11-02,Male,11,10-14,1
29,0,3,0,3,2021-10-25,Female,30,25-34,16
29,3,0,0,3,2021-10-22,Female,12,10-14,3
29,0,0,0,0,2021-10-22,Female,70,70-74,4
29,1,5,0,6,2021-10-24,Male,75,75-79,2
29,1,0,0,1,2021-10-25,Female,67,65-69,6
29,0,0,0,0,2021-10-27,Male,20,20-24,4
29,1,0,0,1,2021-10-23,Male,56,55-64,7
29,1,2,0,3,2021-10-26,Female,72,70-74,2
29,0,0,0,0,2021-11-02,Male,54,45-54,1
29,1,0,0,1,2021-10-24,Female,81,80-84,8
29,3,0,0,3,2021-10-25,Male,12,10-14,2
29,1,10,0,11,2021-10-24,Female,60,55-64,7
29,2,0,0,2,2021-10-25,Male,67,65-69,3
29,2,0,0,2,2021-10-22,Female,66,65-69,9
29,1,0,0,1,2021-10-24,Female,62,55-64,3
29,1,0,0,1,2021-10-23,Female,51,45-54,2
29,2,4,0,6,2021-10-24,Female,53,45-54,5
29,1,0,0,1,2021-10-22,Male,45,45-54,5
29,0,0,0,0,2021-10-22,Male,43,35-44,9
29,2,5,0,7,2021-10-24,Male,18,15-19,4
29,1,0,0,1,2021-10-27,Female,14,10-14,2
29,1,2,0,3,2021-10-22,Male,40,35-44,2
29,0,1,0,1,2021-10-25,Male,67,65-69,18
29,2,1,0,3,2021-10-26,Female,54,45-54,4
29,1,3,0,4,2021-10-24,Male,69,65-69,6
29,1,0,0,1,2021-10-22,Male,51,45-54,4
29,0,0,0,0,2021-10-22,Male,45,45-54,10
29,0,0,0,0,2021-10-23,Female,46,45-54,3
29,1,0,0,1,2021-10-26,Male,66,65-69,17
29,0,10,0,10,2021-10-27,Male,43,35-44,4
29,0,0,0,0,2021-10-25,Male,84,80-84,2
29,1,7,0,8,2021-10-22,Male,25,25-34,9
29,1,4,0,5,2021-10-26,Male,65,65-69,8
29,1,0,0,1,2021-10-23,Female,65,65-69,4
29,1,2,0,3,2021-10-26,Female,57,55-64,2
29,1,10,0,11,2021-10-23,Male,54,45-54,2
29,2,2,0,4,2021-11-02,Male,0,<1,1
29,2,0,0,2,2021-10-26,Male,56,55-64,9
29,3,5,0,8,2021-10-25,Male,5,5-9,2
29,1,15,0,16,2021-10-22,Male,85,85+,2
29,1,3,0,4,2021-10-22,Female,61,55-64,6
29,3,0,0,3,2021-10-24,Male,0,<1,2
29,0,0,0,0,2021-10-23,Male,71,70-74,2
29,1,0,0,1,2021-10-26,Male,65,65-69,2
29,2,9,0,11,2021-10-23,Male,45,45-54,3
29,0,2,0,2,2021-10-23,Female,31,25-34,12
29,0,8,0,8,2021-10-25,Male,30,25-34,16
29,1,1,0,2,2021-10-26,Female,54,45-54,3
29,1,1,0,2,2021-10-25,Male,59,55-64,13
29,1,0,0,1,2021-10-22,Male,69,65-69,2
29,1,0,0,1,2021-10-22,Male,46,45-54,3
29,3,0,0,3,2021-10-23,Male,53,45-54,4
29,0,0,0,0,2021-10-23,Male,77,75-79,2
29,1,0,0,1,2021-10-25,Male,68,65-69,3
29,0,40,0,40,2021-10-24,Male,61,55-64,3
29,1,0,0,1,2021-10-27,Female,66,65-69,7
29,0,0,0,0,2021-10-23,Male,50,45-54,8
29,0,0,0,0,2021-10-26,Female,72,70-74,6
29,3,2,0,5,2021-10-25,Male,1,1-4,3
29,1,1,0,2,2021-10-27,Female,28,25-34,5
29,1,0,0,1,2021-10-25,Male,64,55-64,9
29,0,0,1,1,2021-10-23,Female,52,45-54,7
29,0,0,0,0,2021-10-22,Female,65,65-69,9
29,3,0,0,3,2021-10-24,Female,9,5-9,3
29,1,0,0,1,2021-10-22,Female,63,55-64,9
29,0,0,0,0,2021-10-25,Female,17,15-19,6
29,0,0,0,0,2021-10-31,Male,31,25-34,1
29,0,0,0,0,2021-10-25,Female,53,45-54,3
29,1,0,0,1,2021-10-23,Female,67,65-69,7
29,1,3,0,4,2021-10-26,Female,56,55-64,4
29,0,9,0,9,2021-10-22,Male,68,65-69,3
29,4,0,0,4,2021-10-27,Male,4,1-4,2
29,0,2,0,2,2021-10-24,Male,63,55-64,5
29,0,0,0,0,2021-10-23,Male,73,70-74,3
29,1,0,0,1,2021-10-23,Male,53,45-54,7
29,2,0,27,29,2021-10-25,Male,14,10-14,3
29,1,0,0,1,2021-10-25,Male,68,65-69,2
29,2,0,0,2,2021-10-22,Female,20,20-24,3
29,0,0,0,0,2021-10-27,Female,67,65-69,24
29,0,1,0,1,2021-10-22,Female,54,45-54,2
29,1,1,0,2,2021-10-22,Female,73,70-74,8
29,1,0,0,1,2021-10-26,Male,73,70-74,5
29,0,0,0,0,2021-10-22,Male,41,35-44,19
29,1,0,0,1,2021-10-25,Female,62,55-64,19
29,1,1,0,2,2021-10-22,Female,54,45-54,2
29,1,0,0,1,2021-10-25,Female,42,35-44,4
29,0,5,0,5,2021-10-22,Female,31,25-34,3
29,0,12,0,12,2021-10-22,Female,61,55-64,8
29,0,3,0,3,2021-10-22,Female,54,45-54,9
29,1,1,0,2,2021-10-23,Female,54,45-54,3
29,1,15,0,16,2021-10-22,Male,71,70-74,4
29,1,0,0,1,2021-10-22,Male,71,70-74,3
29,3,0,0,3,2021-10-25,Female,8,5-9,3
29,0,1,30,31,2021-10-28,Male,66,65-69,9
29,2,31,6,39,2021-10-22,Female,3,1-4,7
29,2,0,0,2,2021-10-22,Female,4,1-4,8
29,0,0,0,0,2021-10-22,Female,61,55-64,3
29,0,1,0,1,2021-10-29,Male,28,25-34,1
29,0,0,0,0,2021-10-22,Male,32,25-34,7
29,0,0,0,0,2021-10-22,Male,30,25-34,2
29,0,0,0,0,2021-10-22,Male,24,20-24,9
29,2,0,0,2,2021-10-22,Male,6,5-9,4
29,2,1,0,3,2021-10-26,Female,73,70-74,9
29,1,0,0,1,2021-10-25,Female,51,45-54,7
29,1,0,0,1,2021-10-24,Male,57,55-64,9
29,1,5,0,6,2021-10-23,Female,52,45-54,8
29,1,2,0,3,2021-10-25,Female,56,55-64,2
29,0,11,0,11,2021-10-22,Male,57,55-64,7
29,1,0,0,1,2021-10-23,Male,77,75-79,19
29,0,0,0,0,2021-10-25,Male,67,65-69,7
29,5,0,0,5,2021-10-22,Female,5,5-9,4
29,0,1,0,1,2021-10-22,Female,66,65-69,4
29,1,0,0,1,2021-10-29,Male,32,25-34,1
29,0,3,0,3,2021-10-26,Male,50,45-54,2
29,1,2,0,3,2021-10-23,Female,65,65-69,6
29,1,3,0,4,2021-10-22,Female,51,45-54,2
29,0,0,0,0,2021-10-25,Female,33,25-34,3
29,2,0,0,2,2021-10-23,Male,18,15-19,2
29,1,0,0,1,2021-10-23,Male,68,65-69,3
29,1,0,0,1,2021-10-27,Female,65,65-69,4
29,3,0,0,3,2021-10-25,Male,60,55-64,5
29,0,0,0,0,2021-10-23,Female,52,45-54,3
29,1,0,0,1,2021-10-22,Female,68,65-69,4
29,1,4,10,15,2021-11-02,Female,56,55-64,1
29,0,2,0,2,2021-10-22,Female,31,25-34,2
29,0,1,0,1,2021-10-25,Female,63,55-64,4
29,0,0,0,0,2021-10-22,Male,59,55-64,7
29,1,0,11,12,2021-10-22,Male,46,45-54,9
29,1,0,2,3,2021-10-23,Female,65,65-69,7
29,0,2,0,2,2021-10-22,Female,62,55-64,7
29,1,0,0,1,2021-10-22,Female,41,35-44,2
29,1,0,0,1,2021-10-23,Male,69,65-69,8
29,3,6,24,33,2021-10-28,Female,7,5-9,2
29,0,0,0,0,2021-10-22,Female,70,70-74,3
29,0,1,0,1,2021-10-22,Male,61,55-64,2
29,0,0,0,0,2021-10-28,Female,8,5-9,5
29,1,14,0,15,2021-10-23,Female,19,15-19,16
29,0,0,0,0,2021-10-24,Female,8,5-9,3
29,1,0,0,1,2021-10-23,Female,61,55-64,2
29,0,0,0,0,2021-10-27,Male,27,25-34,4
29,0,2,0,2,2021-10-23,Female,30,25-34,4
29,1,2,0,3,2021-10-22,Female,50,45-54,20
29,3,0,0,3,2021-10-25,Female,2,1-4,2
29,3,0,0,3,2021-10-22,Male,23,20-24,8
29,3,1,0,4,2021-10-22,Female,31,25-34,7
29,1,0,0,1,2021-10-24,Male,64,55-64,4
29,1,0,0,1,2021-10-22,Male,80,80-84,4
29,2,15,0,17,2021-10-27,Female,2,1-4,10
29,3,0,0,3,2021-11-02,Male,6,5-9,1
29,0,0,0,0,2021-10-25,Male,41,35-44,2
29,0,0,0,0,2021-10-22,Male,18,15-19,7
29,0,3,0,3,2021-10-26,Male,54,45-54,2
29,1,31,0,32,2021-10-22,Male,53,45-54,3
29,1,0,0,1,2021-10-25,Female,50,45-54,6
29,0,0,0,0,2021-10-23,Male,56,55-64,19
29,0,1,0,1,2021-10-27,Female,65,65-69,6
29,0,0,0,0,2021-10-27,Male,20,20-24,3
29,1,0,0,1,2021-10-23,Male,66,65-69,5
29,0,0,0,0,2021-10-25,Male,72,70-74,4
29,0,0,0,0,2021-10-25,Male,17,15-19,3
29,0,0,0,0,2021-10-29,Male,27,25-34,1
29,0,0,0,0,2021-10-29,Female,22,20-24,1
29,1,3,0,4,2021-10-22,Female,65,65-69,3
29,0,1,0,1,2021-10-22,Female,27,25-34,8
29,1,0,0,1,2021-10-22,Male,74,70-74,4
29,1,0,0,1,2021-10-25,Male,56,55-64,3
29,0,0,0,0,2021-11-02,Male,54,45-54,1
29,0,0,0,0,2021-10-22,Male,65,65-69,9
29,0,1,0,1,2021-10-26,Female,65,65-69,2
29,0,2,0,2,2021-10-23,Female,45,45-54,2
29,0,1,0,1,2021-10-24,Female,40,35-44,4
29,0,0,0,0,2021-10-23,Male,67,65-69,4
29,0,0,0,0,2021-10-26,Female,57,55-64,7
29,1,0,0,1,2021-10-22,Female,69,65-69,3
29,3,0,0,3,2021-10-24,Female,0,<1,5
29,1,0,0,1,2021-10-23,Male,71,70-74,8
29,0,2,0,2,2021-10-23,Male,34,25-34,7
29,1,4,0,5,2021-10-30,Female,31,25-34,1
29,2,0,0,2,2021-10-29,Female,30,25-34,2
29,2,4,0,6,2021-10-24,Female,68,65-69,2
29,1,8,80,89,2021-10-30,Male,32,25-34,1
29,1,0,0,1,2021-10-22,Male,57,55-64,2
29,1,2,0,3,2021-10-25,Male,69,65-69,2
29,1,0,0,1,2021-10-23,Female,27,25-34,3
29,1,0,0,1,2021-10-22,Male,77,75-79,3
29,0,1,0,1,2021-10-24,Female,61,55-64,4
29,2,0,0,2,2021-10-25,Male,8,5-9,3
29,2,0,0,2,2021-10-28,Male,16,15-19,2
29,1,10,31,42,2021-10-23,Female,28,25-34,4
29,1,0,2,3,2021-10-23,Male,70,70-74,9
29,1,0,0,1,2021-10-22,Female,66,65-69,3
29,2,0,0,2,2021-10-24,Male,43,35-44,2
29,0,0,0,0,2021-10-24,Male,35,35-44,8
29,1,1,0,2,2021-10-26,Male,71,70-74,4
29,2,24,0,26,2021-11-02,Female,6,5-9,1
29,0,2,0,2,2021-10-25,Female,73,70-74,4
29,2,0,0,2,2021-10-26,Female,14,10-14,5
29,3,0,0,3,2021-10-22,Female,50,45-54,2
29,1,0,0,1,2021-10-23,Male,76,75-79,7
29,1,0,0,1,2021-10-23,Female,71,70-74,3
29,0,0,0,0,2021-10-24,Female,38,35-44,9
29,0,3,0,3,2021-10-22,Female,56,55-64,8
29,0,0,0,0,2021-10-26,Male,55,55-64,6
29,3,0,0,3,2021-10-25,Male,18,15-19,2
29,1,1,0,2,2021-10-23,Female,55,55-64,7
29,0,0,0,0,2021-10-22,Male,59,55-64,6
29,1,0,0,1,2021-10-25,Male,62,55-64,5
29,1,0,0,1,2021-10-23,Male,16,15-19,8
29,2,0,0,2,2021-10-22,Male,48,45-54,3
29,0,10,30,40,2021-10-23,Female,24,20-24,2
29,1,0,0,1,2021-10-22,Female,41,35-44,3
29,1,2,0,3,2021-10-23,Male,69,65-69,5
29,0,0,0,0,2021-10-23,Male,43,35-44,2
29,0,2,0,2,2021-10-22,Male,41,35-44,7
29,2,1,0,3,2021-10-22,Female,2,1-4,3
29,0,0,0,0,2021-10-27,Female,28,25-34,2
29,1,0,0,1,2021-10-22,Female,65,65-69,9
29,3,0,0,3,2021-10-24,Female,14,10-14,8
29,3,0,0,3,2021-10-24,Female,10,10-14,2
29,3,1,0,4,2021-10-30,Female,26,25-34,1
29,0,0,0,0,2021-10-22,Female,51,45-54,9
29,0,0,0,0,2021-10-27,Male,72,70-74,2
29,1,2,0,3,2021-10-27,Female,54,45-54,8
29,1,0,0,1,2021-11-02,Male,67,65-69,1
29,1,2,0,3,2021-10-23,Female,31,25-34,4
29,0,24,0,24,2021-10-22,Female,65,65-69,5
29,0,0,0,0,2021-10-23,Male,78,75-79,5
29,2,0,0,2,2021-10-22,Male,43,35-44,3
29,3,3,0,6,2021-10-27,Male,7,5-9,4
29,2,0,4,6,2021-10-24,Male,55,55-64,4
29,0,0,0,0,2021-10-22,Female,21,20-24,3
29,0,0,0,0,2021-10-24,Female,35,35-44,3
29,1,0,10,11,2021-10-25,Female,68,65-69,3
29,0,0,0,0,2021-10-22,Male,52,45-54,10
29,2,0,0,2,2021-11-02,Male,65,65-69,1
29,1,1,0,2,2021-10-26,Female,55,55-64,14
29,3,0,0,3,2021-10-29,Female,34,25-34,12
29,3,3,0,6,2021-10-22,Female,4,1-4,6
29,1,0,0,1,2021-10-22,Male,63,55-64,2
29,1,0,0,1,2021-10-25,Male,67,65-69,2
29,0,0,0,0,2021-10-23,Male,60,55-64,9
29,0,1,0,1,2021-10-25,Female,82,80-84,3
29,0,0,0,0,2021-10-24,Male,34,25-34,21
29,0,0,0,0,2021-10-24,Male,53,45-54,3
29,1,3,0,4,2021-10-25,Male,45,45-54,2
29,2,4,0,6,2021-10-25,Male,7,5-9,2
29,3,0,0,3,2021-10-23,Male,3,1-4,2
29,1,0,2,3,2021-10-25,Female,68,65-69,8
29,2,0,0,2,2021-10-22,Male,49,45-54,7
29,2,0,0,2,2021-10-26,Male,74,70-74,15
29,0,0,0,0,2021-10-26,Female,31,25-34,3
29,1,12,0,13,2021-10-29,Female,27,25-34,1
29,1,0,0,1,2021-10-25,Female,67,65-69,3
29,0,11,0,11,2021-10-29,Female,22,20-24,8
29,0,0,0,0,2021-10-23,Male,76,75-79,2
29,4,0,0,4,2021-10-26,Female,35,35-44,16
29,0,5,0,5,2021-10-22,Male,32,25-34,8
29,0,2,0,2,2021-10-23,Male,15,15-19,5
29,1,0,0,1,2021-10-22,Female,47,45-54,2
29,1,0,0,1,2021-10-25,Male,63,55-64,5
29,2,0,0,2,2021-10-22,Male,19,15-19,2
29,3,0,0,3,2021-10-22,Female,17,15-19,7
29,2,0,0,2,2021-10-24,Female,7,5-9,2
29,1,9,0,10,2021-10-30,Female,1,1-4,1
29,1,0,0,1,2021-10-22,Female,39,35-44,4
29,0,0,0,0,2021-10-22,Female,67,65-69,12
29,2,12,0,14,2021-10-29,Male,4,1-4,1
29,1,2,0,3,2021-10-28,Male,73,70-74,22
29,2,0,0,2,2021-10-22,Female,18,15-19,4
29,1,0,0,1,2021-11-02,Female,31,25-34,1
29,0,32,0,32,2021-10-22,Female,72,70-74,3
29,1,0,0,1,2021-10-22,Male,19,15-19,2
29,3,1,0,4,2021-11-01,Male,2,1-4,1
29,1,3,0,4,2021-10-23,Female,55,55-64,2
29,0,0,0,0,2021-10-22,Female,50,45-54,9
29,0,0,0,0,2021-10-23,Female,69,65-69,3
29,0,0,0,0,2021-10-22,Male,72,70-74,20
29,0,0,0,0,2021-10-27,Male,45,45-54,4
29,1,2,0,3,2021-10-26,Female,56,55-64,14
29,2,3,0,5,2021-10-23,Female,3,1-4,3
29,0,1,0,1,2021-10-24,Female,78,75-79,3
29,2,2,0,4,2021-11-02,Male,10,10-14,1
29,0,3,0,3,2021-10-24,Female,60,55-64,7
29,1,2,0,3,2021-10-25,Male,77,75-79,2
29,1,2,0,3,2021-11-02,Male,73,70-74,1
29,2,0,0,2,2021-10-28,Male,3,1-4,8
29,2,0,0,2,2021-10-22,Male,18,15-19,5
29,0,2,0,2,2021-10-22,Male,65,65-69,4
29,4,0,0,4,2021-10-29,Male,13,10-14,1
29,1,0,0,1,2021-10-22,Female,54,45-54,3
29,0,0,0,0,2021-10-22,Male,68,65-69,3
29,0,0,0,0,2021-10-22,Female,33,25-34,3
29,0,3,0,3,2021-10-25,Female,58,55-64,7
29,3,0,0,3,2021-10-22,Male,20,20-24,8
29,1,3,0,4,2021-10-25,Female,67,65-69,8
29,1,0,0,1,2021-10-23,Male,59,55-64,5
29,1,1,0,2,2021-10-22,Female,68,65-69,9
29,2,1,0,3,2021-10-22,Female,49,45-54,3
29,0,0,0,0,2021-10-22,Male,27,25-34,8
29,2,0,0,2,2021-10-29,Male,9,5-9,1
29,1,0,0,1,2021-10-22,Male,75,75-79,3
29,3,0,0,3,2021-10-25,Female,4,1-4,4
29,2,0,0,2,2021-10-22,Male,5,5-9,6
29,1,0,0,1,2021-10-23,Female,53,45-54,2
29,1,0,0,1,2021-10-26,Female,64,55-64,9
29,1,0,0,1,2021-11-02,Male,62,55-64,1
29,0,20,0,20,2021-10-23,Male,52,45-54,4
29,3,0,0,3,2021-10-22,Male,65,65-69,6
29,0,0,0,0,2021-10-23,Female,50,45-54,2
29,0,2,0,2,2021-10-22,Female,47,45-54,2
29,0,1,0,1,2021-10-24,Female,36,35-44,11
29,1,0,0,1,2021-10-24,Female,54,45-54,7
29,0,0,0,0,2021-10-25,Female,77,75-79,6
29,1,0,0,1,2021-10-25,Male,76,75-79,2
29,2,0,0,2,2021-10-26,Female,72,70-74,20
29,1,0,0,1,2021-10-25,Female,68,65-69,3
29,0,0,0,0,2021-10-24,Male,61,55-64,3
29,1,0,0,1,2021-10-23,Male,72,70-74,3
29,0,0,0,0,2021-10-22,Female,8,5-9,8
29,1,9,0,10,2021-10-23,Male,70,70-74,21
29,0,0,0,0,2021-10-22,Male,62,55-64,3
29,1,3,0,4,2021-10-23,Male,72,70-74,2
29,0,0,0,0,2021-10-25,Male,64,55-64,3
29,0,0,0,0,2021-10-22,Female,9,5-9,5
29,0,2,0,2,2021-10-23,Male,60,55-64,9
29,1,2,0,3,2021-10-22,Male,51,45-54,5
29,0,0,0,0,2021-10-26,Female,58,55-64,21
29,3,0,0,3,2021-10-24,Male,0,<1,2
29,0,0,0,0,2021-10-23,Female,74,70-74,3
29,0,2,0,2,2021-10-25,Female,50,45-54,12
29,3,2,0,5,2021-10-22,Female,17,15-19,4
29,2,0,0,2,2021-10-24,Female,3,1-4,4
29,1,1,0,2,2021-10-23,Male,71,70-74,2
29,0,0,0,0,2021-10-22,Female,49,45-54,8
29,4,0,0,4,2021-10-25,Female,10,10-14,2
29,1,0,0,1,2021-10-23,Male,51,45-54,2
29,1,0,0,1,2021-10-25,Female,67,65-69,2
29,1,6,0,7,2021-10-25,Female,58,55-64,3
29,1,0,0,1,2021-10-22,Male,36,35-44,3
29,3,0,0,3,2021-10-23,Female,56,55-64,4
29,1,4,0,5,2021-10-23,Female,33,25-34,4
29,1,0,0,1,2021-10-22,Female,75,75-79,3
29,0,2,0,2,2021-10-23,Female,70,70-74,5
29,1,0,0,1,2021-10-25,Female,64,55-64,18
29,1,0,0,1,2021-10-23,Female,42,35-44,4
29,2,0,0,2,2021-10-23,Male,2,1-4,5
29,0,0,0,0,2021-10-23,Male,50,45-54,4
29,0,0,0,0,2021-10-22,Female,41,35-44,5
29,0,0,0,0,2021-10-25,Female,68,65-69,5
29,0,0,0,0,2021-10-25,Male,59,55-64,5
29,2,0,0,2,2021-10-25,Male,19,15-19,9
29,1,2,0,3,2021-11-02,Male,9,5-9,1
29,0,2,0,2,2021-10-26,Male,54,45-54,3
29,0,1,0,1,2021-10-23,Male,74,70-74,14
29,0,0,0,0,2021-10-26,Male,65,65-69,3
29,1,0,0,1,2021-10-23,Male,70,70-74,4
29,1,0,0,1,2021-10-22,Female,24,20-24,3
29,3,0,0,3,2021-10-22,Female,62,55-64,2
29,1,1,0,2,2021-10-23,Male,72,70-74,4
29,0,0,0,0,2021-10-26,Male,54,45-54,5
29,0,0,0,0,2021-10-22,Male,53,45-54,5
29,1,1,0,2,2021-10-22,Female,42,35-44,2
29,1,0,0,1,2021-10-28,Male,32,25-34,4
29,1,0,0,1,2021-10-28,Male,74,70-74,2
29,1,0,0,1,2021-10-23,Male,74,70-74,2
29,2,8,0,10,2021-10-23,Male,58,55-64,3
29,0,0,0,0,2021-10-23,Male,10,10-14,3
29,1,1,0,2,2021-11-01,Male,14,10-14,1
29,1,2,0,3,2021-10-24,Female,33,25-34,6
29,1,0,0,1,2021-11-02,Female,31,25-34,1
29,1,4,0,5,2021-10-24,Female,60,55-64,2
29,2,1,0,3,2021-10-24,Male,75,75-79,21
29,2,2,0,4,2021-10-23,Male,64,55-64,4
29,3,0,0,3,2021-10-24,Male,61,55-64,8
29,1,0,0,1,2021-10-24,Female,78,75-79,11
29,1,2,0,3,2021-10-24,Male,60,55-64,3
29,0,0,0,0,2021-10-25,Female,6,5-9,3
29,1,0,0,1,2021-10-24,Male,40,35-44,13
29,1,0,0,1,2021-10-22,Female,70,70-74,3
29,4,10,2,16,2021-10-26,Female,50,45-54,3
29,2,0,0,2,2021-10-22,Male,43,35-44,3
29,1,0,0,1,2021-10-22,Male,52,45-54,8
29,1,0,0,1,2021-10-22,Male,40,35-44,3
29,1,0,45,46,2021-10-25,Male,67,65-69,9
29,1,0,0,1,2021-10-25,Female,80,80-84,8
29,1,0,0,1,2021-10-24,Female,59,55-64,3
29,2,0,0,2,2021-10-25,Male,45,45-54,5
29,1,0,0,1,2021-10-23,Male,77,75-79,7
29,0,1,0,1,2021-10-26,Male,72,70-74,2
29,0,0,0,0,2021-10-24,Male,61,55-64,23
29,1,2,0,3,2021-10-22,Male,67,65-69,7
29,0,0,0,0,2021-10-23,Male,27,25-34,4
29,1,8,0,9,2021-10-24,Male,60,55-64,2
29,0,0,0,0,2021-10-22,Male,44,35-44,3
29,2,2,0,4,2021-10-24,Male,54,45-54,2
29,0,0,0,0,2021-10-27,Male,7,5-9,21
29,0,0,0,0,2021-10-26,Male,53,45-54,3
29,1,0,0,1,2021-10-29,Female,27,25-34,1
29,1,0,0,1,2021-11-02,Male,65,65-69,1
29,0,1,0,1,2021-10-22,Female,42,35-44,3
29,2,0,0,2,2021-10-28,Female,67,65-69,22
29,1,0,0,1,2021-10-24,Male,66,65-69,9
29,3,2,0,5,2021-10-22,Male,22,20-24,10
29,0,4,0,4,2021-11-01,Male,26,25-34,1
29,2,0,0,2,2021-10-24,Female,54,45-54,22
29,0,0,0,0,2021-10-22,Male,38,35-44,8
29,0,0,0,0,2021-10-23,Male,52,45-54,2
29,1,4,0,5,2021-10-24,Female,33,25-34,3
29,1,0,0,1,2021-10-23,Female,57,55-64,2
29,3,0,0,3,2021-10-22,Male,9,5-9,8
29,0,1,0,1,2021-10-25,Female,39,35-44,3
29,2,0,0,2,2021-10-23,Female,68,65-69,4
29,3,0,1,4,2021-10-27,Female,8,5-9,4
29,0,0,0,0,2021-10-22,Male,63,55-64,3
29,2,0,0,2,2021-10-23,Male,72,70-74,8
29,1,0,0,1,2021-10-25,Male,67,65-69,4
29,0,0,0,0,2021-10-23,Female,56,55-64,2
29,0,1,0,1,2021-10-26,Male,66,65-69,9
29,1,1,0,2,2021-10-24,Male,59,55-64,7
29,0,0,0,0,2021-10-24,Female,21,20-24,8
29,1,0,0,1,2021-10-23,Male,50,45-54,3
29,0,0,0,0,2021-10-23,Male,83,80-84,4
29,0,0,0,0,2021-10-24,Male,34,25-34,12
29,1,0,0,1,2021-10-27,Female,26,25-34,6
29,0,1,0,1,2021-10-24,Female,15,15-19,2
29,1,0,0,1,2021-10-22,Female,37,35-44,3
29,2,0,0,2,2021-10-28,Male,3,1-4,8
29,1,1,0,2,2021-10-23,Male,65,65-69,8
29,1,7,16,24,2021-11-02,Female,27,25-34,1
29,1,0,0,1,2021-10-22,Male,68,65-69,8
29,0,0,0,0,2021-10-23,Female,68,65-69,7
29,3,0,0,3,2021-10-25,Female,8,5-9,3
29,1,0,0,1,2021-10-29,Female,29,25-34,1
29,0,0,0,0,2021-10-22,Female,25,25-34,4
29,0,4,0,4,2021-10-26,Male,56,55-64,8
29,1,2,0,3,2021-10-25,Male,70,70-74,21
29,1,0,0,1,2021-10-22,Male,65,65-69,4
29,2,3,0,5,2021-10-22,Male,52,45-54,3
29,0,0,0,0,2021-10-23,Male,53,45-54,23
29,1,1,0,2,2021-10-23,Male,72,70-74,2
29,1,1,0,2,2021-10-25,Female,41,35-44,9
29,0,1,0,1,2021-10-22,Female,70,70-74,8
29,2,0,0,2,2021-10-23,Female,67,65-69,4
29,0,6,0,6,2021-10-23,Female,69,65-69,4
29,4,0,0,4,2021-11-01,Female,21,20-24,1
29,0,1,0,1,2021-10-22,Female,54,45-54,2
29,0,0,0,0,2021-10-22,Male,36,35-44,6
29,0,0,0,0,2021-10-25,Female,43,35-44,8
29,0,0,0,0,2021-10-23,Male,60,55-64,3
29,4,0,0,4,2021-10-26,Male,10,10-14,14
29,0,0,14,14,2021-10-29,Male,22,20-24,1
29,0,0,0,0,2021-10-22,Male,58,55-64,19
29,1,0,0,1,2021-10-24,Female,50,45-54,3
29,1,2,0,3,2021-10-22,Female,42,35-44,2
29,0,0,0,0,2021-10-25,Male,47,45-54,3
29,3,0,0,3,2021-10-25,Female,10,10-14,2
29,3,0,0,3,2021-11-02,Female,4,1-4,1
29,3,0,0,3,2021-10-24,Male,14,10-14,3
29,0,0,0,0,2021-10-23,Male,72,70-74,6
29,1,0,0,1,2021-10-23,Female,53,45-54,9
29,3,2,0,5,2021-10-22,Female,5,5-9,4
29,0,0,0,0,2021-10-25,Male,67,65-69,4
29,0,3,0,3,2021-10-24,Female,60,55-64,11
29,3,0,0,3,2021-11-02,Female,67,65-69,1
29,0,0,0,0,2021-10-25,Female,64,55-64,2
29,3,0,0,3,2021-10-23,Male,66,65-69,3
29,1,0,0,1,2021-10-24,Female,59,55-64,2
29,2,3,0,5,2021-10-22,Female,48,45-54,8
29,1,1,0,2,2021-10-26,Male,52,45-54,20
29,1,0,0,1,2021-10-24,Male,18,15-19,7
29,3,0,0,3,2021-11-01,Female,1,1-4,1
29,0,0,0,0,2021-10-22,Male,34,25-34,3
29,1,0,0,1,2021-10-23,Male,67,65-69,2
29,1,1,0,2,2021-10-22,Female,54,45-54,2
29,0,1,0,1,2021-10-23,Female,69,65-69,5
29,2,0,0,2,2021-10-25,Male,66,65-69,4
29,1,0,0,1,2021-10-22,Male,59,55-64,3
29,3,0,0,3,2021-10-22,Male,19,15-19,3
29,1,0,0,1,2021-10-23,Male,17,15-19,5
29,0,1,0,1,2021-10-22,Male,43,35-44,3
29,4,0,0,4,2021-10-24,Male,4,1-4,3
29,1,0,0,1,2021-10-22,Male,65,65-69,8
29,0,0,0,0,2021-10-26,Male,72,70-74,2
29,1,6,0,7,2021-10-22,Female,23,20-24,4
29,0,0,0,0,2021-10-24,Female,60,55-64,3
29,0,0,0,0,2021-10-22,Male,57,55-64,4
29,0,1,0,1,2021-10-22,Female,50,45-54,2
29,1,0,0,1,2021-11-02,Male,59,55-64,1
29,1,2,20,23,2021-10-27,Male,30,25-34,5
29,1,0,0,1,2021-10-24,Male,79,75-79,16
29,0,7,0,7,2021-10-22,Male,46,45-54,3
29,1,0,0,1,2021-10-22,Female,72,70-74,3
29,0,5,0,5,2021-10-22,Male,42,35-44,8
29,0,0,0,0,2021-10-23,Male,64,55-64,9
29,0,0,0,0,2021-10-24,Male,81,80-84,2
29,1,0,0,1,2021-10-22,Female,62,55-64,9
29,1,1,0,2,2021-10-24,Female,64,55-64,2
29,3,0,0,3,2021-10-26,Female,1,1-4,4
29,1,6,0,7,2021-10-26,Female,65,65-69,3
29,2,2,0,4,2021-10-22,Female,12,10-14,3
29,0,2,0,2,2021-11-02,Female,65,65-69,1
29,1,0,0,1,2021-10-23,Male,70,70-74,2
29,1,0,0,1,2021-10-26,Male,73,70-74,2
29,0,0,0,0,2021-10-24,Female,80,80-84,3
29,2,0,0,2,2021-10-22,Female,25,25-34,6
29,2,0,0,2,2021-10-24,Female,60,55-64,12
29,0,1,1,2,2021-10-25,Female,35,35-44,4
29,2,3,0,5,2021-10-22,Female,69,65-69,13
29,5,0,0,5,2021-10-25,Female,60,55-64,2
29,0,2,2,4,2021-10-24,Female,78,75-79,2
29,1,0,0,1,2021-10-29,Female,23,20-24,1
29,0,0,0,0,2021-10-23,Male,59,55-64,2
29,0,2,0,2,2021-10-23,Male,68,65-69,9
29,1,0,0,1,2021-10-28,Male,39,35-44,8
29,0,0,0,0,2021-10-24,Female,38,35-44,8
29,0,0,0,0,2021-10-22,Male,31,25-34,2
29,1,1,0,2,2021-10-23,Male,55,55-64,9
29,0,0,0,0,2021-10-26,Male,65,65-69,4
29,1,0,0,1,2021-10-23,Female,51,45-54,3
29,1,1,0,2,2021-10-27,Male,65,65-69,3
29,0,5,0,5,2021-10-22,Female,55,55-64,2
29,1,3,0,4,2021-10-23,Male,59,55-64,9
29,0,1,0,1,2021-10-23,Male,65,65-69,9
29,1,1,0,2,2021-10-26,Female,41,35-44,21
29,1,0,0,1,2021-10-25,Male,46,45-54,9
29,1,0,0,1,2021-10-26,Male,65,65-69,2
29,0,0,0,0,2021-10-23,Female,33,25-34,4
29,0,4,0,4,2021-10-29,Female,18,15-19,1
29,0,3,0,3,2021-10-22,Male,38,35-44,13
29,0,0,0,0,2021-10-24,Female,5,5-9,14
29,0,1,0,1,2021-10-26,Male,46,45-54,4
29,1,1,0,2,2021-10-26,Male,74,70-74,2
29,1,2,0,3,2021-10-24,Male,61,55-64,3
29,1,0,0,1,2021-11-02,Male,56,55-64,1
29,1,1,0,2,2021-10-22,Male,72,70-74,2
29,0,0,0,0,2021-10-26,Female,65,65-69,3
29,2,0,0,2,2021-10-25,Female,50,45-54,5
29,1,1,0,2,2021-10-23,Male,52,45-54,3
29,1,4,0,5,2021-10-23,Male,78,75-79,7
29,1,0,0,1,2021-10-25,Male,62,55-64,9
29,0,3,0,3,2021-10-23,Male,72,70-74,3
29,0,0,0,0,2021-10-27,Female,67,65-69,22
29,0,0,0,0,2021-11-02,Male,59,55-64,1
29,1,2,0,3,2021-10-26,Female,26,25-34,4
29,0,0,0,0,2021-10-23,Male,63,55-64,3
29,2,5,0,7,2021-10-23,Male,69,65-69,3
29,4,0,0,4,2021-11-02,Female,10,10-14,8
29,2,35,0,37,2021-10-27,Female,14,10-14,22
29,1,3,0,4,2021-10-23,Male,44,35-44,17
29,1,5,0,6,2021-10-24,Male,31,25-34,8
29,1,4,0,5,2021-10-23,Male,81,80-84,2
29,0,0,0,0,2021-10-25,Male,54,45-54,5
29,1,0,0,1,2021-10-22,Female,68,65-69,3
29,1,2,0,3,2021-10-23,Male,65,65-69,2
29,0,0,0,0,2021-10-23,Female,66,65-69,3
29,1,0,0,1,2021-10-29,Female,31,25-34,1
29,0,4,0,4,2021-10-25,Female,59,55-64,3
29,1,0,0,1,2021-10-23,Male,72,70-74,2
29,1,0,0,1,2021-10-23,Male,67,65-69,2
29,2,0,0,2,2021-10-24,Female,48,45-54,9
29,1,0,0,1,2021-10-22,Male,64,55-64,8
29,1,0,0,1,2021-10-23,Female,47,45-54,2
29,0,0,0,0,2021-10-23,Female,60,55-64,2
29,0,3,0,3,2021-10-23,Female,30,25-34,8
29,0,0,0,0,2021-10-22,Female,40,35-44,4
29,0,0,0,0,2021-10-29,Female,31,25-34,3
29,1,0,0,1,2021-10-25,Male,71,70-74,7
29,1,0,0,1,2021-10-22,Male,50,45-54,9
29,1,0,0,1,2021-10-25,Male,66,65-69,8
29,1,0,0,1,2021-10-22,Male,50,45-54,3
29,1,0,0,1,2021-10-26,Male,72,70-74,4
29,0,0,0,0,2021-10-22,Male,73,70-74,3
29,0,1,0,1,2021-10-22,Female,68,65-69,3
29,0,1,0,1,2021-10-24,Female,59,55-64,2
29,1,0,0,1,2021-10-27,Male,80,80-84,4
29,2,0,0,2,2021-10-22,Female,65,65-69,3
29,1,6,0,7,2021-11-02,Female,21,20-24,1
29,1,0,0,1,2021-10-23,Female,71,70-74,3
29,0,0,0,0,2021-11-02,Female,56,55-64,1
29,0,0,0,0,2021-10-22,Male,57,55-64,3
29,1,0,0,1,2021-10-22,Female,10,10-14,2
29,1,0,0,1,2021-10-22,Female,61,55-64,3
29,0,0,0,0,2021-10-25,Female,53,45-54,8
29,0,0,0,0,2021-10-24,Male,58,55-64,2
29,1,1,0,2,2021-10-26,Male,6,5-9,5
29,0,0,0,0,2021-11-02,Female,4,1-4,1
29,0,1,0,1,2021-10-23,Female,44,35-44,8
29,0,2,0,2,2021-10-22,Female,66,65-69,3
29,0,0,0,0,2021-10-24,Female,75,75-79,3
29,1,0,0,1,2021-10-22,Male,60,55-64,2
29,1,1,0,2,2021-10-23,Female,50,45-54,2
29,1,0,0,1,2021-10-25,Male,64,55-64,9
29,2,5,0,7,2021-10-22,Female,32,25-34,3
29,0,0,0,0,2021-10-25,Male,41,35-44,13
29,0,4,0,4,2021-10-22,Male,49,45-54,4
29,0,1,0,1,2021-10-25,Female,43,35-44,3
29,0,2,0,2,2021-10-27,Female,20,20-24,4
29,1,5,3,9,2021-10-22,Male,71,70-74,4
29,0,1,0,1,2021-10-23,Female,53,45-54,2
29,1,0,0,1,2021-10-28,Female,1,1-4,3
29,1,0,0,1,2021-10-22,Male,68,65-69,2
29,1,0,0,1,2021-10-22,Male,59,55-64,8
29,1,0,0,1,2021-10-22,Male,53,45-54,4
29,1,2,0,3,2021-10-25,Male,68,65-69,7
29,1,0,0,1,2021-10-24,Female,28,25-34,7
29,1,0,0,1,2021-10-24,Female,77,75-79,3
29,0,0,0,0,2021-10-22,Male,62,55-64,4
29,1,0,0,1,2021-10-22,Male,44,35-44,5
29,0,2,2,4,2021-11-01,Male,28,25-34,1
29,0,2,0,2,2021-10-25,Male,34,25-34,7
29,1,10,30,41,2021-10-23,Female,32,25-34,2
29,4,0,0,4,2021-10-22,Male,23,20-24,6
29,1,0,0,1,2021-10-24,Male,58,55-64,3
29,1,0,0,1,2021-11-02,Male,45,45-54,1
29,1,0,0,1,2021-10-25,Male,42,35-44,5
29,2,0,0,2,2021-10-25,Male,53,45-54,9
29,0,0,0,0,2021-10-24,Female,3,1-4,16
29,0,0,0,0,2021-10-26,Female,66,65-69,9
29,1,2,0,3,2021-10-22,Female,67,65-69,9
29,0,1,0,1,2021-10-29,Male,29,25-34,1
29,1,0,0,1,2021-10-23,Male,72,70-74,3
29,1,0,0,1,2021-10-23,Female,31,25-34,3
29,1,3,0,4,2021-10-30,Female,20,20-24,1
29,1,0,0,1,2021-10-26,Female,66,65-69,9
29,1,4,0,5,2021-10-22,Female,45,45-54,5
29,1,0,0,1,2021-10-22,Female,12,10-14,20
29,0,1,0,1,2021-11-02,Female,21,20-24,1
29,1,0,0,1,2021-10-23,Male,78,75-79,6
29,2,13,0,15,2021-11-02,Male,13,10-14,1
29,2,1,0,3,2021-10-22,Female,17,15-19,4
29,0,1,0,1,2021-10-23,Female,53,45-54,2
29,0,0,0,0,2021-10-22,Male,35,35-44,19
29,0,0,0,0,2021-10-22,Male,57,55-64,4
29,0,0,0,0,2021-10-22,Male,71,70-74,5
29,1,0,0,1,2021-10-25,Female,64,55-64,18
29,0,4,0,4,2021-10-24,Female,69,65-69,13
29,1,0,0,1,2021-10-22,Female,52,45-54,4
29,1,0,0,1,2021-10-22,Female,61,55-64,9
29,3,1,0,4,2021-10-30,Female,1,1-4,6
29,1,0,0,1,2021-10-22,Female,47,45-54,2
29,0,2,0,2,2021-10-26,Female,65,65-69,3
29,2,1,0,3,2021-10-26,Female,11,10-14,9
29,0,2,0,2,2021-10-25,Female,27,25-34,4
29,0,0,0,0,2021-10-25,Male,45,45-54,9
29,4,0,0,4,2021-10-22,Male,13,10-14,2
29,0,0,0,0,2021-10-24,Male,78,75-79,6
29,2,3,0,5,2021-10-25,Female,1,1-4,9
29,0,0,0,0,2021-10-22,Male,43,35-44,7
29,2,0,0,2,2021-10-22,Male,53,45-54,3
29,3,0,0,3,2021-10-24,Female,5,5-9,7
29,1,0,0,1,2021-10-22,Male,63,55-64,25
29,0,9,0,9,2021-10-22,Male,34,25-34,5
29,0,0,0,0,2021-10-29,Male,25,25-34,1
29,0,2,0,2,2021-10-22,Male,39,35-44,17
29,1,2,0,3,2021-10-23,Male,51,45-54,4
29,0,3,0,3,2021-10-25,Male,67,65-69,3
29,1,0,0,1,2021-10-24,Female,55,55-64,2
29,0,5,10,15,2021-10-26,Female,54,45-54,4
29,1,1,0,2,2021-10-22,Female,66,65-69,8
29,3,16,0,19,2021-10-23,Male,11,10-14,2
29,1,0,0,1,2021-10-24,Female,37,35-44,3
29,2,0,0,2,2021-10-22,Male,60,55-64,3
29,0,1,0,1,2021-10-23,Male,58,55-64,3
29,0,7,0,7,2021-10-23,Female,44,35-44,5
29,1,0,0,1,2021-10-28,Male,67,65-69,2
29,0,3,0,3,2021-10-29,Female,32,25-34,1
29,1,1,100,102,2021-10-24,Male,68,65-69,17
29,0,0,0,0,2021-10-24,Female,53,45-54,5
29,1,0,0,1,2021-10-26,Female,26,25-34,3
29,1,2,0,3,2021-10-23,Male,78,75-79,3
29,2,2,0,4,2021-11-02,Female,0,<1,1
29,2,0,1,3,2021-10-22,Female,49,45-54,2
29,0,0,0,0,2021-10-25,Female,62,55-64,2
29,1,1,0,2,2021-10-23,Male,49,45-54,3
29,0,0,0,0,2021-10-22,Male,75,75-79,12
29,0,0,0,0,2021-10-27,Female,49,45-54,2
29,1,0,0,1,2021-10-24,Female,60,55-64,2
29,3,24,100,127,2021-10-26,Female,14,10-14,2
29,3,7,0,10,2021-10-27,Female,8,5-9,4
29,1,1,0,2,2021-10-22,Female,41,35-44,6
29,1,0,0,1,2021-10-24,Male,62,55-64,3
29,1,0,0,1,2021-10-26,Female,66,65-69,7
29,1,0,0,1,2021-10-22,Female,29,25-34,3
29,1,2,0,3,2021-10-26,Male,56,55-64,4
29,0,0,0,0,2021-10-22,Female,67,65-69,9
29,0,1,0,1,2021-10-25,Female,67,65-69,7
29,1,0,0,1,2021-10-24,Male,60,55-64,2
29,1,1,0,2,2021-10-28,Female,50,45-54,3
29,2,14,0,16,2021-11-01,Female,18,15-19,1
29,4,5,0,9,2021-10-24,Female,1,1-4,2
29,1,1,0,2,2021-10-23,Male,64,55-64,3
29,1,0,0,1,2021-10-23,Male,66,65-69,4
29,1,0,0,1,2021-10-22,Male,62,55-64,2
29,0,5,0,5,2021-10-22,Female,41,35-44,2
29,1,0,0,1,2021-10-23,Male,27,25-34,3
29,1,0,0,1,2021-10-25,Male,51,45-54,7
29,1,0,0,1,2021-10-22,Male,73,70-74,2
29,0,5,0,5,2021-10-27,Male,27,25-34,5
29,3,1,0,4,2021-10-28,Female,21,20-24,3
29,3,1,0,4,2021-10-22,Male,6,5-9,2
29,2,0,0,2,2021-10-22,Female,36,35-44,9
29,3,6,0,9,2021-10-25,Male,21,20-24,2
29,1,0,0,1,2021-10-23,Male,70,70-74,3
29,1,0,0,1,2021-10-23,Male,57,55-64,8
29,1,4,0,5,2021-10-26,Female,28,25-34,8
29,2,0,0,2,2021-10-22,Male,12,10-14,3
29,0,30,0,30,2021-10-25,Female,23,20-24,2
29,1,0,0,1,2021-10-23,Male,65,65-69,14
29,3,0,0,3,2021-10-26,Male,9,5-9,3
29,0,0,0,0,2021-10-25,Male,14,10-14,3
29,0,0,0,0,2021-10-25,Female,67,65-69,5
29,0,0,0,0,2021-10-23,Female,71,70-74,14
29,1,0,0,1,2021-10-22,Female,52,45-54,8
29,0,0,0,0,2021-10-22,Male,72,70-74,3
29,1,0,0,1,2021-10-27,Male,46,45-54,21
29,1,2,0,3,2021-10-23,Male,73,70-74,4
29,2,5,0,7,2021-10-23,Male,2,1-4,6
29,1,2,0,3,2021-10-23,Male,30,25-34,3
29,4,0,0,4,2021-10-24,Male,10,10-14,3
29,1,0,0,1,2021-10-24,Female,33,25-34,4
29,1,0,0,1,2021-10-23,Male,36,35-44,8
29,1,0,0,1,2021-10-25,Female,64,55-64,18
29,1,0,0,1,2021-10-22,Female,32,25-34,6
29,1,0,0,1,2021-10-25,Female,68,65-69,3
29,3,0,0,3,2021-10-22,Male,14,10-14,11
29,0,0,0,0,2021-10-24,Female,28,25-34,3
29,2,0,0,2,2021-10-23,Female,12,10-14,7
29,0,0,0,0,2021-10-24,Male,33,25-34,7
29,0,6,0,6,2021-10-24,Female,60,55-64,2
29,1,4,20,25,2021-10-24,Male,69,65-69,3
29,1,1,0,2,2021-10-23,Male,67,65-69,3
29,1,1,0,2,2021-10-22,Female,54,45-54,7
29,1,0,0,1,2021-10-23,Female,64,55-64,2
29,1,0,0,1,2021-10-24,Female,60,55-64,2
29,2,2,0,4,2021-10-22,Male,16,15-19,3
29,0,0,0,0,2021-10-22,Male,68,65-69,8
29,0,0,0,0,2021-10-22,Male,37,35-44,8
29,0,1,4,5,2021-10-22,Female,70,70-74,3
29,1,0,0,1,2021-10-22,Female,59,55-64,24
29,0,0,0,0,2021-10-22,Female,26,25-34,14
29,0,0,0,0,2021-10-22,Female,72,70-74,2
29,0,0,0,0,2021-10-27,Female,73,70-74,3
29,2,1,0,3,2021-10-22,Female,30,25-34,4
29,1,2,0,3,2021-10-22,Male,80,80-84,3
29,2,15,0,17,2021-10-22,Male,6,5-9,3
29,1,0,0,1,2021-10-22,Male,71,70-74,3
29,1,0,0,1,2021-10-23,Male,70,70-74,9
29,2,5,0,7,2021-10-26,Female,4,1-4,7
29,2,1,0,3,2021-10-31,Female,24,20-24,1
29,1,0,0,1,2021-10-24,Female,72,70-74,7
29,1,1,0,2,2021-10-24,Male,78,75-79,8
29,0,0,0,0,2021-10-22,Female,65,65-69,4
29,0,1,0,1,2021-11-02,Female,59,55-64,1
29,0,0,0,0,2021-10-27,Male,12,10-14,20
29,0,0,0,0,2021-10-26,Female,56,55-64,9
29,0,0,0,0,2021-10-23,Female,67,65-69,2
29,0,0,0,0,2021-10-25,Female,68,65-69,7
29,1,1,0,2,2021-10-24,Male,75,75-79,4
29,0,2,0,2,2021-10-23,Male,51,45-54,9
29,0,0,0,0,2021-10-24,Female,34,25-34,8
29,2,0,0,2,2021-10-26,Male,65,65-69,9
29,0,2,0,2,2021-10-25,Female,46,45-54,2
29,0,0,0,0,2021-10-25,Male,27,25-34,5
29,1,0,0,1,2021-10-22,Female,59,55-64,4
29,0,6,0,6,2021-10-29,Male,32,25-34,1
29,1,0,0,1,2021-10-22,Female,4,1-4,6
29,1,0,0,1,2021-10-28,Male,73,70-74,2
29,0,0,0,0,2021-10-28,Female,33,25-34,2
29,0,0,0,0,2021-10-24,Female,19,15-19,8
29,0,2,0,2,2021-10-26,Female,44,35-44,3
29,0,0,0,0,2021-10-25,Female,68,65-69,13
29,2,1,0,3,2021-10-23,Male,0,<1,7
29,0,0,0,0,2021-10-23,Male,69,65-69,6
29,0,0,0,0,2021-10-25,Female,77,75-79,15
29,3,3,0,6,2021-10-22,Male,10,10-14,9
29,2,2,0,4,2021-10-26,Female,71,70-74,9
29,1,0,0,1,2021-10-25,Female,54,45-54,2
29,1,0,0,1,2021-10-22,Male,71,70-74,3
29,1,17,22,40,2021-10-24,Female,59,55-64,2
29,1,0,0,1,2021-10-24,Male,37,35-44,3
29,2,4,0,6,2021-10-23,Male,40,35-44,7
29,1,0,0,1,2021-10-23,Female,29,25-34,2
29,3,0,0,3,2021-10-22,Male,2,1-4,4
29,1,0,0,1,2021-10-26,Female,55,55-64,3
29,0,4,0,4,2021-10-25,Female,65,65-69,4
29,1,0,0,1,2021-10-31,Male,25,25-34,1
29,0,0,2,2,2021-10-28,Male,20,20-24,2
29,1,0,0,1,2021-10-26,Male,65,65-69,3
29,1,1,0,2,2021-10-23,Female,14,10-14,3
29,1,0,0,1,2021-11-02,Female,47,45-54,1
29,1,0,0,1,2021-10-26,Male,73,70-74,2
29,0,14,100,114,2021-10-24,Female,55,55-64,2
29,1,0,0,1,2021-10-24,Male,75,75-79,2
29,1,0,0,1,2021-10-22,Male,76,75-79,2
29,1,0,0,1,2021-10-23,Male,56,55-64,2
29,1,4,0,5,2021-10-24,Male,76,75-79,8
29,1,0,0,1,2021-10-23,Male,56,55-64,3
29,0,0,0,0,2021-10-22,Male,54,45-54,2
29,1,4,0,5,2021-10-25,Male,66,65-69,8
29,1,10,0,11,2021-10-23,Female,17,15-19,8
29,0,0,0,0,2021-10-25,Male,7,5-9,3
29,0,2,0,2,2021-10-22,Male,47,45-54,5
29,2,17,0,19,2021-10-22,Female,3,1-4,3
29,1,0,0,1,2021-10-24,Male,70,70-74,8
29,3,2,0,5,2021-10-24,Female,1,1-4,7
29,1,2,0,3,2021-10-25,Female,60,55-64,2
29,0,0,0,0,2021-10-26,Female,28,25-34,17
29,2,0,0,2,2021-10-23,Male,49,45-54,23
29,0,6,0,6,2021-10-25,Female,33,25-34,3
29,0,0,0,0,2021-10-24,Male,61,55-64,7
29,1,0,0,1,2021-10-23,Female,64,55-64,7
29,0,3,0,3,2021-10-22,Female,67,65-69,2
29,2,0,0,2,2021-10-26,Female,17,15-19,2
29,0,0,0,0,2021-10-22,Female,79,75-79,9
29,1,0,0,1,2021-10-23,Female,34,25-34,3
29,1,0,0,1,2021-10-26,Female,66,65-69,8
29,2,0,0,2,2021-10-24,Male,68,65-69,17
29,1,5,0,6,2021-10-25,Female,74,70-74,3
29,0,2,0,2,2021-10-26,Male,72,70-74,3
29,1,3,0,4,2021-10-23,Male,71,70-74,3
29,1,0,0,1,2021-10-24,Male,70,70-74,2
29,1,15,0,16,2021-10-23,Female,69,65-69,9
29,0,0,0,0,2021-10-24,Female,51,45-54,2
29,0,0,0,0,2021-10-30,Male,22,20-24,1
29,0,0,0,0,2021-10-22,Female,69,65-69,2
29,0,0,0,0,2021-10-25,Male,40,35-44,7
29,0,1,0,1,2021-10-29,Female,26,25-34,2
29,1,4,0,5,2021-10-25,Female,33,25-34,5
29,0,0,0,0,2021-10-23,Female,67,65-69,3
29,1,0,0,1,2021-10-22,Male,49,45-54,3
29,0,0,0,0,2021-10-22,Male,53,45-54,6
29,0,0,0,0,2021-10-23,Male,53,45-54,9
29,3,20,37,60,2021-11-02,Male,9,5-9,1
29,0,1,0,1,2021-10-25,Female,33,25-34,3
29,0,0,0,0,2021-10-23,Female,51,45-54,9
29,1,0,0,1,2021-10-22,Female,54,45-54,7
29,1,0,0,1,2021-10-22,Female,66,65-69,8
29,3,0,8,11,2021-10-22,Female,14,10-14,2
29,1,3,0,4,2021-10-23,Female,72,70-74,2
29,1,0,0,1,2021-10-24,Male,59,55-64,7
29,1,0,1,2,2021-10-22,Male,14,10-14,3
29,1,5,0,6,2021-11-02,Female,34,25-34,1
29,0,0,0,0,2021-10-25,Male,45,45-54,8
29,1,1,0,2,2021-10-22,Male,74,70-74,3
29,1,0,0,1,2021-10-24,Male,2,1-4,3
29,1,0,0,1,2021-10-23,Male,57,55-64,9
29,1,0,0,1,2021-10-24,Female,32,25-34,13
29,0,0,0,0,2021-10-26,Female,58,55-64,2
29,1,0,0,1,2021-10-25,Male,67,65-69,7
29,1,0,0,1,2021-10-26,Female,52,45-54,2
29,2,0,0,2,2021-10-22,Male,13,10-14,3
29,3,2,0,5,2021-11-02,Female,22,20-24,1
29,1,2,0,3,2021-11-02,Female,26,25-34,1
29,0,9,0,9,2021-10-23,Male,70,70-74,3
29,1,0,0,1,2021-10-24,Female,53,45-54,2
29,1,2,0,3,2021-10-23,Male,74,70-74,3
29,1,0,2,3,2021-10-24,Male,65,65-69,3
29,0,0,0,0,2021-10-23,Male,34,25-34,5
29,0,0,0,0,2021-10-25,Male,46,45-54,9
29,0,0,0,0,2021-10-26,Male,32,25-34,2
29,1,0,0,1,2021-10-24,Male,70,70-74,2
29,3,1,0,4,2021-10-26,Male,7,5-9,6
29,0,0,0,0,2021-10-22,Female,48,45-54,3
29,0,0,0,0,2021-10-23,Male,52,45-54,3
29,1,0,0,1,2021-11-01,Female,18,15-19,1
29,1,0,0,1,2021-10-22,Male,67,65-69,3
29,2,5,0,7,2021-10-26,Male,62,55-64,9
29,1,0,0,1,2021-10-25,Male,30,25-34,4
29,1,0,0,1,2021-10-22,Male,70,70-74,3
29,7,0,0,7,2021-10-29,Male,31,25-34,1
29,0,1,0,1,2021-10-22,Female,40,35-44,2
29,0,0,0,0,2021-10-24,Male,48,45-54,4
29,0,0,0,0,2021-10-24,Female,32,25-34,14
29,2,0,0,2,2021-10-25,Female,16,15-19,2
29,0,0,0,0,2021-10-22,Female,22,20-24,3
29,0,5,0,5,2021-10-22,Female,66,65-69,9
29,2,0,0,2,2021-10-24,Female,80,80-84,22
29,1,0,0,1,2021-10-23,Male,69,65-69,3
29,1,0,0,1,2021-10-26,Male,72,70-74,3
29,4,3,0,7,2021-10-29,Male,24,20-24,6
29,0,0,0,0,2021-10-22,Female,61,55-64,9
29,1,1,0,2,2021-10-25,Female,53,45-54,8
29,0,1,0,1,2021-10-27,Female,71,70-74,2
29,1,0,0,1,2021-10-22,Female,49,45-54,6
29,0,0,4,4,2021-10-28,Male,29,25-34,2
29,0,0,0,0,2021-10-22,Male,27,25-34,4
29,0,1,0,1,2021-10-22,Female,59,55-64,2
29,1,0,0,1,2021-10-25,Female,45,45-54,2
29,0,4,0,4,2021-10-25,Male,67,65-69,17
29,0,0,0,0,2021-10-22,Male,58,55-64,2
29,0,2,0,2,2021-10-22,Male,54,45-54,5
29,1,1,0,2,2021-10-25,Female,52,45-54,4
29,0,31,0,31,2021-10-27,Female,43,35-44,3
29,1,0,0,1,2021-10-26,Male,73,70-74,2
29,0,0,0,0,2021-10-22,Male,44,35-44,4
29,3,0,0,3,2021-10-28,Male,1,1-4,7
29,1,1,0,2,2021-10-22,Female,36,35-44,2
29,1,0,0,1,2021-10-22,Female,57,55-64,3
29,0,0,0,0,2021-10-22,Male,50,45-54,4
29,2,0,0,2,2021-10-25,Male,19,15-19,17
29,1,3,0,4,2021-10-24,Male,82,80-84,2
29,1,8,0,9,2021-10-23,Male,57,55-64,2
29,2,0,0,2,2021-10-23,Female,10,10-14,3
29,0,2,0,2,2021-10-22,Male,49,45-54,3
30,0,0,0,0,2021-11-04,Female,53,45-54,5
30,2,0,0,2,2021-11-04,Female,34,25-34,3
30,2,0,0,2,2021-11-08,Female,0,<1,4
30,1,4,0,5,2021-11-08,Female,27,25-34,3
30,2,1,0,3,2021-11-04,Female,59,55-64,14
30,2,0,0,2,2021-11-03,Male,12,10-14,10
30,0,0,0,0,2021-11-05,Female,73,70-74,3
30,1,0,0,1,2021-11-04,Male,68,65-69,2
30,0,0,0,0,2021-11-04,Male,4,1-4,6
30,2,0,0,2,2021-11-03,Male,65,65-69,10
30,0,0,0,0,2021-11-08,Female,49,45-54,10
30,0,0,0,0,2021-11-03,Male,60,55-64,4
30,2,4,0,6,2021-11-03,Female,23,20-24,2
30,0,0,0,0,2021-11-03,Male,24,20-24,9
30,1,0,0,1,2021-11-04,Male,19,15-19,2
30,1,0,0,1,2021-11-04,Male,34,25-34,6
30,0,13,0,13,2021-11-09,Female,33,25-34,2
30,2,0,0,2,2021-11-04,Female,2,1-4,10
30,1,0,0,1,2021-11-04,Male,70,70-74,2
30,1,0,0,1,2021-11-03,Female,59,55-64,8
30,1,0,0,1,2021-11-08,Female,29,25-34,1
30,1,2,0,3,2021-11-09,Male,71,70-74,10
30,0,0,0,0,2021-11-04,Female,33,25-34,7
30,1,0,0,1,2021-11-04,Male,70,70-74,4
30,0,12,0,12,2021-11-04,Female,42,35-44,4
30,1,0,0,1,2021-11-04,Male,11,10-14,5
30,0,0,0,0,2021-11-04,Male,41,35-44,4
30,1,3,0,4,2021-11-05,Female,57,55-64,2
30,2,0,0,2,2021-11-08,Male,5,5-9,6
30,2,0,0,2,2021-11-03,Female,7,5-9,3
30,2,0,0,2,2021-11-05,Female,58,55-64,9
30,2,1,0,3,2021-11-05,Male,17,15-19,3
30,1,0,0,1,2021-11-08,Female,68,65-69,8
30,1,1,0,2,2021-11-05,Female,74,70-74,3
30,2,10,0,12,2021-11-04,Female,48,45-54,3
30,2,1,0,3,2021-11-04,Female,2,1-4,4
30,1,1,0,2,2021-11-05,Female,54,45-54,5
30,1,1,0,2,2021-11-04,Male,50,45-54,3
30,2,0,0,2,2021-11-04,Female,46,45-54,7
30,1,0,0,1,2021-11-05,Male,82,80-84,4
30,2,1,0,3,2021-11-03,Female,3,1-4,5
30,0,0,0,0,2021-11-05,Female,66,65-69,9
30,0,1,0,1,2021-11-03,Male,51,45-54,9
30,2,1,0,3,2021-11-08,Female,20,20-24,6
30,3,0,0,3,2021-11-03,Female,13,10-14,23
30,0,0,0,0,2021-11-08,Female,41,35-44,8
30,1,0,0,1,2021-11-08,Male,25,25-34,3
30,3,0,0,3,2021-11-04,Male,10,10-14,4
30,3,0,0,3,2021-11-04,Female,55,55-64,8
30,1,1,0,2,2021-11-04,Male,57,55-64,9
30,1,4,0,5,2021-11-08,Male,58,55-64,1
30,0,0,0,0,2021-11-05,Male,20,20-24,2
30,1,0,0,1,2021-11-05,Male,58,55-64,4
30,1,0,0,1,2021-11-04,Male,53,45-54,5
30,1,0,0,1,2021-11-03,Female,57,55-64,10
30,1,0,0,1,2021-11-08,Female,50,45-54,9
30,1,11,0,12,2021-11-04,Male,60,55-64,10
30,0,2,0,2,2021-11-05,Male,50,45-54,7
30,1,2,0,3,2021-11-04,Female,54,45-54,5
30,1,0,0,1,2021-11-08,Male,36,35-44,19
30,0,1,0,1,2021-11-04,Male,54,45-54,21
30,2,0,0,2,2021-11-08,Female,2,1-4,1
30,0,2,0,2,2021-11-08,Female,66,65-69,6
30,0,0,0,0,2021-11-04,Male,56,55-64,4
30,0,0,0,0,2021-11-05,Female,58,55-64,3
30,0,0,0,0,2021-11-03,Male,42,35-44,27
30,0,1,0,1,2021-11-08,Female,79,75-79,9
30,1,1,0,2,2021-11-04,Female,49,45-54,4
30,1,0,0,1,2021-11-08,Female,33,25-34,3
30,1,15,0,16,2021-11-04,Female,9,5-9,2
30,2,0,0,2,2021-11-09,Female,9,5-9,5
30,0,0,0,0,2021-11-03,Female,18,15-19,3
30,0,0,0,0,2021-11-08,Male,85,85+,24
30,0,11,0,11,2021-11-03,Male,37,35-44,4
30,0,0,0,0,2021-11-03,Male,30,25-34,6
30,0,0,0,0,2021-11-09,Female,67,65-69,13
30,1,0,0,1,2021-11-04,Female,33,25-34,6
30,1,0,0,1,2021-11-03,Male,66,65-69,4
30,3,0,0,3,2021-11-04,Male,3,1-4,14
30,0,3,0,3,2021-11-04,Male,54,45-54,15
30,0,1,0,1,2021-11-05,Male,62,55-64,6
30,1,2,0,3,2021-11-08,Male,63,55-64,9
30,0,11,0,11,2021-11-05,Female,40,35-44,4
30,0,0,0,0,2021-11-04,Male,41,35-44,6
30,1,0,0,1,2021-11-04,Female,69,65-69,5
30,0,2,0,2,2021-11-04,Male,62,55-64,3
30,1,17,0,18,2021-11-03,Female,2,1-4,4
30,1,0,0,1,2021-11-04,Male,70,70-74,4
30,1,1,0,2,2021-11-09,Female,54,45-54,2
30,1,0,0,1,2021-11-05,Female,50,45-54,5
30,0,1,0,1,2021-11-08,Male,36,35-44,8
30,0,9,0,9,2021-11-03,Male,61,55-64,4
30,0,0,0,0,2021-11-03,Female,71,70-74,4
30,5,0,0,5,2021-11-03,Male,19,15-19,2
30,1,0,0,1,2021-11-05,Female,45,45-54,5
30,1,0,0,1,2021-11-03,Female,51,45-54,3
30,2,0,0,2,2021-11-04,Female,15,15-19,8
30,0,0,0,0,2021-11-08,Male,76,75-79,4
30,1,0,0,1,2021-11-08,Female,14,10-14,8
30,0,0,0,0,2021-11-08,Female,78,75-79,4
30,0,0,0,0,2021-11-08,Male,53,45-54,24
30,1,0,0,1,2021-11-04,Female,39,35-44,9
30,0,1,0,1,2021-11-08,Female,39,35-44,8
30,0,0,0,0,2021-11-09,Male,68,65-69,4
30,1,0,0,1,2021-11-03,Male,11,10-14,2
30,0,0,0,0,2021-11-08,Male,61,55-64,10
30,3,0,0,3,2021-11-03,Female,18,15-19,7
30,1,0,0,1,2021-11-08,Male,68,65-69,3
30,0,0,0,0,2021-11-08,Female,51,45-54,2
30,2,3,0,5,2021-11-04,Female,52,45-54,4
30,0,1,0,1,2021-11-03,Female,56,55-64,9
30,0,0,0,0,2021-11-04,Female,34,25-34,3
30,0,12,0,12,2021-11-03,Male,43,35-44,8
30,1,0,0,1,2021-11-03,Male,39,35-44,9
30,1,0,0,1,2021-11-08,Female,53,45-54,2
30,1,0,0,1,2021-11-08,Female,72,70-74,9
30,0,0,0,0,2021-11-04,Female,61,55-64,17
30,2,0,0,2,2021-11-09,Female,73,70-74,4
30,1,3,0,4,2021-11-08,Male,75,75-79,3
30,1,1,0,2,2021-11-03,Male,67,65-69,8
30,1,0,0,1,2021-11-05,Male,62,55-64,2
30,0,0,4,4,2021-11-08,Female,22,20-24,7
30,0,0,0,0,2021-11-09,Female,85,85+,2
30,2,2,0,4,2021-11-04,Female,62,55-64,3
30,0,4,0,4,2021-11-04,Male,27,25-34,2
30,0,5,0,5,2021-11-08,Female,78,75-79,23
30,0,0,0,0,2021-11-03,Male,33,25-34,6
30,1,0,0,1,2021-11-08,Female,64,55-64,4
30,1,0,0,1,2021-11-08,Male,77,75-79,3
30,0,0,0,0,2021-11-08,Female,26,25-34,1
30,2,0,0,2,2021-11-08,Female,31,25-34,1
30,2,0,0,2,2021-11-08,Male,67,65-69,8
30,0,0,0,0,2021-11-03,Male,25,25-34,2
30,0,0,0,0,2021-11-04,Female,53,45-54,17
30,2,1,0,3,2021-11-04,Male,6,5-9,3
30,0,4,4,8,2021-11-03,Male,69,65-69,4
30,1,0,0,1,2021-11-03,Female,47,45-54,2
30,1,0,0,1,2021-11-08,Female,43,35-44,4
30,0,2,0,2,2021-11-03,Male,71,70-74,4
30,0,0,0,0,2021-11-04,Female,65,65-69,4
30,1,2,0,3,2021-11-03,Male,59,55-64,2
30,0,0,0,0,2021-11-08,Female,78,75-79,6
30,1,2,0,3,2021-11-04,Female,61,55-64,3
30,1,0,0,1,2021-11-09,Female,67,65-69,4
30,0,0,0,0,2021-11-08,Female,21,20-24,1
30,0,0,0,0,2021-11-09,Female,20,20-24,12
30,1,0,0,1,2021-11-08,Male,68,65-69,4
30,0,0,0,0,2021-11-08,Male,56,55-64,9
30,2,0,0,2,2021-11-04,Female,56,55-64,3
30,1,0,0,1,2021-11-04,Female,61,55-64,9
30,1,4,0,5,2021-11-08,Female,44,35-44,2
30,0,0,0,0,2021-11-05,Male,73,70-74,10
30,1,0,0,1,2021-11-05,Female,50,45-54,4
30,1,0,0,1,2021-11-04,Female,28,25-34,10
30,1,3,0,4,2021-11-04,Male,30,25-34,2
30,1,0,0,1,2021-11-03,Female,32,25-34,2
30,2,0,0,2,2021-11-08,Male,2,1-4,1
30,2,0,0,2,2021-11-05,Male,65,65-69,9
30,4,0,0,4,2021-11-03,Female,1,1-4,11
30,0,0,0,0,2021-11-09,Female,36,35-44,6
30,0,0,0,0,2021-11-03,Male,70,70-74,18
30,3,0,0,3,2021-11-03,Male,10,10-14,4
30,0,0,0,0,2021-11-08,Female,56,55-64,3
30,1,2,0,3,2021-11-08,Male,78,75-79,3
30,0,3,0,3,2021-11-04,Female,54,45-54,10
30,0,6,0,6,2021-11-08,Male,73,70-74,3
30,0,0,0,0,2021-11-04,Male,33,25-34,9
30,1,0,0,1,2021-11-04,Female,58,55-64,10
30,2,1,5,8,2021-11-05,Male,55,55-64,2
30,1,0,0,1,2021-11-08,Female,72,70-74,8
30,2,2,0,4,2021-11-08,Male,4,1-4,4
30,2,0,0,2,2021-11-04,Male,11,10-14,9
30,0,0,0,0,2021-11-05,Female,76,75-79,10
30,0,0,0,0,2021-11-03,Male,58,55-64,4
30,1,0,0,1,2021-11-08,Male,68,65-69,4
30,4,0,0,4,2021-11-03,Female,4,1-4,21
30,0,0,0,0,2021-11-04,Female,28,25-34,7
30,0,0,0,0,2021-11-08,Female,19,15-19,3
30,3,0,0,3,2021-11-08,Male,15,15-19,24
30,1,0,0,1,2021-11-08,Male,32,25-34,18
30,0,0,0,0,2021-11-09,Male,66,65-69,5
30,0,1,0,1,2021-11-08,Male,70,70-74,20
30,0,5,0,5,2021-11-08,Female,19,15-19,1
30,3,0,0,3,2021-11-08,Female,10,10-14,3
30,1,0,0,1,2021-11-09,Male,77,75-79,2
30,1,0,0,1,2021-11-03,Male,44,35-44,5
30,1,18,0,19,2021-11-09,Male,60,55-64,8
30,0,13,0,13,2021-11-04,Female,27,25-34,6
30,0,0,0,0,2021-11-04,Female,73,70-74,3
30,1,0,0,1,2021-11-04,Male,72,70-74,4
30,0,0,0,0,2021-11-04,Female,3,1-4,4
30,1,0,2,3,2021-11-08,Female,28,25-34,1
30,2,4,0,6,2021-11-03,Male,30,25-34,2
30,2,0,0,2,2021-11-05,Male,63,55-64,9
30,1,2,0,3,2021-11-03,Male,21,20-24,4
30,2,0,0,2,2021-11-08,Female,17,15-19,3
30,2,0,0,2,2021-11-08,Male,35,35-44,8
30,0,1,0,1,2021-11-04,Female,28,25-34,13
30,2,0,35,37,2021-11-04,Male,12,10-14,6
30,0,1,0,1,2021-11-03,Female,33,25-34,3
30,0,0,0,0,2021-11-03,Female,5,5-9,4
30,3,0,0,3,2021-11-04,Female,53,45-54,5
30,0,0,0,0,2021-11-04,Female,31,25-34,18
30,0,0,0,0,2021-11-03,Female,22,20-24,3
30,1,2,0,3,2021-11-03,Male,33,25-34,2
30,1,0,0,1,2021-11-08,Male,71,70-74,3
30,1,0,0,1,2021-11-04,Male,32,25-34,2
30,1,0,0,1,2021-11-03,Female,61,55-64,9
30,3,0,0,3,2021-11-08,Female,8,5-9,2
30,2,0,0,2,2021-11-08,Female,23,20-24,4
30,1,0,0,1,2021-11-04,Male,52,45-54,9
30,0,2,0,2,2021-11-05,Female,31,25-34,3
30,0,1,0,1,2021-11-04,Male,55,55-64,3
30,1,0,12,13,2021-11-05,Female,55,55-64,3
30,1,1,0,2,2021-11-04,Male,55,55-64,7
30,2,0,0,2,2021-11-05,Female,28,25-34,10
30,2,0,0,2,2021-11-03,Male,8,5-9,2
30,2,0,0,2,2021-11-08,Female,0,<1,3
30,0,0,0,0,2021-11-04,Male,30,25-34,16
30,3,0,0,3,2021-11-08,Male,12,10-14,4
30,1,0,0,1,2021-11-09,Male,70,70-74,3
30,1,0,0,1,2021-11-08,Male,73,70-74,2
30,1,0,0,1,2021-11-09,Male,69,65-69,10
30,1,2,0,3,2021-11-04,Male,13,10-14,3
30,1,0,0,1,2021-11-04,Male,35,35-44,3
30,1,5,0,6,2021-11-08,Male,74,70-74,5
30,0,1,0,1,2021-11-04,Male,54,45-54,4
30,0,3,0,3,2021-11-08,Male,82,80-84,3
30,2,0,0,2,2021-11-05,Male,62,55-64,2
30,0,0,0,0,2021-11-04,Male,67,65-69,4
30,1,6,0,7,2021-11-04,Female,21,20-24,3
30,0,3,0,3,2021-11-04,Male,47,45-54,9
30,1,0,0,1,2021-11-04,Female,28,25-34,3
30,1,0,0,1,2021-11-09,Female,68,65-69,10
30,1,2,0,3,2021-11-09,Female,63,55-64,22
30,1,0,0,1,2021-11-05,Female,65,65-69,4
30,1,0,0,1,2021-11-07,Male,35,35-44,3
30,0,6,0,6,2021-11-08,Female,42,35-44,3
30,0,0,0,0,2021-11-08,Female,44,35-44,7
30,3,0,0,3,2021-11-09,Female,56,55-64,3
30,0,0,0,0,2021-11-04,Female,30,25-34,3
30,0,0,0,0,2021-11-04,Male,65,65-69,6
30,3,0,0,3,2021-11-08,Female,18,15-19,1
30,0,0,0,0,2021-11-05,Male,34,25-34,4
30,0,0,0,0,2021-11-04,Male,30,25-34,5
30,1,1,0,2,2021-11-04,Male,8,5-9,3
30,1,1,0,2,2021-11-03,Male,61,55-64,8
30,0,0,10,10,2021-11-03,Female,45,45-54,5
30,2,0,0,2,2021-11-05,Female,2,1-4,5
30,0,0,0,0,2021-11-04,Male,70,70-74,23
30,0,2,0,2,2021-11-03,Female,85,85+,3
30,1,2,0,3,2021-11-04,Male,27,25-34,2
30,1,0,0,1,2021-11-04,Male,65,65-69,6
30,1,0,0,1,2021-11-03,Male,64,55-64,5
30,0,1,0,1,2021-11-04,Female,54,45-54,13
30,1,0,0,1,2021-11-08,Male,68,65-69,3
30,3,0,0,3,2021-11-08,Female,17,15-19,20
30,1,0,0,1,2021-11-05,Male,65,65-69,2
30,0,30,0,30,2021-11-04,Male,53,45-54,6
30,1,0,0,1,2021-11-05,Male,57,55-64,4
30,0,1,0,1,2021-11-08,Female,66,65-69,5
30,4,0,0,4,2021-11-08,Female,16,15-19,3
30,3,1,0,4,2021-11-08,Female,19,15-19,9
30,1,0,0,1,2021-11-03,Female,67,65-69,3
30,1,5,0,6,2021-11-05,Male,40,35-44,10
30,0,0,0,0,2021-11-03,Male,60,55-64,8
30,3,0,0,3,2021-11-09,Male,0,<1,8
30,0,4,0,4,2021-11-09,Female,71,70-74,2
30,0,0,0,0,2021-11-08,Male,31,25-34,1
30,0,1,0,1,2021-11-04,Male,42,35-44,11
30,1,0,0,1,2021-11-04,Female,54,45-54,10
30,0,0,0,0,2021-11-09,Female,69,65-69,5
30,1,0,0,1,2021-11-04,Male,74,70-74,8
30,1,0,0,1,2021-11-04,Female,69,65-69,4
30,1,2,0,3,2021-11-04,Male,43,35-44,7
30,0,0,0,0,2021-11-03,Female,34,25-34,6
30,1,0,0,1,2021-11-04,Male,50,45-54,9
30,1,2,0,3,2021-11-08,Male,57,55-64,21
30,0,0,0,0,2021-11-04,Male,55,55-64,2
30,0,0,0,0,2021-11-08,Female,34,25-34,1
30,1,0,0,1,2021-11-08,Male,6,5-9,1
30,0,2,0,2,2021-11-04,Male,60,55-64,4
30,1,8,0,9,2021-11-05,Male,50,45-54,5
30,1,0,0,1,2021-11-04,Female,61,55-64,3
30,0,0,0,0,2021-11-08,Female,28,25-34,1
30,1,4,0,5,2021-11-09,Male,41,35-44,2
30,1,0,0,1,2021-11-08,Male,24,20-24,13
30,1,0,0,1,2021-11-04,Female,65,65-69,10
30,0,0,0,0,2021-11-03,Female,51,45-54,12
30,0,10,0,10,2021-11-03,Female,43,35-44,7
30,3,11,0,14,2021-11-08,Male,13,10-14,4
30,1,6,0,7,2021-11-03,Female,34,25-34,4
30,0,1,0,1,2021-11-03,Male,68,65-69,5
30,1,0,0,1,2021-11-05,Female,40,35-44,3
30,2,0,0,2,2021-11-09,Female,24,20-24,1
30,1,0,0,1,2021-11-08,Female,53,45-54,4
30,0,1,0,1,2021-11-04,Female,81,80-84,8
30,2,10,0,12,2021-11-09,Female,47,45-54,3
30,0,8,0,8,2021-11-04,Male,58,55-64,5
30,2,0,0,2,2021-11-03,Male,68,65-69,3
30,2,2,0,4,2021-11-03,Male,53,45-54,2
30,1,0,0,1,2021-11-04,Female,30,25-34,4
30,0,5,0,5,2021-11-08,Female,77,75-79,2
30,2,0,0,2,2021-11-08,Male,7,5-9,1
30,1,0,0,1,2021-11-08,Female,61,55-64,3
30,0,0,0,0,2021-11-04,Male,49,45-54,6
30,0,0,0,0,2021-11-03,Male,31,25-34,7
30,2,1,0,3,2021-11-03,Male,67,65-69,2
30,1,0,0,1,2021-11-09,Male,66,65-69,3
30,3,1,0,4,2021-11-05,Male,11,10-14,2
30,0,0,0,0,2021-11-09,Male,46,45-54,6
30,1,0,0,1,2021-11-09,Male,73,70-74,4
30,0,10,64,74,2021-11-09,Male,41,35-44,3
30,1,0,0,1,2021-11-08,Male,64,55-64,8
30,0,0,0,0,2021-11-09,Male,72,70-74,8
30,1,0,0,1,2021-11-04,Male,64,55-64,9
30,1,0,0,1,2021-11-03,Male,45,45-54,8
30,1,1,0,2,2021-11-08,Male,74,70-74,3
30,0,2,0,2,2021-11-04,Male,77,75-79,3
30,1,6,0,7,2021-11-08,Female,68,65-69,8
30,0,2,0,2,2021-11-03,Male,60,55-64,8
30,1,1,0,2,2021-11-03,Female,33,25-34,2
30,2,0,0,2,2021-11-08,Female,8,5-9,1
30,1,0,0,1,2021-11-04,Male,74,70-74,2
30,1,0,0,1,2021-11-03,Female,70,70-74,2
30,1,0,0,1,2021-11-04,Female,53,45-54,3
30,0,0,0,0,2021-11-04,Male,59,55-64,2
30,0,0,0,0,2021-11-08,Female,67,65-69,4
30,2,0,0,2,2021-11-04,Male,54,45-54,4
30,1,0,0,1,2021-11-04,Female,65,65-69,8
30,2,0,0,2,2021-11-03,Female,22,20-24,13
30,1,0,0,1,2021-11-09,Male,77,75-79,6
30,0,2,0,2,2021-11-04,Female,46,45-54,3
30,2,0,0,2,2021-11-03,Male,10,10-14,7
30,2,3,0,5,2021-11-04,Male,52,45-54,4
30,1,2,0,3,2021-11-08,Female,72,70-74,8
30,0,0,0,0,2021-11-09,Female,66,65-69,11
30,0,7,0,7,2021-11-04,Male,57,55-64,3
30,4,0,0,4,2021-11-04,Male,8,5-9,7
30,2,0,0,2,2021-11-05,Male,6,5-9,5
30,3,1,0,4,2021-11-04,Female,26,25-34,3
30,2,0,0,2,2021-11-04,Male,32,25-34,2
30,1,1,0,2,2021-11-04,Male,7,5-9,4
30,1,4,0,5,2021-11-03,Male,27,25-34,2
30,3,0,0,3,2021-11-08,Male,19,15-19,5
30,0,0,0,0,2021-11-04,Male,49,45-54,4
30,1,1,0,2,2021-11-08,Male,72,70-74,4
30,1,0,0,1,2021-11-03,Female,37,35-44,6
30,0,1,0,1,2021-11-03,Female,24,20-24,4
30,1,0,10,11,2021-11-08,Female,54,45-54,2
30,1,1,1,3,2021-11-09,Male,78,75-79,2
30,0,2,0,2,2021-11-05,Female,70,70-74,4
30,3,1,0,4,2021-11-04,Female,19,15-19,5
30,0,0,0,0,2021-11-03,Male,53,45-54,4
30,1,1,0,2,2021-11-05,Female,62,55-64,3
30,0,0,0,0,2021-11-04,Male,23,20-24,10
30,0,1,0,1,2021-11-04,Male,55,55-64,3
30,1,1,0,2,2021-11-03,Female,73,70-74,2
30,0,0,0,0,2021-11-08,Female,50,45-54,3
30,0,0,0,0,2021-11-04,Female,8,5-9,2
30,0,0,0,0,2021-11-03,Male,34,25-34,7
30,0,1,0,1,2021-11-03,Male,69,65-69,5
30,1,1,0,2,2021-11-08,Male,73,70-74,2
30,1,4,0,5,2021-11-03,Male,1,1-4,2
30,0,0,0,0,2021-11-04,Female,55,55-64,3
30,0,1,0,1,2021-11-08,Male,33,25-34,1
30,1,0,0,1,2021-11-08,Female,54,45-54,5
30,0,0,0,0,2021-11-04,Male,18,15-19,10
30,0,1,0,1,2021-11-09,Male,75,75-79,2
30,1,1,0,2,2021-11-04,Female,51,45-54,3
30,2,2,0,4,2021-11-04,Female,0,<1,6
30,1,9,0,10,2021-11-08,Female,22,20-24,1
30,1,0,0,1,2021-11-08,Male,75,75-79,6
30,2,0,0,2,2021-11-04,Female,59,55-64,9
30,1,15,21,37,2021-11-05,Female,6,5-9,19
30,0,4,0,4,2021-11-05,Female,62,55-64,4
30,0,0,0,0,2021-11-08,Male,72,70-74,3
30,1,0,0,1,2021-11-09,Male,70,70-74,3
30,0,3,0,3,2021-11-04,Male,54,45-54,3
30,0,0,0,0,2021-11-03,Male,34,25-34,9
30,0,0,0,0,2021-11-04,Male,43,35-44,8
30,3,0,0,3,2021-11-09,Female,13,10-14,3
30,2,0,0,2,2021-11-08,Male,18,15-19,1
30,1,0,0,1,2021-11-08,Male,75,75-79,4
30,0,0,0,0,2021-11-03,Female,21,20-24,5
30,3,15,0,18,2021-11-04,Female,15,15-19,4
30,0,0,0,0,2021-11-04,Male,42,35-44,4
30,0,0,0,0,2021-11-03,Female,48,45-54,5
30,2,3,0,5,2021-11-04,Male,56,55-64,8
30,2,0,0,2,2021-11-05,Male,17,15-19,10
30,0,0,0,0,2021-11-03,Female,29,25-34,4
30,0,0,0,0,2021-11-08,Male,70,70-74,4
30,0,1,0,1,2021-11-08,Female,73,70-74,5
30,0,10,0,10,2021-11-05,Male,62,55-64,20
30,0,0,0,0,2021-11-03,Male,39,35-44,5
30,1,0,0,1,2021-11-04,Male,69,65-69,5
30,1,0,0,1,2021-11-04,Female,1,1-4,10
30,0,0,0,0,2021-11-05,Male,63,55-64,5
30,2,21,0,23,2021-11-04,Male,8,5-9,3
30,0,0,0,0,2021-11-03,Male,34,25-34,2
30,3,0,0,3,2021-11-03,Male,10,10-14,5
30,0,0,0,0,2021-11-04,Female,37,35-44,4
30,0,3,0,3,2021-11-04,Male,28,25-34,9
30,1,0,0,1,2021-11-08,Female,83,80-84,5
30,1,0,0,1,2021-11-08,Female,70,70-74,4
30,0,0,0,0,2021-11-09,Female,58,55-64,5
30,0,0,0,0,2021-11-08,Male,63,55-64,3
30,1,3,0,4,2021-11-04,Female,45,45-54,6
30,1,0,0,1,2021-11-04,Female,56,55-64,10
30,0,0,0,0,2021-11-08,Male,45,45-54,18
30,1,0,0,1,2021-11-04,Female,56,55-64,3
30,0,8,0,8,2021-11-08,Male,70,70-74,10
30,0,0,0,0,2021-11-04,Female,60,55-64,3
30,1,0,0,1,2021-11-03,Male,29,25-34,9
30,1,0,0,1,2021-11-09,Male,61,55-64,15
30,0,2,0,2,2021-11-08,Male,13,10-14,3
30,0,0,0,0,2021-11-04,Female,23,20-24,4
30,2,62,31,95,2021-11-04,Female,2,1-4,2
30,1,2,0,3,2021-11-04,Female,22,20-24,6
30,1,6,0,7,2021-11-08,Female,66,65-69,3
30,0,0,4,4,2021-11-04,Male,73,70-74,3
30,0,1,100,101,2021-11-08,Female,48,45-54,2
30,1,0,0,1,2021-11-05,Male,62,55-64,4
30,1,1,0,2,2021-11-08,Male,72,70-74,3
30,0,0,0,0,2021-11-09,Female,75,75-79,6
30,1,1,0,2,2021-11-08,Male,32,25-34,2
30,1,2,2,5,2021-11-09,Female,71,70-74,9
30,2,0,0,2,2021-11-04,Male,9,5-9,5
30,0,1,0,1,2021-11-08,Female,59,55-64,4
30,0,0,0,0,2021-11-04,Female,64,55-64,3
30,1,0,0,1,2021-11-09,Male,75,75-79,4
30,0,0,0,0,2021-11-03,Male,51,45-54,4
30,4,0,0,4,2021-11-03,Female,11,10-14,7
30,0,1,0,1,2021-11-09,Female,42,35-44,5
30,0,1,0,1,2021-11-04,Male,55,55-64,3
30,0,11,0,11,2021-11-08,Male,73,70-74,3
30,0,0,0,0,2021-11-05,Female,62,55-64,3
30,1,1,0,2,2021-11-03,Female,69,65-69,5
30,0,3,0,3,2021-11-03,Male,31,25-34,2
30,1,3,0,4,2021-11-08,Female,21,20-24,1
30,1,9,0,10,2021-11-04,Female,41,35-44,2
30,2,1,0,3,2021-11-08,Female,43,35-44,4
30,1,0,0,1,2021-11-03,Male,74,70-74,4
30,2,12,0,14,2021-11-04,Female,54,45-54,4
30,1,7,0,8,2021-11-05,Male,66,65-69,9
30,0,6,0,6,2021-11-08,Male,41,35-44,4
30,1,1,0,2,2021-11-09,Female,65,65-69,3
30,0,0,0,0,2021-11-04,Female,58,55-64,3
30,1,0,0,1,2021-11-04,Male,4,1-4,14
30,1,0,0,1,2021-11-08,Male,69,65-69,19
30,1,40,0,41,2021-11-04,Female,32,25-34,3
30,1,0,0,1,2021-11-04,Female,37,35-44,5
30,3,0,0,3,2021-11-04,Male,12,10-14,2
30,0,0,0,0,2021-11-05,Male,69,65-69,4
30,0,1,0,1,2021-11-03,Female,74,70-74,5
30,1,0,0,1,2021-11-04,Male,12,10-14,9
30,2,7,0,9,2021-11-04,Male,66,65-69,3
30,1,0,0,1,2021-11-04,Male,43,35-44,9
30,0,1,0,1,2021-11-09,Female,27,25-34,3
30,0,0,0,0,2021-11-08,Male,77,75-79,17
30,0,1,0,1,2021-11-08,Male,35,35-44,5
30,0,0,0,0,2021-11-03,Female,69,65-69,5
30,0,1,0,1,2021-11-08,Male,71,70-74,4
30,0,1,0,1,2021-11-04,Female,28,25-34,4
30,0,0,0,0,2021-11-04,Female,71,70-74,20
30,1,0,0,1,2021-11-03,Female,18,15-19,2
30,2,15,1,18,2021-11-03,Female,4,1-4,3
30,0,0,0,0,2021-11-04,Female,49,45-54,3
30,1,2,0,3,2021-11-03,Male,66,65-69,7
30,0,0,0,0,2021-11-08,Male,40,35-44,4
30,1,2,0,3,2021-11-04,Male,54,45-54,4
30,1,9,0,10,2021-11-08,Male,71,70-74,2
30,0,0,0,0,2021-11-08,Male,41,35-44,3
30,2,2,0,4,2021-11-04,Female,55,55-64,3
30,0,0,0,0,2021-11-09,Male,17,15-19,13
30,1,0,0,1,2021-11-04,Female,18,15-19,6
30,4,0,0,4,2021-11-08,Male,0,<1,4
30,0,1,0,1,2021-11-03,Female,31,25-34,9
30,1,0,0,1,2021-11-08,Male,35,35-44,9
30,2,0,0,2,2021-11-04,Male,6,5-9,2
30,0,0,0,0,2021-11-08,Female,45,45-54,4
30,1,2,0,3,2021-11-08,Male,77,75-79,2
30,3,0,0,3,2021-11-03,Female,4,1-4,2
30,1,1,1,3,2021-11-04,Male,63,55-64,4
30,2,0,0,2,2021-11-04,Female,66,65-69,2
30,0,0,0,0,2021-11-09,Female,50,45-54,9
30,2,0,0,2,2021-11-03,Female,42,35-44,9
30,0,2,0,2,2021-11-04,Female,54,45-54,3
30,1,4,0,5,2021-11-08,Male,23,20-24,1
30,1,0,0,1,2021-11-04,Male,65,65-69,3
30,1,0,0,1,2021-11-04,Female,53,45-54,3
30,1,0,0,1,2021-11-05,Male,58,55-64,10
30,1,1,0,2,2021-11-08,Male,71,70-74,3
30,1,2,0,3,2021-11-04,Female,58,55-64,4
30,0,2,0,2,2021-11-04,Female,54,45-54,10
30,0,0,0,0,2021-11-04,Male,65,65-69,9
30,0,1,0,1,2021-11-04,Male,52,45-54,7
30,1,2,0,3,2021-11-03,Male,56,55-64,9
30,1,0,0,1,2021-11-05,Female,68,65-69,5
30,2,0,0,2,2021-11-08,Male,5,5-9,4
30,0,0,0,0,2021-11-04,Male,28,25-34,2
30,3,2,0,5,2021-11-03,Female,51,45-54,4
30,0,0,0,0,2021-11-09,Male,73,70-74,7
30,0,0,0,0,2021-11-04,Male,56,55-64,4
30,1,0,0,1,2021-11-05,Female,72,70-74,9
30,1,0,0,1,2021-11-08,Male,70,70-74,4
30,0,0,0,0,2021-11-03,Female,59,55-64,20
30,1,0,0,1,2021-11-03,Male,59,55-64,9
30,2,3,0,5,2021-11-08,Male,60,55-64,13
30,0,6,0,6,2021-11-08,Female,32,25-34,1
30,1,10,4,15,2021-11-03,Male,66,65-69,6
30,1,0,0,1,2021-11-04,Male,52,45-54,3
30,1,0,0,1,2021-11-05,Female,35,35-44,18
30,1,0,0,1,2021-11-05,Male,63,55-64,6
30,0,0,0,0,2021-11-08,Female,46,45-54,9
30,2,0,0,2,2021-11-08,Female,52,45-54,7
30,1,3,0,4,2021-11-04,Female,60,55-64,5
30,1,0,0,1,2021-11-04,Male,72,70-74,10
30,0,0,0,0,2021-11-04,Female,24,20-24,23
30,1,1,0,2,2021-11-04,Female,45,45-54,6
30,0,0,0,0,2021-11-03,Female,53,45-54,3
30,4,0,0,4,2021-11-04,Male,10,10-14,3
30,1,0,0,1,2021-11-08,Male,72,70-74,6
30,2,0,0,2,2021-11-03,Female,0,<1,9
30,1,0,0,1,2021-11-09,Male,23,20-24,17
30,2,0,0,2,2021-11-04,Female,68,65-69,3
30,1,0,0,1,2021-11-08,Male,31,25-34,1
30,1,1,0,2,2021-11-04,Female,41,35-44,9
30,2,1,0,3,2021-11-04,Male,0,<1,4
30,0,3,0,3,2021-11-08,Male,39,35-44,5
30,1,0,0,1,2021-11-03,Female,54,45-54,9
30,4,0,0,4,2021-11-05,Male,59,55-64,3
30,0,0,0,0,2021-11-04,Male,53,45-54,10
30,1,0,0,1,2021-11-03,Male,46,45-54,5
30,1,2,0,3,2021-11-08,Male,68,65-69,2
30,1,0,0,1,2021-11-09,Male,68,65-69,4
30,2,3,9,14,2021-11-04,Male,69,65-69,11
30,1,1,0,2,2021-11-03,Male,57,55-64,4
30,2,0,0,2,2021-11-05,Female,15,15-19,6
30,0,0,0,0,2021-11-09,Male,80,80-84,9
30,0,0,0,0,2021-11-09,Female,43,35-44,2
30,1,1,0,2,2021-11-08,Female,66,65-69,8
30,1,3,0,4,2021-11-08,Male,3,1-4,2
30,1,0,0,1,2021-11-05,Female,68,65-69,7
30,0,1,0,1,2021-11-04,Male,65,65-69,4
30,0,0,0,0,2021-11-04,Female,65,65-69,8
30,1,0,0,1,2021-11-05,Male,63,55-64,4
30,2,0,0,2,2021-11-04,Female,27,25-34,20
30,1,0,0,1,2021-11-03,Male,74,70-74,2
30,1,3,4,8,2021-11-08,Female,29,25-34,1
30,0,0,0,0,2021-11-04,Female,5,5-9,6
30,1,0,0,1,2021-11-04,Male,58,55-64,4
30,1,1,0,2,2021-11-04,Male,54,45-54,7
30,2,1,0,3,2021-11-03,Male,67,65-69,3
30,3,0,0,3,2021-11-03,Male,1,1-4,2
30,0,0,0,0,2021-11-05,Male,69,65-69,4
30,0,1,0,1,2021-11-05,Female,5,5-9,5
30,1,0,0,1,2021-11-04,Male,58,55-64,6
30,1,0,0,1,2021-11-05,Female,27,25-34,3
30,1,3,0,4,2021-11-09,Female,53,45-54,2
30,1,0,0,1,2021-11-08,Male,70,70-74,25
30,0,7,0,7,2021-11-09,Female,42,35-44,3
30,0,0,0,0,2021-11-08,Male,73,70-74,2
30,1,0,0,1,2021-11-04,Male,59,55-64,10
30,4,3,0,7,2021-11-05,Female,2,1-4,3
30,1,0,0,1,2021-11-04,Female,7,5-9,4
30,1,2,43,46,2021-11-05,Male,69,65-69,2
30,1,0,0,1,2021-11-04,Female,26,25-34,3
30,1,2,0,3,2021-11-08,Male,28,25-34,2
30,1,1,0,2,2021-11-04,Female,41,35-44,3
30,2,5,5,12,2021-11-04,Male,1,1-4,9
30,1,0,0,1,2021-11-08,Male,75,75-79,4
30,1,3,1,5,2021-11-04,Female,5,5-9,3
30,0,0,0,0,2021-11-04,Male,57,55-64,5
30,1,0,0,1,2021-11-05,Female,66,65-69,7
30,0,0,0,0,2021-11-04,Female,52,45-54,3
30,0,1,0,1,2021-11-05,Female,58,55-64,3
30,0,0,1,1,2021-11-08,Male,52,45-54,4
30,3,0,0,3,2021-11-04,Female,18,15-19,3
30,1,0,0,1,2021-11-03,Male,52,45-54,5
30,0,0,0,0,2021-11-03,Male,27,25-34,4
30,1,3,0,4,2021-11-08,Female,52,45-54,3
30,2,0,0,2,2021-11-08,Female,67,65-69,21
30,3,20,0,23,2021-11-04,Female,18,15-19,4
30,1,0,0,1,2021-11-05,Male,58,55-64,7
30,0,0,0,0,2021-11-03,Female,62,55-64,2
30,0,0,0,0,2021-11-09,Female,66,65-69,4
30,0,3,0,3,2021-11-08,Male,24,20-24,1
30,0,0,0,0,2021-11-04,Female,71,70-74,10
30,0,0,0,0,2021-11-04,Female,31,25-34,3
30,1,1,1,3,2021-11-08,Female,46,45-54,3
30,2,1,0,3,2021-11-05,Male,66,65-69,9
30,0,0,0,0,2021-11-05,Male,77,75-79,2
30,2,4,0,6,2021-11-08,Female,18,15-19,2
30,1,0,0,1,2021-11-05,Male,66,65-69,9
30,2,0,0,2,2021-11-04,Female,17,15-19,10
30,1,0,0,1,2021-11-03,Female,65,65-69,8
30,1,0,0,1,2021-11-04,Female,56,55-64,3
30,2,2,0,4,2021-11-04,Male,52,45-54,4
30,1,0,0,1,2021-11-05,Female,66,65-69,10
30,1,6,0,7,2021-11-04,Male,54,45-54,7
30,1,1,0,2,2021-11-04,Female,69,65-69,5
30,1,10,0,11,2021-11-03,Male,56,55-64,10
30,1,0,0,1,2021-11-05,Female,52,45-54,17
30,0,0,0,0,2021-11-05,Male,72,70-74,4
30,0,1,0,1,2021-11-08,Female,42,35-44,5
30,3,10,0,13,2021-11-03,Female,2,1-4,4
30,1,0,0,1,2021-11-08,Male,69,65-69,4
30,1,0,0,1,2021-11-08,Male,69,65-69,3
30,1,0,0,1,2021-11-04,Female,63,55-64,10
30,0,1,0,1,2021-11-03,Male,57,55-64,2
30,0,0,0,0,2021-11-08,Male,12,10-14,1
30,0,0,0,0,2021-11-03,Male,61,55-64,10
30,0,2,0,2,2021-11-08,Male,57,55-64,2
30,0,0,0,0,2021-11-09,Female,33,25-34,8
30,1,0,0,1,2021-11-03,Male,69,65-69,5
30,0,0,0,0,2021-11-05,Female,44,35-44,8
30,0,4,0,4,2021-11-03,Female,61,55-64,16
30,1,0,0,1,2021-11-03,Male,52,45-54,9
30,0,0,0,0,2021-11-08,Female,66,65-69,8
30,1,0,0,1,2021-11-08,Female,50,45-54,24
30,1,0,0,1,2021-11-09,Female,60,55-64,5
30,0,0,0,0,2021-11-04,Male,47,45-54,7
30,1,0,6,7,2021-11-05,Male,71,70-74,2
30,1,0,0,1,2021-11-04,Female,36,35-44,4
30,0,2,0,2,2021-11-03,Male,54,45-54,4
30,1,0,0,1,2021-11-08,Female,67,65-69,3
30,0,1,0,1,2021-11-09,Male,74,70-74,3
30,0,2,0,2,2021-11-04,Male,64,55-64,9
30,2,0,0,2,2021-11-03,Male,52,45-54,10
30,4,12,0,16,2021-11-04,Male,5,5-9,8
30,0,0,0,0,2021-11-04,Female,64,55-64,4
30,0,0,0,0,2021-11-04,Male,31,25-34,4
30,1,0,0,1,2021-11-08,Female,40,35-44,8
30,0,0,0,0,2021-11-03,Female,61,55-64,3
30,1,1,0,2,2021-11-04,Female,66,65-69,4
30,1,0,0,1,2021-11-09,Male,68,65-69,8
30,1,5,0,6,2021-11-08,Male,71,70-74,4
30,3,0,0,3,2021-11-04,Female,10,10-14,5
30,0,0,0,0,2021-11-05,Male,65,65-69,9
30,0,0,0,0,2021-11-04,Female,55,55-64,3
30,0,0,0,0,2021-11-03,Male,26,25-34,6
30,0,0,0,0,2021-11-04,Male,31,25-34,21
30,0,1,0,1,2021-11-09,Male,42,35-44,4
30,1,0,0,1,2021-11-08,Male,70,70-74,6
30,0,0,0,0,2021-11-04,Male,64,55-64,3
30,3,1,0,4,2021-11-03,Female,13,10-14,3
30,0,25,0,25,2021-11-08,Female,19,15-19,2
30,1,0,0,1,2021-11-09,Female,72,70-74,3
30,0,1,0,1,2021-11-09,Male,64,55-64,24
30,0,0,0,0,2021-11-04,Male,54,45-54,10
30,3,2,0,5,2021-11-04,Male,20,20-24,5
30,3,0,0,3,2021-11-04,Female,22,20-24,6
30,1,0,0,1,2021-11-08,Male,64,55-64,2
30,1,0,0,1,2021-11-08,Male,83,80-84,2
30,1,1,0,2,2021-11-04,Male,36,35-44,8
30,1,1,0,2,2021-11-04,Male,68,65-69,7
30,0,0,0,0,2021-11-03,Female,5,5-9,24
30,1,0,0,1,2021-11-03,Female,61,55-64,5
30,0,0,0,0,2021-11-04,Female,66,65-69,15
30,1,0,0,1,2021-11-09,Female,48,45-54,3
30,1,0,0,1,2021-11-09,Female,66,65-69,3
30,2,0,0,2,2021-11-04,Male,3,1-4,5
30,0,0,0,0,2021-11-09,Female,49,45-54,10
30,1,0,0,1,2021-11-03,Female,72,70-74,10
30,1,2,0,3,2021-11-04,Female,52,45-54,4
30,0,0,0,0,2021-11-09,Male,56,55-64,4
30,0,11,0,11,2021-11-04,Female,66,65-69,5
30,1,0,0,1,2021-11-04,Female,72,70-74,5
30,0,1,0,1,2021-11-04,Female,53,45-54,2
30,0,0,0,0,2021-11-04,Female,53,45-54,3
30,0,0,0,0,2021-11-03,Male,51,45-54,6
30,0,2,0,2,2021-11-09,Female,67,65-69,8
30,2,1,0,3,2021-11-04,Female,48,45-54,9
30,0,1,0,1,2021-11-04,Male,57,55-64,3
30,0,0,0,0,2021-11-08,Female,51,45-54,9
30,2,0,0,2,2021-11-04,Male,7,5-9,10
30,2,0,0,2,2021-11-08,Male,30,25-34,6
30,2,0,0,2,2021-11-04,Female,30,25-34,4
30,4,0,0,4,2021-11-04,Male,2,1-4,3
30,1,0,0,1,2021-11-08,Female,42,35-44,10
30,0,5,0,5,2021-11-08,Female,23,20-24,1
30,1,1,0,2,2021-11-04,Male,57,55-64,10
30,0,6,0,6,2021-11-04,Female,74,70-74,4
30,1,0,0,1,2021-11-08,Male,46,45-54,6
30,1,6,0,7,2021-11-04,Male,50,45-54,11
30,3,0,0,3,2021-11-03,Female,7,5-9,4
30,3,10,0,13,2021-11-04,Male,1,1-4,3
30,2,1,0,3,2021-11-05,Male,37,35-44,9
30,3,0,1,4,2021-11-08,Male,0,<1,1
30,1,3,0,4,2021-11-08,Female,39,35-44,4
30,1,1,0,2,2021-11-05,Female,26,25-34,16
30,1,0,0,1,2021-11-08,Female,76,75-79,4
30,2,0,0,2,2021-11-03,Female,12,10-14,2
30,0,0,0,0,2021-11-04,Female,54,45-54,12
30,1,0,0,1,2021-11-08,Male,72,70-74,2
30,0,0,0,0,2021-11-04,Male,64,55-64,4
30,0,0,0,0,2021-11-04,Male,11,10-14,4
30,1,5,0,6,2021-11-08,Female,34,25-34,1
30,0,2,1,3,2021-11-04,Female,76,75-79,2
30,1,0,0,1,2021-11-04,Female,32,25-34,5
30,1,1,0,2,2021-11-04,Female,8,5-9,5
30,1,0,0,1,2021-11-04,Female,19,15-19,5
30,1,0,0,1,2021-11-05,Female,34,25-34,7
30,0,2,0,2,2021-11-08,Female,51,45-54,14
30,3,0,0,3,2021-11-04,Female,19,15-19,4
30,1,2,0,3,2021-11-03,Female,68,65-69,6
30,0,0,0,0,2021-11-05,Male,49,45-54,3
30,0,0,0,0,2021-11-04,Female,61,55-64,5
30,2,1,0,3,2021-11-04,Male,1,1-4,10
30,2,1,0,3,2021-11-08,Female,25,25-34,19
30,3,15,0,18,2021-11-03,Male,5,5-9,3
30,0,0,0,0,2021-11-04,Female,59,55-64,4
30,3,0,0,3,2021-11-04,Female,9,5-9,10
30,0,0,0,0,2021-11-08,Female,67,65-69,21
30,1,0,0,1,2021-11-05,Female,49,45-54,3
30,0,0,0,0,2021-11-05,Female,79,75-79,15
30,2,0,0,2,2021-11-03,Female,67,65-69,2
30,0,0,0,0,2021-11-08,Female,19,15-19,1
30,0,0,0,0,2021-11-08,Male,85,85+,20
30,1,0,0,1,2021-11-05,Male,56,55-64,4
30,1,0,0,1,2021-11-04,Male,67,65-69,4
30,0,0,0,0,2021-11-04,Male,69,65-69,10
30,1,0,0,1,2021-11-03,Male,33,25-34,2
30,0,0,0,0,2021-11-05,Male,37,35-44,4
30,1,2,0,3,2021-11-08,Male,6,5-9,3
30,1,0,0,1,2021-11-04,Male,38,35-44,4
30,0,3,0,3,2021-11-05,Male,63,55-64,4
30,1,0,0,1,2021-11-04,Female,62,55-64,3
30,1,1,0,2,2021-11-03,Female,70,70-74,4
30,0,0,0,0,2021-11-08,Female,71,70-74,7
30,4,0,0,4,2021-11-04,Female,3,1-4,2
30,1,10,0,11,2021-11-08,Female,32,25-34,1
30,1,1,0,2,2021-11-09,Male,62,55-64,4
30,0,3,0,3,2021-11-03,Male,51,45-54,8
30,2,0,0,2,2021-11-09,Male,69,65-69,10
30,1,10,0,11,2021-11-03,Male,60,55-64,4
30,0,0,0,0,2021-11-03,Female,51,45-54,6
30,1,0,0,1,2021-11-08,Male,74,70-74,5
30,0,0,0,0,2021-11-03,Female,56,55-64,2
30,2,1,0,3,2021-11-08,Male,68,65-69,10
30,1,4,0,5,2021-11-04,Male,72,70-74,5
30,0,0,0,0,2021-11-08,Male,69,65-69,4
30,1,0,0,1,2021-11-04,Male,58,55-64,7
30,2,0,0,2,2021-11-08,Male,44,35-44,9
30,1,2,0,3,2021-11-03,Male,60,55-64,6
30,2,1,0,3,2021-11-08,Female,20,20-24,1
30,0,1,0,1,2021-11-04,Female,52,45-54,3
30,0,1,0,1,2021-11-03,Male,52,45-54,6
30,1,0,0,1,2021-11-03,Male,52,45-54,5
30,2,0,0,2,2021-11-05,Male,58,55-64,4
30,1,1,0,2,2021-11-07,Female,48,45-54,5
30,0,0,0,0,2021-11-03,Male,50,45-54,4
30,0,0,0,0,2021-11-04,Female,23,20-24,16
30,0,1,0,1,2021-11-08,Male,66,65-69,3
30,1,1,0,2,2021-11-04,Male,54,45-54,9
30,0,1,0,1,2021-11-04,Male,56,55-64,4
30,0,0,0,0,2021-11-08,Female,22,20-24,1
30,0,9,0,9,2021-11-03,Female,61,55-64,3
30,1,0,0,1,2021-11-03,Female,67,65-69,4
30,0,0,0,0,2021-11-04,Female,70,70-74,9
30,0,2,0,2,2021-11-05,Female,58,55-64,18
30,0,0,0,0,2021-11-04,Female,65,65-69,8
30,2,0,0,2,2021-11-08,Male,2,1-4,4
30,0,1,0,1,2021-11-03,Female,42,35-44,4
30,0,0,0,0,2021-11-04,Female,15,15-19,5
30,2,0,0,2,2021-11-03,Female,30,25-34,9
30,1,0,0,1,2021-11-08,Female,47,45-54,6
30,0,0,0,0,2021-11-08,Female,65,65-69,4
30,0,2,0,2,2021-11-08,Female,68,65-69,6
30,1,2,0,3,2021-11-05,Male,72,70-74,2
30,1,0,0,1,2021-11-08,Male,50,45-54,4
30,1,0,0,1,2021-11-08,Male,47,45-54,3
30,1,0,0,1,2021-11-04,Female,38,35-44,7
30,0,0,0,0,2021-11-05,Male,45,45-54,4
30,1,0,0,1,2021-11-04,Male,58,55-64,5
30,1,0,0,1,2021-11-04,Female,53,45-54,3
30,1,0,0,1,2021-11-04,Male,51,45-54,4
30,1,1,0,2,2021-11-05,Female,4,1-4,6
30,0,1,0,1,2021-11-05,Male,73,70-74,8
30,5,0,0,5,2021-11-04,Male,4,1-4,11
30,1,2,0,3,2021-11-04,Male,6,5-9,5
30,0,13,0,13,2021-11-04,Female,43,35-44,3
30,1,2,0,3,2021-11-03,Male,62,55-64,3
30,1,2,0,3,2021-11-05,Male,69,65-69,3
30,0,1,0,1,2021-11-08,Female,42,35-44,5
30,1,0,0,1,2021-11-04,Female,30,25-34,5
30,1,0,0,1,2021-11-04,Female,31,25-34,3
30,1,2,0,3,2021-11-04,Male,53,45-54,5
30,0,0,0,0,2021-11-03,Male,63,55-64,4
30,1,4,0,5,2021-11-08,Male,77,75-79,3
30,1,0,0,1,2021-11-03,Male,32,25-34,3
30,1,0,0,1,2021-11-05,Female,59,55-64,6
30,1,0,0,1,2021-11-09,Female,70,70-74,4
30,1,0,0,1,2021-11-04,Female,22,20-24,21
30,1,0,0,1,2021-11-04,Male,56,55-64,6
30,1,2,0,3,2021-11-08,Male,57,55-64,4
30,1,1,0,2,2021-11-04,Male,67,65-69,8
30,4,0,0,4,2021-11-05,Male,11,10-14,3
30,2,0,0,2,2021-11-03,Male,12,10-14,5
30,1,0,0,1,2021-11-09,Male,47,45-54,5
30,1,2,0,3,2021-11-03,Female,66,65-69,9
30,0,1,0,1,2021-11-08,Female,40,35-44,6
30,3,0,25,28,2021-11-08,Female,0,<1,1
30,1,0,0,1,2021-11-03,Male,58,55-64,5
30,2,0,0,2,2021-11-04,Female,5,5-9,25
30,0,0,0,0,2021-11-08,Female,65,65-69,3
30,1,0,0,1,2021-11-08,Male,66,65-69,9
30,2,0,0,2,2021-11-09,Male,64,55-64,18
30,2,2,0,4,2021-11-03,Female,2,1-4,2
30,1,0,0,1,2021-11-04,Female,74,70-74,4
30,0,0,0,0,2021-11-04,Female,40,35-44,9
30,1,0,0,1,2021-11-09,Female,33,25-34,14
30,1,0,0,1,2021-11-09,Male,49,45-54,9
30,0,2,0,2,2021-11-03,Male,46,45-54,5
30,1,15,0,16,2021-11-09,Male,66,65-69,6
30,0,1,0,1,2021-11-05,Male,62,55-64,2
30,1,0,0,1,2021-11-08,Female,48,45-54,7
30,2,0,0,2,2021-11-08,Female,11,10-14,1
30,0,0,0,0,2021-11-04,Male,20,20-24,9
30,1,0,0,1,2021-11-04,Male,29,25-34,2
30,2,1,0,3,2021-11-03,Male,25,25-34,2
30,2,0,0,2,2021-11-08,Female,7,5-9,4
30,1,0,2,3,2021-11-08,Female,28,25-34,1
30,0,2,0,2,2021-11-04,Male,39,35-44,3
30,0,0,0,0,2021-11-05,Male,65,65-69,6
30,1,0,0,1,2021-11-04,Female,75,75-79,2
30,0,1,0,1,2021-11-09,Female,20,20-24,1
30,1,0,0,1,2021-11-03,Male,69,65-69,5
30,1,0,0,1,2021-11-08,Male,75,75-79,10
30,3,2,0,5,2021-11-08,Male,10,10-14,2
30,1,30,0,31,2021-11-03,Male,50,45-54,5
30,0,0,0,0,2021-11-04,Male,58,55-64,2
30,0,30,0,30,2021-11-03,Male,48,45-54,3
30,1,5,0,6,2021-11-08,Male,71,70-74,3
30,1,0,0,1,2021-11-05,Male,37,35-44,2
30,1,3,0,4,2021-11-08,Female,27,25-34,1
30,3,0,0,3,2021-11-08,Male,18,15-19,3
30,0,0,0,0,2021-11-03,Male,72,70-74,9
30,2,0,0,2,2021-11-09,Male,8,5-9,3
30,0,3,0,3,2021-11-04,Male,44,35-44,10
30,0,0,0,0,2021-11-04,Female,33,25-34,5
30,1,0,0,1,2021-11-08,Female,30,25-34,1
30,1,0,0,1,2021-11-03,Female,59,55-64,3
30,3,3,0,6,2021-11-04,Male,53,45-54,4
30,0,10,0,10,2021-11-09,Female,45,45-54,8
30,0,0,0,0,2021-11-08,Female,26,25-34,2
30,0,2,0,2,2021-11-03,Male,59,55-64,6
30,1,0,0,1,2021-11-08,Male,9,5-9,1
30,0,0,0,0,2021-11-05,Male,59,55-64,9
30,0,0,0,0,2021-11-08,Male,66,65-69,17
30,1,1,0,2,2021-11-04,Male,68,65-69,7
30,1,0,0,1,2021-11-04,Female,53,45-54,4
30,0,0,0,0,2021-11-04,Male,48,45-54,8
30,1,0,0,1,2021-11-05,Female,62,55-64,4
30,0,0,0,0,2021-11-04,Male,61,55-64,4
30,0,0,0,0,2021-11-03,Female,13,10-14,4
30,0,0,0,0,2021-11-05,Female,22,20-24,11
30,3,3,0,6,2021-11-08,Female,1,1-4,1
30,0,1,0,1,2021-11-04,Female,20,20-24,2
30,1,0,0,1,2021-11-04,Male,69,65-69,9
30,4,0,0,4,2021-11-08,Female,3,1-4,1
30,1,0,0,1,2021-11-08,Male,77,75-79,9
30,3,0,0,3,2021-11-03,Female,4,1-4,9
30,1,0,0,1,2021-11-04,Female,56,55-64,8
30,1,3,0,4,2021-11-04,Female,66,65-69,4
30,0,1,0,1,2021-11-08,Male,33,25-34,8
30,1,0,0,1,2021-11-04,Female,48,45-54,6
30,0,0,0,0,2021-11-08,Female,57,55-64,2
30,1,2,0,3,2021-11-04,Male,34,25-34,9
30,0,0,0,0,2021-11-04,Female,17,15-19,4
30,1,1,0,2,2021-11-03,Male,76,75-79,4
30,1,1,0,2,2021-11-03,Male,52,45-54,8
30,0,0,0,0,2021-11-04,Male,44,35-44,4
30,1,3,0,4,2021-11-04,Male,65,65-69,8
30,1,0,0,1,2021-11-03,Male,61,55-64,9
30,1,0,0,1,2021-11-05,Female,63,55-64,4
30,1,0,0,1,2021-11-03,Female,51,45-54,3
30,1,1,0,2,2021-11-03,Male,72,70-74,7
30,0,0,0,0,2021-11-03,Female,39,35-44,3
30,0,0,0,0,2021-11-03,Female,23,20-24,11
30,0,0,0,0,2021-11-04,Female,60,55-64,5
30,0,0,0,0,2021-11-08,Male,66,65-69,8
30,0,0,0,0,2021-11-03,Male,39,35-44,3
30,2,10,0,12,2021-11-04,Male,16,15-19,8
30,0,0,0,0,2021-11-08,Female,63,55-64,2
30,1,1,0,2,2021-11-04,Male,71,70-74,3
30,0,2,1,3,2021-11-03,Female,60,55-64,24
30,3,0,0,3,2021-11-08,Female,6,5-9,1
30,1,1,0,2,2021-11-04,Female,32,25-34,5
30,0,0,0,0,2021-11-05,Male,43,35-44,5
30,0,0,0,0,2021-11-08,Female,68,65-69,17
30,1,0,0,1,2021-11-03,Male,53,45-54,4
30,2,0,0,2,2021-11-09,Male,71,70-74,3
30,0,0,0,0,2021-11-04,Female,25,25-34,4
30,1,0,0,1,2021-11-04,Female,11,10-14,2
30,1,0,0,1,2021-11-09,Male,58,55-64,3
30,1,0,0,1,2021-11-04,Male,72,70-74,4
30,2,0,0,2,2021-11-04,Female,24,20-24,4
30,1,0,0,1,2021-11-03,Female,66,65-69,10
30,3,0,0,3,2021-11-05,Female,7,5-9,6
30,2,1,0,3,2021-11-08,Female,5,5-9,2
30,1,0,0,1,2021-11-08,Female,76,75-79,7
30,3,1,0,4,2021-11-04,Female,20,20-24,3
30,0,0,0,0,2021-11-04,Male,26,25-34,3
30,2,0,0,2,2021-11-08,Female,53,45-54,5
30,1,0,0,1,2021-11-08,Male,56,55-64,3
30,1,0,0,1,2021-11-08,Male,49,45-54,8
30,0,0,0,0,2021-11-03,Male,61,55-64,4
30,1,30,0,31,2021-11-09,Female,59,55-64,9
30,3,0,0,3,2021-11-09,Male,23,20-24,3
30,2,5,0,7,2021-11-04,Male,12,10-14,6
30,0,11,0,11,2021-11-04,Female,43,35-44,4
30,1,0,0,1,2021-11-09,Female,69,65-69,3
30,3,16,0,19,2021-11-04,Female,2,1-4,6
30,0,0,0,0,2021-11-05,Male,75,75-79,4
30,1,0,0,1,2021-11-04,Female,6,5-9,3
30,0,8,0,8,2021-11-04,Female,57,55-64,5
30,0,0,0,0,2021-11-05,Male,57,55-64,9
30,0,0,0,0,2021-11-08,Female,46,45-54,4
30,1,6,0,7,2021-11-03,Female,49,45-54,10
30,0,5,0,5,2021-11-04,Female,52,45-54,6
30,2,0,0,2,2021-11-08,Female,12,10-14,4
30,0,0,0,0,2021-11-03,Male,65,65-69,5
30,2,0,0,2,2021-11-05,Male,71,70-74,23
30,0,0,0,0,2021-11-08,Male,78,75-79,2
30,0,0,0,0,2021-11-08,Male,18,15-19,1
30,1,0,0,1,2021-11-05,Female,73,70-74,5
30,2,0,0,2,2021-11-03,Female,19,15-19,4
30,1,0,0,1,2021-11-03,Female,69,65-69,4
30,0,0,0,0,2021-11-08,Male,51,45-54,20
30,0,0,0,0,2021-11-09,Male,76,75-79,3
30,0,0,0,0,2021-11-04,Male,66,65-69,4
30,3,2,0,5,2021-11-09,Male,26,25-34,2
30,2,4,0,6,2021-11-05,Male,5,5-9,3
30,0,0,0,0,2021-11-08,Male,65,65-69,4
30,0,4,0,4,2021-11-04,Female,71,70-74,4
30,0,32,0,32,2021-11-03,Male,61,55-64,10
30,1,0,2,3,2021-11-03,Male,48,45-54,13
30,2,0,0,2,2021-11-08,Male,10,10-14,4
30,1,1,0,2,2021-11-04,Female,52,45-54,3
30,0,0,0,0,2021-11-05,Male,60,55-64,8
30,0,0,0,0,2021-11-08,Male,63,55-64,4
30,3,2,0,5,2021-11-05,Female,67,65-69,19
30,1,0,0,1,2021-11-04,Male,61,55-64,2
30,3,0,0,3,2021-11-04,Female,26,25-34,7
30,1,0,0,1,2021-11-03,Female,72,70-74,4
30,0,4,0,4,2021-11-04,Male,69,65-69,3
30,0,0,0,0,2021-11-04,Male,56,55-64,2
30,3,15,27,45,2021-11-04,Male,10,10-14,4
30,0,0,0,0,2021-11-04,Female,56,55-64,9
30,4,0,2,6,2021-11-04,Male,28,25-34,13
30,0,2,0,2,2021-11-03,Male,60,55-64,3
30,0,0,0,0,2021-11-09,Female,70,70-74,17
30,0,1,0,1,2021-11-08,Male,70,70-74,4
30,1,0,0,1,2021-11-04,Female,49,45-54,19
30,0,2,0,2,2021-11-03,Female,50,45-54,4
30,1,10,0,11,2021-11-08,Male,25,25-34,1
30,0,0,0,0,2021-11-03,Male,60,55-64,3
30,1,2,0,3,2021-11-03,Female,59,55-64,5
30,1,0,0,1,2021-11-04,Female,37,35-44,9
30,2,0,0,2,2021-11-08,Male,9,5-9,4
30,1,0,0,1,2021-11-09,Male,73,70-74,8
30,2,0,14,16,2021-11-08,Male,4,1-4,3
30,1,0,38,39,2021-11-04,Male,61,55-64,3
30,1,1,0,2,2021-11-08,Male,70,70-74,4
30,1,0,0,1,2021-11-05,Male,66,65-69,3
30,4,0,0,4,2021-11-08,Male,24,20-24,1
30,0,0,0,0,2021-11-03,Female,23,20-24,5
30,2,0,0,2,2021-11-04,Male,1,1-4,3
30,3,0,0,3,2021-11-04,Female,3,1-4,9
30,1,1,0,2,2021-11-04,Female,62,55-64,5
30,1,0,0,1,2021-11-03,Female,54,45-54,4
30,1,3,0,4,2021-11-05,Male,58,55-64,3
30,2,0,0,2,2021-11-04,Female,15,15-19,3
30,0,0,0,0,2021-11-05,Female,68,65-69,4
30,1,0,0,1,2021-11-04,Male,60,55-64,2
30,2,2,0,4,2021-11-04,Female,17,15-19,4
30,1,0,0,1,2021-11-04,Male,71,70-74,4
30,1,0,0,1,2021-11-04,Female,69,65-69,6
30,2,1,0,3,2021-11-08,Female,71,70-74,21
30,2,0,0,2,2021-11-03,Male,8,5-9,5
30,1,0,0,1,2021-11-04,Male,62,55-64,2
30,1,0,0,1,2021-11-09,Male,69,65-69,3
30,2,3,15,20,2021-11-04,Male,4,1-4,4
30,1,0,0,1,2021-11-04,Female,71,70-74,6
30,3,29,0,32,2021-11-05,Female,10,10-14,12
30,0,1,33,34,2021-11-08,Female,32,25-34,1
30,1,0,3,4,2021-11-09,Male,71,70-74,4
30,1,0,0,1,2021-11-03,Male,61,55-64,3
30,1,0,0,1,2021-11-03,Female,50,45-54,3
30,1,2,0,3,2021-11-03,Female,37,35-44,7
30,2,1,0,3,2021-11-04,Female,28,25-34,10
30,0,0,0,0,2021-11-03,Female,37,35-44,19
30,1,1,0,2,2021-11-04,Female,63,55-64,10
30,4,5,0,9,2021-11-03,Male,4,1-4,5
30,3,0,0,3,2021-11-08,Male,5,5-9,2
30,1,3,0,4,2021-11-03,Female,25,25-34,2
30,1,0,0,1,2021-11-04,Female,60,55-64,14
30,3,3,0,6,2021-11-08,Female,51,45-54,13
30,0,3,0,3,2021-11-04,Female,54,45-54,4
30,0,0,0,0,2021-11-08,Male,39,35-44,9
30,0,1,0,1,2021-11-03,Male,41,35-44,3
30,0,3,0,3,2021-11-03,Male,50,45-54,5
30,3,2,0,5,2021-11-04,Male,10,10-14,2
30,0,0,0,0,2021-11-04,Female,18,15-19,4
30,1,3,0,4,2021-11-04,Female,56,55-64,5
30,1,0,0,1,2021-11-09,Female,63,55-64,3
30,0,0,0,0,2021-11-04,Female,62,55-64,6
30,3,0,0,3,2021-11-08,Male,1,1-4,3
30,1,1,12,14,2021-11-08,Female,57,55-64,11
30,1,0,0,1,2021-11-08,Male,40,35-44,4
30,3,15,0,18,2021-11-03,Female,0,<1,4
30,1,2,0,3,2021-11-04,Male,68,65-69,3
30,0,0,0,0,2021-11-08,Male,21,20-24,1
30,0,0,0,0,2021-11-05,Female,72,70-74,3
30,1,0,0,1,2021-11-04,Female,55,55-64,9
30,1,0,0,1,2021-11-08,Female,73,70-74,10
30,1,1,0,2,2021-11-04,Male,62,55-64,3
30,0,2,0,2,2021-11-04,Female,30,25-34,5
30,1,0,0,1,2021-11-09,Male,70,70-74,4
30,2,0,0,2,2021-11-04,Male,35,35-44,10
30,0,0,0,0,2021-11-04,Female,40,35-44,9
30,1,0,0,1,2021-11-09,Female,54,45-54,2
30,1,2,0,3,2021-11-04,Female,72,70-74,14
30,0,0,0,0,2021-11-03,Female,65,65-69,9
30,1,1,0,2,2021-11-04,Male,63,55-64,21
30,0,0,0,0,2021-11-08,Female,66,65-69,9
30,1,1,6,8,2021-11-08,Male,30,25-34,1
30,0,0,0,0,2021-11-09,Female,70,70-74,5
30,0,0,0,0,2021-11-05,Male,65,65-69,8
30,0,0,0,0,2021-11-08,Male,28,25-34,1
30,0,0,0,0,2021-11-04,Male,57,55-64,4
30,2,0,1,3,2021-11-08,Female,45,45-54,2
30,2,1,0,3,2021-11-03,Male,6,5-9,4
30,2,5,0,7,2021-11-04,Female,26,25-34,12
30,0,4,0,4,2021-11-05,Female,65,65-69,4
30,2,0,0,2,2021-11-04,Male,13,10-14,3
30,3,0,0,3,2021-11-09,Female,50,45-54,3
30,0,0,0,0,2021-11-08,Female,56,55-64,9
30,1,19,0,20,2021-11-03,Female,7,5-9,2
30,3,0,0,3,2021-11-04,Male,14,10-14,10
30,1,0,0,1,2021-11-08,Female,67,65-69,3
30,2,1,0,3,2021-11-04,Female,12,10-14,4
30,2,0,0,2,2021-11-04,Male,45,45-54,10
30,1,2,0,3,2021-11-09,Female,72,70-74,3
30,1,0,0,1,2021-11-03,Female,54,45-54,6
30,0,0,0,0,2021-11-04,Male,68,65-69,8
30,2,0,0,2,2021-11-08,Female,20,20-24,6
30,1,4,0,5,2021-11-04,Female,38,35-44,9
30,0,0,0,0,2021-11-04,Male,51,45-54,6
30,3,0,0,3,2021-11-03,Male,17,15-19,9
30,1,0,0,1,2021-11-08,Male,65,65-69,7
30,2,0,0,2,2021-11-03,Male,15,15-19,4
30,0,0,0,0,2021-11-04,Female,55,55-64,3
30,1,0,0,1,2021-11-08,Male,60,55-64,6
30,0,0,0,0,2021-11-05,Female,70,70-74,4
30,0,2,0,2,2021-11-08,Female,35,35-44,6
30,0,2,0,2,2021-11-09,Female,61,55-64,4
30,1,0,0,1,2021-11-08,Female,59,55-64,24
30,2,28,0,30,2021-11-04,Male,19,15-19,9
30,3,0,0,3,2021-11-04,Male,3,1-4,6
30,0,0,0,0,2021-11-03,Female,44,35-44,4
30,0,0,0,0,2021-11-04,Female,66,65-69,8
30,0,0,0,0,2021-11-04,Male,53,45-54,26
30,1,0,0,1,2021-11-08,Female,58,55-64,5
30,3,0,0,3,2021-11-08,Female,1,1-4,3
30,1,18,0,19,2021-11-08,Male,30,25-34,1
30,1,1,0,2,2021-11-04,Female,55,55-64,6
30,1,0,0,1,2021-11-04,Female,58,55-64,3
30,0,0,0,0,2021-11-04,Female,34,25-34,5
30,2,1,0,3,2021-11-03,Female,11,10-14,3
30,0,0,2,2,2021-11-08,Female,21,20-24,1
30,1,2,0,3,2021-11-08,Male,62,55-64,2
30,1,3,0,4,2021-11-03,Female,22,20-24,2
30,1,1,0,2,2021-11-04,Male,8,5-9,5
30,3,0,0,3,2021-11-08,Male,23,20-24,12
30,2,0,0,2,2021-11-08,Female,17,15-19,22
30,1,1,0,2,2021-11-04,Female,73,70-74,8
30,1,0,0,1,2021-11-03,Female,63,55-64,4
30,1,0,0,1,2021-11-03,Male,68,65-69,8
30,0,14,0,14,2021-11-08,Male,62,55-64,5
30,0,3,0,3,2021-11-04,Male,75,75-79,3
30,1,0,0,1,2021-11-05,Male,71,70-74,3
30,1,2,0,3,2021-11-08,Male,58,55-64,6
30,0,13,0,13,2021-11-04,Female,54,45-54,3
30,0,0,0,0,2021-11-04,Male,34,25-34,8
30,0,0,0,0,2021-11-04,Female,35,35-44,4
30,2,0,9,11,2021-11-04,Female,19,15-19,8
30,1,2,0,3,2021-11-04,Female,68,65-69,21
30,1,3,0,4,2021-11-05,Male,69,65-69,4
30,0,2,0,2,2021-11-03,Female,41,35-44,7
30,0,0,0,0,2021-11-08,Male,48,45-54,9
30,1,0,0,1,2021-11-09,Female,72,70-74,2
30,2,0,0,2,2021-11-08,Male,6,5-9,1
30,1,0,0,1,2021-11-03,Male,81,80-84,4
30,0,1,0,1,2021-11-03,Male,60,55-64,3
30,1,0,0,1,2021-11-08,Female,46,45-54,10
30,0,0,0,0,2021-11-05,Female,52,45-54,9
30,1,0,0,1,2021-11-04,Female,54,45-54,3
30,1,0,0,1,2021-11-04,Female,1,1-4,2
30,1,0,0,1,2021-11-05,Female,31,25-34,3
30,1,0,0,1,2021-11-05,Female,67,65-69,8
30,1,0,0,1,2021-11-04,Male,61,55-64,5
30,0,0,0,0,2021-11-04,Male,54,45-54,9
30,0,0,0,0,2021-11-03,Female,61,55-64,3
30,1,0,0,1,2021-11-04,Female,35,35-44,9
30,1,0,0,1,2021-11-04,Male,53,45-54,9
30,0,0,0,0,2021-11-03,Male,51,45-54,8
30,1,0,0,1,2021-11-04,Male,35,35-44,8
30,1,0,0,1,2021-11-08,Male,72,70-74,3
30,3,0,6,9,2021-11-03,Female,8,5-9,3
30,3,0,0,3,2021-11-08,Male,2,1-4,1
30,3,1,0,4,2021-11-03,Male,7,5-9,8
30,3,0,0,3,2021-11-04,Female,5,5-9,10
30,0,0,0,0,2021-11-03,Female,33,25-34,5
30,0,1,0,1,2021-11-04,Male,78,75-79,2
30,0,0,0,0,2021-11-05,Male,28,25-34,2
30,0,0,0,0,2021-11-04,Female,57,55-64,7
30,2,0,0,2,2021-11-09,Female,17,15-19,4
30,2,0,0,2,2021-11-03,Male,33,25-34,2
30,0,0,0,0,2021-11-04,Female,51,45-54,2
30,3,0,0,3,2021-11-03,Female,0,<1,4
30,4,0,0,4,2021-11-08,Female,1,1-4,3
30,1,2,0,3,2021-11-04,Male,61,55-64,6
30,2,1,0,3,2021-11-04,Female,15,15-19,2
30,1,0,0,1,2021-11-04,Male,36,35-44,3
30,0,0,0,0,2021-11-09,Male,74,70-74,3
30,0,0,0,0,2021-11-09,Male,74,70-74,2
30,1,0,0,1,2021-11-05,Male,66,65-69,3
30,0,0,0,0,2021-11-03,Female,65,65-69,8
30,0,0,0,0,2021-11-08,Male,71,70-74,9
30,0,0,0,0,2021-11-08,Female,66,65-69,6
30,3,0,0,3,2021-11-08,Male,23,20-24,1
30,1,2,0,3,2021-11-08,Male,64,55-64,3
30,2,3,0,5,2021-11-04,Female,31,25-34,2
30,1,0,0,1,2021-11-04,Female,62,55-64,4
30,0,2,0,2,2021-11-03,Female,31,25-34,25
30,1,0,0,1,2021-11-08,Male,76,75-79,3
30,2,0,1,3,2021-11-05,Male,63,55-64,2
30,2,0,0,2,2021-11-05,Male,66,65-69,2
30,1,3,0,4,2021-11-09,Male,6,5-9,4
30,3,0,0,3,2021-11-08,Female,0,<1,1
30,1,0,0,1,2021-11-08,Female,24,20-24,2
30,1,0,0,1,2021-11-04,Male,60,55-64,6
30,1,11,0,12,2021-11-04,Female,35,35-44,4
30,1,0,0,1,2021-11-03,Female,23,20-24,2
30,2,0,0,2,2021-11-08,Female,17,15-19,6
30,1,0,0,1,2021-11-04,Male,71,70-74,4
30,1,4,0,5,2021-11-04,Female,62,55-64,9
30,0,0,0,0,2021-11-04,Male,47,45-54,3
30,0,0,0,0,2021-11-05,Female,74,70-74,9
30,0,0,0,0,2021-11-04,Female,19,15-19,3
30,0,1,0,1,2021-11-08,Female,48,45-54,9
30,1,0,0,1,2021-11-03,Female,60,55-64,4
30,0,0,0,0,2021-11-03,Male,52,45-54,5
30,0,0,0,0,2021-11-05,Female,63,55-64,2
30,2,16,0,18,2021-11-09,Male,11,10-14,6
30,5,0,0,5,2021-11-04,Female,8,5-9,3
30,3,0,0,3,2021-11-08,Female,16,15-19,18
30,1,5,0,6,2021-11-08,Male,81,80-84,3
30,1,0,0,1,2021-11-03,Female,47,45-54,3
30,2,0,0,2,2021-11-09,Male,69,65-69,14
30,1,75,0,76,2021-11-04,Male,74,70-74,18
30,0,8,0,8,2021-11-04,Male,59,55-64,5
30,2,0,0,2,2021-11-05,Male,2,1-4,4
30,0,3,0,3,2021-11-09,Female,39,35-44,5
30,3,8,5,16,2021-11-04,Male,1,1-4,6
30,1,0,0,1,2021-11-05,Female,46,45-54,4
30,1,0,0,1,2021-11-04,Female,55,55-64,6
30,1,0,0,1,2021-11-04,Male,56,55-64,5
30,1,0,0,1,2021-11-03,Male,48,45-54,3
30,1,0,0,1,2021-11-03,Male,60,55-64,2
30,1,0,0,1,2021-11-04,Female,54,45-54,4
30,0,1,5,6,2021-11-03,Female,34,25-34,2
30,2,0,6,8,2021-11-09,Male,13,10-14,1
30,0,2,0,2,2021-11-09,Female,78,75-79,4
30,1,1,0,2,2021-11-04,Female,64,55-64,3
30,2,2,0,4,2021-11-03,Male,15,15-19,4
30,0,0,0,0,2021-11-04,Female,32,25-34,5
30,1,0,0,1,2021-11-04,Male,53,45-54,10
30,1,0,0,1,2021-11-05,Female,24,20-24,3
30,1,0,0,1,2021-11-08,Female,68,65-69,2
30,1,0,0,1,2021-11-08,Male,60,55-64,4
30,3,0,0,3,2021-11-04,Male,12,10-14,10
30,1,2,0,3,2021-11-04,Female,12,10-14,4
30,1,1,0,2,2021-11-05,Male,55,55-64,9
30,0,3,0,3,2021-11-08,Male,51,45-54,10
30,1,40,0,41,2021-11-04,Female,50,45-54,6
30,3,0,0,3,2021-11-04,Female,72,70-74,3
30,0,7,0,7,2021-11-03,Female,40,35-44,6
30,4,1,0,5,2021-11-08,Female,12,10-14,7
30,0,0,0,0,2021-11-04,Male,49,45-54,6
30,2,2,0,4,2021-11-05,Female,63,55-64,2
30,0,5,0,5,2021-11-04,Female,52,45-54,3
30,1,0,0,1,2021-11-04,Male,70,70-74,5
30,1,0,0,1,2021-11-08,Female,8,5-9,1
30,2,0,0,2,2021-11-04,Female,14,10-14,4
30,0,0,0,0,2021-11-08,Male,77,75-79,21
30,3,0,0,3,2021-11-08,Female,20,20-24,1
30,1,1,0,2,2021-11-09,Male,34,25-34,1
30,2,0,0,2,2021-11-09,Female,69,65-69,18
30,1,1,0,2,2021-11-04,Male,61,55-64,4
30,0,1,0,1,2021-11-03,Female,27,25-34,4
30,0,3,0,3,2021-11-04,Male,34,25-34,8
30,0,2,0,2,2021-11-03,Female,53,45-54,2
30,2,2,0,4,2021-11-08,Female,1,1-4,1
30,0,0,0,0,2021-11-03,Male,60,55-64,3
30,0,0,0,0,2021-11-06,Male,41,35-44,9
30,1,0,0,1,2021-11-08,Female,57,55-64,8
30,0,0,0,0,2021-11-08,Female,23,20-24,3
30,3,0,0,3,2021-11-04,Female,40,35-44,3
30,1,0,0,1,2021-11-03,Female,60,55-64,10
30,1,0,0,1,2021-11-05,Male,51,45-54,3
30,0,0,0,0,2021-11-05,Female,66,65-69,4
30,0,1,0,1,2021-11-05,Male,45,45-54,5
30,2,0,0,2,2021-11-08,Male,70,70-74,4
30,1,0,0,1,2021-11-04,Male,71,70-74,4
30,0,0,0,0,2021-11-04,Female,32,25-34,8
30,0,0,0,0,2021-11-08,Male,22,20-24,1
30,3,0,0,3,2021-11-03,Female,1,1-4,6
30,0,0,0,0,2021-11-04,Female,73,70-74,3
30,1,0,0,1,2021-11-08,Female,77,75-79,3
30,1,2,0,3,2021-11-05,Female,45,45-54,4
30,0,0,0,0,2021-11-04,Male,55,55-64,10
30,1,3,0,4,2021-11-05,Female,50,45-54,4
30,1,0,0,1,2021-11-08,Female,77,75-79,4
30,0,0,0,0,2021-11-04,Female,58,55-64,2
30,3,0,0,3,2021-11-03,Female,18,15-19,9
30,2,0,0,2,2021-11-03,Female,11,10-14,10
30,3,0,0,3,2021-11-03,Female,59,55-64,4
30,2,0,0,2,2021-11-09,Male,70,70-74,3
30,0,0,0,0,2021-11-05,Male,66,65-69,9
30,0,0,0,0,2021-11-08,Male,69,65-69,4
30,0,1,0,1,2021-11-04,Male,67,65-69,9
30,1,1,0,2,2021-11-05,Male,77,75-79,7
30,1,0,0,1,2021-11-09,Female,54,45-54,6
30,0,1,0,1,2021-11-08,Male,67,65-69,3
30,1,2,0,3,2021-11-04,Male,75,75-79,3
30,0,4,0,4,2021-11-04,Male,62,55-64,4
30,1,0,0,1,2021-11-04,Male,60,55-64,9
30,2,2,0,4,2021-11-04,Female,49,45-54,9
30,1,0,0,1,2021-11-08,Male,85,85+,7
30,1,0,0,1,2021-11-03,Male,37,35-44,8
30,0,2,0,2,2021-11-05,Female,63,55-64,5
30,0,3,0,3,2021-11-04,Male,38,35-44,3
30,1,1,0,2,2021-11-05,Female,69,65-69,10
30,0,1,0,1,2021-11-04,Female,43,35-44,4
30,1,9,0,10,2021-11-09,Female,13,10-14,2
30,3,0,0,3,2021-11-08,Male,20,20-24,20
30,0,1,0,1,2021-11-08,Male,39,35-44,9
30,2,0,7,9,2021-11-09,Female,53,45-54,4
30,0,0,0,0,2021-11-09,Male,52,45-54,7
30,0,0,0,0,2021-11-09,Female,65,65-69,22
30,2,0,0,2,2021-11-03,Female,6,5-9,2
30,0,0,0,0,2021-11-09,Male,38,35-44,3
30,0,0,0,0,2021-11-03,Male,45,45-54,6
30,0,1,0,1,2021-11-09,Male,18,15-19,1
30,1,2,0,3,2021-11-08,Female,33,25-34,2
30,1,0,0,1,2021-11-08,Female,24,20-24,1
30,2,0,0,2,2021-11-04,Female,30,25-34,3
30,1,5,0,6,2021-11-09,Male,64,55-64,3
30,0,3,0,3,2021-11-08,Female,55,55-64,10
30,1,0,0,1,2021-11-09,Female,71,70-74,7
30,0,0,0,0,2021-11-05,Male,70,70-74,3
30,3,1,0,4,2021-11-04,Male,57,55-64,9
30,0,17,0,17,2021-11-04,Female,52,45-54,6
30,2,0,0,2,2021-11-04,Male,52,45-54,9
30,1,0,0,1,2021-11-04,Female,53,45-54,4
30,0,2,0,2,2021-11-09,Male,44,35-44,5
30,1,0,0,1,2021-11-05,Male,36,35-44,4
30,1,0,0,1,2021-11-04,Female,67,65-69,10
30,2,0,0,2,2021-11-08,Female,21,20-24,1
30,2,0,0,2,2021-11-04,Male,50,45-54,4
30,0,0,0,0,2021-11-08,Female,65,65-69,8
30,2,0,0,2,2021-11-08,Male,68,65-69,21
30,0,0,0,0,2021-11-04,Female,66,65-69,7
30,0,0,0,0,2021-11-08,Male,50,45-54,4
30,2,3,0,5,2021-11-03,Female,11,10-14,4
30,0,0,0,0,2021-11-08,Female,58,55-64,20
30,1,1,0,2,2021-11-04,Male,45,45-54,9
30,1,0,0,1,2021-11-08,Male,68,65-69,6
30,3,0,52,55,2021-11-03,Male,1,1-4,2
30,1,0,0,1,2021-11-08,Male,73,70-74,4
30,0,0,0,0,2021-11-03,Female,0,<1,2
30,3,0,0,3,2021-11-04,Female,61,55-64,3
30,0,3,0,3,2021-11-04,Male,45,45-54,3
30,1,2,0,3,2021-11-05,Female,62,55-64,2
30,0,0,0,0,2021-11-08,Male,41,35-44,4
30,3,0,0,3,2021-11-03,Female,49,45-54,4
30,0,0,0,0,2021-11-08,Female,65,65-69,9
30,0,0,0,0,2021-11-05,Female,67,65-69,6
30,1,0,0,1,2021-11-04,Male,53,45-54,5
30,3,0,0,3,2021-11-03,Male,2,1-4,2
30,2,0,0,2,2021-11-08,Male,0,<1,1
30,1,0,0,1,2021-11-04,Male,53,45-54,10
30,3,0,0,3,2021-11-08,Male,27,25-34,1
30,1,0,1,2,2021-11-09,Female,74,70-74,9
30,0,1,0,1,2021-11-09,Male,43,35-44,16
30,0,1,0,1,2021-11-05,Male,72,70-74,3
30,1,0,0,1,2021-11-09,Female,65,65-69,3
30,0,0,0,0,2021-11-05,Female,53,45-54,9
30,1,0,0,1,2021-11-08,Female,76,75-79,9
30,0,1,0,1,2021-11-04,Female,59,55-64,4
30,1,0,0,1,2021-11-05,Female,34,25-34,5
30,1,28,0,29,2021-11-04,Female,31,25-34,2
30,2,0,0,2,2021-11-04,Female,60,55-64,3
30,1,0,0,1,2021-11-08,Female,41,35-44,4
30,1,0,0,1,2021-11-04,Female,51,45-54,4
30,0,2,0,2,2021-11-08,Female,58,55-64,4
30,0,0,0,0,2021-11-03,Female,23,20-24,21
30,1,0,0,1,2021-11-03,Male,61,55-64,5
30,1,2,0,3,2021-11-04,Male,54,45-54,3
30,3,0,0,3,2021-11-08,Female,1,1-4,6
30,1,1,0,2,2021-11-03,Female,61,55-64,8
30,2,20,0,22,2021-11-09,Female,49,45-54,6
30,1,0,0,1,2021-11-08,Male,72,70-74,3
30,1,0,2,3,2021-11-04,Female,44,35-44,5
30,0,0,0,0,2021-11-04,Male,57,55-64,3
30,0,0,0,0,2021-11-03,Male,22,20-24,7
30,1,0,0,1,2021-11-05,Male,65,65-69,4
30,0,3,0,3,2021-11-03,Male,52,45-54,4
30,1,0,0,1,2021-11-08,Female,71,70-74,21
30,1,0,0,1,2021-11-09,Male,68,65-69,8
30,3,0,0,3,2021-11-08,Female,6,5-9,1
30,0,0,0,0,2021-11-08,Male,33,25-34,6
30,3,0,0,3,2021-11-05,Male,8,5-9,10
30,0,1,0,1,2021-11-04,Female,59,55-64,7
30,1,0,0,1,2021-11-05,Male,42,35-44,3
30,4,1,0,5,2021-11-08,Male,2,1-4,4
30,2,0,0,2,2021-11-04,Male,53,45-54,3
30,0,0,0,0,2021-11-04,Female,67,65-69,9
30,0,0,0,0,2021-11-03,Male,59,55-64,2
30,1,0,0,1,2021-11-08,Male,65,65-69,8
30,4,0,0,4,2021-11-08,Male,66,65-69,8
30,2,0,0,2,2021-11-08,Female,14,10-14,4
30,0,0,0,0,2021-11-04,Female,7,5-9,3
30,0,4,0,4,2021-11-08,Female,40,35-44,4
30,0,0,0,0,2021-11-08,Male,29,25-34,1
30,1,0,0,1,2021-11-03,Male,53,45-54,5
30,0,0,0,0,2021-11-09,Male,65,65-69,2
30,1,16,15,32,2021-11-09,Male,60,55-64,18
30,0,1,0,1,2021-11-05,Female,43,35-44,4
30,1,0,0,1,2021-11-09,Male,67,65-69,6
30,2,0,0,2,2021-11-04,Male,14,10-14,4
30,1,0,0,1,2021-11-03,Male,71,70-74,3
30,1,0,0,1,2021-11-03,Female,59,55-64,24
30,0,3,0,3,2021-11-04,Female,23,20-24,3
30,2,0,0,2,2021-11-05,Female,3,1-4,2
30,3,0,0,3,2021-11-05,Female,9,5-9,6
30,2,3,0,5,2021-11-04,Male,6,5-9,2
30,3,0,0,3,2021-11-08,Female,50,45-54,4
30,2,0,0,2,2021-11-08,Male,18,15-19,4
30,1,0,0,1,2021-11-09,Female,69,65-69,4
30,0,0,0,0,2021-11-03,Male,21,20-24,10
30,0,0,0,0,2021-11-04,Female,25,25-34,11
30,1,0,0,1,2021-11-04,Female,32,25-34,4
30,1,0,0,1,2021-11-08,Female,49,45-54,8
30,0,3,0,3,2021-11-03,Male,74,70-74,3
30,0,6,0,6,2021-11-08,Male,49,45-54,4
30,2,0,0,2,2021-11-04,Female,17,15-19,3
30,0,0,0,0,2021-11-09,Male,70,70-74,4
30,1,1,0,2,2021-11-09,Male,67,65-69,10
30,0,0,0,0,2021-11-05,Male,35,35-44,9
30,1,0,70,71,2021-11-09,Male,65,65-69,3
30,0,0,0,0,2021-11-08,Female,30,25-34,4
30,0,8,0,8,2021-11-05,Female,56,55-64,2
30,0,0,0,0,2021-11-08,Female,29,25-34,5
30,1,0,0,1,2021-11-04,Female,65,65-69,2
30,0,0,0,0,2021-11-05,Female,64,55-64,4
30,3,0,0,3,2021-11-09,Male,3,1-4,1
30,0,1,0,1,2021-11-08,Male,83,80-84,13
30,0,6,0,6,2021-11-08,Female,25,25-34,1
30,2,0,0,2,2021-11-08,Female,40,35-44,3
30,2,2,0,4,2021-11-08,Male,80,80-84,3
30,1,0,0,1,2021-11-03,Female,63,55-64,3
30,0,0,0,0,2021-11-04,Male,63,55-64,4
30,2,0,0,2,2021-11-03,Female,2,1-4,4
30,1,0,0,1,2021-11-08,Female,31,25-34,1
30,0,0,0,0,2021-11-04,Female,72,70-74,7
30,1,0,0,1,2021-11-04,Female,49,45-54,7
30,1,0,0,1,2021-11-04,Male,58,55-64,4
30,1,1,0,2,2021-11-08,Male,74,70-74,2
30,1,1,0,2,2021-11-04,Male,64,55-64,10
30,0,10,0,10,2021-11-04,Female,44,35-44,10
30,1,1,0,2,2021-11-09,Male,71,70-74,5
30,1,0,0,1,2021-11-03,Male,50,45-54,7
30,1,0,0,1,2021-11-09,Male,37,35-44,14
30,5,2,0,7,2021-11-09,Male,22,20-24,7
30,0,0,0,0,2021-11-09,Female,39,35-44,3
30,1,0,0,1,2021-11-03,Female,22,20-24,11
30,1,1,0,2,2021-11-03,Male,35,35-44,14
30,0,7,0,7,2021-11-04,Male,58,55-64,4
30,0,0,0,0,2021-11-05,Female,42,35-44,4
30,0,0,0,0,2021-11-08,Male,38,35-44,9
30,1,0,0,1,2021-11-03,Female,52,45-54,11
30,1,1,0,2,2021-11-05,Male,73,70-74,5
30,0,0,0,0,2021-11-08,Female,46,45-54,4
30,1,0,0,1,2021-11-04,Male,38,35-44,4
30,1,0,0,1,2021-11-05,Male,63,55-64,3
30,1,0,0,1,2021-11-03,Female,22,20-24,2
30,1,2,0,3,2021-11-03,Male,22,20-24,5
30,0,1,0,1,2021-11-03,Male,61,55-64,3
30,1,0,0,1,2021-11-08,Male,73,70-74,4
30,3,2,0,5,2021-11-08,Female,20,20-24,2
30,3,4,0,7,2021-11-04,Male,7,5-9,4
30,1,0,0,1,2021-11-04,Female,57,55-64,3
30,1,0,0,1,2021-11-05,Male,58,55-64,3
30,0,3,0,3,2021-11-05,Male,63,55-64,3
30,1,0,0,1,2021-11-08,Male,2,1-4,1
30,0,0,0,0,2021-11-04,Male,44,35-44,6
30,1,0,0,1,2021-11-04,Male,52,45-54,6
30,2,0,0,2,2021-11-08,Male,1,1-4,1
30,0,0,0,0,2021-11-05,Female,29,25-34,2
30,1,4,0,5,2021-11-08,Female,63,55-64,8
30,1,0,0,1,2021-11-04,Male,61,55-64,9
30,2,1,0,3,2021-11-04,Male,11,10-14,6
30,1,0,0,1,2021-11-08,Female,27,25-34,1
30,2,2,0,4,2021-11-04,Female,63,55-64,21
30,5,0,0,5,2021-11-03,Male,3,1-4,4
30,0,0,0,0,2021-11-08,Female,33,25-34,1
30,2,2,0,4,2021-11-09,Female,71,70-74,4
30,1,1,0,2,2021-11-05,Male,56,55-64,3
30,1,0,0,1,2021-11-08,Male,69,65-69,3
30,0,1,0,1,2021-11-03,Male,54,45-54,5
30,1,0,0,1,2021-11-03,Male,71,70-74,5
30,0,0,0,0,2021-11-03,Male,59,55-64,14
30,1,0,0,1,2021-11-05,Male,61,55-64,14
30,2,0,0,2,2021-11-08,Male,31,25-34,1
30,0,2,0,2,2021-11-08,Female,51,45-54,10
30,1,0,0,1,2021-11-04,Male,67,65-69,9
30,1,3,0,4,2021-11-09,Female,21,20-24,1
30,1,0,0,1,2021-11-04,Male,58,55-64,4
30,0,1,0,1,2021-11-04,Female,63,55-64,5
30,1,0,0,1,2021-11-09,Male,70,70-74,2
30,1,0,0,1,2021-11-05,Female,64,55-64,7
30,1,0,0,1,2021-11-04,Male,67,65-69,2
30,0,0,0,0,2021-11-03,Male,65,65-69,4
30,2,0,0,2,2021-11-04,Female,53,45-54,21
30,0,13,0,13,2021-11-08,Female,29,25-34,1
30,0,2,0,2,2021-11-08,Female,66,65-69,4
30,0,0,0,0,2021-11-08,Male,54,45-54,5
30,1,0,0,1,2021-11-08,Female,35,35-44,19
30,1,8,0,9,2021-11-04,Male,72,70-74,4
30,1,0,0,1,2021-11-04,Male,40,35-44,6
30,0,0,0,0,2021-11-04,Female,26,25-34,5
30,0,0,0,0,2021-11-04,Female,58,55-64,2
30,1,0,0,1,2021-11-08,Female,38,35-44,8
30,1,0,0,1,2021-11-08,Male,56,55-64,16
30,1,0,0,1,2021-11-08,Female,33,25-34,5
30,3,0,0,3,2021-11-04,Male,14,10-14,3
30,1,1,0,2,2021-11-05,Female,72,70-74,7
30,4,1,0,5,2021-11-08,Female,18,15-19,1
30,1,0,0,1,2021-11-08,Female,69,65-69,3
30,1,0,0,1,2021-11-04,Male,70,70-74,4
30,0,10,0,10,2021-11-03,Female,22,20-24,9
30,4,0,0,4,2021-11-08,Female,21,20-24,1
30,1,0,0,1,2021-11-09,Male,14,10-14,3
30,0,2,0,2,2021-11-05,Female,65,65-69,5
30,0,0,0,0,2021-11-09,Male,72,70-74,4
30,3,0,0,3,2021-11-08,Female,42,35-44,4
30,2,0,0,2,2021-11-04,Female,7,5-9,2
30,1,0,0,1,2021-11-09,Male,69,65-69,9
30,1,0,0,1,2021-11-04,Female,37,35-44,3
30,1,0,0,1,2021-11-08,Male,57,55-64,3
30,0,2,0,2,2021-11-05,Female,77,75-79,9
30,0,4,0,4,2021-11-03,Male,60,55-64,3
30,2,0,0,2,2021-11-04,Male,65,65-69,6
30,1,0,0,1,2021-11-03,Male,22,20-24,5
30,1,1,0,2,2021-11-05,Male,78,75-79,10
30,0,0,0,0,2021-11-08,Male,57,55-64,8
30,1,1,0,2,2021-11-04,Male,62,55-64,10
30,0,0,0,0,2021-11-04,Male,55,55-64,3
30,1,0,0,1,2021-11-08,Female,57,55-64,3
30,0,0,0,0,2021-11-04,Male,36,35-44,3
30,1,0,0,1,2021-11-03,Female,60,55-64,3
30,1,2,0,3,2021-11-03,Female,57,55-64,2
30,0,10,0,10,2021-11-09,Male,80,80-84,5
30,1,0,0,1,2021-11-08,Female,63,55-64,2
30,2,0,1,3,2021-11-03,Female,35,35-44,1
30,1,0,0,1,2021-11-08,Female,39,35-44,5
30,1,0,0,1,2021-11-05,Female,58,55-64,3
30,1,0,0,1,2021-11-08,Female,55,55-64,11
30,3,0,0,3,2021-11-05,Female,37,35-44,8
30,0,2,0,2,2021-11-04,Female,81,80-84,7
30,0,0,0,0,2021-11-04,Female,69,65-69,7
30,1,1,0,2,2021-11-09,Male,80,80-84,3
30,0,0,0,0,2021-11-03,Female,54,45-54,9
30,1,0,0,1,2021-11-04,Male,35,35-44,8
30,1,1,0,2,2021-11-04,Male,21,20-24,2
30,1,5,0,6,2021-11-09,Female,22,20-24,1
30,3,0,0,3,2021-11-08,Male,28,25-34,2
30,1,3,0,4,2021-11-03,Female,30,25-34,4
30,1,5,0,6,2021-11-09,Female,77,75-79,20
30,1,0,0,1,2021-11-08,Male,77,75-79,3
30,3,0,0,3,2021-11-08,Male,3,1-4,2
30,0,0,0,0,2021-11-08,Male,68,65-69,6
30,1,1,0,2,2021-11-09,Male,78,75-79,8
30,0,0,0,0,2021-11-03,Female,25,25-34,5
30,0,0,0,0,2021-11-08,Female,36,35-44,2
30,0,0,0,0,2021-11-05,Female,16,15-19,15
30,1,0,0,1,2021-11-03,Female,32,25-34,7
30,1,5,0,6,2021-11-09,Male,67,65-69,4
30,0,1,0,1,2021-11-03,Female,59,55-64,8
30,2,6,0,8,2021-11-03,Female,7,5-9,3
30,1,0,0,1,2021-11-04,Female,57,55-64,8
30,1,1,0,2,2021-11-08,Male,21,20-24,1
30,0,18,0,18,2021-11-08,Female,27,25-34,1
30,0,0,34,34,2021-11-08,Male,69,65-69,12
30,0,4,0,4,2021-11-04,Female,34,25-34,5
30,1,1,0,2,2021-11-03,Female,67,65-69,8
30,4,0,0,4,2021-11-04,Male,32,25-34,4
30,2,0,0,2,2021-11-06,Male,69,65-69,19
30,1,0,0,1,2021-11-05,Male,68,65-69,5
30,2,0,0,2,2021-11-04,Male,48,45-54,6
30,2,0,0,2,2021-11-03,Male,14,10-14,2
30,2,0,0,2,2021-11-08,Female,20,20-24,1
30,0,0,0,0,2021-11-08,Female,81,80-84,7
30,0,4,21,25,2021-11-04,Female,30,25-34,17
30,1,0,0,1,2021-11-03,Female,14,10-14,4
30,0,3,0,3,2021-11-05,Female,70,70-74,5
30,0,6,13,19,2021-11-09,Male,65,65-69,3
30,1,1,0,2,2021-11-03,Male,75,75-79,3
30,1,0,0,1,2021-11-04,Female,67,65-69,7
30,0,3,0,3,2021-11-09,Male,16,15-19,3
30,1,1,0,2,2021-11-08,Female,72,70-74,3
30,0,0,0,0,2021-11-04,Male,54,45-54,2
30,1,0,0,1,2021-11-08,Female,81,80-84,9
30,3,0,0,3,2021-11-08,Male,13,10-14,3
30,0,1,0,1,2021-11-04,Female,38,35-44,4
30,1,1,0,2,2021-11-04,Female,60,55-64,8
30,3,3,0,6,2021-11-05,Male,2,1-4,4
30,2,10,0,12,2021-11-08,Male,67,65-69,4
30,2,0,0,2,2021-11-03,Male,15,15-19,2
30,1,0,0,1,2021-11-03,Female,51,45-54,3
30,2,1,0,3,2021-11-08,Female,54,45-54,6
30,1,0,0,1,2021-11-03,Male,45,45-54,6
30,0,0,0,0,2021-11-04,Male,43,35-44,10
30,1,0,0,1,2021-11-04,Female,55,55-64,4
30,2,1,0,3,2021-11-03,Male,15,15-19,5
30,1,3,0,4,2021-11-04,Male,40,35-44,3
30,1,0,0,1,2021-11-08,Male,71,70-74,2
30,0,2,0,2,2021-11-05,Female,56,55-64,2
30,2,0,0,2,2021-11-04,Female,55,55-64,5
30,1,1,0,2,2021-11-05,Female,81,80-84,4
30,1,0,0,1,2021-11-04,Female,50,45-54,5
30,1,0,0,1,2021-11-04,Male,66,65-69,2
30,0,1,0,1,2021-11-09,Female,81,80-84,2
30,1,3,0,4,2021-11-09,Male,70,70-74,7
30,1,2,0,3,2021-11-04,Male,51,45-54,5
30,0,3,0,3,2021-11-04,Male,45,45-54,11
30,0,0,0,0,2021-11-05,Female,46,45-54,4
30,0,0,0,0,2021-11-08,Male,43,35-44,5
30,1,0,0,1,2021-11-08,Female,67,65-69,2
30,0,0,0,0,2021-11-08,Male,84,80-84,3
30,1,2,0,3,2021-11-05,Female,25,25-34,7
30,2,0,0,2,2021-11-05,Male,37,35-44,5
30,1,2,0,3,2021-11-09,Female,57,55-64,3
30,1,1,0,2,2021-11-05,Male,54,45-54,3
30,3,16,0,19,2021-11-04,Male,6,5-9,3
30,1,0,0,1,2021-11-04,Male,85,85+,3
30,0,0,0,0,2021-11-08,Male,71,70-74,3
30,1,0,0,1,2021-11-04,Male,28,25-34,6
30,1,0,0,1,2021-11-05,Male,65,65-69,3
30,2,6,0,8,2021-11-04,Male,45,45-54,4
30,1,0,0,1,2021-11-04,Male,31,25-34,5
30,2,1,0,3,2021-11-09,Male,9,5-9,8
30,1,0,0,1,2021-11-05,Female,63,55-64,3
30,0,1,0,1,2021-11-03,Female,31,25-34,13
30,1,1,0,2,2021-11-04,Female,54,45-54,4
30,1,0,0,1,2021-11-03,Male,17,15-19,2
30,0,0,0,0,2021-11-03,Male,69,65-69,3
30,0,1,0,1,2021-11-08,Female,65,65-69,16
30,1,0,0,1,2021-11-04,Female,10,10-14,3
30,2,0,0,2,2021-11-08,Female,18,15-19,1
30,1,0,0,1,2021-11-04,Male,46,45-54,4
30,3,0,0,3,2021-11-04,Male,53,45-54,5
30,1,0,0,1,2021-11-08,Male,73,70-74,18
30,1,0,0,1,2021-11-08,Male,68,65-69,4
30,0,40,0,40,2021-11-04,Male,61,55-64,4
30,0,2,0,2,2021-11-03,Female,59,55-64,2
30,4,2,0,6,2021-11-04,Female,51,45-54,2
30,0,0,0,0,2021-11-03,Male,53,45-54,8
30,1,0,0,1,2021-11-03,Female,66,65-69,8
30,0,0,0,0,2021-11-08,Male,50,45-54,9
30,1,4,0,5,2021-11-05,Male,7,5-9,3
30,2,0,0,2,2021-11-08,Female,18,15-19,1
30,0,4,0,4,2021-11-09,Female,72,70-74,7
30,3,0,0,3,2021-11-09,Male,2,1-4,4
30,0,9,0,9,2021-11-08,Male,36,35-44,13
30,1,0,0,1,2021-11-04,Male,64,55-64,10
30,0,1,0,1,2021-11-08,Female,65,65-69,10
30,0,0,0,0,2021-11-08,Female,27,25-34,3
30,3,0,0,3,2021-11-04,Female,6,5-9,4
30,1,0,0,1,2021-11-05,Female,63,55-64,10
30,0,0,0,0,2021-11-08,Female,19,15-19,7
30,1,0,0,1,2021-11-08,Female,67,65-69,8
30,2,0,0,2,2021-11-08,Male,31,25-34,1
30,1,1,0,2,2021-11-09,Male,79,75-79,2
30,0,0,0,0,2021-11-08,Female,31,25-34,2
30,1,5,0,6,2021-11-03,Female,56,55-64,5
30,1,0,4,5,2021-11-08,Male,33,25-34,1
30,0,6,0,6,2021-11-04,Male,68,65-69,4
30,4,11,0,15,2021-11-04,Male,2,1-4,3
30,0,1,0,1,2021-11-05,Male,63,55-64,6
30,0,0,0,0,2021-11-08,Male,73,70-74,4
30,1,0,0,1,2021-11-04,Male,53,45-54,8
30,2,0,0,2,2021-11-08,Male,12,10-14,4
30,1,0,0,1,2021-11-08,Male,68,65-69,3
30,2,0,0,2,2021-11-03,Male,14,10-14,7
30,1,0,0,1,2021-11-03,Female,20,20-24,4
30,0,1,0,1,2021-11-04,Female,54,45-54,3
30,0,6,0,6,2021-11-08,Female,31,25-34,1
30,3,0,0,3,2021-11-03,Female,1,1-4,19
30,1,0,0,1,2021-11-08,Female,73,70-74,9
30,0,0,0,0,2021-11-08,Male,34,25-34,1
30,2,0,0,2,2021-11-05,Male,16,15-19,4
30,1,2,0,3,2021-11-08,Male,73,70-74,6
30,1,0,0,1,2021-11-08,Female,62,55-64,20
30,1,2,0,3,2021-11-04,Female,54,45-54,3
30,0,9,100,109,2021-11-04,Female,31,25-34,4
30,0,10,0,10,2021-11-03,Female,61,55-64,9
30,0,3,0,3,2021-11-04,Female,54,45-54,10
30,1,0,0,1,2021-11-04,Female,54,45-54,4
30,1,1,0,2,2021-11-03,Male,71,70-74,5
30,2,0,0,2,2021-11-03,Male,13,10-14,3
30,1,0,0,1,2021-11-05,Male,71,70-74,4
30,0,5,41,46,2021-11-04,Male,66,65-69,10
30,3,0,0,3,2021-11-03,Female,2,1-4,8
30,2,0,0,2,2021-11-03,Female,3,1-4,9
30,0,0,0,0,2021-11-03,Female,32,25-34,3
30,0,0,0,0,2021-11-08,Male,30,25-34,3
30,4,0,0,4,2021-11-04,Male,78,75-79,9
30,2,0,0,2,2021-11-07,Male,44,35-44,8
30,3,4,0,7,2021-11-05,Male,22,20-24,5
30,0,0,0,0,2021-11-03,Male,24,20-24,10
30,1,0,0,1,2021-11-08,Female,73,70-74,10
30,1,0,0,1,2021-11-04,Male,57,55-64,10
30,1,0,0,1,2021-11-04,Male,48,45-54,4
30,1,0,0,1,2021-11-04,Female,52,45-54,9
30,3,2,0,5,2021-11-08,Female,16,15-19,1
30,1,0,0,1,2021-11-08,Female,56,55-64,3
30,0,0,0,0,2021-11-09,Male,72,70-74,2
30,1,1,0,2,2021-11-09,Female,69,65-69,20
30,5,0,0,5,2021-11-05,Female,7,5-9,5
30,0,3,3,6,2021-11-03,Female,66,65-69,5
30,2,0,0,2,2021-11-04,Male,15,15-19,4
30,0,1,0,1,2021-11-03,Male,50,45-54,3
30,1,0,0,1,2021-11-03,Female,65,65-69,7
30,1,2,0,3,2021-11-03,Female,51,45-54,2
30,2,0,0,2,2021-11-03,Male,17,15-19,3
30,1,1,0,2,2021-11-04,Male,68,65-69,4
30,3,0,0,3,2021-11-05,Male,60,55-64,6
30,1,0,0,1,2021-11-04,Female,52,45-54,4
30,1,0,0,1,2021-11-08,Female,68,65-69,5
30,0,0,0,0,2021-11-04,Male,51,45-54,9
30,1,3,6,10,2021-11-04,Female,56,55-64,2
30,0,0,0,0,2021-11-03,Female,31,25-34,3
30,0,0,0,0,2021-11-03,Male,59,55-64,8
30,1,0,6,7,2021-11-04,Male,46,45-54,10
30,0,1,0,1,2021-11-03,Male,20,20-24,1
30,2,3,46,51,2021-11-04,Female,18,15-19,5
30,1,1,5,7,2021-11-04,Female,65,65-69,8
30,0,30,0,30,2021-11-04,Male,57,55-64,9
30,0,3,0,3,2021-11-04,Female,62,55-64,8
30,1,1,0,2,2021-11-03,Female,41,35-44,3
30,1,0,0,1,2021-11-04,Male,54,45-54,3
30,1,0,0,1,2021-11-03,Male,69,65-69,9
30,3,0,39,42,2021-11-05,Female,6,5-9,3
30,0,0,0,0,2021-11-04,Female,70,70-74,4
30,0,0,0,0,2021-11-03,Male,61,55-64,3
30,0,0,0,0,2021-11-03,Female,5,5-9,6
30,0,0,0,0,2021-11-09,Male,31,25-34,1
30,0,0,0,0,2021-11-04,Female,8,5-9,4
30,1,0,0,1,2021-11-04,Female,61,55-64,3
30,0,0,0,0,2021-11-04,Male,27,25-34,5
30,1,2,0,3,2021-11-08,Female,42,35-44,16
30,2,0,0,2,2021-11-03,Female,39,35-44,3
30,3,1,0,4,2021-11-09,Female,2,1-4,3
30,1,0,0,1,2021-11-05,Male,55,55-64,12
30,1,3,0,4,2021-11-05,Male,64,55-64,5
30,1,3,0,4,2021-11-08,Male,65,65-69,3
30,1,1,0,2,2021-11-04,Female,69,65-69,3
30,2,0,0,2,2021-11-08,Female,1,1-4,11
30,3,0,0,3,2021-11-08,Male,6,5-9,2
30,0,0,0,0,2021-11-04,Male,41,35-44,3
30,2,0,0,2,2021-11-09,Male,61,55-64,2
30,3,0,0,3,2021-11-08,Male,22,20-24,1
30,0,0,0,0,2021-11-04,Male,18,15-19,8
30,0,3,0,3,2021-11-05,Male,54,45-54,3
30,0,0,0,0,2021-11-08,Male,56,55-64,20
30,0,0,0,0,2021-11-09,Male,67,65-69,5
30,0,1,0,1,2021-11-04,Female,65,65-69,7
30,1,1,0,2,2021-11-03,Male,66,65-69,6
30,0,0,0,0,2021-11-04,Male,38,35-44,4
30,0,0,2,2,2021-11-03,Male,27,25-34,2
30,0,0,0,0,2021-11-04,Female,22,20-24,2
30,1,2,0,3,2021-11-09,Female,65,65-69,4
30,0,1,0,1,2021-11-09,Female,47,45-54,7
30,0,0,0,0,2021-11-04,Female,27,25-34,9
30,1,0,0,1,2021-11-04,Male,74,70-74,5
30,4,0,0,4,2021-11-08,Female,20,20-24,1
30,1,0,0,1,2021-11-04,Male,56,55-64,4
30,0,0,0,0,2021-11-04,Male,54,45-54,2
30,0,0,0,0,2021-11-04,Male,66,65-69,10
30,0,0,0,0,2021-11-04,Female,65,65-69,3
30,0,2,0,2,2021-11-04,Female,45,45-54,3
30,0,6,0,6,2021-11-03,Female,37,35-44,3
30,1,0,0,1,2021-11-04,Male,67,65-69,5
30,2,0,0,2,2021-11-04,Male,54,45-54,3
30,1,0,1,2,2021-11-03,Female,69,65-69,4
30,2,3,0,5,2021-11-09,Male,4,1-4,1
30,3,0,0,3,2021-11-04,Female,0,<1,6
30,1,0,0,1,2021-11-05,Male,71,70-74,9
30,1,3,0,4,2021-11-09,Female,19,15-19,6
30,2,0,0,2,2021-11-08,Female,1,1-4,1
30,0,0,0,0,2021-11-03,Male,60,55-64,4
30,1,1,0,2,2021-11-03,Female,31,25-34,2
30,2,1,0,3,2021-11-09,Female,68,65-69,3
30,1,0,5,6,2021-11-08,Female,19,15-19,1
30,1,0,0,1,2021-11-04,Male,57,55-64,3
30,0,0,0,0,2021-11-08,Male,68,65-69,8
30,1,1,0,2,2021-11-05,Female,27,25-34,4
30,1,0,0,1,2021-11-09,Male,78,75-79,4
30,0,8,0,8,2021-11-03,Female,60,55-64,5
30,2,0,0,2,2021-11-08,Male,5,5-9,4
30,2,0,22,24,2021-11-08,Male,17,15-19,3
30,0,0,0,0,2021-11-04,Female,28,25-34,5
30,1,0,0,1,2021-11-04,Male,70,70-74,10
30,1,0,0,1,2021-11-03,Female,66,65-69,4
30,2,0,0,2,2021-11-09,Female,39,35-44,3
30,0,2,0,2,2021-11-09,Male,35,35-44,9
30,1,0,0,1,2021-11-03,Male,71,70-74,5
30,2,0,0,2,2021-11-03,Female,9,5-9,2
30,0,1,0,1,2021-11-04,Female,74,70-74,5
30,2,0,0,2,2021-11-09,Female,11,10-14,6
30,4,0,0,4,2021-11-04,Female,50,45-54,3
30,1,0,0,1,2021-11-08,Male,76,75-79,8
30,0,0,0,0,2021-11-08,Female,39,35-44,10
30,0,3,0,3,2021-11-04,Female,56,55-64,9
30,0,0,0,0,2021-11-04,Male,55,55-64,7
30,1,2,0,3,2021-11-04,Female,55,55-64,8
30,0,1,0,1,2021-11-08,Female,26,25-34,1
30,0,0,0,0,2021-11-03,Male,59,55-64,7
30,0,1,1,2,2021-11-03,Female,61,55-64,2
30,1,0,54,55,2021-11-05,Male,18,15-19,9
30,1,9,0,10,2021-11-08,Female,57,55-64,2
30,1,0,0,1,2021-11-08,Female,31,25-34,1
30,1,0,0,1,2021-11-08,Female,41,35-44,4
30,3,18,0,21,2021-11-08,Female,4,1-4,2
30,1,0,0,1,2021-11-09,Male,69,65-69,6
30,0,0,0,0,2021-11-05,Male,43,35-44,3
30,0,1,0,1,2021-11-04,Male,41,35-44,8
30,2,1,0,3,2021-11-03,Female,2,1-4,4
30,0,0,0,0,2021-11-09,Female,28,25-34,3
30,1,0,0,1,2021-11-04,Female,65,65-69,10
30,3,0,0,3,2021-11-03,Female,14,10-14,9
30,3,0,0,3,2021-11-08,Female,26,25-34,2
30,1,0,0,1,2021-11-08,Female,22,20-24,1
30,1,0,0,1,2021-11-05,Male,53,45-54,5
30,0,0,0,0,2021-11-04,Male,68,65-69,6
30,0,2,0,2,2021-11-04,Female,51,45-54,10
30,0,0,0,0,2021-11-08,Male,72,70-74,3
30,1,2,0,3,2021-11-03,Female,54,45-54,9
30,1,0,16,17,2021-11-08,Female,10,10-14,3
30,1,3,2,6,2021-11-04,Female,31,25-34,5
30,0,1,0,1,2021-11-04,Female,65,65-69,6
30,0,0,0,0,2021-11-08,Male,78,75-79,6
30,2,0,0,2,2021-11-08,Male,43,35-44,4
30,3,0,0,3,2021-11-04,Male,6,5-9,5
30,2,10,0,12,2021-11-04,Male,55,55-64,5
30,0,0,0,0,2021-11-03,Female,21,20-24,4
30,0,1,0,1,2021-11-08,Female,34,25-34,1
30,0,0,0,0,2021-11-05,Female,35,35-44,4
30,1,0,0,1,2021-11-08,Female,68,65-69,4
30,0,0,0,0,2021-11-04,Male,52,45-54,11
30,0,0,0,0,2021-11-04,Female,31,25-34,4
30,1,1,0,2,2021-11-04,Female,55,55-64,15
30,4,1,42,47,2021-11-04,Female,5,5-9,14
30,3,0,0,3,2021-11-08,Female,34,25-34,13
30,1,1,0,2,2021-11-04,Male,63,55-64,3
30,1,0,0,1,2021-11-08,Male,68,65-69,3
30,0,0,0,0,2021-11-05,Female,26,25-34,4
30,0,5,0,5,2021-11-04,Male,60,55-64,10
30,0,0,0,0,2021-11-08,Female,82,80-84,4
30,0,6,0,6,2021-11-04,Male,54,45-54,4
30,1,4,0,5,2021-11-08,Male,45,45-54,3
30,2,2,0,4,2021-11-03,Male,9,5-9,3
30,0,0,0,0,2021-11-04,Male,54,45-54,8
30,1,0,0,1,2021-11-04,Female,68,65-69,9
30,2,2,0,4,2021-11-04,Female,2,1-4,7
30,0,5,50,55,2021-11-05,Female,31,25-34,4
30,3,0,0,3,2021-11-03,Female,18,15-19,3
30,1,0,0,1,2021-11-04,Female,27,25-34,2
30,1,1,0,2,2021-11-08,Female,67,65-69,4
30,3,0,0,3,2021-11-08,Female,35,35-44,17
30,0,2,4,6,2021-11-04,Male,32,25-34,9
30,1,2,0,3,2021-11-04,Male,18,15-19,6
30,1,0,0,1,2021-11-04,Female,47,45-54,3
30,1,0,0,1,2021-11-08,Male,2,1-4,1
30,2,0,1,3,2021-11-04,Male,19,15-19,3
30,3,0,0,3,2021-11-04,Female,15,15-19,8
30,2,2,0,4,2021-11-03,Female,1,1-4,3
30,1,0,0,1,2021-11-08,Female,39,35-44,5
30,2,0,0,2,2021-11-03,Male,4,1-4,2
30,1,2,0,3,2021-11-08,Male,73,70-74,23
30,2,0,26,28,2021-11-03,Female,3,1-4,3
30,2,0,0,2,2021-11-08,Female,17,15-19,5
30,0,0,0,0,2021-11-08,Female,72,70-74,4
30,0,0,0,0,2021-11-04,Male,66,65-69,3
30,3,6,0,9,2021-11-03,Male,2,1-4,2
30,1,0,0,1,2021-11-04,Female,25,25-34,3
30,2,3,0,5,2021-11-04,Male,5,5-9,2
30,1,0,0,1,2021-11-03,Female,55,55-64,3
30,0,0,0,0,2021-11-03,Female,50,45-54,10
30,0,0,0,0,2021-11-04,Female,69,65-69,4
30,0,0,0,0,2021-11-08,Male,72,70-74,21
30,0,0,0,0,2021-11-04,Male,45,45-54,5
30,1,0,0,1,2021-11-08,Female,56,55-64,15
30,1,0,0,1,2021-11-09,Male,66,65-69,4
30,0,1,0,1,2021-11-09,Female,78,75-79,4
30,1,0,0,1,2021-11-03,Male,14,10-14,2
30,1,0,0,1,2021-11-09,Male,77,75-79,3
30,1,0,0,1,2021-11-03,Male,68,65-69,8
30,2,0,0,2,2021-11-03,Male,18,15-19,6
30,1,0,0,1,2021-11-04,Female,53,45-54,2
30,0,0,0,0,2021-11-04,Male,65,65-69,5
30,3,0,0,3,2021-11-03,Male,13,10-14,2
30,1,0,0,1,2021-11-04,Female,54,45-54,4
30,0,0,0,0,2021-11-03,Female,3,1-4,2
30,0,0,0,0,2021-11-04,Male,68,65-69,4
30,0,0,0,0,2021-11-05,Female,33,25-34,4
30,0,11,0,11,2021-11-04,Female,58,55-64,8
30,0,0,5,5,2021-11-09,Male,65,65-69,2
30,3,1,0,4,2021-11-03,Male,20,20-24,9
30,1,2,0,3,2021-11-09,Female,67,65-69,9
30,1,0,0,1,2021-11-03,Male,59,55-64,6
30,1,0,0,1,2021-11-08,Female,68,65-69,10
30,1,0,0,1,2021-11-03,Male,75,75-79,4
30,2,6,0,8,2021-11-08,Male,0,<1,1
30,3,0,0,3,2021-11-04,Male,0,<1,3
30,3,15,0,18,2021-11-05,Female,2,1-4,5
30,2,0,0,2,2021-11-04,Male,6,5-9,7
30,2,0,0,2,2021-11-08,Male,10,10-14,1
30,1,4,0,5,2021-11-03,Female,29,25-34,2
30,1,19,0,20,2021-11-05,Male,71,70-74,6
30,0,0,0,0,2021-11-08,Male,52,45-54,5
30,3,0,0,3,2021-11-04,Male,65,65-69,7
30,0,0,0,0,2021-11-03,Female,50,45-54,3
30,0,1,0,1,2021-11-05,Female,36,35-44,12
30,0,0,0,0,2021-11-04,Female,77,75-79,7
30,1,1,0,2,2021-11-04,Female,25,25-34,23
30,0,0,0,0,2021-11-08,Female,24,20-24,1
30,1,0,0,1,2021-11-09,Male,76,75-79,3
30,2,2,0,4,2021-11-08,Male,2,1-4,1
30,1,0,0,1,2021-11-08,Female,68,65-69,4
30,0,0,0,0,2021-11-08,Male,61,55-64,4
30,1,4,0,5,2021-11-08,Male,74,70-74,2
30,1,0,0,1,2021-11-04,Male,72,70-74,4
30,0,0,0,0,2021-11-04,Female,9,5-9,9
30,1,8,0,9,2021-11-04,Male,70,70-74,22
30,0,0,0,0,2021-11-03,Male,62,55-64,4
30,1,2,0,3,2021-11-04,Male,72,70-74,3
30,0,0,0,0,2021-11-05,Male,64,55-64,4
30,1,0,0,1,2021-11-04,Female,6,5-9,6
30,0,5,0,5,2021-11-05,Male,44,35-44,4
30,0,3,0,3,2021-11-03,Male,60,55-64,10
30,1,2,0,3,2021-11-03,Male,61,55-64,6
30,3,0,0,3,2021-11-05,Male,0,<1,3
30,0,0,0,0,2021-11-08,Female,74,70-74,4
30,0,2,0,2,2021-11-09,Female,50,45-54,13
30,3,0,0,3,2021-11-03,Female,16,15-19,5
30,1,31,0,32,2021-11-09,Male,71,70-74,3
30,1,0,0,1,2021-11-08,Female,67,65-69,3
30,1,0,0,1,2021-11-03,Male,36,35-44,4
30,3,1,0,4,2021-11-09,Female,57,55-64,5
30,1,2,0,3,2021-11-04,Female,33,25-34,5
30,0,0,5,5,2021-11-03,Female,27,25-34,3
30,1,0,0,1,2021-11-03,Female,75,75-79,4
30,0,0,0,0,2021-11-08,Female,70,70-74,6
30,1,0,0,1,2021-11-08,Female,64,55-64,19
30,2,0,0,2,2021-11-04,Male,3,1-4,6
30,0,0,0,0,2021-11-08,Male,51,45-54,5
30,1,3,0,4,2021-11-08,Male,74,70-74,3
30,0,1,0,1,2021-11-05,Female,41,35-44,6
30,0,0,0,0,2021-11-08,Female,68,65-69,6
30,0,3,0,3,2021-11-04,Male,59,55-64,6
30,2,0,0,2,2021-11-08,Male,18,15-19,10
30,1,0,0,1,2021-11-03,Male,5,5-9,2
30,0,1,0,1,2021-11-08,Male,54,45-54,4
30,0,1,2,3,2021-11-08,Male,65,65-69,4
30,4,15,0,19,2021-11-09,Female,15,15-19,15
30,1,0,0,1,2021-11-08,Male,70,70-74,5
30,1,0,0,1,2021-11-08,Female,24,20-24,4
30,3,1,0,4,2021-11-04,Female,62,55-64,3
30,1,5,0,6,2021-11-03,Male,72,70-74,5
30,0,0,0,0,2021-11-04,Male,54,45-54,6
30,3,0,0,3,2021-11-09,Male,8,5-9,1
30,0,1,0,1,2021-11-03,Female,54,45-54,2
30,1,0,0,1,2021-11-03,Female,42,35-44,3
30,1,0,0,1,2021-11-08,Male,32,25-34,5
30,1,0,0,1,2021-11-08,Male,74,70-74,3
30,1,0,0,1,2021-11-04,Female,68,65-69,9
30,1,0,0,1,2021-11-09,Male,74,70-74,3
30,2,1,0,3,2021-11-04,Male,58,55-64,4
30,0,0,0,0,2021-11-04,Male,10,10-14,4
30,1,0,0,1,2021-11-05,Male,64,55-64,2
30,0,6,0,6,2021-11-09,Male,72,70-74,8
30,0,2,0,2,2021-11-04,Male,69,65-69,2
30,0,0,0,0,2021-11-04,Male,50,45-54,3
30,0,0,0,0,2021-11-03,Female,24,20-24,14
30,2,0,0,2,2021-11-03,Male,1,1-4,3
30,1,4,0,5,2021-11-04,Female,60,55-64,3
30,1,1,0,2,2021-11-03,Female,27,25-34,8
30,2,2,0,4,2021-11-09,Male,75,75-79,22
30,1,0,0,1,2021-11-03,Male,60,55-64,4
30,2,3,0,5,2021-11-08,Female,30,25-34,1
30,2,2,0,4,2021-11-08,Male,53,45-54,4
30,1,0,0,1,2021-11-05,Male,41,35-44,14
30,1,2,0,3,2021-11-03,Female,70,70-74,4
30,0,0,0,0,2021-11-05,Male,48,45-54,3
30,1,0,0,1,2021-11-04,Female,60,55-64,4
30,1,0,0,1,2021-11-03,Male,52,45-54,9
30,1,0,0,1,2021-11-04,Male,40,35-44,4
30,1,30,30,61,2021-11-04,Male,67,65-69,10
30,1,1,0,2,2021-11-09,Female,80,80-84,9
30,0,1,0,1,2021-11-08,Female,37,35-44,2
30,1,4,0,5,2021-11-03,Female,59,55-64,4
30,0,18,0,18,2021-11-08,Male,32,25-34,1
30,1,0,0,1,2021-11-05,Male,46,45-54,6
30,1,2,0,3,2021-11-09,Male,73,70-74,12
30,0,0,0,0,2021-11-08,Male,72,70-74,3
30,0,0,0,0,2021-11-09,Male,74,70-74,3
30,0,0,0,0,2021-11-04,Male,27,25-34,5
30,0,1,0,1,2021-11-03,Female,41,35-44,8
30,0,0,0,0,2021-11-04,Male,53,45-54,4
30,1,0,0,1,2021-11-03,Female,27,25-34,2
30,0,0,0,0,2021-11-04,Male,61,55-64,2
30,0,3,0,3,2021-11-04,Female,42,35-44,4
30,2,0,0,2,2021-11-05,Female,67,65-69,23
30,0,3,0,3,2021-11-03,Female,62,55-64,8
30,1,4,0,5,2021-11-03,Male,12,10-14,9
30,1,0,0,1,2021-11-04,Female,53,45-54,2
30,1,0,0,1,2021-11-04,Female,67,65-69,7
30,1,0,0,1,2021-11-09,Male,44,35-44,7
30,0,0,0,0,2021-11-03,Male,38,35-44,9
30,1,0,0,1,2021-11-05,Male,72,70-74,8
30,2,0,0,2,2021-11-05,Female,68,65-69,4
30,0,0,0,0,2021-11-04,Male,52,45-54,3
30,0,0,0,0,2021-11-03,Female,57,55-64,3
30,3,0,0,3,2021-11-04,Male,5,5-9,9
30,0,0,0,0,2021-11-08,Female,39,35-44,4
30,2,0,0,2,2021-11-03,Female,69,65-69,5
30,3,0,0,3,2021-11-04,Female,9,5-9,5
30,0,0,0,0,2021-11-08,Male,63,55-64,4
30,1,0,0,1,2021-11-04,Male,63,55-64,7
30,2,0,0,2,2021-11-03,Male,72,70-74,9
30,0,0,0,0,2021-11-05,Male,58,55-64,8
30,0,5,0,5,2021-11-09,Female,56,55-64,3
30,0,1,0,1,2021-11-08,Male,66,65-69,10
30,1,2,0,3,2021-11-05,Male,60,55-64,8
30,0,0,0,0,2021-11-04,Female,21,20-24,9
30,0,4,0,4,2021-11-08,Male,17,15-19,6
30,1,0,0,1,2021-11-08,Male,50,45-54,4
30,0,1,0,1,2021-11-08,Male,83,80-84,5
30,0,2,0,2,2021-11-03,Male,34,25-34,13
30,1,0,0,1,2021-11-03,Female,37,35-44,4
30,2,0,0,2,2021-11-09,Male,3,1-4,9
30,1,0,0,1,2021-11-08,Male,65,65-69,9
30,1,5,0,6,2021-11-05,Female,69,65-69,5
30,1,2,0,3,2021-11-04,Female,27,25-34,2
30,1,0,0,1,2021-11-08,Male,67,65-69,9
30,0,0,0,0,2021-11-05,Female,68,65-69,8
30,0,0,0,0,2021-11-04,Male,56,55-64,3
30,2,0,0,2,2021-11-03,Male,13,10-14,8
30,3,0,0,3,2021-11-04,Female,5,5-9,4
30,3,0,0,3,2021-11-08,Male,19,15-19,10
30,1,1,0,2,2021-11-03,Female,29,25-34,2
30,0,0,0,0,2021-11-05,Female,25,25-34,5
30,0,4,0,4,2021-11-04,Male,60,55-64,3
30,0,3,1,4,2021-11-03,Female,63,55-64,6
30,2,0,0,2,2021-11-03,Female,30,25-34,4
30,0,0,0,0,2021-11-09,Male,56,55-64,9
30,2,4,0,6,2021-11-03,Male,52,45-54,4
30,1,1,0,2,2021-11-05,Male,72,70-74,3
30,2,0,0,2,2021-11-08,Male,53,45-54,3
30,0,0,0,0,2021-11-08,Female,70,70-74,9
30,2,0,0,2,2021-11-03,Female,67,65-69,5
30,0,0,0,0,2021-11-08,Female,69,65-69,5
30,0,2,0,2,2021-11-03,Female,54,45-54,3
30,1,0,0,1,2021-11-08,Male,66,65-69,4
30,0,0,0,0,2021-11-03,Male,37,35-44,7
30,0,0,0,0,2021-11-03,Male,60,55-64,4
30,4,0,0,4,2021-11-09,Male,12,10-14,15
30,0,0,11,11,2021-11-04,Male,22,20-24,2
30,1,0,0,1,2021-11-09,Male,85,85+,2
30,2,0,0,2,2021-11-04,Male,18,15-19,4
30,1,0,0,1,2021-11-04,Female,50,45-54,4
30,1,5,0,6,2021-11-03,Female,42,35-44,3
30,3,0,0,3,2021-11-05,Female,33,25-34,2
30,0,0,0,0,2021-11-05,Male,47,45-54,4
30,3,0,3,6,2021-11-09,Female,11,10-14,3
30,0,1,0,1,2021-11-04,Female,58,55-64,2
30,0,0,0,0,2021-11-08,Male,72,70-74,7
30,1,4,0,5,2021-11-09,Male,54,45-54,6
30,1,1,0,2,2021-11-04,Female,53,45-54,10
30,3,15,0,18,2021-11-04,Female,9,5-9,5
30,3,0,1,4,2021-11-08,Female,1,1-4,1
30,0,0,0,0,2021-11-04,Female,60,55-64,12
30,3,0,0,3,2021-11-08,Female,67,65-69,2
30,0,2,0,2,2021-11-06,Female,51,45-54,2
30,2,2,0,4,2021-11-03,Male,33,25-34,2
30,0,0,0,0,2021-11-05,Female,64,55-64,3
30,3,0,0,3,2021-11-04,Male,66,65-69,4
30,1,0,0,1,2021-11-05,Female,59,55-64,3
30,2,0,0,2,2021-11-08,Female,48,45-54,9
30,2,0,0,2,2021-11-03,Female,54,45-54,14
30,1,0,0,1,2021-11-03,Female,61,55-64,2
30,1,0,0,1,2021-11-04,Male,63,55-64,6
30,1,0,5,6,2021-11-04,Male,67,65-69,3
30,2,0,0,2,2021-11-04,Female,18,15-19,6
30,1,6,0,7,2021-11-04,Female,56,55-64,16
30,0,0,0,0,2021-11-03,Female,41,35-44,7
30,2,1,0,3,2021-11-08,Male,66,65-69,5
30,1,0,0,1,2021-11-03,Male,59,55-64,4
30,3,1,0,4,2021-11-08,Male,28,25-34,1
30,3,0,0,3,2021-11-09,Male,17,15-19,4
30,1,0,0,1,2021-11-08,Male,17,15-19,6
30,0,0,0,0,2021-11-03,Male,43,35-44,4
30,4,0,0,4,2021-11-04,Male,3,1-4,4
30,1,0,0,1,2021-11-05,Male,65,65-69,9
30,1,0,0,1,2021-11-08,Female,23,20-24,5
30,0,2,0,2,2021-11-08,Male,57,55-64,5
30,1,0,0,1,2021-11-03,Female,50,45-54,3
30,1,1,0,2,2021-11-08,Male,65,65-69,3
30,1,0,0,1,2021-11-04,Male,59,55-64,2
30,2,0,0,2,2021-11-08,Female,20,20-24,1
30,0,5,0,5,2021-11-04,Male,46,45-54,4
30,1,1,0,2,2021-11-08,Male,6,5-9,1
30,1,0,0,1,2021-11-04,Female,72,70-74,4
30,0,0,1,1,2021-11-04,Male,64,55-64,10
30,0,0,0,0,2021-11-09,Male,81,80-84,3
30,1,0,0,1,2021-11-03,Female,62,55-64,10
30,1,5,0,6,2021-11-03,Male,59,55-64,2
30,2,2,0,4,2021-11-03,Female,11,10-14,4
30,0,3,0,3,2021-11-05,Female,65,65-69,2
30,2,0,0,2,2021-11-08,Male,70,70-74,3
30,1,0,0,1,2021-11-08,Male,73,70-74,3
30,3,16,0,19,2021-11-03,Female,4,1-4,3
30,0,0,0,0,2021-11-08,Female,80,80-84,4
30,1,0,0,1,2021-11-08,Male,72,70-74,3
30,2,0,0,2,2021-11-04,Female,25,25-34,7
30,3,2,43,48,2021-11-04,Male,17,15-19,2
30,0,0,0,0,2021-11-08,Female,35,35-44,5
30,5,0,0,5,2021-11-03,Female,60,55-64,3
30,0,5,0,5,2021-11-05,Female,78,75-79,3
30,0,0,0,0,2021-11-04,Male,59,55-64,3
30,0,0,0,0,2021-11-04,Male,69,65-69,10
30,1,0,0,1,2021-11-04,Male,39,35-44,9
30,0,0,0,0,2021-11-03,Male,31,25-34,3
30,0,0,0,0,2021-11-03,Female,40,35-44,7
30,1,2,0,3,2021-11-05,Male,68,65-69,16
30,1,3,0,4,2021-11-08,Male,71,70-74,10
30,0,0,0,0,2021-11-08,Male,65,65-69,5
30,1,0,0,1,2021-11-04,Female,51,45-54,4
30,1,12,0,13,2021-11-05,Male,65,65-69,4
30,1,0,0,1,2021-11-08,Female,32,25-34,1
30,0,0,0,0,2021-11-04,Male,62,55-64,8
30,0,6,0,6,2021-11-04,Female,55,55-64,3
30,1,1,0,2,2021-11-04,Male,59,55-64,10
30,1,0,0,1,2021-11-08,Male,47,45-54,10
30,1,0,0,1,2021-11-05,Male,11,10-14,5
30,0,0,0,0,2021-11-03,Female,33,25-34,5
30,5,15,29,49,2021-11-03,Female,14,10-14,3
30,0,0,0,0,2021-11-08,Male,38,35-44,14
30,0,0,0,0,2021-11-08,Female,26,25-34,1
30,0,0,0,0,2021-11-08,Female,8,5-9,15
30,1,2,0,3,2021-11-04,Male,72,70-74,3
30,0,0,0,0,2021-11-05,Female,50,45-54,6
30,1,1,0,2,2021-11-04,Female,49,45-54,5
30,1,1,0,2,2021-11-08,Male,52,45-54,4
30,1,0,0,1,2021-11-04,Male,78,75-79,8
30,1,0,0,1,2021-11-05,Male,62,55-64,10
30,0,0,0,0,2021-11-08,Male,72,70-74,4
30,0,0,0,0,2021-11-08,Female,68,65-69,23
30,1,0,0,1,2021-11-04,Female,70,70-74,2
30,0,1,0,1,2021-11-05,Male,59,55-64,2
30,1,1,0,2,2021-11-04,Female,26,25-34,5
30,1,0,0,1,2021-11-05,Male,63,55-64,4
30,2,3,0,5,2021-11-04,Male,69,65-69,4
30,1,1,0,2,2021-11-04,Male,53,45-54,2
30,0,0,0,0,2021-11-04,Male,22,20-24,4
30,4,0,0,4,2021-11-08,Female,11,10-14,9
30,1,1,0,2,2021-11-04,Male,44,35-44,18
30,1,2,0,3,2021-11-05,Female,63,55-64,17
30,1,0,0,1,2021-11-09,Male,81,80-84,3
30,0,0,0,0,2021-11-08,Male,54,45-54,6
30,3,0,0,3,2021-11-08,Male,6,5-9,4
30,1,0,0,1,2021-11-03,Male,66,65-69,3
30,0,0,0,0,2021-11-04,Female,66,65-69,4
30,1,0,0,1,2021-11-04,Female,31,25-34,2
30,0,6,0,6,2021-11-03,Female,59,55-64,4
30,0,0,0,0,2021-11-08,Female,33,25-34,2
30,1,0,0,1,2021-11-05,Male,67,65-69,3
30,2,0,0,2,2021-11-08,Female,48,45-54,10
30,1,2,0,3,2021-11-04,Male,65,65-69,9
30,0,0,0,0,2021-11-03,Female,60,55-64,3
30,0,1,0,1,2021-11-04,Female,30,25-34,9
30,0,0,0,0,2021-11-08,Female,40,35-44,5
30,0,0,4,4,2021-11-05,Female,31,25-34,4
30,1,0,0,1,2021-11-04,Male,71,70-74,8
30,3,0,0,3,2021-11-09,Male,14,10-14,4
30,1,0,0,1,2021-11-03,Male,53,45-54,10
30,1,0,0,1,2021-11-08,Male,66,65-69,9
30,1,0,0,1,2021-11-03,Male,50,45-54,4
30,0,0,0,0,2021-11-03,Female,38,35-44,12
30,0,0,0,0,2021-11-04,Male,47,45-54,7
30,0,0,0,0,2021-11-03,Male,73,70-74,4
30,1,0,0,1,2021-11-08,Male,80,80-84,5
30,0,0,0,0,2021-11-04,Male,27,25-34,3
30,1,1,0,2,2021-11-04,Male,31,25-34,3
30,2,0,0,2,2021-11-08,Female,65,65-69,4
30,1,4,0,5,2021-11-09,Female,67,65-69,3
30,1,0,0,1,2021-11-04,Female,71,70-74,4
30,0,3,0,3,2021-11-04,Male,58,55-64,5
30,0,0,0,0,2021-11-03,Male,57,55-64,4
30,2,0,0,2,2021-11-04,Female,11,10-14,3
30,1,0,0,1,2021-11-03,Female,61,55-64,4
30,1,2,0,3,2021-11-08,Male,5,5-9,6
30,0,1,0,1,2021-11-04,Female,4,1-4,2
30,0,0,0,0,2021-11-04,Female,44,35-44,9
30,0,2,0,2,2021-11-09,Female,66,65-69,4
30,0,1,0,1,2021-11-09,Female,75,75-79,4
30,1,0,0,1,2021-11-03,Male,60,55-64,3
30,0,2,0,2,2021-11-04,Female,54,45-54,2
30,1,2,0,3,2021-11-05,Female,51,45-54,3
30,0,0,0,0,2021-11-08,Male,67,65-69,2
30,1,0,0,1,2021-11-05,Male,64,55-64,10
30,2,1,0,3,2021-11-04,Female,32,25-34,4
30,0,0,0,0,2021-11-04,Female,21,20-24,11
30,1,0,0,1,2021-11-04,Male,52,45-54,3
30,0,0,0,0,2021-11-04,Female,30,25-34,4
30,0,7,0,7,2021-11-08,Male,49,45-54,5
30,0,1,0,1,2021-11-05,Female,44,35-44,4
30,1,1,0,2,2021-11-04,Male,55,55-64,8
30,1,1,0,2,2021-11-03,Male,71,70-74,5
30,0,0,0,0,2021-11-04,Female,53,45-54,3
30,1,0,0,1,2021-11-08,Male,68,65-69,10
30,1,0,0,1,2021-11-03,Female,1,1-4,4
30,1,0,0,1,2021-11-03,Male,59,55-64,9
30,1,0,0,1,2021-11-03,Male,53,45-54,5
30,1,0,0,1,2021-11-08,Male,68,65-69,8
30,1,0,0,1,2021-11-09,Female,28,25-34,8
30,1,0,0,1,2021-11-08,Female,77,75-79,4
30,1,0,0,1,2021-11-08,Male,67,65-69,22
30,1,0,0,1,2021-11-04,Male,44,35-44,6
30,0,0,0,0,2021-11-04,Male,33,25-34,8
30,1,0,0,1,2021-11-09,Female,32,25-34,3
30,2,3,0,5,2021-11-08,Female,2,1-4,1
30,2,0,0,2,2021-11-04,Female,54,45-54,23
30,1,0,0,1,2021-11-04,Male,53,45-54,10
30,1,0,0,1,2021-11-09,Male,70,70-74,2
30,3,0,0,3,2021-11-05,Female,4,1-4,17
30,1,0,0,1,2021-11-04,Female,67,65-69,10
30,1,2,0,3,2021-11-05,Male,81,80-84,3
30,0,10,0,10,2021-11-04,Male,30,25-34,2
30,1,0,0,1,2021-11-08,Female,31,25-34,4
30,0,1,0,1,2021-11-08,Female,72,70-74,8
30,1,2,0,3,2021-11-08,Female,45,45-54,6
30,1,0,0,1,2021-11-04,Female,12,10-14,21
30,2,1,0,3,2021-11-09,Female,67,65-69,21
30,1,0,0,1,2021-11-04,Male,37,35-44,5
30,2,16,0,18,2021-11-03,Male,10,10-14,2
30,3,1,0,4,2021-11-05,Female,15,15-19,2
30,2,1,0,3,2021-11-03,Female,15,15-19,5
30,0,0,0,0,2021-11-04,Female,53,45-54,3
30,3,0,0,3,2021-11-03,Male,35,35-44,20
30,0,0,0,0,2021-11-03,Male,71,70-74,6
30,1,0,0,1,2021-11-08,Female,64,55-64,19
30,0,2,0,2,2021-11-08,Female,69,65-69,14
30,1,0,0,1,2021-11-04,Female,52,45-54,5
30,0,0,0,0,2021-11-03,Female,28,25-34,5
30,0,1,0,1,2021-11-07,Male,24,20-24,6
30,1,0,0,1,2021-11-03,Female,61,55-64,10
30,1,0,0,1,2021-11-04,Female,47,45-54,3
30,2,1,22,25,2021-11-09,Female,10,10-14,10
30,0,0,0,0,2021-11-08,Male,46,45-54,10
30,4,38,0,42,2021-11-08,Male,3,1-4,3
30,0,0,0,0,2021-11-08,Female,15,15-19,4
30,0,0,0,0,2021-11-09,Male,78,75-79,7
30,2,1,0,3,2021-11-04,Male,4,1-4,10
30,0,0,0,0,2021-11-09,Male,43,35-44,8
30,1,0,0,1,2021-11-03,Male,22,20-24,4
30,1,0,0,1,2021-11-04,Male,63,55-64,26
30,3,0,0,3,2021-11-08,Male,8,5-9,1
30,2,1,0,3,2021-11-08,Male,18,15-19,2
30,1,1,0,2,2021-11-03,Male,51,45-54,5
30,0,0,0,0,2021-11-04,Male,67,65-69,4
30,4,0,0,4,2021-11-05,Male,4,1-4,2
30,1,0,0,1,2021-11-04,Female,55,55-64,3
30,0,0,0,0,2021-11-03,Female,54,45-54,5
30,1,1,0,2,2021-11-09,Female,66,65-69,9
30,3,5,0,8,2021-11-04,Male,12,10-14,3
30,2,0,0,2,2021-11-03,Male,60,55-64,4
30,0,0,0,0,2021-11-05,Male,58,55-64,4
30,0,12,0,12,2021-11-04,Female,44,35-44,6
30,1,0,0,1,2021-11-04,Male,64,55-64,2
30,0,38,2,40,2021-11-03,Female,32,25-34,2
30,1,0,0,1,2021-11-08,Male,68,65-69,18
30,0,0,0,0,2021-11-04,Female,53,45-54,6
30,1,0,0,1,2021-11-05,Male,78,75-79,4
30,1,0,0,1,2021-11-08,Female,71,70-74,4
30,1,0,0,1,2021-11-04,Male,69,65-69,2
30,1,1,0,2,2021-11-08,Female,49,45-54,3
30,1,0,0,1,2021-11-08,Female,50,45-54,3
30,4,0,0,4,2021-11-08,Female,20,20-24,1
30,1,0,0,1,2021-11-03,Male,49,45-54,4
30,1,0,0,1,2021-11-04,Male,76,75-79,13
30,1,1,0,2,2021-11-04,Female,61,55-64,3
30,2,0,0,2,2021-11-05,Male,3,1-4,3
30,1,0,0,1,2021-11-04,Female,29,25-34,2
30,1,0,0,1,2021-11-08,Female,41,35-44,7
30,1,0,0,1,2021-11-09,Male,80,80-84,4
30,0,0,0,0,2021-11-08,Female,27,25-34,2
30,0,0,0,0,2021-11-03,Female,67,65-69,10
30,1,0,0,1,2021-11-03,Male,60,55-64,3
30,1,0,0,1,2021-11-08,Female,50,45-54,4
30,0,0,0,0,2021-11-05,Male,45,45-54,7
30,1,0,0,1,2021-11-08,Male,64,55-64,4
30,0,2,0,2,2021-11-04,Female,44,35-44,8
30,1,0,0,1,2021-11-04,Male,66,65-69,5
30,0,0,0,0,2021-11-08,Male,35,35-44,19
30,1,0,0,1,2021-11-05,Male,62,55-64,3
30,0,4,0,4,2021-11-04,Female,41,35-44,3
30,0,0,4,4,2021-11-08,Male,27,25-34,4
30,2,0,0,2,2021-11-04,Female,27,25-34,1
30,2,0,5,7,2021-11-08,Female,7,5-9,1
30,0,3,0,3,2021-11-05,Female,32,25-34,6
30,1,0,0,1,2021-11-09,Male,51,45-54,8
30,1,0,0,1,2021-11-05,Male,73,70-74,3
30,0,7,0,7,2021-11-04,Male,27,25-34,6
30,3,1,27,31,2021-11-03,Male,8,5-9,3
30,2,0,0,2,2021-11-04,Female,36,35-44,10
30,2,0,0,2,2021-11-08,Male,0,<1,1
30,0,0,0,0,2021-11-08,Male,75,75-79,2
30,1,0,0,1,2021-11-08,Male,70,70-74,4
30,1,0,0,1,2021-11-04,Male,57,55-64,9
30,1,0,0,1,2021-11-08,Female,21,20-24,1
30,2,0,0,2,2021-11-09,Male,11,10-14,4
30,3,2,0,5,2021-11-08,Female,18,15-19,10
30,1,0,0,1,2021-11-08,Female,32,25-34,1
30,3,0,0,3,2021-11-05,Male,7,5-9,4
30,1,4,0,5,2021-11-04,Female,60,55-64,2
30,0,0,0,0,2021-11-09,Female,67,65-69,6
30,1,0,0,1,2021-11-08,Male,32,25-34,1
30,0,0,0,0,2021-11-08,Female,71,70-74,15
30,1,0,0,1,2021-11-03,Female,52,45-54,9
30,0,0,0,0,2021-11-03,Male,62,55-64,3
30,1,0,0,1,2021-11-08,Female,42,35-44,2
30,0,0,0,0,2021-11-04,Male,72,70-74,4
30,1,1,0,2,2021-11-08,Male,73,70-74,5
30,1,2,0,3,2021-11-04,Male,30,25-34,4
30,4,0,0,4,2021-11-08,Male,11,10-14,4
30,0,0,0,0,2021-11-04,Female,66,65-69,8
30,1,0,0,1,2021-11-04,Female,33,25-34,5
30,1,0,0,1,2021-11-09,Male,65,65-69,2
30,1,0,0,1,2021-11-05,Female,64,55-64,19
30,1,2,0,3,2021-11-09,Male,35,35-44,2
30,2,2,0,4,2021-11-05,Female,65,65-69,8
30,1,0,2,3,2021-11-04,Female,32,25-34,7
30,2,0,0,2,2021-11-05,Female,68,65-69,4
30,3,0,0,3,2021-11-08,Male,10,10-14,12
30,0,0,3,3,2021-11-04,Female,28,25-34,4
30,2,0,0,2,2021-11-04,Female,11,10-14,8
30,1,0,0,1,2021-11-04,Female,45,45-54,8
30,1,2,0,3,2021-11-04,Male,69,65-69,4
30,1,1,2,4,2021-11-09,Male,67,65-69,4
30,1,0,0,1,2021-11-04,Female,54,45-54,8
30,3,0,0,3,2021-11-09,Female,36,35-44,7
30,1,0,0,1,2021-11-03,Female,64,55-64,3
30,1,0,0,1,2021-11-09,Female,39,35-44,6
30,1,0,0,1,2021-11-08,Male,74,70-74,2
30,2,0,0,2,2021-11-08,Male,16,15-19,4
30,0,0,0,0,2021-11-03,Male,68,65-69,9
30,2,1,0,3,2021-11-08,Female,21,20-24,1
30,0,0,0,0,2021-11-04,Male,37,35-44,9
30,0,2,0,2,2021-11-03,Female,70,70-74,4
30,0,0,0,0,2021-11-08,Female,72,70-74,3
30,1,0,0,1,2021-11-04,Female,34,25-34,4
30,2,0,0,2,2021-11-08,Female,13,10-14,2
30,2,1,0,3,2021-11-04,Female,30,25-34,5
30,1,0,0,1,2021-11-08,Male,80,80-84,4
30,1,0,0,1,2021-11-04,Female,48,45-54,4
30,0,0,0,0,2021-11-08,Male,36,35-44,6
30,2,0,0,2,2021-11-08,Female,12,10-14,1
30,2,2,0,4,2021-11-08,Male,9,5-9,4
30,1,0,0,1,2021-11-08,Male,71,70-74,4
30,1,0,0,1,2021-11-04,Male,70,70-74,10
30,0,0,0,0,2021-11-03,Female,47,45-54,4
30,1,1,0,2,2021-11-03,Female,57,55-64,3
30,1,0,0,1,2021-11-09,Male,48,45-54,9
30,1,1,0,2,2021-11-08,Female,72,70-74,8
30,1,0,0,1,2021-11-09,Male,78,75-79,9
30,0,4,0,4,2021-11-03,Female,64,55-64,2
30,0,7,0,7,2021-11-04,Female,56,55-64,10
30,3,4,0,7,2021-11-04,Male,53,45-54,9
30,0,2,0,2,2021-11-04,Female,67,65-69,3
30,1,1,0,2,2021-11-08,Male,75,75-79,5
30,0,0,0,0,2021-11-03,Male,51,45-54,10
30,0,0,0,0,2021-11-04,Female,35,35-44,9
30,2,0,0,2,2021-11-05,Male,65,65-69,10
30,0,6,0,6,2021-11-08,Female,46,45-54,3
30,2,1,0,3,2021-11-08,Male,6,5-9,1
30,1,0,0,1,2021-11-04,Female,59,55-64,5
30,1,0,0,1,2021-11-03,Male,32,25-34,2
30,2,0,0,2,2021-11-09,Female,3,1-4,7
30,0,0,0,0,2021-11-03,Female,33,25-34,3
30,0,0,0,0,2021-11-04,Female,19,15-19,9
30,0,0,0,0,2021-11-09,Female,44,35-44,4
30,0,0,0,0,2021-11-09,Female,68,65-69,14
30,2,0,0,2,2021-11-08,Male,0,<1,8
30,0,0,0,0,2021-11-03,Male,69,65-69,7
30,0,0,0,0,2021-11-04,Female,77,75-79,16
30,3,5,0,8,2021-11-03,Male,13,10-14,10
30,1,0,0,1,2021-11-08,Male,72,70-74,6
30,0,2,0,2,2021-11-08,Male,66,65-69,2
30,1,0,0,1,2021-11-03,Male,72,70-74,4
30,1,17,5,23,2021-11-03,Female,59,55-64,3
30,1,0,0,1,2021-11-04,Male,37,35-44,4
30,1,5,0,6,2021-11-09,Male,63,55-64,3
30,2,0,0,2,2021-11-08,Male,9,5-9,1
30,2,0,0,2,2021-11-04,Male,40,35-44,8
30,0,0,0,0,2021-11-03,Male,51,45-54,4
30,1,0,0,1,2021-11-08,Male,72,70-74,4
30,3,0,0,3,2021-11-04,Male,1,1-4,5
30,3,0,0,3,2021-11-08,Female,12,10-14,17
30,0,1,0,1,2021-11-09,Female,65,65-69,5
30,0,0,0,0,2021-11-08,Male,71,70-74,2
30,2,0,0,2,2021-11-03,Male,46,45-54,4
30,1,11,0,12,2021-11-04,Male,55,55-64,3
30,2,1,0,3,2021-11-09,Male,4,1-4,1
30,1,0,0,1,2021-11-09,Male,65,65-69,4
30,3,4,0,7,2021-11-09,Female,10,10-14,4
30,1,0,0,1,2021-11-08,Female,47,45-54,2
30,1,0,0,1,2021-11-05,Male,73,70-74,3
30,0,3,0,3,2021-11-04,Female,64,55-64,2
30,1,10,0,11,2021-11-03,Male,19,15-19,8
30,1,0,0,1,2021-11-05,Male,75,75-79,3
30,1,14,0,15,2021-11-09,Male,77,75-79,3
30,1,2,0,3,2021-11-09,Male,43,35-44,3
30,0,0,0,0,2021-11-08,Female,42,35-44,6
30,0,0,1,1,2021-11-04,Male,32,25-34,3
30,1,2,0,3,2021-11-09,Male,66,65-69,9
30,1,0,0,1,2021-11-04,Male,30,25-34,5
30,0,0,0,0,2021-11-08,Male,5,5-9,4
30,0,0,0,0,2021-11-04,Male,47,45-54,6
30,2,18,0,20,2021-11-03,Female,4,1-4,4
30,1,2,0,3,2021-11-09,Male,71,70-74,9
30,3,0,0,3,2021-11-05,Female,4,1-4,8
30,1,0,0,1,2021-11-03,Female,60,55-64,3
30,2,0,0,2,2021-11-04,Male,49,45-54,24
30,1,1,0,2,2021-11-09,Male,53,45-54,2
30,0,5,0,5,2021-11-03,Female,33,25-34,4
30,0,2,0,2,2021-11-09,Male,61,55-64,8
30,0,0,0,0,2021-11-08,Female,9,5-9,1
30,1,0,0,1,2021-11-03,Female,52,45-54,2
30,0,1,0,1,2021-11-08,Female,33,25-34,1
30,0,4,7,11,2021-11-04,Female,67,65-69,3
30,2,0,0,2,2021-11-04,Female,16,15-19,3
30,0,0,0,0,2021-11-08,Female,79,75-79,10
30,1,0,0,1,2021-11-03,Female,34,25-34,4
30,1,0,0,1,2021-11-08,Female,66,65-69,9
30,1,3,0,4,2021-11-08,Female,74,70-74,4
30,0,0,0,0,2021-11-08,Male,72,70-74,4
30,0,5,0,5,2021-11-03,Male,71,70-74,4
30,1,0,1,2,2021-11-04,Male,70,70-74,3
30,1,0,0,1,2021-11-08,Female,69,65-69,10
30,0,0,0,0,2021-11-03,Female,51,45-54,3
30,0,0,0,0,2021-11-03,Male,22,20-24,2
30,0,1,0,1,2021-11-09,Male,41,35-44,8
30,1,0,0,1,2021-11-05,Female,33,25-34,6
30,1,2,0,3,2021-11-08,Female,53,45-54,3
30,0,0,0,0,2021-11-04,Female,67,65-69,4
30,1,0,0,1,2021-11-08,Male,49,45-54,4
30,1,0,0,1,2021-11-08,Female,34,25-34,8
30,0,0,0,0,2021-11-03,Male,53,45-54,7
30,0,2,0,2,2021-11-04,Male,53,45-54,10
30,3,20,0,23,2021-11-04,Male,8,5-9,2
30,2,1,0,3,2021-11-04,Male,12,10-14,2
30,1,0,0,1,2021-11-07,Female,70,70-74,10
30,0,1,0,1,2021-11-09,Female,33,25-34,4
30,2,0,0,2,2021-11-03,Female,13,10-14,3
30,1,0,0,1,2021-11-04,Female,54,45-54,8
30,1,0,0,1,2021-11-04,Male,54,45-54,3
30,1,0,0,1,2021-11-05,Female,66,65-69,9
30,3,0,4,7,2021-11-09,Female,13,10-14,3
30,0,12,11,23,2021-11-04,Female,72,70-74,3
30,1,3,0,4,2021-11-08,Male,73,70-74,3
30,1,1,1,3,2021-11-05,Female,68,65-69,2
30,0,0,14,14,2021-11-04,Female,48,45-54,2
30,1,0,20,21,2021-11-08,Male,11,10-14,4
30,3,0,0,3,2021-11-04,Male,0,<1,3
30,1,0,0,1,2021-11-08,Female,34,25-34,2
30,1,0,0,1,2021-11-03,Female,54,45-54,4
30,0,0,0,0,2021-11-08,Male,45,45-54,9
30,3,0,0,3,2021-11-04,Female,3,1-4,6
30,1,1,0,2,2021-11-05,Male,74,70-74,4
30,2,61,0,63,2021-11-08,Male,31,25-34,1
30,1,0,0,1,2021-11-09,Female,66,65-69,10
30,0,0,0,0,2021-11-08,Male,14,10-14,1
30,1,0,0,1,2021-11-04,Male,57,55-64,10
30,1,2,0,3,2021-11-03,Female,32,25-34,14
30,0,0,0,0,2021-11-09,Female,75,75-79,3
30,1,0,0,1,2021-11-04,Female,55,55-64,19
30,0,0,0,0,2021-11-05,Female,58,55-64,3
30,1,0,0,1,2021-11-08,Male,65,65-69,2
30,2,0,0,2,2021-11-04,Male,14,10-14,4
30,1,0,0,1,2021-11-04,Female,67,65-69,2
30,0,2,0,2,2021-11-03,Male,46,45-54,3
30,1,0,0,1,2021-11-05,Female,26,25-34,2
30,0,0,0,0,2021-11-04,Male,70,70-74,4
30,0,2,0,2,2021-11-03,Male,24,20-24,16
30,1,0,0,1,2021-11-03,Female,53,45-54,3
30,1,0,0,1,2021-11-04,Male,74,70-74,4
30,1,1,0,2,2021-11-04,Male,65,65-69,4
30,0,0,0,0,2021-11-08,Male,46,45-54,10
30,0,0,0,0,2021-11-03,Male,32,25-34,3
30,1,0,0,1,2021-11-08,Male,70,70-74,3
30,3,1,0,4,2021-11-05,Male,9,5-9,7
30,0,0,0,0,2021-11-05,Female,48,45-54,4
30,1,0,0,1,2021-11-04,Male,67,65-69,4
30,1,1,0,2,2021-11-04,Male,59,55-64,2
30,2,0,0,2,2021-11-04,Male,59,55-64,4
30,0,0,0,0,2021-11-04,Female,29,25-34,14
30,0,0,0,0,2021-11-04,Female,61,55-64,2
30,2,3,0,5,2021-11-05,Male,63,55-64,10
30,0,0,0,0,2021-11-04,Female,31,25-34,6
30,0,0,0,0,2021-11-04,Female,41,35-44,3
30,0,0,2,2,2021-11-09,Male,21,20-24,1
30,1,0,0,1,2021-11-03,Male,53,45-54,2
30,2,0,0,2,2021-11-08,Female,18,15-19,3
30,2,1,0,3,2021-11-05,Female,22,20-24,4
30,0,7,0,7,2021-11-03,Female,66,65-69,10
30,2,0,0,2,2021-11-03,Female,80,80-84,23
30,0,0,0,0,2021-11-05,Female,17,15-19,8
30,1,0,0,1,2021-11-08,Male,72,70-74,4
30,3,4,0,7,2021-11-05,Female,66,65-69,8
30,0,1,0,1,2021-11-03,Female,61,55-64,10
30,1,2,0,3,2021-11-09,Female,53,45-54,9
30,0,0,0,0,2021-11-09,Female,71,70-74,3
30,1,0,0,1,2021-11-08,Female,49,45-54,7
30,2,2,0,4,2021-11-09,Female,22,20-24,1
30,0,0,4,4,2021-11-04,Male,29,25-34,3
30,0,2,0,2,2021-11-03,Female,59,55-64,3
30,1,0,0,1,2021-11-08,Female,45,45-54,3
30,3,1,0,4,2021-11-06,Female,10,10-14,15
30,0,2,0,2,2021-11-08,Male,67,65-69,18
30,0,0,0,0,2021-11-03,Male,58,55-64,3
30,0,0,0,0,2021-11-03,Female,22,20-24,4
30,1,0,0,1,2021-11-03,Female,52,45-54,5
30,0,0,0,0,2021-11-08,Female,34,25-34,1
30,1,0,0,1,2021-11-09,Male,73,70-74,3
30,0,0,0,0,2021-11-04,Male,44,35-44,5
30,1,0,0,1,2021-11-08,Male,20,20-24,1
30,1,2,0,3,2021-11-04,Female,36,35-44,3
30,1,12,0,13,2021-11-05,Female,57,55-64,2
30,1,0,0,1,2021-11-04,Female,57,55-64,4
30,0,0,0,0,2021-11-04,Male,50,45-54,5
30,2,0,0,2,2021-11-05,Male,18,15-19,18
30,1,2,0,3,2021-11-08,Male,82,80-84,3
30,1,0,5,6,2021-11-08,Male,57,55-64,3
30,2,0,0,2,2021-11-04,Female,14,10-14,4
30,0,3,0,3,2021-11-03,Male,49,45-54,4
31,0,0,0,0,2021-11-18,Female,53,45-54,6
31,2,0,0,2,2021-11-22,Female,0,<1,5
31,1,0,0,1,2021-11-20,Female,70,70-74,19
31,2,0,0,2,2021-11-18,Male,12,10-14,11
31,0,1,0,1,2021-11-19,Female,73,70-74,4
31,1,0,0,1,2021-11-18,Male,68,65-69,3
31,3,0,0,3,2021-11-22,Male,3,1-4,7
31,2,0,0,2,2021-11-17,Male,65,65-69,11
31,0,10,0,10,2021-11-18,Female,49,45-54,11
31,2,2,0,4,2021-11-20,Female,3,1-4,1
31,0,0,0,0,2021-11-18,Male,60,55-64,5
31,1,9,1,11,2021-11-17,Female,23,20-24,3
31,0,0,0,0,2021-11-18,Male,28,25-34,10
31,1,0,0,1,2021-11-17,Female,56,55-64,7
31,0,1,0,1,2021-11-22,Female,3,1-4,11
31,1,1,0,2,2021-11-18,Female,59,55-64,9
31,1,1,0,2,2021-11-19,Male,71,70-74,11
31,0,0,0,0,2021-11-17,Female,33,25-34,8
31,1,0,0,1,2021-11-19,Male,70,70-74,5
31,0,7,0,7,2021-11-17,Female,42,35-44,5
31,1,0,0,1,2021-11-17,Female,14,10-14,6
31,0,0,0,0,2021-11-17,Female,54,45-54,20
31,1,2,0,3,2021-11-17,Female,57,55-64,3
31,2,0,0,2,2021-11-18,Male,9,5-9,7
31,2,0,0,2,2021-11-22,Female,30,25-34,4
31,1,0,0,1,2021-11-20,Male,76,75-79,3
31,1,1,0,2,2021-11-18,Female,74,70-74,4
31,0,0,0,0,2021-11-18,Female,6,5-9,7
31,2,8,0,10,2021-11-18,Female,48,45-54,4
31,0,0,0,0,2021-11-23,Male,53,45-54,9
31,1,34,0,35,2021-11-20,Female,62,55-64,18
31,2,16,0,18,2021-11-17,Male,16,15-19,3
31,2,1,0,3,2021-11-18,Female,2,1-4,5
31,0,0,0,0,2021-11-19,Male,69,65-69,13
31,1,5,0,6,2021-11-18,Female,54,45-54,6
31,2,0,0,2,2021-11-18,Male,50,45-54,4
31,1,2,0,3,2021-11-18,Male,41,35-44,5
31,1,0,0,1,2021-11-19,Male,72,70-74,5
31,2,1,0,3,2021-11-17,Female,2,1-4,6
31,1,1,0,2,2021-11-17,Male,58,55-64,4
31,0,1,0,1,2021-11-17,Female,66,65-69,10
31,5,0,0,5,2021-11-19,Male,18,15-19,1
31,0,0,0,0,2021-11-23,Male,49,45-54,1
31,1,0,0,1,2021-11-22,Male,35,35-44,8
31,0,0,0,0,2021-11-22,Male,51,45-54,10
31,3,5,0,8,2021-11-17,Female,6,5-9,4
31,2,0,0,2,2021-11-18,Female,14,10-14,24
31,0,0,0,0,2021-11-18,Female,41,35-44,9
31,1,0,0,1,2021-11-17,Male,25,25-34,4
31,3,0,0,3,2021-11-18,Female,55,55-64,9
31,1,1,0,2,2021-11-17,Male,57,55-64,10
31,1,0,0,1,2021-11-17,Female,65,65-69,2
31,1,1,0,2,2021-11-18,Male,58,55-64,5
31,1,0,0,1,2021-11-23,Male,53,45-54,6
31,0,0,0,0,2021-11-18,Male,79,75-79,2
31,1,0,0,1,2021-11-18,Female,57,55-64,11
31,0,0,0,0,2021-11-23,Male,41,35-44,1
31,1,0,0,1,2021-11-17,Female,50,45-54,10
31,1,10,0,11,2021-11-19,Male,60,55-64,11
31,0,3,0,3,2021-11-18,Male,48,45-54,8
31,0,0,0,0,2021-11-22,Male,50,45-54,8
31,0,1,0,1,2021-11-20,Female,24,20-24,1
31,1,0,0,1,2021-11-17,Female,54,45-54,6
31,3,0,0,3,2021-11-19,Female,23,20-24,1
31,0,1,0,1,2021-11-17,Male,54,45-54,22
31,0,0,0,0,2021-11-17,Female,37,35-44,4
31,1,0,0,1,2021-11-18,Male,77,75-79,8
31,1,0,0,1,2021-11-18,Female,50,45-54,3
31,1,0,0,1,2021-11-18,Female,40,35-44,3
31,0,0,0,0,2021-11-17,Male,42,35-44,28
31,1,0,0,1,2021-11-19,Female,49,45-54,5
31,1,0,0,1,2021-11-18,Male,8,5-9,3
31,4,0,0,4,2021-11-19,Female,5,5-9,6
31,0,0,0,0,2021-11-18,Female,18,15-19,4
31,0,0,0,0,2021-11-22,Male,85,85+,25
31,0,5,0,5,2021-11-19,Male,37,35-44,5
31,0,1,0,1,2021-11-20,Male,21,20-24,1
31,0,3,0,3,2021-11-17,Male,30,25-34,7
31,1,0,0,1,2021-11-18,Female,33,25-34,7
31,2,0,0,2,2021-11-22,Male,11,10-14,3
31,1,0,0,1,2021-11-17,Male,66,65-69,5
31,3,0,0,3,2021-11-17,Male,3,1-4,15
31,0,1,0,1,2021-11-18,Male,54,45-54,16
31,2,0,0,2,2021-11-17,Male,15,15-19,18
31,0,2,0,2,2021-11-19,Male,62,55-64,7
31,1,25,0,26,2021-11-22,Male,33,25-34,10
31,0,6,0,6,2021-11-18,Female,40,35-44,5
31,0,4,0,4,2021-11-17,Male,41,35-44,7
31,1,0,0,1,2021-11-19,Female,69,65-69,6
31,0,2,0,2,2021-11-19,Male,62,55-64,4
31,0,0,0,0,2021-11-18,Male,70,70-74,5
31,0,1,0,1,2021-11-18,Female,54,45-54,3
31,1,0,0,1,2021-11-18,Female,50,45-54,6
31,0,0,0,0,2021-11-19,Male,36,35-44,9
31,0,0,0,0,2021-11-19,Female,23,20-24,1
31,0,3,0,3,2021-11-17,Male,61,55-64,5
31,0,0,0,0,2021-11-20,Female,56,55-64,5
31,5,0,0,5,2021-11-17,Male,19,15-19,3
31,1,0,0,1,2021-11-17,Female,45,45-54,6
31,2,0,0,2,2021-11-22,Female,53,45-54,3
31,2,0,0,2,2021-11-17,Female,18,15-19,9
31,0,1,0,1,2021-11-23,Female,45,45-54,1
31,1,0,0,1,2021-11-22,Male,76,75-79,5
31,1,0,0,1,2021-11-17,Female,14,10-14,9
31,0,3,1,4,2021-11-18,Female,78,75-79,5
31,1,0,0,1,2021-11-18,Female,39,35-44,10
31,0,0,0,0,2021-11-18,Male,68,65-69,5
31,2,0,3,5,2021-11-19,Male,2,1-4,1
31,1,0,0,1,2021-11-17,Male,11,10-14,3
31,0,2,0,2,2021-11-17,Female,51,45-54,6
31,1,4,0,5,2021-11-19,Female,60,55-64,3
31,0,0,0,0,2021-11-22,Male,61,55-64,11
31,3,0,0,3,2021-11-19,Female,18,15-19,8
31,1,0,0,1,2021-11-19,Male,68,65-69,4
31,0,0,0,0,2021-11-18,Female,51,45-54,3
31,2,4,1,7,2021-11-17,Female,52,45-54,5
31,0,0,0,0,2021-11-21,Female,56,55-64,10
31,0,10,0,10,2021-11-17,Male,43,35-44,9
31,1,0,0,1,2021-11-23,Female,9,5-9,1
31,1,0,0,1,2021-11-18,Male,39,35-44,10
31,1,0,0,1,2021-11-21,Female,72,70-74,10
31,0,0,0,0,2021-11-21,Female,24,20-24,1
31,0,0,0,0,2021-11-18,Female,61,55-64,18
31,2,0,0,2,2021-11-19,Female,73,70-74,5
31,1,3,0,4,2021-11-17,Male,67,65-69,9
31,1,0,0,1,2021-11-18,Male,62,55-64,3
31,1,0,0,1,2021-11-19,Male,64,55-64,3
31,3,0,0,3,2021-11-18,Female,50,45-54,3
31,0,1,2,3,2021-11-18,Female,62,55-64,4
31,0,0,0,0,2021-11-18,Female,78,75-79,24
31,0,0,0,0,2021-11-17,Male,33,25-34,7
31,1,0,0,1,2021-11-19,Male,77,75-79,4
31,2,0,0,2,2021-11-22,Female,31,25-34,2
31,0,3,0,3,2021-11-18,Female,53,45-54,18
31,1,0,0,1,2021-11-20,Female,24,20-24,1
31,2,1,0,3,2021-11-17,Male,5,5-9,4
31,1,0,0,1,2021-11-20,Female,20,20-24,1
31,0,5,0,5,2021-11-18,Male,69,65-69,5
31,1,0,1,2,2021-11-18,Female,47,45-54,3
31,1,5,0,6,2021-11-17,Female,43,35-44,5
31,0,1,0,1,2021-11-22,Male,71,70-74,5
31,0,2,0,2,2021-11-18,Female,65,65-69,5
31,1,3,0,4,2021-11-18,Male,59,55-64,3
31,1,1,0,2,2021-11-18,Female,61,55-64,4
31,1,0,0,1,2021-11-17,Male,68,65-69,5
31,0,0,0,0,2021-11-18,Male,56,55-64,10
31,2,0,0,2,2021-11-17,Female,56,55-64,4
31,2,0,0,2,2021-11-21,Female,3,1-4,1
31,1,0,0,1,2021-11-19,Female,71,70-74,5
31,1,9,0,10,2021-11-17,Female,44,35-44,3
31,1,0,0,1,2021-11-22,Female,50,45-54,5
31,0,2,0,2,2021-11-23,Male,53,45-54,1
31,1,0,0,1,2021-11-20,Female,28,25-34,11
31,0,1,0,1,2021-11-22,Female,34,25-34,2
31,1,31,0,32,2021-11-23,Male,69,65-69,1
31,2,0,0,2,2021-11-17,Male,13,10-14,2
31,0,7,5,12,2021-11-21,Female,24,20-24,1
31,2,0,0,2,2021-11-17,Male,65,65-69,10
31,4,0,0,4,2021-11-18,Female,1,1-4,12
31,3,0,0,3,2021-11-17,Male,10,10-14,5
31,2,0,0,2,2021-11-21,Female,24,20-24,1
31,1,0,0,1,2021-11-19,Male,78,75-79,4
31,0,5,0,5,2021-11-17,Female,54,45-54,11
31,1,0,0,1,2021-11-22,Male,68,65-69,23
31,0,0,0,0,2021-11-17,Male,33,25-34,10
31,2,1,0,3,2021-11-17,Male,2,1-4,6
31,0,0,0,0,2021-11-18,Male,32,25-34,6
31,1,0,0,1,2021-11-19,Female,72,70-74,9
31,1,0,0,1,2021-11-18,Male,39,35-44,5
31,1,0,0,1,2021-11-18,Female,40,35-44,4
31,2,0,0,2,2021-11-17,Male,12,10-14,10
31,0,0,0,0,2021-11-19,Female,76,75-79,11
31,0,0,0,0,2021-11-23,Female,65,65-69,1
31,1,0,0,1,2021-11-20,Male,56,55-64,2
31,1,3,0,4,2021-11-20,Female,22,20-24,1
31,0,1,0,1,2021-11-17,Male,58,55-64,5
31,1,0,0,1,2021-11-22,Male,68,65-69,5
31,8,0,0,8,2021-11-19,Male,46,45-54,4
31,1,0,0,1,2021-11-20,Male,31,25-34,1
31,3,0,0,3,2021-11-19,Male,18,15-19,25
31,0,0,0,0,2021-11-22,Male,66,65-69,6
31,0,1,0,1,2021-11-17,Male,51,45-54,3
31,0,1,0,1,2021-11-19,Male,70,70-74,21
31,3,0,0,3,2021-11-18,Female,14,10-14,4
31,1,0,0,1,2021-11-17,Male,44,35-44,6
31,1,3,0,4,2021-11-18,Male,60,55-64,9
31,1,1,0,2,2021-11-18,Female,62,55-64,10
31,0,0,0,0,2021-11-19,Female,23,20-24,1
31,0,4,11,15,2021-11-21,Female,19,15-19,1
31,1,0,0,1,2021-11-18,Male,72,70-74,5
31,3,1,0,4,2021-11-22,Male,30,25-34,3
31,1,0,0,1,2021-11-18,Female,66,65-69,6
31,1,3,0,4,2021-11-18,Male,21,20-24,5
31,1,0,0,1,2021-11-17,Male,65,65-69,4
31,2,2,0,4,2021-11-17,Female,18,15-19,4
31,0,0,0,0,2021-11-23,Male,70,70-74,1
31,1,0,0,1,2021-11-21,Male,35,35-44,9
31,2,0,30,32,2021-11-18,Male,12,10-14,7
31,1,0,0,1,2021-11-23,Female,73,70-74,1
31,0,1,0,1,2021-11-20,Female,33,25-34,4
31,0,0,0,0,2021-11-17,Female,8,5-9,5
31,3,0,0,3,2021-11-18,Female,53,45-54,6
31,1,3,0,4,2021-11-20,Male,33,25-34,3
31,1,0,0,1,2021-11-19,Male,71,70-74,4
31,1,0,0,1,2021-11-17,Female,61,55-64,10
31,0,0,0,0,2021-11-22,Female,24,20-24,1
31,3,0,0,3,2021-11-22,Female,6,5-9,3
31,4,0,0,4,2021-11-22,Male,2,1-4,3
31,1,0,0,1,2021-11-19,Male,52,45-54,10
31,0,0,0,0,2021-11-17,Female,45,45-54,2
31,1,0,0,1,2021-11-18,Male,55,55-64,8
31,2,0,0,2,2021-11-18,Female,28,25-34,11
31,0,0,0,0,2021-11-19,Male,69,65-69,18
31,3,0,0,3,2021-11-17,Female,0,<1,4
31,0,0,0,0,2021-11-19,Male,30,25-34,17
31,3,3,7,13,2021-11-18,Male,13,10-14,5
31,1,4,0,5,2021-11-23,Male,55,55-64,1
31,2,2,0,4,2021-11-17,Female,7,5-9,3
31,0,0,0,0,2021-11-19,Male,73,70-74,3
31,1,1,0,2,2021-11-18,Male,69,65-69,11
31,2,0,0,2,2021-11-18,Female,0,<1,9
31,1,1,0,2,2021-11-17,Male,10,10-14,4
31,0,0,0,0,2021-11-20,Female,31,25-34,9
31,1,0,0,1,2021-11-22,Male,74,70-74,6
31,0,1,0,1,2021-11-17,Male,54,45-54,5
31,1,0,0,1,2021-11-22,Female,44,35-44,8
31,0,5,1,6,2021-11-19,Male,82,80-84,4
31,0,1,0,1,2021-11-18,Male,51,45-54,5
31,0,0,0,0,2021-11-18,Male,47,45-54,10
31,1,0,0,1,2021-11-17,Female,65,65-69,5
31,0,0,0,0,2021-11-18,Male,35,35-44,4
31,0,0,0,0,2021-11-18,Female,42,35-44,4
31,0,0,0,0,2021-11-17,Female,44,35-44,8
31,0,0,0,0,2021-11-17,Female,30,25-34,4
31,0,9,8,17,2021-11-20,Female,23,20-24,1
31,1,0,0,1,2021-11-18,Male,65,65-69,7
31,0,0,0,0,2021-11-18,Male,34,25-34,5
31,0,0,0,0,2021-11-19,Female,23,20-24,1
31,0,0,0,0,2021-11-17,Male,20,20-24,6
31,1,1,0,2,2021-11-17,Male,61,55-64,9
31,1,2,0,3,2021-11-18,Male,55,55-64,7
31,2,0,0,2,2021-11-17,Female,1,1-4,6
31,0,0,0,0,2021-11-18,Male,70,70-74,24
31,0,0,0,0,2021-11-20,Female,18,15-19,1
31,1,0,8,9,2021-11-22,Male,27,25-34,3
31,0,0,0,0,2021-11-21,Female,54,45-54,14
31,1,0,0,1,2021-11-18,Male,68,65-69,4
31,1,0,0,1,2021-11-18,Male,65,65-69,3
31,0,30,0,30,2021-11-17,Male,53,45-54,7
31,1,0,0,1,2021-11-21,Male,57,55-64,5
31,2,2,0,4,2021-11-19,Male,32,25-34,3
31,4,2,0,6,2021-11-18,Female,15,15-19,4
31,2,0,0,2,2021-11-19,Female,60,55-64,8
31,0,0,0,0,2021-11-18,Female,42,35-44,4
31,2,0,0,2,2021-11-22,Female,54,45-54,6
31,1,1,0,2,2021-11-19,Female,39,35-44,3
31,1,4,0,5,2021-11-19,Female,71,70-74,4
31,3,0,0,3,2021-11-17,Female,21,20-24,10
31,1,0,0,1,2021-11-17,Female,67,65-69,4
31,1,5,0,6,2021-11-17,Male,40,35-44,11
31,0,0,0,0,2021-11-18,Male,32,25-34,9
31,3,0,0,3,2021-11-17,Male,0,<1,9
31,0,1,0,1,2021-11-17,Male,42,35-44,12
31,1,0,0,1,2021-11-17,Female,54,45-54,11
31,0,0,0,0,2021-11-18,Female,69,65-69,6
31,2,1,3,6,2021-11-22,Male,78,75-79,2
31,1,0,0,1,2021-11-19,Female,69,65-69,5
31,1,2,0,3,2021-11-20,Male,57,55-64,22
31,2,0,0,2,2021-11-18,Male,7,5-9,2
31,0,0,0,0,2021-11-19,Male,60,55-64,5
31,0,2,0,2,2021-11-23,Female,70,70-74,1
31,3,9,2,14,2021-11-23,Male,4,1-4,1
31,1,8,0,9,2021-11-19,Male,50,45-54,6
31,1,0,0,1,2021-11-17,Female,61,55-64,4
31,1,3,0,4,2021-11-19,Male,70,70-74,4
31,1,1,0,2,2021-11-18,Male,24,20-24,14
31,1,0,0,1,2021-11-18,Female,65,65-69,11
31,0,0,0,0,2021-11-18,Female,51,45-54,13
31,0,10,0,10,2021-11-17,Female,43,35-44,8
31,3,0,0,3,2021-11-22,Male,14,10-14,5
31,1,6,0,7,2021-11-22,Female,34,25-34,5
31,0,31,0,31,2021-11-18,Female,75,75-79,8
31,0,1,0,1,2021-11-18,Male,68,65-69,6
31,1,0,0,1,2021-11-18,Female,40,35-44,4
31,2,0,0,2,2021-11-20,Female,24,20-24,2
31,0,0,0,0,2021-11-19,Male,23,20-24,1
31,0,2,0,2,2021-11-20,Female,81,80-84,9
31,0,1,0,1,2021-11-17,Male,58,55-64,6
31,1,0,0,1,2021-11-19,Male,27,25-34,9
31,2,0,0,2,2021-11-17,Male,68,65-69,4
31,2,1,0,3,2021-11-18,Male,47,45-54,3
31,1,0,0,1,2021-11-18,Female,30,25-34,5
31,1,0,0,1,2021-11-17,Female,61,55-64,4
31,0,0,0,0,2021-11-19,Male,49,45-54,7
31,0,0,0,0,2021-11-20,Male,31,25-34,8
31,2,4,0,6,2021-11-22,Male,67,65-69,3
31,1,0,0,1,2021-11-19,Male,55,55-64,9
31,3,0,0,3,2021-11-19,Female,16,15-19,3
31,3,15,0,18,2021-11-17,Male,11,10-14,3
31,0,0,0,0,2021-11-17,Male,46,45-54,7
31,1,0,0,1,2021-11-19,Male,73,70-74,5
31,0,30,15,45,2021-11-17,Male,41,35-44,4
31,1,0,0,1,2021-11-18,Male,64,55-64,9
31,3,0,0,3,2021-11-23,Male,8,5-9,1
31,0,0,0,0,2021-11-21,Male,18,15-19,1
31,1,0,0,1,2021-11-17,Male,64,55-64,10
31,0,0,0,0,2021-11-18,Female,67,65-69,15
31,1,0,0,1,2021-11-17,Male,45,45-54,9
31,1,4,0,5,2021-11-19,Male,74,70-74,4
31,2,1,0,3,2021-11-22,Female,24,20-24,1
31,0,0,0,0,2021-11-18,Male,77,75-79,4
31,1,0,0,1,2021-11-18,Female,68,65-69,9
31,1,0,0,1,2021-11-22,Female,33,25-34,3
31,1,0,0,1,2021-11-18,Male,74,70-74,3
31,0,0,0,0,2021-11-19,Male,59,55-64,3
31,0,0,0,0,2021-11-18,Female,67,65-69,5
31,1,0,0,1,2021-11-18,Female,65,65-69,9
31,0,0,0,0,2021-11-17,Female,57,55-64,7
31,2,1,0,3,2021-11-18,Female,22,20-24,14
31,1,0,0,1,2021-11-19,Male,77,75-79,7
31,2,0,0,2,2021-11-19,Male,52,45-54,5
31,0,1,0,1,2021-11-17,Male,57,55-64,4
31,0,0,0,0,2021-11-19,Female,25,25-34,12
31,4,0,0,4,2021-11-17,Male,5,5-9,8
31,1,0,0,1,2021-11-18,Male,8,5-9,5
31,0,0,3,3,2021-11-19,Male,49,45-54,5
31,0,0,0,0,2021-11-18,Male,72,70-74,5
31,0,0,0,0,2021-11-18,Female,37,35-44,7
31,0,5,25,30,2021-11-19,Female,20,20-24,1
31,1,0,0,1,2021-11-18,Female,30,25-34,4
31,1,0,2,3,2021-11-22,Female,54,45-54,3
31,0,1,0,1,2021-11-18,Female,70,70-74,5
31,0,0,0,0,2021-11-19,Female,48,45-54,6
31,3,0,0,3,2021-11-17,Female,19,15-19,6
31,0,0,0,0,2021-11-17,Male,53,45-54,5
31,1,0,0,1,2021-11-18,Female,62,55-64,4
31,0,0,0,0,2021-11-23,Female,0,<1,1
31,0,0,0,0,2021-11-20,Male,23,20-24,11
31,1,0,0,1,2021-11-19,Female,73,70-74,3
31,0,0,0,0,2021-11-17,Female,50,45-54,4
31,0,0,0,0,2021-11-17,Male,34,25-34,8
31,0,2,0,2,2021-11-19,Male,69,65-69,6
31,0,0,0,0,2021-11-21,Female,50,45-54,7
31,1,2,0,3,2021-11-19,Male,73,70-74,3
31,2,0,0,2,2021-11-21,Male,2,1-4,1
31,0,1,0,1,2021-11-19,Male,33,25-34,2
31,1,0,0,1,2021-11-22,Female,54,45-54,6
31,0,0,0,0,2021-11-22,Male,17,15-19,11
31,0,2,0,2,2021-11-19,Male,75,75-79,3
31,0,0,0,0,2021-11-18,Female,51,45-54,4
31,2,2,0,4,2021-11-17,Female,0,<1,7
31,1,0,0,1,2021-11-18,Male,75,75-79,7
31,2,45,0,47,2021-11-19,Female,59,55-64,10
31,0,0,0,0,2021-11-22,Male,45,45-54,4
31,1,1,0,2,2021-11-20,Female,8,5-9,20
31,0,0,0,0,2021-11-18,Male,29,25-34,4
31,0,2,0,2,2021-11-19,Female,62,55-64,5
31,1,0,0,1,2021-11-19,Male,70,70-74,4
31,0,2,0,2,2021-11-17,Male,55,55-64,4
31,0,0,0,0,2021-11-17,Male,34,25-34,10
31,0,0,0,0,2021-11-18,Male,43,35-44,9
31,3,1,0,4,2021-11-18,Female,11,10-14,4
31,0,0,0,0,2021-11-18,Male,22,20-24,2
31,0,0,0,0,2021-11-17,Female,21,20-24,6
31,3,20,0,23,2021-11-18,Female,19,15-19,5
31,0,0,0,0,2021-11-18,Female,48,45-54,6
31,2,1,0,3,2021-11-18,Male,56,55-64,9
31,0,0,0,0,2021-11-18,Male,68,65-69,3
31,2,1,0,3,2021-11-18,Male,15,15-19,11
31,0,0,0,0,2021-11-18,Male,70,70-74,5
31,0,4,0,4,2021-11-18,Female,73,70-74,6
31,3,0,0,3,2021-11-19,Female,19,15-19,1
31,2,0,0,2,2021-11-18,Male,39,35-44,6
31,1,0,0,1,2021-11-18,Male,69,65-69,6
31,2,0,0,2,2021-11-20,Female,16,15-19,12
31,0,0,0,0,2021-11-19,Male,63,55-64,6
31,2,1,0,3,2021-11-22,Male,7,5-9,4
31,0,0,0,0,2021-11-22,Male,44,35-44,19
31,3,0,0,3,2021-11-19,Male,11,10-14,6
31,0,3,0,3,2021-11-18,Male,28,25-34,10
31,0,0,0,0,2021-11-18,Female,58,55-64,6
31,0,2,0,2,2021-11-18,Male,63,55-64,4
31,1,0,0,1,2021-11-17,Female,45,45-54,7
31,0,1,0,1,2021-11-20,Female,76,75-79,9
31,1,5,0,6,2021-11-17,Female,56,55-64,11
31,0,0,0,0,2021-11-17,Male,45,45-54,19
31,1,31,0,32,2021-11-19,Female,67,65-69,3
31,1,0,0,1,2021-11-17,Female,56,55-64,4
31,0,0,0,0,2021-11-18,Male,70,70-74,11
31,0,0,0,0,2021-11-19,Female,60,55-64,4
31,1,0,0,1,2021-11-18,Male,29,25-34,10
31,1,0,0,1,2021-11-17,Male,61,55-64,16
31,0,2,0,2,2021-11-19,Male,12,10-14,4
31,1,1,0,2,2021-11-17,Female,66,65-69,4
31,1,0,0,1,2021-11-19,Male,62,55-64,5
31,0,0,0,0,2021-11-19,Male,73,70-74,4
31,1,1,0,2,2021-11-19,Male,62,55-64,5
31,0,1,3,4,2021-11-23,Male,48,45-54,1
31,0,0,0,0,2021-11-19,Female,23,20-24,1
31,2,0,0,2,2021-11-17,Female,40,35-44,4
31,0,0,0,0,2021-11-19,Male,37,35-44,4
31,0,0,0,0,2021-11-22,Female,34,25-34,4
31,1,2,0,3,2021-11-19,Female,71,70-74,10
31,1,1,0,2,2021-11-17,Female,64,55-64,3
31,1,0,0,1,2021-11-18,Female,50,45-54,2
31,2,0,0,2,2021-11-18,Male,7,5-9,6
31,0,2,0,2,2021-11-17,Female,59,55-64,5
31,0,0,0,0,2021-11-17,Female,64,55-64,4
31,1,0,0,1,2021-11-21,Male,75,75-79,5
31,0,0,0,0,2021-11-22,Male,51,45-54,5
31,1,1,0,2,2021-11-17,Female,33,25-34,10
31,3,0,0,3,2021-11-23,Female,6,5-9,1
31,0,0,0,0,2021-11-18,Male,76,75-79,3
31,0,0,0,0,2021-11-19,Female,73,70-74,3
31,2,0,0,2,2021-11-22,Male,66,65-69,11
31,1,2,0,3,2021-11-18,Female,69,65-69,6
31,2,15,0,17,2021-11-19,Female,43,35-44,5
31,1,0,0,1,2021-11-18,Male,74,70-74,5
31,1,8,0,9,2021-11-19,Female,15,15-19,3
31,2,1,0,3,2021-11-22,Female,54,45-54,5
31,1,3,0,4,2021-11-19,Male,66,65-69,10
31,0,0,0,0,2021-11-17,Male,41,35-44,5
31,1,2,0,3,2021-11-17,Female,65,65-69,4
31,0,0,0,0,2021-11-18,Female,58,55-64,4
31,0,0,0,0,2021-11-22,Female,2,1-4,15
31,3,0,0,3,2021-11-21,Male,19,15-19,1
31,0,0,0,0,2021-11-20,Female,71,70-74,19
31,1,1,0,2,2021-11-20,Male,69,65-69,20
31,0,1,0,1,2021-11-18,Male,47,45-54,5
31,1,0,0,1,2021-11-23,Female,54,45-54,1
31,1,3,0,4,2021-11-22,Male,74,70-74,14
31,1,4,0,5,2021-11-18,Female,37,35-44,6
31,2,0,0,2,2021-11-19,Female,20,20-24,1
31,3,0,0,3,2021-11-20,Male,12,10-14,3
31,0,0,0,0,2021-11-19,Male,69,65-69,5
31,1,0,0,1,2021-11-17,Male,13,10-14,10
31,2,5,6,13,2021-11-17,Male,66,65-69,4
31,1,0,0,1,2021-11-17,Male,43,35-44,10
31,2,0,0,2,2021-11-20,Male,2,1-4,1
31,0,3,0,3,2021-11-20,Female,20,20-24,1
31,0,1,0,1,2021-11-19,Female,27,25-34,4
31,0,1,1,2,2021-11-19,Male,77,75-79,18
31,1,0,0,1,2021-11-19,Male,59,55-64,5
31,0,1,0,1,2021-11-19,Male,35,35-44,6
31,1,0,0,1,2021-11-18,Female,69,65-69,6
31,0,0,0,0,2021-11-22,Male,71,70-74,5
31,0,0,0,0,2021-11-19,Female,28,25-34,5
31,0,0,0,0,2021-11-18,Female,71,70-74,21
31,1,0,0,1,2021-11-18,Male,48,45-54,2
31,3,0,0,3,2021-11-21,Female,19,15-19,1
31,1,0,0,1,2021-11-17,Male,54,45-54,5
31,1,0,0,1,2021-11-19,Male,71,70-74,3
31,1,4,0,5,2021-11-19,Female,30,25-34,6
31,2,7,0,9,2021-11-19,Female,55,55-64,4
31,0,0,0,0,2021-11-22,Male,15,15-19,14
31,1,0,0,1,2021-11-19,Female,66,65-69,17
31,1,0,0,1,2021-11-17,Female,18,15-19,7
31,4,0,0,4,2021-11-17,Male,4,1-4,5
31,0,10,0,10,2021-11-17,Female,31,25-34,10
31,1,0,0,1,2021-11-19,Male,35,35-44,10
31,2,0,0,2,2021-11-18,Male,9,5-9,2
31,3,1,0,4,2021-11-18,Female,58,55-64,5
31,1,0,0,1,2021-11-22,Male,77,75-79,3
31,1,0,0,1,2021-11-18,Male,76,75-79,20
31,3,0,0,3,2021-11-20,Male,19,15-19,8
31,1,0,0,1,2021-11-22,Male,46,45-54,9
31,0,0,0,0,2021-11-20,Female,18,15-19,1
31,1,0,0,1,2021-11-18,Male,68,65-69,5
31,0,0,0,0,2021-11-22,Female,50,45-54,10
31,2,2,0,4,2021-11-18,Female,9,5-9,10
31,0,0,0,0,2021-11-22,Female,54,45-54,4
31,1,4,0,5,2021-11-19,Male,73,70-74,4
31,1,0,0,1,2021-11-22,Female,19,15-19,1
31,1,0,0,1,2021-11-18,Male,65,65-69,4
31,0,0,0,0,2021-11-19,Female,72,70-74,7
31,1,0,0,1,2021-11-17,Female,53,45-54,4
31,1,0,0,1,2021-11-18,Male,58,55-64,11
31,1,0,0,1,2021-11-19,Male,71,70-74,4
31,1,2,0,3,2021-11-18,Female,58,55-64,5
31,0,0,0,0,2021-11-18,Male,53,45-54,14
31,0,0,0,0,2021-11-18,Female,54,45-54,11
31,1,4,0,5,2021-11-17,Male,33,25-34,5
31,3,0,0,3,2021-11-18,Male,16,15-19,9
31,2,4,0,6,2021-11-19,Male,6,5-9,4
31,0,0,0,0,2021-11-17,Male,65,65-69,10
31,1,0,0,1,2021-11-18,Female,42,35-44,5
31,0,1,0,1,2021-11-18,Male,52,45-54,8
31,1,2,0,3,2021-11-18,Male,56,55-64,10
31,1,0,0,1,2021-11-17,Female,68,65-69,6
31,1,0,0,1,2021-11-19,Female,60,55-64,4
31,1,0,0,1,2021-11-18,Male,70,70-74,4
31,0,0,2,2,2021-11-23,Male,27,25-34,1
31,2,20,0,22,2021-11-18,Male,9,5-9,5
31,0,0,0,0,2021-11-17,Male,28,25-34,3
31,3,0,0,3,2021-11-22,Female,51,45-54,5
31,0,0,3,3,2021-11-18,Male,27,25-34,9
31,0,0,0,0,2021-11-21,Male,48,45-54,18
31,0,0,0,0,2021-11-17,Male,56,55-64,9
31,2,2,0,4,2021-11-17,Female,41,35-44,6
31,0,0,0,0,2021-11-19,Female,65,65-69,2
31,0,0,0,0,2021-11-18,Male,56,55-64,5
31,1,0,0,1,2021-11-18,Female,72,70-74,10
31,3,0,0,3,2021-11-20,Female,21,20-24,1
31,3,25,0,28,2021-11-17,Female,5,5-9,6
31,1,0,0,1,2021-11-18,Male,70,70-74,5
31,1,0,0,1,2021-11-21,Male,13,10-14,3
31,0,0,0,0,2021-11-19,Female,59,55-64,21
31,1,0,0,1,2021-11-19,Male,59,55-64,10
31,2,3,0,5,2021-11-22,Male,60,55-64,14
31,2,0,0,2,2021-11-23,Female,11,10-14,1
31,1,0,0,1,2021-11-17,Male,45,45-54,10
31,2,10,0,12,2021-11-18,Female,19,15-19,10
31,1,1,12,14,2021-11-17,Male,58,55-64,7
31,0,0,0,0,2021-11-18,Female,45,45-54,7
31,1,0,0,1,2021-11-18,Male,52,45-54,4
31,2,0,0,2,2021-11-21,Female,22,20-24,15
31,3,0,0,3,2021-11-19,Male,15,15-19,6
31,0,0,0,0,2021-11-19,Male,38,35-44,6
31,3,0,0,3,2021-11-21,Female,52,45-54,8
31,0,0,0,0,2021-11-20,Male,2,1-4,1
31,1,0,0,1,2021-11-19,Female,60,55-64,6
31,1,0,0,1,2021-11-18,Male,72,70-74,11
31,2,2,0,4,2021-11-22,Female,67,65-69,6
31,0,0,0,0,2021-11-18,Female,24,20-24,24
31,1,1,0,2,2021-11-19,Female,19,15-19,1
31,3,0,0,3,2021-11-23,Male,66,65-69,1
31,0,2,0,2,2021-11-17,Female,53,45-54,4
31,1,0,0,1,2021-11-18,Male,43,35-44,3
31,0,3,0,3,2021-11-19,Male,65,65-69,7
31,3,0,0,3,2021-11-23,Male,18,15-19,1
31,2,0,0,2,2021-11-23,Female,0,<1,10
31,0,1,0,1,2021-11-17,Male,23,20-24,18
31,0,0,0,0,2021-11-19,Female,22,20-24,1
31,1,0,0,1,2021-11-20,Male,21,20-24,1
31,2,1,0,3,2021-11-22,Female,68,65-69,4
31,0,0,0,0,2021-11-18,Female,42,35-44,4
31,1,0,0,1,2021-11-18,Female,62,55-64,2
31,1,0,0,1,2021-11-18,Male,31,25-34,2
31,0,0,0,0,2021-11-17,Male,60,55-64,10
31,1,0,0,1,2021-11-17,Female,41,35-44,10
31,0,0,0,0,2021-11-23,Female,52,45-54,1
31,2,1,0,3,2021-11-18,Male,0,<1,5
31,0,0,0,0,2021-11-18,Male,39,35-44,6
31,1,0,0,1,2021-11-17,Female,54,45-54,10
31,3,10,0,13,2021-11-18,Male,59,55-64,4
31,0,1,0,1,2021-11-17,Male,53,45-54,11
31,1,1,0,2,2021-11-17,Male,46,45-54,6
31,0,0,0,0,2021-11-20,Female,28,25-34,6
31,0,0,0,0,2021-11-23,Male,10,10-14,1
31,1,4,0,5,2021-11-17,Male,68,65-69,3
31,1,0,0,1,2021-11-18,Male,68,65-69,5
31,2,5,13,20,2021-11-18,Male,69,65-69,12
31,2,0,0,2,2021-11-18,Female,16,15-19,7
31,1,2,0,3,2021-11-18,Female,66,65-69,9
31,4,0,0,4,2021-11-20,Female,19,15-19,1
31,1,2,0,3,2021-11-19,Female,67,65-69,8
31,0,1,0,1,2021-11-18,Male,65,65-69,5
31,0,0,0,0,2021-11-18,Male,63,55-64,5
31,1,9,0,10,2021-11-20,Male,23,20-24,1
31,2,1,0,3,2021-11-18,Female,27,25-34,21
31,1,0,0,1,2021-11-20,Male,68,65-69,9
31,2,0,0,2,2021-11-19,Female,45,45-54,3
31,1,0,0,1,2021-11-19,Male,74,70-74,3
31,1,0,0,1,2021-11-22,Male,32,25-34,8
31,0,0,0,0,2021-11-17,Female,7,5-9,7
31,0,1,0,1,2021-11-22,Male,54,45-54,8
31,0,0,0,0,2021-11-22,Female,53,45-54,3
31,2,1,7,10,2021-11-17,Male,67,65-69,4
31,0,0,0,0,2021-11-19,Male,69,65-69,5
31,0,39,5,44,2021-11-18,Male,39,35-44,3
31,2,0,0,2,2021-11-17,Female,9,5-9,6
31,1,0,0,1,2021-11-17,Female,53,45-54,3
31,1,1,0,2,2021-11-19,Male,70,70-74,26
31,0,0,0,0,2021-11-19,Female,62,55-64,3
31,1,0,0,1,2021-11-19,Male,59,55-64,11
31,1,2,0,3,2021-11-21,Male,69,65-69,3
31,1,100,0,101,2021-11-18,Female,51,45-54,4
31,1,1,0,2,2021-11-21,Female,26,25-34,4
31,0,0,0,0,2021-11-21,Female,69,65-69,7
31,1,0,0,1,2021-11-23,Male,49,45-54,1
31,1,2,0,3,2021-11-18,Female,41,35-44,4
31,2,0,0,2,2021-11-17,Male,1,1-4,10
31,1,0,0,1,2021-11-17,Male,57,55-64,6
31,1,0,0,1,2021-11-17,Female,66,65-69,8
31,0,0,0,0,2021-11-18,Female,52,45-54,4
31,1,0,0,1,2021-11-17,Female,28,25-34,4
31,1,5,0,6,2021-11-17,Male,58,55-64,4
31,0,0,0,0,2021-11-22,Female,9,5-9,22
31,0,0,0,0,2021-11-17,Male,52,45-54,5
31,1,0,0,1,2021-11-18,Male,52,45-54,6
31,2,0,0,2,2021-11-18,Female,67,65-69,22
31,3,0,0,3,2021-11-19,Female,18,15-19,5
31,1,0,0,1,2021-11-18,Male,58,55-64,8
31,0,2,0,2,2021-11-17,Female,66,65-69,5
31,0,0,0,0,2021-11-19,Female,71,70-74,11
31,0,1,0,1,2021-11-19,Male,55,55-64,16
31,0,0,0,0,2021-11-23,Female,28,25-34,1
31,0,0,0,0,2021-11-18,Female,31,25-34,4
31,2,3,0,5,2021-11-18,Male,66,65-69,10
31,0,0,0,0,2021-11-18,Male,58,55-64,8
31,3,5,0,8,2021-11-23,Male,8,5-9,1
31,2,0,0,2,2021-11-20,Male,24,20-24,1
31,0,0,0,0,2021-11-17,Male,43,35-44,20
31,1,0,0,1,2021-11-17,Female,65,65-69,9
31,1,0,0,1,2021-11-18,Female,56,55-64,4
31,1,0,0,1,2021-11-18,Female,49,45-54,3
31,1,0,0,1,2021-11-17,Female,26,25-34,3
31,1,0,0,1,2021-11-19,Male,54,45-54,8
31,1,1,0,2,2021-11-18,Female,69,65-69,6
31,1,1,0,2,2021-11-17,Male,56,55-64,11
31,3,1,0,4,2021-11-19,Female,22,20-24,1
31,2,0,0,2,2021-11-22,Male,6,5-9,4
31,0,10,0,10,2021-11-18,Female,42,35-44,6
31,3,1,0,4,2021-11-19,Female,19,15-19,15
31,3,2,0,5,2021-11-18,Female,2,1-4,5
31,1,0,0,1,2021-11-22,Male,69,65-69,5
31,1,0,0,1,2021-11-18,Male,69,65-69,4
31,6,0,0,6,2021-11-23,Female,3,1-4,6
31,2,1,0,3,2021-11-21,Male,19,15-19,1
31,1,3,0,4,2021-11-20,Female,39,35-44,3
31,1,0,0,1,2021-11-18,Male,61,55-64,3
31,2,1,0,3,2021-11-17,Male,1,1-4,1
31,1,0,0,1,2021-11-19,Female,63,55-64,11
31,0,0,0,0,2021-11-17,Male,57,55-64,3
31,0,1,0,1,2021-11-18,Female,33,25-34,9
31,0,0,0,0,2021-11-19,Male,38,35-44,5
31,1,0,0,1,2021-11-18,Male,69,65-69,6
31,0,0,0,0,2021-11-18,Male,52,45-54,10
31,1,0,0,1,2021-11-17,Female,50,45-54,25
31,0,0,0,0,2021-11-18,Male,47,45-54,8
31,1,0,0,1,2021-11-17,Male,24,20-24,10
31,1,0,0,1,2021-11-22,Female,19,15-19,1
31,1,0,0,1,2021-11-21,Male,71,70-74,3
31,1,0,0,1,2021-11-18,Female,36,35-44,5
31,0,0,0,0,2021-11-17,Female,50,45-54,3
31,1,4,0,5,2021-11-21,Female,24,20-24,1
31,0,0,0,0,2021-11-23,Male,36,35-44,3
31,0,10,0,10,2021-11-17,Male,54,45-54,5
31,2,0,0,2,2021-11-21,Male,67,65-69,11
31,1,0,0,1,2021-11-17,Female,67,65-69,4
31,0,0,0,0,2021-11-18,Male,74,70-74,4
31,0,2,0,2,2021-11-17,Male,64,55-64,10
31,2,0,0,2,2021-11-18,Male,52,45-54,11
31,0,0,0,0,2021-11-18,Female,81,80-84,13
31,0,0,0,0,2021-11-18,Female,64,55-64,5
31,0,0,0,0,2021-11-22,Female,40,35-44,9
31,0,0,0,0,2021-11-17,Female,61,55-64,4
31,1,1,0,2,2021-11-17,Female,41,35-44,5
31,1,0,0,1,2021-11-17,Male,68,65-69,9
31,3,0,0,3,2021-11-20,Female,14,10-14,6
31,0,0,0,0,2021-11-22,Male,65,65-69,10
31,0,0,0,0,2021-11-17,Female,30,25-34,10
31,0,1,0,1,2021-11-17,Female,55,55-64,4
31,0,0,0,0,2021-11-17,Male,26,25-34,7
31,2,1,0,3,2021-11-18,Female,34,25-34,3
31,0,1,0,1,2021-11-19,Female,55,55-64,3
31,1,0,0,1,2021-11-18,Male,70,70-74,7
31,1,0,0,1,2021-11-23,Female,68,65-69,1
31,0,6,0,6,2021-11-17,Male,64,55-64,4
31,3,1,0,4,2021-11-18,Female,13,10-14,4
31,1,1,0,2,2021-11-19,Female,73,70-74,4
31,1,0,0,1,2021-11-21,Female,22,20-24,1
31,0,1,0,1,2021-11-19,Male,64,55-64,25
31,0,0,2,2,2021-11-18,Male,51,45-54,9
31,0,0,0,0,2021-11-18,Male,54,45-54,11
31,3,4,0,7,2021-11-18,Male,24,20-24,6
31,1,1,0,2,2021-11-17,Male,64,55-64,3
31,1,3,0,4,2021-11-20,Male,83,80-84,3
31,1,0,0,1,2021-11-17,Male,68,65-69,8
31,1,0,0,1,2021-11-18,Female,61,55-64,6
31,0,0,4,4,2021-11-17,Female,66,65-69,16
31,1,0,0,1,2021-11-18,Female,48,45-54,4
31,1,3,0,4,2021-11-17,Female,66,65-69,4
31,3,0,0,3,2021-11-17,Male,3,1-4,6
31,0,3,0,3,2021-11-19,Female,49,45-54,11
31,1,0,0,1,2021-11-18,Female,72,70-74,11
31,1,0,0,1,2021-11-19,Female,52,45-54,5
31,1,0,0,1,2021-11-22,Female,28,25-34,8
31,0,1,0,1,2021-11-19,Male,56,55-64,5
31,1,0,0,1,2021-11-20,Male,14,10-14,15
31,0,1,1,2,2021-11-18,Female,66,65-69,6
31,1,0,0,1,2021-11-18,Female,72,70-74,6
31,0,3,0,3,2021-11-17,Female,53,45-54,3
31,0,0,0,0,2021-11-20,Female,53,45-54,4
31,0,0,0,0,2021-11-23,Female,9,5-9,1
31,0,0,0,0,2021-11-17,Female,67,65-69,9
31,1,0,0,1,2021-11-23,Male,67,65-69,1
31,0,4,0,4,2021-11-17,Male,55,55-64,22
31,0,0,0,0,2021-11-17,Female,53,45-54,2
31,2,1,0,3,2021-11-19,Female,48,45-54,10
31,0,0,0,0,2021-11-17,Male,57,55-64,4
31,0,4,0,4,2021-11-18,Female,51,45-54,10
31,1,0,0,1,2021-11-17,Female,51,45-54,6
31,2,0,2,4,2021-11-19,Male,30,25-34,7
31,2,0,0,2,2021-11-18,Female,30,25-34,5
31,2,0,0,2,2021-11-22,Male,51,45-54,15
31,4,0,0,4,2021-11-17,Male,3,1-4,4
31,2,15,0,17,2021-11-18,Female,5,5-9,2
31,1,0,0,1,2021-11-18,Female,42,35-44,11
31,0,1,0,1,2021-11-20,Female,21,20-24,1
31,0,1,0,1,2021-11-18,Female,74,70-74,5
31,1,0,0,1,2021-11-18,Male,46,45-54,7
31,0,5,0,5,2021-11-18,Male,50,45-54,12
31,3,0,0,3,2021-11-20,Female,9,5-9,5
31,3,0,0,3,2021-11-19,Male,4,1-4,4
31,1,0,0,1,2021-11-22,Male,65,65-69,2
31,1,0,0,1,2021-11-18,Female,76,75-79,5
31,0,0,0,0,2021-11-18,Female,54,45-54,13
31,0,0,0,0,2021-11-18,Male,64,55-64,5
31,0,3,0,3,2021-11-18,Female,76,75-79,3
31,1,1,0,2,2021-11-18,Female,32,25-34,6
31,1,0,0,1,2021-11-21,Female,24,20-24,1
31,0,0,0,0,2021-11-18,Female,54,45-54,2
31,2,1,0,3,2021-11-19,Female,19,15-19,4
31,1,0,0,1,2021-11-17,Female,24,20-24,4
31,4,3,0,7,2021-11-19,Male,19,15-19,3
31,2,0,0,2,2021-11-23,Male,61,55-64,19
31,1,0,0,1,2021-11-18,Female,34,25-34,8
31,0,3,0,3,2021-11-17,Female,51,45-54,15
31,2,0,0,2,2021-11-19,Male,22,20-24,1
31,2,1,0,3,2021-11-17,Male,6,5-9,12
31,1,0,0,1,2021-11-17,Female,68,65-69,7
31,2,0,28,30,2021-11-18,Male,9,5-9,5
31,1,2,0,3,2021-11-19,Male,79,75-79,3
31,3,0,0,3,2021-11-19,Female,6,5-9,12
31,2,2,0,4,2021-11-17,Male,56,55-64,3
31,0,0,0,0,2021-11-18,Female,61,55-64,6
31,1,31,0,32,2021-11-23,Male,57,55-64,1
31,2,0,0,2,2021-11-20,Male,1,1-4,11
31,0,8,0,8,2021-11-19,Female,59,55-64,5
31,3,0,0,3,2021-11-18,Female,9,5-9,11
31,0,0,0,0,2021-11-17,Female,67,65-69,22
31,0,0,0,0,2021-11-18,Female,69,65-69,24
31,1,2,0,3,2021-11-20,Female,49,45-54,4
31,0,1,0,1,2021-11-22,Female,79,75-79,16
31,2,1,0,3,2021-11-18,Male,69,65-69,12
31,2,0,0,2,2021-11-17,Female,67,65-69,3
31,0,0,0,0,2021-11-17,Female,19,15-19,2
31,0,1,0,1,2021-11-19,Male,85,85+,21
31,1,0,0,1,2021-11-22,Male,56,55-64,5
31,1,1,0,2,2021-11-18,Male,67,65-69,5
31,0,0,0,0,2021-11-18,Male,69,65-69,11
31,1,0,0,1,2021-11-17,Male,33,25-34,3
31,0,1,0,1,2021-11-17,Male,37,35-44,5
31,1,2,0,3,2021-11-17,Male,38,35-44,5
31,0,4,0,4,2021-11-18,Male,63,55-64,5
31,1,0,0,1,2021-11-19,Female,62,55-64,4
31,0,1,0,1,2021-11-18,Male,67,65-69,2
31,1,0,0,1,2021-11-18,Female,70,70-74,5
31,0,1,0,1,2021-11-19,Female,71,70-74,8
31,4,0,0,4,2021-11-17,Female,2,1-4,3
31,0,0,0,0,2021-11-17,Male,46,45-54,7
31,2,0,0,2,2021-11-19,Male,69,65-69,11
31,2,0,3,5,2021-11-18,Male,14,10-14,6
31,1,0,0,1,2021-11-18,Male,60,55-64,5
31,0,1,0,1,2021-11-18,Female,67,65-69,14
31,0,0,0,0,2021-11-20,Female,60,55-64,2
31,0,0,0,0,2021-11-20,Female,14,10-14,1
31,0,0,0,0,2021-11-17,Female,51,45-54,7
31,1,0,0,1,2021-11-19,Male,74,70-74,6
31,0,0,0,0,2021-11-19,Male,41,35-44,8
31,0,0,0,0,2021-11-17,Female,56,55-64,3
31,1,3,0,4,2021-11-18,Male,72,70-74,6
31,3,0,0,3,2021-11-18,Female,47,45-54,2
31,0,2,0,2,2021-11-19,Male,69,65-69,5
31,1,0,0,1,2021-11-18,Male,58,55-64,8
31,2,0,0,2,2021-11-19,Male,44,35-44,10
31,1,0,0,1,2021-11-18,Female,24,20-24,9
31,1,2,0,3,2021-11-18,Male,60,55-64,7
31,0,2,0,2,2021-11-18,Male,52,45-54,7
31,1,0,0,1,2021-11-17,Male,52,45-54,6
31,2,1,0,3,2021-11-17,Male,34,25-34,7
31,2,0,0,2,2021-11-17,Male,7,5-9,5
31,0,0,0,0,2021-11-17,Female,23,20-24,17
31,0,5,0,5,2021-11-18,Female,54,45-54,4
31,1,0,0,1,2021-11-18,Female,77,75-79,9
31,1,0,0,1,2021-11-19,Male,54,45-54,10
31,0,0,0,0,2021-11-17,Male,56,55-64,5
31,1,0,0,1,2021-11-19,Female,50,45-54,3
31,0,14,0,14,2021-11-18,Female,61,55-64,4
31,1,21,0,22,2021-11-17,Female,67,65-69,5
31,0,0,0,0,2021-11-18,Female,70,70-74,10
31,0,1,0,1,2021-11-19,Female,65,65-69,9
31,2,1,0,3,2021-11-17,Male,1,1-4,5
31,0,4,0,4,2021-11-17,Female,42,35-44,5
31,2,0,0,2,2021-11-17,Male,1,1-4,10
31,1,0,0,1,2021-11-19,Female,47,45-54,7
31,2,0,0,2,2021-11-17,Male,1,1-4,9
31,0,0,0,0,2021-11-18,Female,65,65-69,5
31,0,0,0,0,2021-11-18,Female,68,65-69,7
31,0,1,0,1,2021-11-20,Female,22,20-24,1
31,4,0,0,4,2021-11-22,Male,22,20-24,1
31,1,2,1,4,2021-11-19,Male,72,70-74,3
31,1,0,0,1,2021-11-18,Male,50,45-54,5
31,1,0,0,1,2021-11-22,Female,38,35-44,8
31,1,0,0,1,2021-11-17,Male,58,55-64,6
31,4,0,0,4,2021-11-22,Female,9,5-9,4
31,0,0,0,0,2021-11-17,Female,18,15-19,5
31,1,0,0,1,2021-11-17,Male,51,45-54,5
31,1,2,0,3,2021-11-19,Female,4,1-4,7
31,0,1,0,1,2021-11-22,Male,73,70-74,9
31,1,2,0,3,2021-11-18,Male,9,5-9,6
31,0,12,0,12,2021-11-18,Female,52,45-54,4
31,0,6,0,6,2021-11-22,Male,18,15-19,6
31,0,0,0,0,2021-11-17,Male,61,55-64,7
31,1,2,0,3,2021-11-18,Male,62,55-64,4
31,1,0,0,1,2021-11-18,Male,69,65-69,4
31,0,3,0,3,2021-11-19,Female,42,35-44,6
31,1,2,0,3,2021-11-18,Female,30,25-34,6
31,1,0,0,1,2021-11-20,Female,31,25-34,4
31,1,1,0,2,2021-11-18,Male,53,45-54,6
31,0,0,0,0,2021-11-19,Male,63,55-64,5
31,1,0,0,1,2021-11-17,Female,59,55-64,7
31,1,0,0,1,2021-11-19,Female,70,70-74,5
31,4,0,0,4,2021-11-17,Male,10,10-14,4
31,2,0,0,2,2021-11-17,Male,13,10-14,6
31,1,0,0,1,2021-11-19,Female,47,45-54,3
31,2,2,0,4,2021-11-18,Female,6,5-9,5
31,1,0,0,1,2021-11-20,Male,47,45-54,6
31,1,0,0,1,2021-11-17,Female,66,65-69,10
31,0,1,0,1,2021-11-22,Female,40,35-44,7
31,0,0,0,0,2021-11-22,Male,31,25-34,6
31,1,0,0,1,2021-11-17,Male,58,55-64,6
31,2,0,0,2,2021-11-17,Female,9,5-9,26
31,0,3,0,3,2021-11-19,Male,70,70-74,3
31,0,1,0,1,2021-11-23,Female,37,35-44,1
31,2,0,12,14,2021-11-19,Male,3,1-4,1
31,2,0,0,2,2021-11-17,Male,64,55-64,19
31,0,0,0,0,2021-11-17,Female,40,35-44,10
31,1,2,0,3,2021-11-18,Female,65,65-69,12
31,0,20,29,49,2021-11-23,Male,9,5-9,1
31,1,0,0,1,2021-11-19,Male,49,45-54,10
31,0,2,0,2,2021-11-18,Male,46,45-54,6
31,1,0,0,1,2021-11-17,Male,66,65-69,7
31,2,0,0,2,2021-11-22,Male,4,1-4,3
31,1,0,0,1,2021-11-19,Female,48,45-54,8
31,1,0,0,1,2021-11-17,Male,20,20-24,10
31,0,1,0,1,2021-11-22,Male,43,35-44,4
31,0,0,0,0,2021-11-21,Female,23,20-24,1
31,2,15,0,17,2021-11-17,Female,5,5-9,5
31,1,0,0,1,2021-11-18,Female,75,75-79,3
31,1,0,0,1,2021-11-18,Male,61,55-64,6
31,2,2,0,4,2021-11-23,Female,67,65-69,1
31,1,0,0,1,2021-11-18,Male,69,65-69,6
31,1,3,0,4,2021-11-20,Male,75,75-79,11
31,1,30,0,31,2021-11-17,Male,50,45-54,6
31,0,0,0,0,2021-11-18,Male,48,45-54,4
31,1,0,0,1,2021-11-22,Male,37,35-44,3
31,1,0,0,1,2021-11-18,Male,66,65-69,3
31,0,0,0,0,2021-11-21,Female,22,20-24,1
31,1,3,0,4,2021-11-19,Female,27,25-34,2
31,2,6,0,8,2021-11-20,Male,10,10-14,3
31,5,1,0,6,2021-11-22,Male,22,20-24,1
31,0,0,0,0,2021-11-19,Male,74,70-74,5
31,3,0,0,3,2021-11-17,Male,17,15-19,4
31,1,0,0,1,2021-11-22,Male,72,70-74,10
31,2,0,0,2,2021-11-17,Male,7,5-9,4
31,0,12,0,12,2021-11-17,Male,44,35-44,11
31,1,0,0,1,2021-11-18,Female,59,55-64,4
31,3,0,0,3,2021-11-17,Male,53,45-54,5
31,0,0,0,0,2021-11-17,Female,45,45-54,9
31,0,2,0,2,2021-11-18,Male,59,55-64,7
31,0,0,0,0,2021-11-17,Male,66,65-69,18
31,0,3,0,3,2021-11-23,Male,67,65-69,1
31,1,0,0,1,2021-11-18,Male,68,65-69,8
31,1,0,0,1,2021-11-18,Female,53,45-54,5
31,0,0,0,0,2021-11-22,Female,18,15-19,5
31,0,0,0,0,2021-11-17,Male,61,55-64,5
31,0,0,0,0,2021-11-19,Female,48,45-54,3
31,0,0,0,0,2021-11-20,Female,4,1-4,1
31,2,0,0,2,2021-11-20,Female,20,20-24,1
31,1,0,0,1,2021-11-19,Male,69,65-69,10
31,1,0,0,1,2021-11-19,Male,77,75-79,10
31,3,4,0,7,2021-11-17,Female,4,1-4,10
31,0,0,0,0,2021-11-17,Female,26,25-34,3
31,2,0,0,2,2021-11-23,Female,2,1-4,1
31,1,4,0,5,2021-11-18,Female,35,35-44,5
31,0,0,0,0,2021-11-23,Male,73,70-74,1
31,1,0,0,1,2021-11-18,Female,56,55-64,9
31,0,1,0,1,2021-11-18,Male,33,25-34,9
31,1,0,0,1,2021-11-18,Female,48,45-54,7
31,0,0,0,0,2021-11-18,Female,57,55-64,3
31,1,0,0,1,2021-11-17,Male,34,25-34,10
31,0,0,0,0,2021-11-22,Female,17,15-19,5
31,1,1,0,2,2021-11-18,Male,76,75-79,5
31,0,0,0,0,2021-11-22,Male,44,35-44,5
31,1,3,0,4,2021-11-17,Male,65,65-69,9
31,0,3,0,3,2021-11-18,Female,42,35-44,5
31,0,0,0,0,2021-11-17,Male,61,55-64,10
31,1,1,0,2,2021-11-20,Female,63,55-64,5
31,0,0,0,0,2021-11-22,Female,60,55-64,9
31,3,0,19,22,2021-11-18,Female,17,15-19,8
31,0,1,0,1,2021-11-19,Female,75,75-79,3
31,0,0,0,0,2021-11-18,Female,60,55-64,6
31,0,0,0,0,2021-11-17,Male,66,65-69,9
31,0,1,0,1,2021-11-18,Male,39,35-44,4
31,1,0,0,1,2021-11-17,Male,21,20-24,2
31,0,1,0,1,2021-11-18,Female,63,55-64,3
31,0,0,0,0,2021-11-17,Male,60,55-64,26
31,1,3,0,4,2021-11-19,Male,71,70-74,4
31,1,0,0,1,2021-11-17,Female,29,25-34,7
31,0,0,0,0,2021-11-19,Female,60,55-64,25
31,1,1,0,2,2021-11-23,Female,61,55-64,1
31,3,0,0,3,2021-11-19,Female,7,5-9,2
31,1,2,0,3,2021-11-22,Female,32,25-34,6
31,0,1,0,1,2021-11-23,Female,37,35-44,1
31,0,1,0,1,2021-11-18,Female,68,65-69,18
31,1,0,0,1,2021-11-17,Male,53,45-54,5
31,0,0,0,0,2021-11-18,Female,25,25-34,5
31,0,0,0,0,2021-11-18,Male,17,15-19,3
31,0,8,0,8,2021-11-19,Female,21,20-24,1
31,1,0,0,1,2021-11-19,Male,72,70-74,5
31,3,0,0,3,2021-11-23,Male,8,5-9,1
31,0,0,0,0,2021-11-19,Female,21,20-24,1
31,1,0,0,1,2021-11-22,Female,66,65-69,11
31,1,1,0,2,2021-11-18,Female,34,25-34,6
31,1,0,0,1,2021-11-21,Female,76,75-79,8
31,3,1,0,4,2021-11-18,Male,13,10-14,4
31,1,0,0,1,2021-11-17,Female,24,20-24,3
31,1,0,0,1,2021-11-17,Female,64,55-64,10
31,1,0,11,12,2021-11-17,Male,56,55-64,4
31,1,0,0,1,2021-11-19,Male,49,45-54,9
31,1,0,0,1,2021-11-23,Male,58,55-64,1
31,1,0,0,1,2021-11-22,Male,23,20-24,6
31,0,1,0,1,2021-11-17,Male,61,55-64,5
31,0,0,0,0,2021-11-23,Male,52,45-54,1
31,0,0,0,0,2021-11-19,Female,38,35-44,4
31,1,30,0,31,2021-11-19,Female,59,55-64,10
31,0,0,0,0,2021-11-19,Male,23,20-24,4
31,2,5,0,7,2021-11-18,Male,14,10-14,7
31,0,1,0,1,2021-11-17,Female,43,35-44,5
31,3,0,0,3,2021-11-17,Female,4,1-4,7
31,0,1,0,1,2021-11-19,Male,75,75-79,5
31,3,0,0,3,2021-11-17,Male,8,5-9,3
31,0,0,0,0,2021-11-17,Male,57,55-64,10
31,0,0,0,0,2021-11-19,Female,46,45-54,5
31,0,0,0,0,2021-11-18,Female,52,45-54,7
31,2,0,0,2,2021-11-17,Female,10,10-14,5
31,0,0,0,0,2021-11-17,Male,65,65-69,6
31,0,0,0,0,2021-11-19,Male,80,80-84,10
31,0,0,0,0,2021-11-19,Male,78,75-79,3
31,1,0,0,1,2021-11-18,Male,73,70-74,5
31,1,0,0,1,2021-11-18,Female,73,70-74,6
31,2,0,0,2,2021-11-17,Female,16,15-19,5
31,1,0,0,1,2021-11-22,Female,69,65-69,5
31,0,1,0,1,2021-11-18,Male,51,45-54,21
31,0,0,0,0,2021-11-18,Male,76,75-79,4
31,0,1,0,1,2021-11-17,Male,66,65-69,5
31,0,0,1,1,2021-11-17,Male,65,65-69,5
31,0,33,0,33,2021-11-17,Male,61,55-64,11
31,0,0,0,0,2021-11-17,Male,57,55-64,2
31,0,0,0,0,2021-11-22,Male,18,15-19,1
31,2,0,0,2,2021-11-17,Male,10,10-14,5
31,1,0,0,1,2021-11-18,Female,52,45-54,4
31,0,0,0,0,2021-11-19,Male,60,55-64,9
31,0,0,0,0,2021-11-19,Male,63,55-64,5
31,2,0,0,2,2021-11-18,Female,67,65-69,20
31,0,0,0,0,2021-11-23,Male,28,25-34,8
31,1,0,0,1,2021-11-22,Female,26,25-34,8
31,0,1,0,1,2021-11-19,Male,69,65-69,4
31,0,0,0,0,2021-11-17,Male,56,55-64,3
31,1,0,0,1,2021-11-17,Male,45,45-54,6
31,1,10,0,11,2021-11-19,Female,52,45-54,2
31,3,25,55,83,2021-11-17,Male,10,10-14,5
31,0,0,0,0,2021-11-17,Female,56,55-64,10
31,0,0,0,0,2021-11-18,Male,28,25-34,14
31,0,2,0,2,2021-11-18,Male,60,55-64,4
31,0,3,0,3,2021-11-18,Male,70,70-74,5
31,0,4,0,4,2021-11-18,Female,50,45-54,5
31,0,0,0,0,2021-11-22,Male,48,45-54,4
31,1,10,0,11,2021-11-17,Female,25,25-34,2
31,0,0,0,0,2021-11-17,Male,60,55-64,4
31,1,0,0,1,2021-11-18,Female,59,55-64,6
31,0,0,0,0,2021-11-21,Male,7,5-9,10
31,4,0,0,4,2021-11-17,Female,32,25-34,14
31,1,1,0,2,2021-11-19,Male,73,70-74,9
31,1,0,10,11,2021-11-19,Male,61,55-64,4
31,1,0,0,1,2021-11-18,Male,70,70-74,5
31,0,0,0,0,2021-11-18,Male,24,20-24,2
31,0,0,0,0,2021-11-17,Female,23,20-24,6
31,2,0,0,2,2021-11-17,Male,2,1-4,4
31,3,0,0,3,2021-11-18,Female,1,1-4,10
31,1,1,0,2,2021-11-19,Female,62,55-64,6
31,1,0,0,1,2021-11-17,Female,54,45-54,5
31,0,9,0,9,2021-11-18,Female,42,35-44,4
31,1,0,0,1,2021-11-18,Female,18,15-19,4
31,2,0,0,2,2021-11-19,Female,18,15-19,1
31,0,38,0,38,2021-11-18,Female,68,65-69,5
31,1,3,0,4,2021-11-19,Male,60,55-64,3
31,2,1,0,3,2021-11-18,Female,18,15-19,5
31,1,2,0,3,2021-11-18,Female,64,55-64,4
31,1,2,0,3,2021-11-18,Male,71,70-74,5
31,2,0,0,2,2021-11-22,Female,71,70-74,22
31,2,0,0,2,2021-11-19,Male,8,5-9,6
31,1,0,1,2,2021-11-18,Male,62,55-64,3
31,1,1,0,2,2021-11-19,Male,69,65-69,4
31,1,0,0,1,2021-11-18,Female,39,35-44,4
31,0,0,0,0,2021-11-19,Male,81,80-84,3
31,2,0,0,2,2021-11-17,Male,3,1-4,5
31,1,0,0,1,2021-11-19,Female,71,70-74,7
31,3,25,0,28,2021-11-18,Female,11,10-14,13
31,1,0,0,1,2021-11-18,Male,71,70-74,5
31,1,0,0,1,2021-11-19,Male,60,55-64,4
31,1,1,0,2,2021-11-17,Female,50,45-54,4
31,2,1,0,3,2021-11-18,Female,28,25-34,11
31,1,1,0,2,2021-11-19,Female,37,35-44,20
31,0,0,0,0,2021-11-17,Male,55,55-64,11
31,0,0,0,0,2021-11-17,Male,59,55-64,9
31,0,0,10,10,2021-11-22,Male,29,25-34,10
31,0,1,0,1,2021-11-20,Female,54,45-54,5
31,1,1,4,6,2021-11-22,Male,39,35-44,10
31,0,0,0,0,2021-11-17,Male,41,35-44,4
31,2,0,2,4,2021-11-18,Male,34,25-34,5
31,0,3,0,3,2021-11-17,Male,50,45-54,6
31,1,0,0,1,2021-11-17,Male,54,45-54,2
31,1,0,2,3,2021-11-22,Female,54,45-54,3
31,1,84,81,166,2021-11-17,Female,57,55-64,6
31,2,6,0,8,2021-11-23,Female,56,55-64,1
31,1,2,0,3,2021-11-17,Female,31,25-34,13
31,1,0,0,1,2021-11-19,Female,63,55-64,4
31,1,0,0,1,2021-11-17,Female,60,55-64,5
31,0,0,0,0,2021-11-19,Female,62,55-64,7
31,1,5,0,6,2021-11-20,Female,57,55-64,12
31,1,0,0,1,2021-11-18,Male,40,35-44,5
31,3,0,0,3,2021-11-19,Female,0,<1,5
31,1,2,0,3,2021-11-18,Male,68,65-69,4
31,0,0,0,0,2021-11-18,Female,72,70-74,4
31,1,0,0,1,2021-11-19,Female,55,55-64,10
31,1,4,0,5,2021-11-20,Female,24,20-24,1
31,0,0,0,0,2021-11-17,Male,58,55-64,4
31,1,0,0,1,2021-11-18,Female,73,70-74,11
31,1,0,0,1,2021-11-18,Female,43,35-44,7
31,1,1,0,2,2021-11-18,Male,62,55-64,4
31,0,2,0,2,2021-11-18,Female,30,25-34,6
31,1,1,0,2,2021-11-19,Male,70,70-74,5
31,1,6,0,7,2021-11-19,Female,32,25-34,4
31,2,0,0,2,2021-11-18,Male,35,35-44,11
31,0,0,0,0,2021-11-17,Female,65,65-69,10
31,1,1,0,2,2021-11-18,Male,63,55-64,22
31,0,0,0,0,2021-11-22,Male,45,45-54,10
31,1,0,0,1,2021-11-17,Female,58,55-64,3
31,0,0,0,0,2021-11-19,Female,70,70-74,9
31,0,0,0,0,2021-11-22,Female,70,70-74,6
31,0,0,0,0,2021-11-17,Male,65,65-69,9
31,3,1,0,4,2021-11-19,Male,2,1-4,3
31,2,2,0,4,2021-11-17,Female,45,45-54,3
31,1,0,0,1,2021-11-21,Female,22,20-24,1
31,0,0,0,0,2021-11-17,Female,41,35-44,5
31,1,0,0,1,2021-11-22,Male,69,65-69,3
31,0,2,0,2,2021-11-17,Female,56,55-64,10
31,0,0,0,0,2021-11-23,Male,81,80-84,2
31,3,0,0,3,2021-11-18,Male,10,10-14,11
31,1,2,0,3,2021-11-19,Male,13,10-14,1
31,1,0,0,1,2021-11-17,Female,67,65-69,4
31,2,1,0,3,2021-11-18,Female,11,10-14,5
31,2,1,0,3,2021-11-17,Male,45,45-54,11
31,0,0,0,0,2021-11-17,Female,54,45-54,7
31,1,0,0,1,2021-11-22,Female,46,45-54,9
31,2,0,0,2,2021-11-18,Male,74,70-74,5
31,1,0,0,1,2021-11-19,Female,38,35-44,10
31,0,0,0,0,2021-11-17,Male,51,45-54,7
31,0,0,0,0,2021-11-17,Male,19,15-19,10
31,2,0,0,2,2021-11-17,Male,16,15-19,5
31,2,0,0,2,2021-11-19,Male,72,70-74,20
31,1,0,0,1,2021-11-20,Male,60,55-64,7
31,3,1,0,4,2021-11-21,Male,22,20-24,1
31,0,3,0,3,2021-11-18,Female,70,70-74,5
31,0,1,0,1,2021-11-22,Female,35,35-44,7
31,0,2,0,2,2021-11-17,Female,61,55-64,5
31,3,0,0,3,2021-11-22,Male,17,15-19,10
31,3,0,0,3,2021-11-18,Male,2,1-4,7
31,0,2,0,2,2021-11-19,Female,44,35-44,5
31,0,0,0,0,2021-11-17,Female,66,65-69,9
31,0,0,0,0,2021-11-17,Male,53,45-54,27
31,3,0,0,3,2021-11-21,Female,2,1-4,4
31,1,0,0,1,2021-11-19,Female,55,55-64,7
31,0,0,0,0,2021-11-17,Male,5,5-9,5
31,1,0,0,1,2021-11-18,Female,58,55-64,4
31,0,0,0,0,2021-11-22,Female,34,25-34,6
31,3,0,0,3,2021-11-21,Female,24,20-24,1
31,1,0,0,1,2021-11-18,Male,62,55-64,3
31,2,0,0,2,2021-11-22,Male,68,65-69,8
31,1,2,0,3,2021-11-17,Female,22,20-24,3
31,1,2,0,3,2021-11-19,Male,68,65-69,3
31,1,0,0,1,2021-11-18,Male,7,5-9,6
31,0,0,0,0,2021-11-17,Female,0,<1,9
31,1,0,0,1,2021-11-19,Female,50,45-54,13
31,0,1,0,1,2021-11-19,Female,69,65-69,23
31,0,0,0,0,2021-11-22,Male,75,75-79,2
31,3,2,0,5,2021-11-17,Female,18,15-19,23
31,0,0,3,3,2021-11-19,Female,0,<1,1
31,1,0,0,1,2021-11-19,Female,85,85+,4
31,1,0,0,1,2021-11-18,Female,63,55-64,5
31,2,0,0,2,2021-11-18,Female,18,15-19,9
31,0,0,0,0,2021-11-18,Female,32,25-34,9
31,1,6,0,7,2021-11-18,Male,62,55-64,6
31,0,0,0,0,2021-11-20,Male,75,75-79,4
31,1,1,0,2,2021-11-19,Male,71,70-74,4
31,1,33,0,34,2021-11-19,Female,60,55-64,3
31,0,0,0,0,2021-11-18,Female,35,35-44,5
31,1,0,10,11,2021-11-18,Female,15,15-19,9
31,1,1,0,2,2021-11-19,Female,68,65-69,22
31,2,0,0,2,2021-11-21,Female,22,20-24,1
31,1,2,0,3,2021-11-19,Male,69,65-69,5
31,0,1,0,1,2021-11-22,Female,41,35-44,8
31,1,2,0,3,2021-11-19,Male,72,70-74,3
31,1,0,0,1,2021-11-17,Male,64,55-64,9
31,1,0,0,1,2021-11-18,Male,81,80-84,5
31,0,2,0,2,2021-11-17,Male,66,65-69,3
31,1,0,0,1,2021-11-18,Female,54,45-54,4
31,1,0,0,1,2021-11-22,Female,1,1-4,3
31,1,32,0,33,2021-11-17,Male,5,5-9,2
31,1,0,0,1,2021-11-19,Female,31,25-34,4
31,1,0,0,1,2021-11-18,Male,61,55-64,6
31,0,0,0,0,2021-11-17,Female,61,55-64,4
31,1,0,0,1,2021-11-18,Female,36,35-44,10
31,1,0,0,1,2021-11-18,Male,53,45-54,10
31,0,0,0,0,2021-11-22,Male,51,45-54,9
31,2,0,0,2,2021-11-19,Male,35,35-44,9
31,1,3,0,4,2021-11-18,Male,72,70-74,4
31,3,0,0,3,2021-11-18,Female,5,5-9,4
31,3,0,0,3,2021-11-17,Female,8,5-9,11
31,1,0,0,1,2021-11-18,Male,36,35-44,5
31,0,1,0,1,2021-11-18,Female,33,25-34,6
31,0,0,0,0,2021-11-18,Male,78,75-79,3
31,1,1,0,2,2021-11-19,Male,69,65-69,5
31,2,0,1,3,2021-11-17,Female,16,15-19,5
31,1,0,0,1,2021-11-17,Male,0,<1,3
31,1,0,0,1,2021-11-20,Female,24,20-24,1
31,0,0,0,0,2021-11-22,Female,51,45-54,3
31,0,30,0,30,2021-11-23,Male,48,45-54,1
31,3,0,0,3,2021-11-17,Female,0,<1,5
31,2,0,0,2,2021-11-22,Female,51,45-54,19
31,4,0,0,4,2021-11-22,Female,3,1-4,4
31,1,2,0,3,2021-11-17,Male,61,55-64,7
31,0,2,0,2,2021-11-17,Female,25,25-34,18
31,1,0,0,1,2021-11-17,Female,17,15-19,3
31,1,0,0,1,2021-11-17,Male,44,35-44,10
31,0,0,0,0,2021-11-18,Male,41,35-44,5
31,0,2,0,2,2021-11-19,Male,74,70-74,4
31,1,0,0,1,2021-11-19,Male,74,70-74,3
31,0,0,0,0,2021-11-17,Male,66,65-69,4
31,2,0,0,2,2021-11-20,Female,55,55-64,4
31,0,0,0,0,2021-11-17,Female,65,65-69,9
31,4,7,10,21,2021-11-17,Male,64,55-64,3
31,0,0,0,0,2021-11-19,Male,71,70-74,10
31,0,0,0,0,2021-11-20,Female,66,65-69,7
31,2,0,0,2,2021-11-19,Female,32,25-34,3
31,0,0,0,0,2021-11-22,Male,43,35-44,2
31,1,0,0,1,2021-11-18,Female,62,55-64,5
31,0,1,0,1,2021-11-23,Female,31,25-34,26
31,1,3,0,4,2021-11-18,Male,76,75-79,4
31,1,0,0,1,2021-11-17,Male,53,45-54,3
31,1,0,0,1,2021-11-20,Male,8,5-9,5
31,2,0,0,2,2021-11-18,Male,11,10-14,4
31,1,0,0,1,2021-11-17,Female,30,25-34,4
31,1,6,0,7,2021-11-21,Male,60,55-64,7
31,5,0,0,5,2021-11-18,Male,0,<1,2
31,0,0,0,0,2021-11-19,Female,70,70-74,22
31,1,1,0,2,2021-11-19,Male,71,70-74,5
31,0,4,0,4,2021-11-18,Female,62,55-64,10
31,1,0,0,1,2021-11-19,Male,72,70-74,2
31,0,0,0,0,2021-11-18,Male,47,45-54,4
31,0,0,0,0,2021-11-18,Female,74,70-74,10
31,0,1,0,1,2021-11-22,Female,48,45-54,10
31,1,0,0,1,2021-11-19,Female,60,55-64,5
31,0,0,0,0,2021-11-18,Male,52,45-54,6
31,0,0,0,0,2021-11-17,Male,57,55-64,2
31,0,7,0,7,2021-11-19,Female,63,55-64,3
31,2,21,0,23,2021-11-17,Male,14,10-14,7
31,0,0,0,0,2021-11-19,Female,9,5-9,4
31,1,0,0,1,2021-11-18,Male,81,80-84,4
31,1,0,0,1,2021-11-18,Male,66,65-69,8
31,1,0,0,1,2021-11-19,Female,63,55-64,4
31,1,0,0,1,2021-11-22,Female,47,45-54,4
31,2,0,0,2,2021-11-22,Male,69,65-69,15
31,0,2,0,2,2021-11-21,Male,24,20-24,1
31,0,13,0,13,2021-11-18,Female,35,35-44,3
31,3,0,1,4,2021-11-22,Male,3,1-4,5
31,0,4,0,4,2021-11-22,Female,39,35-44,6
31,1,0,0,1,2021-11-23,Female,55,55-64,1
31,0,0,0,0,2021-11-19,Male,70,70-74,7
31,3,2,9,14,2021-11-17,Male,4,1-4,7
31,1,1,0,2,2021-11-18,Female,46,45-54,5
31,1,10,0,11,2021-11-17,Male,56,55-64,6
31,1,0,0,1,2021-11-18,Male,48,45-54,4
31,1,0,0,1,2021-11-22,Male,60,55-64,3
31,1,0,0,1,2021-11-22,Female,54,45-54,5
31,2,0,0,2,2021-11-22,Male,14,10-14,2
31,0,0,0,0,2021-11-19,Female,78,75-79,5
31,1,0,0,1,2021-11-17,Female,64,55-64,4
31,0,0,0,0,2021-11-18,Female,32,25-34,6
31,1,0,0,1,2021-11-17,Male,53,45-54,11
31,1,0,0,1,2021-11-18,Male,49,45-54,7
31,0,2,0,2,2021-11-22,Male,73,70-74,6
31,3,0,0,3,2021-11-22,Male,14,10-14,19
31,3,0,0,3,2021-11-17,Male,10,10-14,11
31,1,3,0,4,2021-11-21,Female,22,20-24,7
31,0,3,0,3,2021-11-18,Male,51,45-54,11
31,1,0,0,1,2021-11-18,Female,50,45-54,7
31,0,5,0,5,2021-11-17,Female,40,35-44,7
31,4,9,0,13,2021-11-19,Female,12,10-14,8
31,1,5,34,40,2021-11-21,Female,22,20-24,1
31,0,0,0,0,2021-11-18,Male,49,45-54,7
31,0,4,0,4,2021-11-20,Female,52,45-54,4
31,0,1,0,1,2021-11-18,Male,62,55-64,4
31,1,0,0,1,2021-11-18,Female,5,5-9,2
31,0,1,0,1,2021-11-23,Male,54,45-54,1
31,2,0,0,2,2021-11-21,Female,10,10-14,5
31,0,0,0,0,2021-11-18,Male,58,55-64,22
31,1,0,0,1,2021-11-19,Female,79,75-79,3
31,2,0,0,2,2021-11-19,Female,69,65-69,19
31,7,1,0,8,2021-11-23,Male,4,1-4,1
31,1,0,0,1,2021-11-18,Male,61,55-64,5
31,0,0,0,0,2021-11-18,Female,27,25-34,5
31,0,0,0,0,2021-11-17,Male,34,25-34,9
31,0,1,0,1,2021-11-17,Female,53,45-54,3
31,0,0,0,0,2021-11-18,Male,60,55-64,4
31,0,4,0,4,2021-11-18,Male,46,45-54,10
31,1,0,0,1,2021-11-18,Female,57,55-64,9
31,1,0,0,1,2021-11-22,Male,52,45-54,7
31,0,0,0,0,2021-11-21,Male,23,20-24,1
31,0,0,0,0,2021-11-23,Male,56,55-64,1
31,3,0,0,3,2021-11-18,Female,40,35-44,4
31,1,0,0,1,2021-11-18,Female,60,55-64,11
31,0,0,0,0,2021-11-19,Male,59,55-64,8
31,1,0,0,1,2021-11-18,Male,51,45-54,4
31,0,0,0,0,2021-11-18,Female,66,65-69,5
31,0,0,0,0,2021-11-17,Male,45,45-54,6
31,1,0,0,1,2021-11-17,Female,31,25-34,4
31,0,3,0,3,2021-11-19,Male,53,45-54,5
31,1,0,0,1,2021-11-18,Male,71,70-74,5
31,0,0,0,0,2021-11-18,Male,60,55-64,3
31,2,0,0,2,2021-11-20,Female,60,55-64,19
31,0,2,0,2,2021-11-17,Male,22,20-24,2
31,0,0,0,0,2021-11-19,Female,73,70-74,4
31,1,0,0,1,2021-11-17,Male,55,55-64,11
31,1,5,0,6,2021-11-20,Male,69,65-69,4
31,1,3,0,4,2021-11-18,Female,50,45-54,5
31,1,0,0,1,2021-11-18,Female,77,75-79,5
31,0,1,0,1,2021-11-17,Female,58,55-64,3
31,0,0,0,0,2021-11-18,Female,49,45-54,3
31,3,3,0,6,2021-11-17,Female,18,15-19,10
31,2,0,0,2,2021-11-20,Female,13,10-14,11
31,3,0,0,3,2021-11-18,Female,59,55-64,5
31,0,0,0,0,2021-11-18,Male,66,65-69,10
31,0,0,0,0,2021-11-18,Male,69,65-69,5
31,0,3,0,3,2021-11-18,Female,48,45-54,3
31,1,0,0,1,2021-11-18,Male,77,75-79,8
31,1,1,0,2,2021-11-18,Female,54,45-54,7
31,0,0,0,0,2021-11-17,Male,67,65-69,4
31,1,0,19,20,2021-11-19,Male,75,75-79,4
31,1,0,0,1,2021-11-19,Male,60,55-64,10
31,0,0,0,0,2021-11-23,Male,33,25-34,2
31,0,2,0,2,2021-11-19,Female,63,55-64,6
31,0,5,0,5,2021-11-17,Male,38,35-44,4
31,1,1,0,2,2021-11-18,Female,69,65-69,11
31,0,0,0,0,2021-11-18,Female,43,35-44,5
31,1,0,0,1,2021-11-18,Female,13,10-14,3
31,1,3,0,4,2021-11-19,Female,69,65-69,4
31,3,0,0,3,2021-11-20,Male,22,20-24,21
31,2,0,0,2,2021-11-17,Male,66,65-69,16
31,1,2,0,3,2021-11-21,Male,18,15-19,1
31,0,0,0,0,2021-11-17,Female,65,65-69,23
31,2,0,0,2,2021-11-18,Female,6,5-9,3
31,0,0,0,0,2021-11-18,Male,45,45-54,7
31,0,0,0,0,2021-11-17,Male,8,5-9,4
31,2,0,0,2,2021-11-17,Female,30,25-34,4
31,2,0,0,2,2021-11-17,Female,53,45-54,5
31,1,1,0,2,2021-11-18,Male,64,55-64,4
31,0,0,0,0,2021-11-20,Female,55,55-64,11
31,1,0,0,1,2021-11-19,Female,71,70-74,8
31,1,0,0,1,2021-11-19,Male,73,70-74,5
31,0,3,0,3,2021-11-22,Female,20,20-24,1
31,0,0,0,0,2021-11-18,Male,70,70-74,4
31,3,2,0,5,2021-11-17,Male,59,55-64,10
31,0,11,0,11,2021-11-18,Female,52,45-54,7
31,2,1,1,4,2021-11-18,Male,52,45-54,10
31,1,0,0,1,2021-11-17,Female,53,45-54,5
31,1,0,0,1,2021-11-18,Male,68,65-69,7
31,0,1,0,1,2021-11-22,Male,44,35-44,6
31,1,0,0,1,2021-11-19,Male,36,35-44,5
31,2,0,0,2,2021-11-18,Female,44,35-44,5
31,0,0,0,0,2021-11-17,Female,66,65-69,8
31,0,0,0,0,2021-11-18,Male,50,45-54,5
31,4,2,0,6,2021-11-17,Female,13,10-14,5
31,0,8,15,23,2021-11-20,Female,74,70-74,4
31,1,0,0,1,2021-11-18,Male,45,45-54,10
31,1,0,0,1,2021-11-22,Female,27,25-34,10
31,1,0,0,1,2021-11-17,Male,68,65-69,7
31,3,0,0,3,2021-11-17,Male,4,1-4,3
31,3,0,0,3,2021-11-19,Female,20,20-24,1
31,1,1,0,2,2021-11-20,Male,73,70-74,5
31,0,3,0,3,2021-11-17,Male,45,45-54,4
31,2,0,0,2,2021-11-17,Male,8,5-9,2
31,1,1,0,2,2021-11-19,Female,62,55-64,3
31,0,0,0,0,2021-11-21,Male,41,35-44,5
31,0,0,0,0,2021-11-17,Female,50,45-54,6
31,0,0,0,0,2021-11-17,Female,65,65-69,10
31,0,2,0,2,2021-11-17,Female,67,65-69,7
31,1,1,0,2,2021-11-21,Male,53,45-54,6
31,3,0,0,3,2021-11-17,Male,4,1-4,3
31,1,0,0,1,2021-11-17,Male,53,45-54,11
31,0,1,0,1,2021-11-19,Female,47,45-54,10
31,2,3,0,5,2021-11-23,Male,66,65-69,3
31,0,0,0,0,2021-11-18,Male,72,70-74,4
31,1,0,0,1,2021-11-18,Female,65,65-69,4
31,0,0,0,0,2021-11-19,Female,53,45-54,10
31,1,0,0,1,2021-11-18,Female,76,75-79,10
31,0,4,0,4,2021-11-19,Female,59,55-64,5
31,1,0,0,1,2021-11-19,Female,52,45-54,3
31,1,0,0,1,2021-11-17,Female,34,25-34,6
31,1,3,0,4,2021-11-19,Female,31,25-34,3
31,1,0,0,1,2021-11-17,Female,41,35-44,5
31,1,0,0,1,2021-11-19,Female,51,45-54,5
31,1,0,0,1,2021-11-21,Female,23,20-24,1
31,1,3,0,4,2021-11-20,Male,72,70-74,3
31,0,0,0,0,2021-11-18,Female,58,55-64,5
31,0,4,0,4,2021-11-19,Female,22,20-24,1
31,0,0,0,0,2021-11-23,Male,60,55-64,1
31,0,0,0,0,2021-11-17,Female,23,20-24,22
31,1,0,0,1,2021-11-17,Male,61,55-64,6
31,1,2,0,3,2021-11-17,Male,54,45-54,4
31,3,7,0,10,2021-11-17,Female,4,1-4,7
31,2,1,0,3,2021-11-17,Female,61,55-64,9
31,1,0,0,1,2021-11-23,Female,62,55-64,1
31,1,0,0,1,2021-11-19,Male,72,70-74,4
31,1,0,0,1,2021-11-17,Female,44,35-44,6
31,0,0,0,0,2021-11-17,Male,57,55-64,4
31,3,0,0,3,2021-11-23,Male,1,1-4,1
31,1,4,0,5,2021-11-18,Male,65,65-69,5
31,0,1,0,1,2021-11-18,Male,52,45-54,5
31,3,0,0,3,2021-11-23,Female,0,<1,1
31,1,0,0,1,2021-11-18,Male,68,65-69,9
31,3,0,4,7,2021-11-18,Female,7,5-9,2
31,0,0,0,0,2021-11-18,Male,46,45-54,7
31,3,0,0,3,2021-11-18,Male,9,5-9,11
31,3,0,0,3,2021-11-18,Female,37,35-44,16
31,0,0,0,0,2021-11-20,Female,6,5-9,1
31,0,0,0,0,2021-11-17,Male,19,15-19,7
31,1,0,0,1,2021-11-20,Male,42,35-44,4
31,1,0,0,1,2021-11-22,Male,71,70-74,9
31,0,0,0,0,2021-11-18,Male,53,45-54,4
31,0,1,0,1,2021-11-19,Male,59,55-64,3
31,0,0,0,0,2021-11-19,Male,49,45-54,3
31,0,0,0,0,2021-11-19,Female,9,5-9,4
31,0,4,0,4,2021-11-21,Female,40,35-44,5
31,2,0,0,2,2021-11-17,Male,34,25-34,22
31,2,0,0,2,2021-11-23,Male,53,45-54,1
31,1,0,0,1,2021-11-18,Male,53,45-54,6
31,2,0,0,2,2021-11-19,Female,8,5-9,1
31,1,3,0,4,2021-11-18,Female,34,25-34,5
31,0,5,0,5,2021-11-17,Male,65,65-69,3
31,0,2,0,2,2021-11-17,Male,67,65-69,7
31,2,20,0,22,2021-11-17,Male,13,10-14,5
31,1,1,0,2,2021-11-20,Male,71,70-74,4
31,1,0,0,1,2021-11-18,Female,59,55-64,25
31,3,19,0,22,2021-11-17,Male,8,5-9,3
31,3,2,0,5,2021-11-17,Female,50,45-54,5
31,2,1,0,3,2021-11-22,Male,17,15-19,5
31,0,0,0,0,2021-11-17,Male,21,20-24,11
31,0,0,0,0,2021-11-18,Female,25,25-34,12
31,1,0,0,1,2021-11-17,Female,32,25-34,5
31,1,1,0,2,2021-11-19,Female,49,45-54,9
31,0,6,0,6,2021-11-18,Male,74,70-74,4
31,1,2,0,3,2021-11-19,Male,72,70-74,3
31,0,2,0,2,2021-11-19,Male,49,45-54,5
31,0,0,0,0,2021-11-18,Male,70,70-74,5
31,1,0,0,1,2021-11-17,Male,67,65-69,11
31,0,0,0,0,2021-11-18,Male,54,45-54,6
31,1,0,0,1,2021-11-18,Male,65,65-69,4
31,0,1,0,1,2021-11-17,Female,30,25-34,5
31,0,5,0,5,2021-11-17,Female,56,55-64,3
31,1,0,0,1,2021-11-18,Male,53,45-54,5
31,1,3,0,4,2021-11-17,Female,65,65-69,3
31,0,0,0,0,2021-11-18,Female,64,55-64,5
31,1,10,0,11,2021-11-18,Female,27,25-34,2
31,0,0,0,0,2021-11-18,Female,40,35-44,4
31,1,1,0,2,2021-11-19,Female,69,65-69,4
31,0,0,0,0,2021-11-18,Male,63,55-64,5
31,2,0,0,2,2021-11-17,Female,2,1-4,5
31,0,0,0,0,2021-11-21,Female,21,20-24,1
31,1,11,0,12,2021-11-18,Female,56,55-64,2
31,1,0,0,1,2021-11-19,Female,31,25-34,2
31,1,0,0,1,2021-11-17,Male,58,55-64,5
31,2,3,0,5,2021-11-23,Female,52,45-54,1
31,1,0,0,1,2021-11-19,Male,74,70-74,3
31,0,0,0,0,2021-11-17,Female,44,35-44,11
31,1,0,0,1,2021-11-22,Male,50,45-54,8
31,0,0,0,0,2021-11-17,Female,29,25-34,9
31,0,0,0,0,2021-11-22,Female,39,35-44,4
31,1,0,0,1,2021-11-19,Female,22,20-24,12
31,0,2,0,2,2021-11-17,Male,58,55-64,5
31,0,0,0,0,2021-11-17,Female,42,35-44,5
31,0,5,0,5,2021-11-18,Male,38,35-44,10
31,1,0,0,1,2021-11-19,Female,52,45-54,12
31,1,3,0,4,2021-11-21,Male,73,70-74,6
31,0,0,0,0,2021-11-18,Female,46,45-54,5
31,1,0,0,1,2021-11-19,Male,38,35-44,5
31,1,0,0,1,2021-11-18,Female,58,55-64,5
31,1,0,0,1,2021-11-19,Male,63,55-64,4
31,3,13,0,16,2021-11-23,Female,2,1-4,1
31,0,7,0,7,2021-11-22,Female,37,35-44,8
31,3,2,0,5,2021-11-18,Male,22,20-24,6
31,0,1,0,1,2021-11-18,Male,61,55-64,4
31,2,1,0,3,2021-11-17,Female,20,20-24,3
31,3,0,0,3,2021-11-17,Male,9,5-9,5
31,1,0,0,1,2021-11-17,Female,57,55-64,4
31,1,0,0,1,2021-11-17,Male,58,55-64,4
31,0,0,0,0,2021-11-19,Male,63,55-64,4
31,3,0,0,3,2021-11-18,Female,5,5-9,9
31,2,0,0,2,2021-11-21,Male,4,1-4,2
31,0,0,0,0,2021-11-21,Female,29,25-34,3
31,1,2,0,3,2021-11-19,Female,63,55-64,9
31,1,0,0,1,2021-11-18,Male,61,55-64,10
31,2,0,27,29,2021-11-17,Male,14,10-14,7
31,1,1,0,2,2021-11-19,Male,75,75-79,18
31,0,0,0,0,2021-11-17,Male,51,45-54,4
31,0,1,0,1,2021-11-23,Male,71,70-74,1
31,5,2,0,7,2021-11-17,Male,4,1-4,5
31,0,0,0,0,2021-11-21,Female,33,25-34,2
31,2,0,0,2,2021-11-20,Female,71,70-74,5
31,1,0,0,1,2021-11-19,Male,69,65-69,4
31,0,2,0,2,2021-11-17,Male,54,45-54,6
31,0,0,0,0,2021-11-18,Male,71,70-74,6
31,0,0,0,0,2021-11-17,Male,46,45-54,3
31,0,0,0,0,2021-11-17,Female,16,15-19,3
31,0,0,0,0,2021-11-22,Male,59,55-64,15
31,1,0,0,1,2021-11-19,Male,53,45-54,6
31,0,0,4,4,2021-11-18,Male,31,25-34,2
31,0,1,0,1,2021-11-23,Male,52,45-54,1
31,0,1,0,1,2021-11-17,Female,51,45-54,11
31,1,0,0,1,2021-11-17,Male,67,65-69,10
31,0,1,0,1,2021-11-19,Female,63,55-64,6
31,1,0,0,1,2021-11-17,Female,64,55-64,8
31,1,3,0,4,2021-11-17,Male,67,65-69,3
31,1,0,0,1,2021-11-18,Male,38,35-44,5
31,0,2,0,2,2021-11-17,Male,65,65-69,5
31,2,0,0,2,2021-11-19,Female,53,45-54,22
31,0,0,0,0,2021-11-17,Female,66,65-69,5
31,0,0,0,0,2021-11-23,Male,54,45-54,6
31,1,0,0,1,2021-11-18,Female,60,55-64,3
31,1,0,0,1,2021-11-19,Female,35,35-44,20
31,0,0,0,0,2021-11-20,Male,21,20-24,1
31,1,3,0,4,2021-11-19,Male,72,70-74,5
31,2,0,0,2,2021-11-22,Male,68,65-69,4
31,2,0,0,2,2021-11-17,Female,1,1-4,8
31,4,0,0,4,2021-11-17,Female,1,1-4,8
31,0,7,0,7,2021-11-17,Female,58,55-64,3
31,1,0,0,1,2021-11-18,Female,38,35-44,9
31,0,3,0,3,2021-11-17,Male,57,55-64,2
31,0,0,0,0,2021-11-20,Male,22,20-24,1
31,1,0,0,1,2021-11-21,Male,56,55-64,17
31,2,0,0,2,2021-11-19,Female,49,45-54,4
31,3,0,0,3,2021-11-18,Male,10,10-14,4
31,1,0,0,1,2021-11-18,Female,72,70-74,8
31,2,0,0,2,2021-11-18,Male,3,1-4,2
31,0,0,0,0,2021-11-18,Male,66,65-69,10
31,0,1,0,1,2021-11-17,Female,30,25-34,6
31,1,2,0,3,2021-11-19,Female,69,65-69,4
31,1,3,0,4,2021-11-18,Male,70,70-74,5
31,0,1,0,1,2021-11-18,Female,22,20-24,10
31,0,2,0,2,2021-11-20,Male,44,35-44,17
31,0,0,0,0,2021-11-17,Female,65,65-69,6
31,1,0,0,1,2021-11-18,Male,69,65-69,10
31,1,0,0,1,2021-11-20,Female,44,35-44,4
31,1,0,0,1,2021-11-19,Female,71,70-74,5
31,0,0,0,0,2021-11-17,Male,60,55-64,4
31,1,1,2,4,2021-11-22,Male,70,70-74,8
31,0,0,0,0,2021-11-17,Male,40,35-44,10
31,1,0,0,1,2021-11-20,Male,73,70-74,5
31,0,0,0,0,2021-11-21,Female,18,15-19,1
31,1,1,0,2,2021-11-19,Male,78,75-79,11
31,0,0,0,0,2021-11-17,Male,57,55-64,9
31,0,0,0,0,2021-11-18,Female,68,65-69,19
31,1,0,0,1,2021-11-18,Male,62,55-64,11
31,0,0,0,0,2021-11-17,Male,55,55-64,4
31,1,10,0,11,2021-11-18,Female,57,55-64,4
31,0,0,0,0,2021-11-22,Male,37,35-44,4
31,4,0,0,4,2021-11-20,Female,12,10-14,4
31,0,0,0,0,2021-11-18,Female,67,65-69,5
31,0,0,0,0,2021-11-18,Female,60,55-64,4
31,1,1,0,2,2021-11-17,Female,57,55-64,3
31,0,1,0,1,2021-11-18,Male,54,45-54,3
31,0,0,0,0,2021-11-21,Male,69,65-69,2
31,0,4,0,4,2021-11-18,Female,51,45-54,6
31,0,3,0,3,2021-11-19,Male,80,80-84,6
31,0,0,0,0,2021-11-19,Female,66,65-69,21
31,2,0,0,2,2021-11-19,Male,16,15-19,4
31,1,10,0,11,2021-11-19,Female,39,35-44,6
31,1,0,0,1,2021-11-17,Female,58,55-64,4
31,3,0,0,3,2021-11-18,Female,42,35-44,9
31,0,0,0,0,2021-11-19,Male,42,35-44,4
31,0,0,0,0,2021-11-18,Female,69,65-69,8
31,1,0,0,1,2021-11-19,Male,80,80-84,4
31,0,0,0,0,2021-11-17,Female,54,45-54,10
31,0,0,0,0,2021-11-18,Male,39,35-44,9
31,2,0,0,2,2021-11-19,Male,50,45-54,3
31,2,10,0,12,2021-11-20,Male,68,65-69,24
31,1,2,0,3,2021-11-19,Female,77,75-79,21
31,2,0,0,2,2021-11-22,Male,1,1-4,5
31,0,10,0,10,2021-11-23,Female,49,45-54,1
31,2,0,0,2,2021-11-18,Female,9,5-9,20
31,1,0,0,1,2021-11-18,Male,77,75-79,4
31,3,17,0,20,2021-11-17,Male,2,1-4,3
31,0,0,0,0,2021-11-17,Male,68,65-69,7
31,2,3,0,5,2021-11-23,Male,53,45-54,1
31,1,0,0,1,2021-11-19,Male,78,75-79,9
31,1,0,12,13,2021-11-23,Female,35,35-44,1
31,0,0,0,0,2021-11-19,Male,24,20-24,1
31,1,2,0,3,2021-11-18,Female,36,35-44,3
31,2,0,0,2,2021-11-21,Male,41,35-44,6
31,1,3,0,4,2021-11-17,Female,19,15-19,8
31,0,0,0,0,2021-11-18,Female,16,15-19,16
31,0,0,0,0,2021-11-19,Male,69,65-69,8
31,1,0,0,1,2021-11-17,Female,68,65-69,6
31,4,1,0,5,2021-11-19,Female,6,5-9,2
31,1,0,0,1,2021-11-19,Male,67,65-69,5
31,1,0,0,1,2021-11-17,Female,56,55-64,5
31,3,0,0,3,2021-11-20,Male,21,20-24,1
31,1,1,0,2,2021-11-17,Male,61,55-64,5
31,0,2,0,2,2021-11-18,Female,59,55-64,9
31,1,0,0,1,2021-11-20,Female,19,15-19,1
31,0,5,0,5,2021-11-17,Male,21,20-24,2
31,1,0,0,1,2021-11-22,Female,34,25-34,2
31,0,2,0,2,2021-11-18,Female,52,45-54,6
31,0,0,0,0,2021-11-18,Male,69,65-69,13
31,0,0,0,0,2021-11-22,Male,5,5-9,11
31,0,0,0,0,2021-11-18,Female,52,45-54,8
31,0,2,0,2,2021-11-23,Male,67,65-69,1
31,1,10,0,11,2021-11-17,Male,68,65-69,6
31,2,0,0,2,2021-11-19,Male,48,45-54,7
31,1,0,0,1,2021-11-23,Male,61,55-64,1
31,2,0,0,2,2021-11-18,Female,20,20-24,2
31,0,0,0,0,2021-11-18,Female,81,80-84,8
31,0,0,0,0,2021-11-18,Female,30,25-34,18
31,0,0,0,0,2021-11-17,Female,10,10-14,5
31,0,0,0,0,2021-11-18,Female,70,70-74,6
31,1,5,15,21,2021-11-18,Male,75,75-79,4
31,1,0,0,1,2021-11-17,Male,56,55-64,8
31,0,7,0,7,2021-11-19,Male,54,45-54,3
31,0,0,0,0,2021-11-21,Female,22,20-24,1
31,1,0,0,1,2021-11-19,Female,81,80-84,10
31,1,10,0,11,2021-11-18,Female,60,55-64,9
31,3,3,0,6,2021-11-17,Male,2,1-4,5
31,2,3,0,5,2021-11-20,Female,63,55-64,17
31,0,3,0,3,2021-11-18,Female,34,25-34,2
31,2,3,0,5,2021-11-22,Female,66,65-69,10
31,0,0,0,0,2021-11-18,Male,60,55-64,3
31,1,0,0,1,2021-11-21,Female,62,55-64,4
31,1,0,0,1,2021-11-17,Female,51,45-54,4
31,1,0,0,1,2021-11-19,Female,54,45-54,7
31,1,0,0,1,2021-11-17,Male,45,45-54,7
31,0,0,0,0,2021-11-21,Female,18,15-19,1
31,0,0,0,0,2021-11-17,Male,43,35-44,11
31,0,0,0,0,2021-11-21,Male,19,15-19,1
31,1,0,0,1,2021-11-22,Female,55,55-64,5
31,2,0,0,2,2021-11-17,Male,19,15-19,6
31,1,3,0,4,2021-11-17,Male,40,35-44,4
31,0,1,0,1,2021-11-21,Male,67,65-69,19
31,1,3,0,4,2021-11-19,Male,71,70-74,3
31,0,0,0,0,2021-11-17,Female,56,55-64,3
31,2,0,0,2,2021-11-17,Female,55,55-64,6
31,1,2,0,3,2021-11-19,Female,81,80-84,5
31,1,0,0,1,2021-11-19,Female,50,45-54,6
31,0,3,0,3,2021-11-19,Female,81,80-84,3
31,1,2,0,3,2021-11-17,Male,51,45-54,6
31,0,1,0,1,2021-11-18,Male,45,45-54,12
31,1,0,0,1,2021-11-17,Male,68,65-69,2
31,1,0,0,1,2021-11-17,Female,46,45-54,5
31,0,0,0,0,2021-11-22,Male,43,35-44,6
31,1,4,0,5,2021-11-18,Female,67,65-69,3
31,0,12,15,27,2021-11-20,Male,84,80-84,4
31,3,1,0,4,2021-11-18,Male,5,5-9,3
31,1,3,0,4,2021-11-17,Female,65,65-69,9
31,2,0,0,2,2021-11-19,Male,37,35-44,6
31,1,0,0,1,2021-11-17,Male,54,45-54,4
31,1,0,0,1,2021-11-22,Female,23,20-24,1
31,3,21,0,24,2021-11-18,Male,7,5-9,4
31,0,0,0,0,2021-11-23,Male,71,70-74,4
31,2,0,0,2,2021-11-17,Male,45,45-54,5
31,1,0,0,1,2021-11-23,Male,49,45-54,1
31,0,0,0,0,2021-11-20,Female,68,65-69,10
31,1,0,0,1,2021-11-18,Male,31,25-34,6
31,2,2,0,4,2021-11-17,Male,6,5-9,9
31,1,0,0,1,2021-11-22,Female,63,55-64,4
31,0,1,0,1,2021-11-17,Female,31,25-34,14
31,1,1,0,2,2021-11-17,Female,54,45-54,5
31,1,0,0,1,2021-11-18,Male,16,15-19,3
31,1,2,0,3,2021-11-20,Male,21,20-24,1
31,1,0,0,1,2021-11-19,Male,69,65-69,4
31,1,0,0,1,2021-11-18,Male,46,45-54,5
31,3,0,0,3,2021-11-22,Male,53,45-54,6
31,1,3,0,4,2021-11-18,Male,73,70-74,19
31,1,0,0,1,2021-11-17,Male,68,65-69,5
31,0,3,0,3,2021-11-18,Male,61,55-64,5
31,0,7,0,7,2021-11-18,Female,59,55-64,3
31,3,0,0,3,2021-11-17,Female,51,45-54,3
31,0,0,0,0,2021-11-17,Male,53,45-54,9
31,1,0,0,1,2021-11-18,Female,45,45-54,2
31,1,1,0,2,2021-11-17,Female,66,65-69,9
31,0,0,0,0,2021-11-17,Male,50,45-54,10
31,1,4,0,5,2021-11-20,Male,8,5-9,4
31,2,0,2,4,2021-11-17,Female,18,15-19,2
31,0,0,0,0,2021-11-19,Female,23,20-24,3
31,0,0,0,0,2021-11-20,Male,20,20-24,1
31,0,8,0,8,2021-11-18,Female,72,70-74,8
31,3,1,0,4,2021-11-17,Male,2,1-4,5
31,1,1,0,2,2021-11-18,Male,64,55-64,11
31,0,0,0,0,2021-11-20,Female,52,45-54,8
31,0,1,0,1,2021-11-22,Female,65,65-69,11
31,1,0,0,1,2021-11-18,Female,27,25-34,4
31,1,0,0,1,2021-11-23,Female,74,70-74,1
31,3,1,0,4,2021-11-21,Female,8,5-9,5
31,1,0,0,1,2021-11-18,Female,63,55-64,11
31,0,0,0,0,2021-11-19,Female,15,15-19,8
31,0,0,0,0,2021-11-17,Female,53,45-54,4
31,0,0,0,0,2021-11-18,Male,42,35-44,3
31,1,0,0,1,2021-11-19,Male,61,55-64,2
31,1,5,0,6,2021-11-18,Female,56,55-64,6
31,0,0,0,0,2021-11-17,Male,68,65-69,5
31,4,11,0,15,2021-11-18,Male,4,1-4,4
31,0,1,0,1,2021-11-18,Male,63,55-64,7
31,0,0,0,0,2021-11-19,Male,73,70-74,5
31,1,11,0,12,2021-11-17,Male,53,45-54,9
31,2,3,0,5,2021-11-18,Male,13,10-14,5
31,0,0,0,0,2021-11-21,Male,23,20-24,1
31,2,0,0,2,2021-11-17,Female,20,20-24,5
31,0,0,0,0,2021-11-20,Female,22,20-24,1
31,0,7,0,7,2021-11-17,Female,54,45-54,4
31,0,28,35,63,2021-11-20,Female,18,15-19,1
31,1,1,0,2,2021-11-19,Female,73,70-74,10
31,2,0,0,2,2021-11-17,Male,19,15-19,5
31,1,0,0,1,2021-11-18,Male,73,70-74,7
31,0,0,0,0,2021-11-19,Male,41,35-44,20
31,1,1,0,2,2021-11-19,Female,62,55-64,21
31,1,0,0,1,2021-11-17,Female,54,45-54,4
31,1,0,0,1,2021-11-17,Female,43,35-44,5
31,0,3,0,3,2021-11-17,Female,54,45-54,11
31,1,0,0,1,2021-11-21,Female,54,45-54,5
31,1,0,0,1,2021-11-17,Male,56,55-64,15
31,1,50,0,51,2021-11-19,Male,71,70-74,6
31,1,0,0,1,2021-11-19,Male,71,70-74,5
31,1,1,0,2,2021-11-18,Female,1,1-4,9
31,2,0,0,2,2021-11-22,Female,4,1-4,10
31,0,0,0,0,2021-11-17,Female,61,55-64,4
31,0,0,0,0,2021-11-17,Female,32,25-34,4
31,1,0,0,1,2021-11-17,Male,32,25-34,8
31,4,1,0,5,2021-11-19,Male,78,75-79,10
31,2,0,0,2,2021-11-22,Male,44,35-44,9
31,0,0,0,0,2021-11-17,Male,24,20-24,11
31,1,0,0,1,2021-11-22,Female,51,45-54,8
31,0,0,0,0,2021-11-22,Female,30,25-34,2
31,1,0,0,1,2021-11-18,Male,48,45-54,5
31,1,0,0,1,2021-11-19,Female,52,45-54,10
31,4,0,0,4,2021-11-21,Male,18,15-19,1
31,0,0,0,0,2021-11-22,Male,73,70-74,2
31,1,0,0,1,2021-11-18,Female,56,55-64,4
31,0,2,0,2,2021-11-19,Male,57,55-64,8
31,5,0,0,5,2021-11-22,Female,8,5-9,6
31,0,2,0,2,2021-11-17,Female,66,65-69,6
31,2,0,0,2,2021-11-17,Male,18,15-19,5
31,1,64,0,65,2021-11-20,Female,51,45-54,3
31,4,0,0,4,2021-11-23,Male,3,1-4,1
31,2,0,0,2,2021-11-18,Male,19,15-19,4
31,1,1,0,2,2021-11-19,Male,68,65-69,5
31,3,0,0,3,2021-11-20,Male,60,55-64,7
31,1,0,0,1,2021-11-20,Male,68,65-69,2
31,1,0,0,1,2021-11-19,Female,52,45-54,5
31,1,0,0,1,2021-11-17,Female,68,65-69,6
31,0,0,0,0,2021-11-17,Male,51,45-54,10
31,0,0,0,0,2021-11-17,Male,59,55-64,9
31,1,0,0,1,2021-11-17,Male,46,45-54,11
31,1,0,0,1,2021-11-18,Female,18,15-19,6
31,1,0,0,1,2021-11-18,Female,65,65-69,9
31,0,21,0,21,2021-11-18,Male,57,55-64,10
31,0,2,0,2,2021-11-18,Female,62,55-64,9
31,1,2,0,3,2021-11-17,Female,41,35-44,4
31,1,0,0,1,2021-11-23,Female,66,65-69,1
31,1,0,0,1,2021-11-18,Male,69,65-69,10
31,0,0,0,0,2021-11-19,Female,70,70-74,5
31,0,0,0,0,2021-11-18,Male,61,55-64,4
31,2,0,0,2,2021-11-17,Female,8,5-9,7
31,0,0,0,0,2021-11-22,Male,31,25-34,2
31,2,0,5,7,2021-11-20,Female,8,5-9,5
31,1,0,0,1,2021-11-18,Female,61,55-64,4
31,0,4,7,11,2021-11-17,Female,31,25-34,5
31,2,0,0,2,2021-11-22,Female,39,35-44,4
31,3,8,0,11,2021-11-23,Female,3,1-4,4
31,3,1,0,4,2021-11-19,Male,15,15-19,9
31,1,0,0,1,2021-11-19,Male,55,55-64,13
31,1,4,0,5,2021-11-18,Male,64,55-64,6
31,1,8,0,9,2021-11-22,Female,23,20-24,1
31,1,0,0,1,2021-11-22,Male,80,80-84,5
31,2,0,0,2,2021-11-19,Female,3,1-4,12
31,0,0,0,0,2021-11-18,Male,18,15-19,9
31,0,0,0,0,2021-11-17,Male,54,45-54,4
31,0,1,0,1,2021-11-17,Male,56,55-64,21
31,0,10,0,10,2021-11-22,Female,20,20-24,1
31,0,1,0,1,2021-11-21,Male,18,15-19,1
31,0,2,0,2,2021-11-17,Female,65,65-69,8
31,1,2,0,3,2021-11-17,Male,66,65-69,7
31,0,0,0,0,2021-11-18,Male,72,70-74,5
31,0,0,0,0,2021-11-19,Male,41,35-44,5
31,0,1,0,1,2021-11-18,Male,27,25-34,3
31,2,0,0,2,2021-11-21,Female,23,20-24,1
31,1,3,0,4,2021-11-17,Female,65,65-69,5
31,0,0,0,0,2021-11-22,Female,47,45-54,8
31,0,0,0,0,2021-11-19,Female,27,25-34,10
31,1,2,0,3,2021-11-19,Male,74,70-74,6
31,2,0,0,2,2021-11-22,Female,20,20-24,2
31,0,0,0,0,2021-11-18,Female,34,25-34,2
31,1,0,0,1,2021-11-18,Male,56,55-64,5
31,0,0,0,0,2021-11-18,Male,35,35-44,3
31,0,0,0,0,2021-11-17,Male,66,65-69,11
31,0,1,0,1,2021-11-17,Female,45,45-54,4
31,0,0,0,0,2021-11-18,Female,54,45-54,5
31,1,0,0,1,2021-11-18,Male,67,65-69,6
31,0,11,0,11,2021-11-17,Female,57,55-64,8
31,0,0,0,0,2021-11-20,Female,19,15-19,19
31,0,0,0,0,2021-11-18,Male,34,25-34,8
31,1,0,1,2,2021-11-18,Female,69,65-69,5
31,1,4,0,5,2021-11-23,Male,64,55-64,1
31,1,0,0,1,2021-11-19,Male,66,65-69,6
31,3,0,0,3,2021-11-17,Female,0,<1,7
31,1,0,0,1,2021-11-19,Male,71,70-74,10
31,0,0,0,0,2021-11-18,Male,34,25-34,8
31,2,0,0,2,2021-11-23,Male,6,5-9,1
31,1,9,10,20,2021-11-20,Female,19,15-19,7
31,1,0,13,14,2021-11-18,Male,60,55-64,5
31,2,0,0,2,2021-11-19,Female,68,65-69,4
31,1,40,0,41,2021-11-17,Male,32,25-34,2
31,1,0,0,1,2021-11-17,Male,57,55-64,4
31,1,1,0,2,2021-11-22,Male,69,65-69,3
31,0,0,0,0,2021-11-17,Male,68,65-69,9
31,1,0,0,1,2021-11-22,Female,27,25-34,5
31,1,0,0,1,2021-11-19,Male,78,75-79,5
31,0,4,0,4,2021-11-18,Female,60,55-64,6
31,0,0,0,0,2021-11-23,Male,31,25-34,1
31,1,0,0,1,2021-11-23,Male,69,65-69,1
31,2,0,0,2,2021-11-19,Male,9,5-9,5
31,0,0,0,0,2021-11-17,Female,28,25-34,6
31,3,0,0,3,2021-11-17,Male,2,1-4,9
31,1,0,0,1,2021-11-18,Male,70,70-74,11
31,0,0,0,0,2021-11-20,Female,18,15-19,1
31,1,0,0,1,2021-11-22,Female,66,65-69,5
31,0,0,0,0,2021-11-19,Male,35,35-44,10
31,1,0,0,1,2021-11-19,Male,71,70-74,6
31,1,0,0,1,2021-11-22,Male,74,70-74,2
31,2,3,0,5,2021-11-22,Female,14,10-14,7
31,0,0,0,0,2021-11-21,Female,27,25-34,4
31,1,0,0,1,2021-11-19,Male,76,75-79,9
31,0,0,0,0,2021-11-21,Female,21,20-24,1
31,1,0,0,1,2021-11-19,Female,71,70-74,4
31,0,0,0,0,2021-11-19,Female,39,35-44,11
31,3,0,0,3,2021-11-18,Male,18,15-19,3
31,1,0,0,1,2021-11-21,Female,55,55-64,9
31,1,0,0,1,2021-11-18,Female,71,70-74,4
31,1,0,0,1,2021-11-19,Female,61,55-64,3
31,1,0,0,1,2021-11-19,Male,62,55-64,6
31,0,0,85,85,2021-11-17,Male,15,15-19,10
31,2,0,3,5,2021-11-18,Female,10,10-14,2
31,1,0,0,1,2021-11-17,Female,41,35-44,5
31,3,0,0,3,2021-11-19,Female,4,1-4,3
31,1,0,0,1,2021-11-22,Male,69,65-69,7
31,0,0,0,0,2021-11-17,Male,43,35-44,4
31,0,9,0,9,2021-11-17,Male,41,35-44,9
31,2,2,0,4,2021-11-18,Female,4,1-4,5
31,1,0,0,1,2021-11-17,Female,65,65-69,11
31,2,0,0,2,2021-11-18,Female,12,10-14,10
31,3,2,0,5,2021-11-19,Female,26,25-34,3
31,0,1,0,1,2021-11-23,Male,66,65-69,1
31,1,0,0,1,2021-11-18,Female,22,20-24,2
31,1,0,0,1,2021-11-22,Male,53,45-54,6
31,0,1,0,1,2021-11-17,Male,68,65-69,7
31,0,1,0,1,2021-11-18,Female,51,45-54,11
31,0,0,0,0,2021-11-19,Male,72,70-74,4
31,1,3,0,4,2021-11-17,Female,54,45-54,10
31,1,2,0,3,2021-11-23,Male,52,45-54,1
31,1,0,8,9,2021-11-17,Female,12,10-14,4
31,1,5,0,6,2021-11-18,Female,31,25-34,6
31,0,10,0,10,2021-11-17,Female,65,65-69,7
31,0,2,0,2,2021-11-18,Male,78,75-79,7
31,2,0,0,2,2021-11-17,Male,43,35-44,5
31,0,0,0,0,2021-11-17,Female,21,20-24,5
31,0,1,0,1,2021-11-17,Female,34,25-34,2
31,1,0,0,1,2021-11-20,Female,21,20-24,1
31,1,2,1,4,2021-11-18,Male,58,55-64,17
31,1,0,0,1,2021-11-18,Female,55,55-64,16
31,4,0,5,9,2021-11-17,Female,5,5-9,15
31,3,0,0,3,2021-11-17,Female,34,25-34,14
31,3,13,0,16,2021-11-19,Female,3,1-4,7
31,1,0,0,1,2021-11-19,Male,63,55-64,4
31,1,0,0,1,2021-11-17,Male,68,65-69,4
31,0,2,0,2,2021-11-20,Male,60,55-64,11
31,0,0,0,0,2021-11-19,Female,82,80-84,5
31,0,0,0,0,2021-11-18,Male,34,25-34,22
31,0,6,0,6,2021-11-17,Male,54,45-54,5
31,0,0,0,0,2021-11-19,Female,58,55-64,2
31,1,4,0,5,2021-11-17,Male,45,45-54,4
31,2,0,0,2,2021-11-22,Male,9,5-9,4
31,0,1,0,1,2021-11-17,Male,54,45-54,9
31,1,1,0,2,2021-11-18,Female,68,65-69,10
31,2,0,0,2,2021-11-18,Male,49,45-54,8
31,3,0,0,3,2021-11-21,Female,18,15-19,4
31,1,0,0,1,2021-11-17,Female,67,65-69,5
31,0,0,0,0,2021-11-18,Female,22,20-24,9
31,0,4,0,4,2021-11-17,Male,32,25-34,10
31,1,2,0,3,2021-11-17,Male,16,15-19,7
31,1,0,0,1,2021-11-19,Female,47,45-54,4
31,3,15,0,18,2021-11-17,Female,19,15-19,9
31,3,1,0,4,2021-11-17,Female,6,5-9,3
31,1,0,0,1,2021-11-19,Female,39,35-44,6
31,0,0,0,0,2021-11-19,Female,68,65-69,13
31,2,0,0,2,2021-11-17,Male,3,1-4,3
31,1,2,0,3,2021-11-20,Male,73,70-74,24
31,2,0,12,14,2021-11-17,Female,2,1-4,4
31,1,0,0,1,2021-11-18,Female,54,45-54,12
31,2,26,0,28,2021-11-19,Female,15,15-19,6
31,1,0,0,1,2021-11-19,Female,31,25-34,2
31,2,0,0,2,2021-11-17,Male,19,15-19,3
31,0,0,0,0,2021-11-17,Male,66,65-69,4
31,0,2,0,2,2021-11-22,Female,25,25-34,4
31,1,0,0,1,2021-11-17,Female,55,55-64,4
31,0,0,0,0,2021-11-17,Female,50,45-54,11
31,0,0,0,0,2021-11-18,Female,69,65-69,5
31,0,0,0,0,2021-11-18,Male,72,70-74,22
31,0,0,0,0,2021-11-23,Male,45,45-54,6
31,1,0,0,1,2021-11-18,Male,66,65-69,5
31,0,2,0,2,2021-11-19,Female,78,75-79,5
31,1,0,0,1,2021-11-18,Male,69,65-69,3
31,0,2,0,2,2021-11-21,Female,60,55-64,8
31,1,0,0,1,2021-11-20,Male,77,75-79,4
31,1,5,0,6,2021-11-22,Female,22,20-24,1
31,1,1,0,2,2021-11-18,Male,73,70-74,2
31,2,0,0,2,2021-11-20,Male,1,1-4,9
31,2,1,0,3,2021-11-17,Male,18,15-19,7
31,1,0,0,1,2021-11-17,Female,53,45-54,3
31,0,1,0,1,2021-11-17,Male,65,65-69,6
31,1,0,0,1,2021-11-17,Female,54,45-54,5
31,0,0,0,0,2021-11-19,Female,16,15-19,3
31,0,1,0,1,2021-11-23,Female,48,45-54,1
31,0,0,0,0,2021-11-20,Male,68,65-69,5
31,2,0,8,10,2021-11-20,Male,20,20-24,1
31,0,0,0,0,2021-11-19,Male,65,65-69,3
31,0,5,0,5,2021-11-22,Female,19,15-19,1
31,3,0,0,3,2021-11-19,Male,20,20-24,10
31,1,0,0,1,2021-11-19,Male,59,55-64,7
31,1,0,0,1,2021-11-22,Male,75,75-79,5
31,3,0,0,3,2021-11-17,Male,0,<1,4
31,3,15,0,18,2021-11-18,Female,3,1-4,6
31,2,0,0,2,2021-11-19,Male,8,5-9,8
31,2,0,0,2,2021-11-17,Female,52,45-54,3
31,1,0,0,1,2021-11-19,Female,64,55-64,10
31,1,0,0,1,2021-11-19,Male,71,70-74,7
31,0,0,4,4,2021-11-19,Male,52,45-54,6
31,3,0,0,3,2021-11-17,Male,65,65-69,8
31,0,0,0,0,2021-11-18,Female,50,45-54,4
31,0,1,0,1,2021-11-19,Female,36,35-44,13
31,0,0,0,0,2021-11-21,Female,77,75-79,8
31,1,2,0,3,2021-11-17,Female,25,25-34,24
31,0,0,0,0,2021-11-22,Male,76,75-79,4
31,0,0,2,2,2021-11-19,Male,19,15-19,1
31,2,0,0,2,2021-11-19,Female,72,70-74,21
31,1,0,100,101,2021-11-20,Female,19,15-19,1
31,2,0,0,2,2021-11-21,Male,42,35-44,5
31,1,0,0,1,2021-11-19,Female,68,65-69,5
31,1,3,0,4,2021-11-19,Male,74,70-74,3
31,3,16,0,19,2021-11-20,Male,6,5-9,21
31,1,0,0,1,2021-11-19,Male,72,70-74,5
31,1,13,0,14,2021-11-19,Male,70,70-74,23
31,0,0,0,0,2021-11-19,Male,62,55-64,5
31,0,0,0,0,2021-11-18,Male,44,35-44,6
31,1,4,0,5,2021-11-19,Male,72,70-74,4
31,0,0,0,0,2021-11-17,Male,64,55-64,5
31,0,0,0,0,2021-11-19,Female,7,5-9,7
31,0,0,0,0,2021-11-17,Male,44,35-44,5
31,1,2,0,3,2021-11-17,Male,51,45-54,7
31,3,15,0,18,2021-11-18,Male,0,<1,4
31,0,1,0,1,2021-11-23,Male,63,55-64,1
31,0,1,0,1,2021-11-18,Female,74,70-74,5
31,0,0,0,0,2021-11-18,Male,77,75-79,18
31,0,1,0,1,2021-11-18,Female,50,45-54,14
31,3,0,0,3,2021-11-17,Female,18,15-19,6
31,2,0,0,2,2021-11-18,Female,55,55-64,3
31,0,0,0,0,2021-11-19,Female,49,45-54,9
31,2,0,0,2,2021-11-17,Male,52,45-54,3
31,1,3,0,4,2021-11-22,Female,58,55-64,4
31,1,0,0,1,2021-11-19,Male,36,35-44,5
31,3,0,0,3,2021-11-17,Female,57,55-64,6
31,1,7,0,8,2021-11-18,Female,33,25-34,6
31,1,3,0,4,2021-11-17,Female,65,65-69,2
31,1,1,0,2,2021-11-18,Female,75,75-79,5
31,0,0,0,0,2021-11-19,Female,70,70-74,7
31,2,0,0,2,2021-11-19,Male,2,1-4,7
31,0,0,0,0,2021-11-18,Male,51,45-54,6
31,1,2,0,3,2021-11-18,Male,74,70-74,4
31,0,5,0,5,2021-11-18,Female,41,35-44,7
31,0,0,0,0,2021-11-19,Female,62,55-64,7
31,0,0,0,0,2021-11-22,Male,59,55-64,7
31,2,0,0,2,2021-11-19,Male,17,15-19,11
31,0,4,0,4,2021-11-23,Female,72,70-74,1
31,0,1,0,1,2021-11-18,Male,74,70-74,15
31,3,5,0,8,2021-11-20,Female,17,15-19,16
31,1,0,0,1,2021-11-18,Male,70,70-74,6
31,1,0,0,1,2021-11-18,Female,24,20-24,5
31,3,0,0,3,2021-11-18,Female,62,55-64,4
31,0,0,0,0,2021-11-23,Male,48,45-54,1
31,1,0,0,1,2021-11-21,Male,72,70-74,6
31,0,0,0,0,2021-11-17,Male,54,45-54,7
31,0,1,0,1,2021-11-18,Male,53,45-54,6
31,0,0,0,0,2021-11-17,Female,54,45-54,3
31,1,1,4,6,2021-11-17,Female,42,35-44,4
31,1,0,0,1,2021-11-18,Male,74,70-74,4
31,1,0,0,1,2021-11-17,Female,58,55-64,10
31,1,0,0,1,2021-11-18,Male,74,70-74,4
31,1,0,0,1,2021-11-18,Male,58,55-64,5
31,0,0,0,0,2021-11-18,Male,11,10-14,5
31,0,1,5,6,2021-11-19,Female,27,25-34,4
31,0,0,0,0,2021-11-18,Male,69,65-69,3
31,0,0,0,0,2021-11-19,Male,50,45-54,4
31,2,0,0,2,2021-11-18,Female,13,10-14,2
31,2,0,0,2,2021-11-22,Male,4,1-4,4
31,1,4,0,5,2021-11-19,Female,60,55-64,4
31,1,0,0,1,2021-11-23,Male,57,55-64,1
31,2,0,0,2,2021-11-19,Male,75,75-79,23
31,2,0,0,2,2021-11-19,Female,63,55-64,16
31,1,0,0,1,2021-11-19,Male,59,55-64,2
31,2,1,0,3,2021-11-18,Male,64,55-64,5
31,3,0,0,3,2021-11-19,Male,62,55-64,9
31,1,5,0,6,2021-11-19,Male,73,70-74,2
31,3,14,0,17,2021-11-18,Female,6,5-9,9
31,1,3,0,4,2021-11-19,Male,60,55-64,5
31,1,0,0,1,2021-11-17,Female,30,25-34,2
31,1,0,0,1,2021-11-17,Male,41,35-44,15
31,1,2,0,3,2021-11-19,Female,70,70-74,5
31,0,0,0,0,2021-11-18,Male,48,45-54,4
31,4,0,0,4,2021-11-17,Female,13,10-14,4
31,2,0,0,2,2021-11-17,Male,43,35-44,4
31,1,0,0,1,2021-11-19,Female,60,55-64,5
31,1,4,25,30,2021-11-18,Male,67,65-69,11
31,0,0,0,0,2021-11-19,Female,37,35-44,3
31,2,0,0,2,2021-11-23,Female,56,55-64,1
31,1,5,0,6,2021-11-18,Female,59,55-64,5
31,0,6,0,6,2021-11-22,Male,32,25-34,2
31,0,0,0,0,2021-11-19,Male,61,55-64,24
31,0,0,0,0,2021-11-23,Male,27,25-34,6
31,0,0,0,0,2021-11-17,Male,44,35-44,4
31,2,0,0,2,2021-11-22,Male,54,45-54,3
31,0,10,0,10,2021-11-22,Female,41,35-44,9
31,0,0,0,0,2021-11-19,Male,53,45-54,5
31,1,1,0,2,2021-11-19,Female,27,25-34,3
31,1,0,0,1,2021-11-18,Male,65,65-69,2
31,0,2,0,2,2021-11-18,Female,42,35-44,5
31,2,0,0,2,2021-11-17,Female,67,65-69,24
31,1,0,0,1,2021-11-18,Male,67,65-69,10
31,0,2,0,2,2021-11-23,Female,69,65-69,1
31,1,0,0,1,2021-11-22,Female,22,20-24,1
31,0,1,1,2,2021-11-21,Female,62,55-64,9
31,1,1,0,2,2021-11-17,Male,14,10-14,10
31,3,0,0,3,2021-11-22,Female,2,1-4,12
31,1,0,0,1,2021-11-17,Female,53,45-54,3
31,1,1,0,2,2021-11-18,Female,67,65-69,8
31,0,0,0,0,2021-11-18,Male,38,35-44,10
31,3,0,0,3,2021-11-17,Male,7,5-9,10
31,0,7,0,7,2021-11-19,Female,39,35-44,5
31,2,0,0,2,2021-11-18,Female,69,65-69,6
31,0,0,0,0,2021-11-22,Male,63,55-64,5
31,2,0,0,2,2021-11-18,Male,72,70-74,10
31,0,0,0,0,2021-11-18,Male,58,55-64,9
31,0,4,0,4,2021-11-17,Female,56,55-64,4
31,0,1,0,1,2021-11-18,Male,66,65-69,11
31,1,0,0,1,2021-11-17,Male,60,55-64,9
31,0,0,0,0,2021-11-17,Female,21,20-24,10
31,1,0,0,1,2021-11-17,Male,50,45-54,5
31,0,1,0,1,2021-11-19,Male,83,80-84,6
31,0,0,0,0,2021-11-20,Male,34,25-34,14
31,1,0,0,1,2021-11-22,Female,37,35-44,5
31,1,1,0,2,2021-11-17,Male,65,65-69,10
31,3,0,0,3,2021-11-19,Female,13,10-14,7
31,0,0,0,0,2021-11-19,Male,40,35-44,5
31,1,9,0,10,2021-11-19,Female,69,65-69,6
31,1,0,0,1,2021-11-18,Male,67,65-69,10
31,1,0,0,1,2021-11-17,Male,56,55-64,4
31,2,0,0,2,2021-11-18,Male,11,10-14,9
31,3,0,0,3,2021-11-17,Female,9,5-9,5
31,1,1,0,2,2021-11-17,Female,29,25-34,3
31,0,0,0,0,2021-11-18,Female,25,25-34,6
31,1,0,0,1,2021-11-17,Male,66,65-69,2
31,0,2,0,2,2021-11-17,Male,60,55-64,4
31,0,4,0,4,2021-11-18,Female,63,55-64,7
31,0,0,0,0,2021-11-17,Female,30,25-34,5
31,1,0,0,1,2021-11-17,Male,65,65-69,5
31,2,3,0,5,2021-11-18,Male,52,45-54,5
31,0,0,0,0,2021-11-17,Male,53,45-54,24
31,3,0,0,3,2021-11-19,Female,19,15-19,1
31,0,4,0,4,2021-11-18,Male,72,70-74,4
31,1,0,0,1,2021-11-20,Male,53,45-54,4
31,1,1,0,2,2021-11-17,Female,41,35-44,10
31,0,0,0,0,2021-11-18,Female,70,70-74,10
31,0,0,0,0,2021-11-17,Female,67,65-69,6
31,0,0,0,0,2021-11-22,Female,69,65-69,6
31,0,1,0,1,2021-11-17,Female,54,45-54,4
31,1,0,0,1,2021-11-18,Female,46,45-54,2
31,1,0,0,1,2021-11-22,Male,66,65-69,5
31,0,0,0,0,2021-11-18,Male,37,35-44,8
31,0,0,0,0,2021-11-19,Male,60,55-64,5
31,0,0,30,30,2021-11-17,Male,22,20-24,3
31,0,3,0,3,2021-11-17,Male,58,55-64,20
31,1,0,0,1,2021-11-19,Male,85,85+,3
31,1,2,0,3,2021-11-17,Female,42,35-44,4
31,0,14,0,14,2021-11-19,Male,47,45-54,5
31,0,1,0,1,2021-11-17,Female,58,55-64,3
31,0,0,0,0,2021-11-20,Female,22,20-24,1
31,0,0,0,0,2021-11-19,Male,72,70-74,8
31,1,0,0,1,2021-11-18,Male,54,45-54,7
31,1,0,0,1,2021-11-18,Female,53,45-54,11
31,2,4,0,6,2021-11-19,Female,58,55-64,3
31,3,15,0,18,2021-11-17,Female,8,5-9,6
31,3,0,0,3,2021-11-21,Female,67,65-69,3
31,0,1,0,1,2021-11-23,Male,56,55-64,1
31,0,10,0,10,2021-11-19,Female,51,45-54,3
31,2,1,0,3,2021-11-18,Male,33,25-34,3
31,0,0,0,0,2021-11-17,Female,64,55-64,4
31,3,0,0,3,2021-11-17,Male,66,65-69,5
31,1,1,0,2,2021-11-19,Female,59,55-64,4
31,0,3,0,3,2021-11-19,Female,48,45-54,10
31,1,2,0,3,2021-11-22,Female,54,45-54,15
31,1,0,0,1,2021-11-22,Male,52,45-54,21
31,1,1,0,2,2021-11-17,Male,62,55-64,8
31,2,4,30,36,2021-11-19,Male,10,10-14,4
31,1,0,0,1,2021-11-18,Male,63,55-64,7
31,0,0,0,0,2021-11-17,Male,67,65-69,4
31,1,4,0,5,2021-11-18,Female,56,55-64,17
31,0,0,0,0,2021-11-17,Male,56,55-64,4
31,0,0,0,0,2021-11-17,Female,44,35-44,2
31,2,1,0,3,2021-11-17,Male,66,65-69,6
31,1,0,0,1,2021-11-19,Male,59,55-64,5
31,3,53,0,56,2021-11-17,Male,28,25-34,2
31,3,0,0,3,2021-11-18,Male,17,15-19,5
31,1,0,0,1,2021-11-22,Female,18,15-19,1
31,0,1,0,1,2021-11-17,Male,43,35-44,5
31,1,0,0,1,2021-11-17,Female,30,25-34,3
31,4,0,0,4,2021-11-17,Male,1,1-4,5
31,1,0,0,1,2021-11-17,Male,65,65-69,10
31,1,0,0,1,2021-11-18,Female,23,20-24,6
31,0,1,0,1,2021-11-17,Male,57,55-64,6
31,1,0,0,1,2021-11-18,Female,50,45-54,4
31,1,0,0,1,2021-11-17,Male,65,65-69,4
31,1,2,0,3,2021-11-18,Male,30,25-34,6
31,1,0,0,1,2021-11-19,Male,80,80-84,17
31,0,4,0,4,2021-11-17,Male,46,45-54,5
31,1,0,0,1,2021-11-19,Female,72,70-74,5
31,0,0,0,0,2021-11-17,Male,42,35-44,9
31,0,1,1,2,2021-11-18,Male,64,55-64,11
31,0,0,0,0,2021-11-21,Male,22,20-24,1
31,3,0,0,3,2021-11-22,Male,15,15-19,23
31,0,0,0,0,2021-11-18,Male,81,80-84,4
31,1,0,0,1,2021-11-18,Female,62,55-64,11
31,1,6,0,7,2021-11-17,Female,65,65-69,4
31,1,7,0,8,2021-11-19,Male,59,55-64,3
31,2,0,0,2,2021-11-18,Female,14,10-14,5
31,1,0,0,1,2021-11-19,Male,73,70-74,4
31,0,0,0,0,2021-11-22,Female,80,80-84,5
31,1,0,0,1,2021-11-22,Male,72,70-74,4
31,0,0,0,0,2021-11-17,Male,40,35-44,8
31,2,0,0,2,2021-11-21,Female,25,25-34,8
31,0,1,0,1,2021-11-19,Female,35,35-44,6
31,0,0,0,0,2021-11-19,Male,69,65-69,11
31,0,0,0,0,2021-11-23,Male,70,70-74,1
31,0,0,0,0,2021-11-17,Female,40,35-44,8
31,2,0,0,2,2021-11-22,Male,68,65-69,17
31,1,5,0,6,2021-11-21,Female,21,20-24,1
31,0,0,0,0,2021-11-17,Male,65,65-69,6
31,0,0,0,0,2021-11-21,Female,57,55-64,2
31,1,0,0,1,2021-11-17,Female,51,45-54,5
31,1,0,0,1,2021-11-17,Female,32,25-34,2
31,0,0,0,0,2021-11-19,Male,62,55-64,9
31,0,7,0,7,2021-11-18,Female,55,55-64,4
31,1,1,0,2,2021-11-19,Male,59,55-64,11
31,0,1,0,1,2021-11-17,Male,65,65-69,10
31,1,0,0,1,2021-11-22,Female,41,35-44,22
31,1,0,0,1,2021-11-17,Male,47,45-54,11
31,1,0,0,1,2021-11-22,Male,65,65-69,3
31,1,0,0,1,2021-11-22,Male,10,10-14,6
31,1,0,0,1,2021-11-17,Female,33,25-34,6
31,1,0,0,1,2021-11-19,Female,38,35-44,19
31,1,1,0,2,2021-11-19,Male,74,70-74,3
31,0,0,0,0,2021-11-22,Male,18,15-19,2
31,1,3,0,4,2021-11-19,Male,72,70-74,4
31,0,0,0,0,2021-11-22,Female,65,65-69,4
31,3,2,0,5,2021-11-21,Male,23,20-24,1
31,2,0,0,2,2021-11-18,Female,50,45-54,7
31,1,0,0,1,2021-11-18,Female,49,45-54,6
31,1,1,0,2,2021-11-18,Male,52,45-54,5
31,0,0,0,0,2021-11-23,Male,79,75-79,1
31,1,0,0,1,2021-11-18,Male,78,75-79,9
31,1,0,0,1,2021-11-19,Male,62,55-64,11
31,0,2,0,2,2021-11-21,Male,43,35-44,10
31,0,0,0,0,2021-11-18,Female,68,65-69,24
31,1,0,0,1,2021-11-21,Male,37,35-44,15
31,1,0,0,1,2021-11-19,Female,70,70-74,3
31,0,2,0,2,2021-11-17,Male,59,55-64,3
31,3,0,0,3,2021-11-20,Female,0,<1,1
31,0,0,0,0,2021-11-19,Male,63,55-64,5
31,2,1,0,3,2021-11-21,Male,69,65-69,5
31,1,1,0,2,2021-11-17,Male,53,45-54,3
31,0,0,0,0,2021-11-18,Male,22,20-24,5
31,4,8,0,12,2021-11-17,Female,13,10-14,10
31,1,0,0,1,2021-11-22,Male,31,25-34,9
31,1,0,0,1,2021-11-20,Male,81,80-84,4
31,0,0,0,0,2021-11-17,Male,54,45-54,7
31,0,0,0,0,2021-11-22,Female,68,65-69,4
31,1,0,0,1,2021-11-23,Female,8,5-9,1
31,0,0,0,0,2021-11-18,Female,66,65-69,5
31,0,6,0,6,2021-11-18,Female,59,55-64,5
31,2,0,0,2,2021-11-19,Male,72,70-74,3
31,0,0,0,0,2021-11-19,Female,33,25-34,3
31,1,0,0,1,2021-11-17,Male,67,65-69,4
31,2,0,0,2,2021-11-22,Female,48,45-54,11
31,1,2,0,3,2021-11-18,Male,65,65-69,10
31,1,0,2,3,2021-11-23,Male,72,70-74,1
31,0,0,0,0,2021-11-19,Female,60,55-64,4
31,0,8,0,8,2021-11-21,Female,30,25-34,10
31,3,0,0,3,2021-11-23,Male,12,10-14,5
31,0,0,0,0,2021-11-20,Male,18,15-19,1
31,1,0,0,1,2021-11-17,Male,53,45-54,11
31,2,0,0,2,2021-11-19,Male,18,15-19,1
31,1,0,0,1,2021-11-18,Male,66,65-69,10
31,0,0,0,0,2021-11-18,Male,50,45-54,5
31,1,0,0,1,2021-11-19,Male,72,70-74,5
31,2,1,0,3,2021-11-19,Female,24,20-24,6
31,0,0,0,0,2021-11-17,Female,38,35-44,13
31,0,0,0,0,2021-11-18,Male,73,70-74,5
31,0,0,0,0,2021-11-19,Male,27,25-34,4
31,0,0,0,0,2021-11-18,Male,31,25-34,4
31,1,0,0,1,2021-11-22,Female,71,70-74,5
31,0,0,0,0,2021-11-17,Male,58,55-64,6
31,0,0,0,0,2021-11-17,Male,57,55-64,5
31,0,0,0,0,2021-11-23,Female,46,45-54,1
31,3,0,0,3,2021-11-22,Female,12,10-14,4
31,1,0,0,1,2021-11-17,Female,61,55-64,5
31,1,5,0,6,2021-11-20,Male,8,5-9,7
31,3,0,0,3,2021-11-18,Female,1,1-4,3
31,0,0,0,0,2021-11-18,Female,44,35-44,10
31,0,2,0,2,2021-11-18,Female,66,65-69,5
31,0,1,0,1,2021-11-19,Female,75,75-79,5
31,1,0,0,1,2021-11-18,Male,60,55-64,4
31,0,2,0,2,2021-11-17,Female,54,45-54,3
31,1,0,0,1,2021-11-20,Female,51,45-54,4
31,0,4,0,4,2021-11-22,Male,67,65-69,3
31,1,0,0,1,2021-11-17,Male,64,55-64,11
31,2,3,0,5,2021-11-19,Female,32,25-34,5
31,0,0,0,0,2021-11-17,Male,41,35-44,14
31,1,1,0,2,2021-11-18,Female,67,65-69,19
31,0,7,0,7,2021-11-22,Male,49,45-54,6
31,0,1,0,1,2021-11-18,Female,44,35-44,5
31,0,1,0,1,2021-11-19,Male,55,55-64,9
31,1,1,2,4,2021-11-18,Male,71,70-74,6
31,0,0,0,0,2021-11-19,Female,37,35-44,16
31,0,0,0,0,2021-11-17,Female,53,45-54,4
31,1,0,0,1,2021-11-21,Female,22,20-24,1
31,1,0,0,1,2021-11-18,Male,59,55-64,10
31,1,1,0,2,2021-11-19,Male,68,65-69,9
31,1,0,0,1,2021-11-19,Female,77,75-79,5
31,1,0,0,1,2021-11-19,Male,72,70-74,2
31,0,0,0,0,2021-11-18,Male,63,55-64,5
31,1,0,0,1,2021-11-17,Male,67,65-69,23
31,1,0,0,1,2021-11-18,Male,44,35-44,7
31,0,0,0,0,2021-11-17,Male,33,25-34,9
31,0,0,0,0,2021-11-18,Female,23,20-24,2
31,3,2,0,5,2021-11-18,Female,2,1-4,2
31,2,0,0,2,2021-11-22,Female,13,10-14,24
31,4,0,0,4,2021-11-17,Male,24,20-24,7
31,0,0,0,0,2021-11-18,Female,51,45-54,3
31,1,0,0,1,2021-11-17,Male,53,45-54,11
31,1,0,0,1,2021-11-19,Male,70,70-74,3
31,1,0,0,1,2021-11-23,Female,72,70-74,1
31,0,1,0,1,2021-11-18,Female,66,65-69,10
31,1,0,0,1,2021-11-18,Female,67,65-69,11
31,1,0,0,1,2021-11-18,Male,81,80-84,4
31,1,1,0,2,2021-11-19,Male,72,70-74,4
31,1,0,0,1,2021-11-17,Female,31,25-34,5
31,1,2,0,3,2021-11-18,Female,66,65-69,10
31,1,5,0,6,2021-11-20,Female,45,45-54,7
31,1,0,2,3,2021-11-18,Male,75,75-79,3
31,0,2,0,2,2021-11-17,Female,68,65-69,2
31,0,0,0,0,2021-11-19,Male,78,75-79,7
31,1,0,0,1,2021-11-21,Male,37,35-44,6
31,3,0,18,21,2021-11-18,Female,15,15-19,3
31,2,0,0,2,2021-11-22,Female,15,15-19,6
31,0,0,0,0,2021-11-17,Female,53,45-54,4
31,0,0,0,0,2021-11-19,Male,35,35-44,21
31,0,0,0,0,2021-11-17,Male,24,20-24,5
31,1,0,0,1,2021-11-17,Female,64,55-64,20
31,0,2,0,2,2021-11-20,Female,69,65-69,15
31,1,0,0,1,2021-11-19,Female,52,45-54,6
31,1,0,0,1,2021-11-17,Female,61,55-64,11
31,1,0,0,1,2021-11-22,Male,57,55-64,12
31,1,0,0,1,2021-11-21,Female,47,45-54,4
31,0,2,0,2,2021-11-18,Female,65,65-69,4
31,0,0,0,0,2021-11-23,Female,34,25-34,1
31,0,0,0,0,2021-11-19,Male,45,45-54,11
31,4,1,0,5,2021-11-17,Male,3,1-4,4
31,0,1,0,1,2021-11-19,Male,78,75-79,8
31,2,1,0,3,2021-11-18,Male,4,1-4,11
31,0,0,0,0,2021-11-19,Male,43,35-44,9
31,2,0,0,2,2021-11-17,Male,53,45-54,4
31,0,0,0,0,2021-11-20,Female,8,5-9,8
31,1,0,0,1,2021-11-19,Male,63,55-64,27
31,3,0,5,8,2021-11-17,Male,38,35-44,2
31,0,0,0,0,2021-11-19,Male,25,25-34,2
31,0,0,0,0,2021-11-22,Female,38,35-44,11
31,2,0,0,2,2021-11-17,Male,18,15-19,3
31,0,0,0,0,2021-11-20,Male,39,35-44,18
31,1,0,0,1,2021-11-18,Male,51,45-54,6
31,0,3,0,3,2021-11-17,Male,67,65-69,5
31,1,0,0,1,2021-11-17,Female,55,55-64,4
31,0,0,0,0,2021-11-22,Female,54,45-54,6
31,3,5,0,8,2021-11-17,Male,12,10-14,4
31,0,0,0,0,2021-11-18,Female,37,35-44,4
31,2,0,0,2,2021-11-18,Male,60,55-64,5
31,0,0,0,0,2021-11-22,Female,44,35-44,7
31,1,0,0,1,2021-11-17,Male,64,55-64,3
31,1,0,0,1,2021-11-19,Male,78,75-79,2
31,0,7,4,11,2021-11-18,Female,32,25-34,3
31,2,0,0,2,2021-11-20,Female,1,1-4,1
31,1,0,0,1,2021-11-21,Male,68,65-69,19
31,0,0,0,0,2021-11-17,Female,53,45-54,7
31,1,0,0,1,2021-11-22,Female,71,70-74,5
31,1,0,0,1,2021-11-20,Female,49,45-54,4
31,2,0,0,2,2021-11-18,Female,62,55-64,3
31,1,0,0,1,2021-11-17,Female,50,45-54,4
31,1,0,0,1,2021-11-21,Female,23,20-24,1
31,1,0,0,1,2021-11-18,Male,49,45-54,5
31,0,0,0,0,2021-11-19,Male,76,75-79,14
31,0,0,0,0,2021-11-19,Female,49,45-54,3
31,1,0,0,1,2021-11-22,Female,52,45-54,4
31,1,0,0,1,2021-11-19,Female,61,55-64,4
31,1,0,0,1,2021-11-19,Male,63,55-64,5
31,1,0,0,1,2021-11-17,Female,66,65-69,8
31,1,0,0,1,2021-11-17,Female,30,25-34,4
31,2,2,0,4,2021-11-18,Male,56,55-64,5
31,0,0,0,0,2021-11-19,Female,19,15-19,1
31,0,0,0,0,2021-11-19,Female,67,65-69,11
31,1,0,0,1,2021-11-18,Male,66,65-69,21
31,1,0,0,1,2021-11-18,Male,60,55-64,4
31,1,0,0,1,2021-11-17,Female,50,45-54,5
31,1,0,0,1,2021-11-17,Male,64,55-64,5
31,0,0,0,0,2021-11-22,Female,44,35-44,9
31,1,0,0,1,2021-11-18,Male,66,65-69,6
31,3,0,0,3,2021-11-20,Female,27,25-34,2
31,0,2,0,2,2021-11-19,Female,32,25-34,7
31,1,0,0,1,2021-11-22,Male,41,35-44,9
31,1,0,0,1,2021-11-18,Male,73,70-74,4
31,0,1,0,1,2021-11-18,Male,27,25-34,7
31,3,0,22,25,2021-11-18,Male,7,5-9,4
31,2,0,0,2,2021-11-18,Female,36,35-44,11
31,0,0,0,0,2021-11-19,Male,0,<1,2
31,1,0,0,1,2021-11-17,Male,57,55-64,10
31,1,4,0,5,2021-11-18,Female,28,25-34,9
31,1,0,0,1,2021-11-17,Male,62,55-64,2
31,2,0,0,2,2021-11-18,Male,13,10-14,5
31,1,0,0,1,2021-11-17,Female,32,25-34,2
31,3,0,0,3,2021-11-18,Male,9,5-9,5
31,1,1,0,2,2021-11-19,Female,60,55-64,3
31,0,1,0,1,2021-11-19,Female,71,70-74,16
31,1,0,0,1,2021-11-20,Female,22,20-24,1
31,0,0,0,0,2021-11-18,Male,72,70-74,5
31,4,0,0,4,2021-11-19,Male,11,10-14,5
31,0,0,0,0,2021-11-17,Female,66,65-69,9
31,1,5,0,6,2021-11-23,Male,72,70-74,1
31,0,0,0,0,2021-11-22,Female,33,25-34,6
31,1,0,0,1,2021-11-22,Male,65,65-69,3
31,1,2,0,3,2021-11-17,Female,58,55-64,7
31,1,3,10,14,2021-11-19,Male,35,35-44,3
31,2,3,0,5,2021-11-22,Female,65,65-69,9
31,3,15,0,18,2021-11-18,Male,11,10-14,15
31,0,0,0,0,2021-11-18,Female,68,65-69,5
31,1,0,0,1,2021-11-17,Female,29,25-34,4
31,3,0,0,3,2021-11-22,Male,12,10-14,13
31,1,0,0,1,2021-11-18,Female,28,25-34,5
31,0,0,0,0,2021-11-18,Female,10,10-14,9
31,1,0,0,1,2021-11-17,Female,48,45-54,9
31,0,1,0,1,2021-11-17,Male,33,25-34,8
31,2,6,31,39,2021-11-23,Female,14,10-14,1
31,1,0,0,1,2021-11-19,Male,69,65-69,5
31,1,1,1,3,2021-11-18,Male,67,65-69,5
31,1,0,0,1,2021-11-17,Female,54,45-54,9
31,1,0,0,1,2021-11-17,Female,64,55-64,4
31,1,0,0,1,2021-11-19,Male,74,70-74,3
31,2,1,0,3,2021-11-18,Male,16,15-19,5
31,0,0,0,0,2021-11-18,Male,68,65-69,10
31,0,40,0,40,2021-11-23,Female,49,45-54,1
31,0,0,0,0,2021-11-19,Female,21,20-24,1
31,1,1,0,2,2021-11-23,Female,57,55-64,1
31,0,0,0,0,2021-11-17,Male,37,35-44,10
31,0,0,0,0,2021-11-18,Female,70,70-74,5
31,1,0,0,1,2021-11-18,Female,59,55-64,25
31,0,0,0,0,2021-11-19,Female,72,70-74,4
31,1,1,0,2,2021-11-17,Female,34,25-34,5
31,2,0,0,2,2021-11-17,Female,11,10-14,3
31,2,1,0,3,2021-11-17,Female,30,25-34,6
31,1,0,1,2,2021-11-19,Male,80,80-84,5
31,4,0,0,4,2021-11-22,Female,18,15-19,4
31,1,0,0,1,2021-11-22,Male,33,25-34,7
31,1,0,0,1,2021-11-19,Female,23,20-24,1
31,1,0,0,1,2021-11-18,Female,48,45-54,5
31,0,1,0,1,2021-11-20,Male,21,20-24,1
31,2,1,0,3,2021-11-19,Male,9,5-9,5
31,1,0,0,1,2021-11-18,Male,71,70-74,5
31,1,0,0,1,2021-11-19,Male,70,70-74,11
31,0,0,25,25,2021-11-22,Male,23,20-24,1
31,2,18,0,20,2021-11-17,Female,2,1-4,8
31,2,0,0,2,2021-11-21,Female,18,15-19,1
31,0,1,0,1,2021-11-21,Female,47,45-54,5
31,1,0,0,1,2021-11-17,Female,67,65-69,15
31,0,0,0,0,2021-11-18,Female,69,65-69,19
31,1,0,0,1,2021-11-19,Male,48,45-54,10
31,1,0,0,1,2021-11-20,Female,72,70-74,9
31,1,0,0,1,2021-11-18,Male,78,75-79,10
31,0,1,0,1,2021-11-17,Female,65,65-69,5
31,0,2,0,2,2021-11-17,Female,64,55-64,3
31,0,0,0,0,2021-11-22,Male,24,20-24,1
31,1,0,0,1,2021-11-23,Female,34,25-34,1
31,0,0,0,0,2021-11-17,Male,14,10-14,21
31,4,2,0,6,2021-11-17,Male,1,1-4,3
31,0,5,0,5,2021-11-17,Female,56,55-64,11
31,3,1,0,4,2021-11-17,Male,53,45-54,10
31,0,2,0,2,2021-11-17,Female,67,65-69,4
31,1,1,0,2,2021-11-19,Male,35,35-44,6
31,0,0,0,0,2021-11-22,Male,51,45-54,11
31,2,0,0,2,2021-11-17,Male,65,65-69,11
31,0,0,0,0,2021-11-21,Female,46,45-54,4
31,0,0,0,0,2021-11-19,Male,27,25-34,6
31,1,0,0,1,2021-11-19,Female,59,55-64,6
31,1,5,0,6,2021-11-18,Male,32,25-34,3
31,1,0,0,1,2021-11-18,Male,73,70-74,3
31,0,2,0,2,2021-11-20,Female,44,35-44,5
31,2,0,0,2,2021-11-18,Male,0,<1,9
31,1,0,0,1,2021-11-23,Female,67,65-69,1
31,0,0,0,0,2021-11-18,Male,69,65-69,8
31,0,0,0,0,2021-11-19,Female,77,75-79,17
31,1,0,0,1,2021-11-23,Female,38,35-44,1
31,3,11,0,14,2021-11-17,Male,12,10-14,11
31,1,0,0,1,2021-11-17,Female,54,45-54,3
31,0,0,0,0,2021-11-22,Male,66,65-69,3
31,1,0,0,1,2021-11-18,Male,72,70-74,5
31,1,0,0,1,2021-11-22,Male,61,55-64,3
31,1,3,0,4,2021-11-18,Female,59,55-64,4
31,1,0,0,1,2021-11-19,Male,37,35-44,5
31,2,0,0,2,2021-11-19,Male,40,35-44,9
31,1,0,0,1,2021-11-19,Female,29,25-34,3
31,0,2,0,2,2021-11-18,Male,51,45-54,5
31,1,0,0,1,2021-11-19,Male,72,70-74,5
31,3,0,0,3,2021-11-18,Male,4,1-4,6
31,0,3,0,3,2021-11-18,Female,65,65-69,6
31,0,0,0,0,2021-11-18,Male,71,70-74,3
31,2,0,0,2,2021-11-22,Male,46,45-54,5
31,1,0,0,1,2021-11-22,Male,65,65-69,5
31,3,0,0,3,2021-11-19,Female,11,10-14,5
31,1,0,0,1,2021-11-19,Female,47,45-54,3
31,0,0,0,0,2021-11-18,Female,56,55-64,3
31,0,0,0,0,2021-11-18,Female,64,55-64,3
31,1,0,0,1,2021-11-17,Male,19,15-19,9
31,1,0,0,1,2021-11-18,Male,75,75-79,4
31,2,1,0,3,2021-11-19,Male,21,20-24,1
31,1,0,0,1,2021-11-17,Male,56,55-64,3
31,1,0,3,4,2021-11-20,Male,0,<1,1
31,0,0,0,0,2021-11-18,Female,42,35-44,7
31,0,0,4,4,2021-11-18,Male,32,25-34,4
31,1,2,0,3,2021-11-19,Male,76,75-79,9
31,1,0,0,1,2021-11-17,Male,56,55-64,4
31,1,7,0,8,2021-11-22,Female,63,55-64,10
31,1,2,0,3,2021-11-22,Male,30,25-34,6
31,1,0,0,1,2021-11-18,Female,19,15-19,9
31,2,0,27,29,2021-11-17,Male,9,5-9,5
31,0,0,0,0,2021-11-18,Male,47,45-54,7
31,2,16,0,18,2021-11-17,Female,2,1-4,5
31,1,0,0,1,2021-11-21,Female,18,15-19,1
31,1,1,0,2,2021-11-19,Male,71,70-74,10
31,3,0,0,3,2021-11-22,Female,4,1-4,9
31,0,2,0,2,2021-11-20,Female,28,25-34,18
31,1,0,0,1,2021-11-17,Male,53,45-54,3
31,0,0,0,0,2021-11-17,Male,61,55-64,9
31,0,3,0,3,2021-11-23,Male,51,45-54,1
31,1,0,0,1,2021-11-19,Female,64,55-64,8
31,0,0,0,0,2021-11-17,Female,33,25-34,2
31,0,0,0,0,2021-11-18,Female,67,65-69,4
31,0,0,0,0,2021-11-18,Female,79,75-79,11
31,1,0,0,1,2021-11-17,Female,34,25-34,5
31,1,0,0,1,2021-11-17,Female,66,65-69,10
31,1,2,0,3,2021-11-20,Female,74,70-74,5
31,0,0,0,0,2021-11-22,Male,72,70-74,5
31,1,4,0,5,2021-11-18,Male,71,70-74,5
31,1,1,0,2,2021-11-19,Male,70,70-74,4
31,2,0,0,2,2021-11-18,Female,74,70-74,8
31,0,4,0,4,2021-11-18,Female,51,45-54,4
31,0,0,0,0,2021-11-22,Male,22,20-24,3
31,0,0,0,0,2021-11-18,Female,69,65-69,3
31,0,1,2,3,2021-11-17,Male,40,35-44,9
31,0,2,0,2,2021-11-18,Female,53,45-54,4
31,0,0,0,0,2021-11-18,Female,67,65-69,5
31,0,0,0,0,2021-11-19,Male,28,25-34,13
31,2,0,0,2,2021-11-23,Female,10,10-14,1
31,1,0,0,1,2021-11-20,Female,34,25-34,9
31,2,0,0,2,2021-11-22,Male,13,10-14,3
31,1,0,0,1,2021-11-19,Female,70,70-74,11
31,0,2,0,2,2021-11-17,Female,33,25-34,5
31,0,4,0,4,2021-11-21,Female,51,45-54,10
31,2,1,0,3,2021-11-17,Female,11,10-14,4
31,1,2,0,3,2021-11-22,Female,54,45-54,9
31,1,6,0,7,2021-11-22,Male,53,45-54,6
31,1,0,0,1,2021-11-17,Female,66,65-69,10
31,1,7,0,8,2021-11-19,Male,73,70-74,4
31,1,0,0,1,2021-11-21,Female,49,45-54,8
31,1,0,0,1,2021-11-17,Female,68,65-69,3
31,1,0,0,1,2021-11-18,Female,34,25-34,3
31,1,0,0,1,2021-11-17,Female,54,45-54,5
31,0,0,35,35,2021-11-17,Male,48,45-54,10
31,4,0,0,4,2021-11-17,Female,1,1-4,7
31,1,1,0,2,2021-11-19,Male,74,70-74,5
31,1,1,0,2,2021-11-18,Female,66,65-69,11
31,1,0,0,1,2021-11-17,Male,57,55-64,11
31,1,1,0,2,2021-11-18,Female,32,25-34,15
31,2,0,0,2,2021-11-22,Male,29,25-34,3
31,1,0,0,1,2021-11-17,Male,67,65-69,8
31,0,0,0,0,2021-11-20,Female,20,20-24,1
31,2,0,0,2,2021-11-17,Male,14,10-14,5
31,1,0,0,1,2021-11-20,Male,71,70-74,3
31,0,1,0,1,2021-11-17,Male,46,45-54,4
31,0,1,0,1,2021-11-18,Male,65,65-69,2
31,0,0,0,0,2021-11-19,Male,70,70-74,5
31,0,2,0,2,2021-11-17,Male,24,20-24,17
31,1,0,0,1,2021-11-18,Female,53,45-54,4
31,1,0,0,1,2021-11-20,Male,74,70-74,5
31,0,0,0,0,2021-11-19,Male,35,35-44,6
31,0,0,0,0,2021-11-23,Male,46,45-54,11
31,1,4,0,5,2021-11-18,Male,70,70-74,4
31,3,1,0,4,2021-11-18,Male,7,5-9,8
31,0,0,0,0,2021-11-19,Female,48,45-54,5
31,1,0,0,1,2021-11-17,Male,67,65-69,5
31,2,0,0,2,2021-11-18,Male,39,35-44,7
31,0,7,0,7,2021-11-23,Male,42,35-44,1
31,1,2,2,5,2021-11-18,Male,59,55-64,3
31,2,0,0,2,2021-11-19,Male,59,55-64,5
31,0,2,0,2,2021-11-17,Female,61,55-64,3
31,1,0,0,1,2021-11-18,Male,30,25-34,5
31,1,0,0,1,2021-11-18,Male,70,70-74,4
31,0,0,0,0,2021-11-23,Male,61,55-64,1
31,0,0,0,0,2021-11-22,Female,41,35-44,4
31,1,0,0,1,2021-11-17,Male,53,45-54,3
31,2,0,0,2,2021-11-18,Male,67,65-69,19
31,0,0,0,0,2021-11-20,Female,32,25-34,15
31,2,0,0,2,2021-11-17,Female,16,15-19,4
31,0,1,0,1,2021-11-20,Female,66,65-69,11
31,2,1,0,3,2021-11-21,Female,80,80-84,24
31,1,0,0,1,2021-11-19,Male,72,70-74,5
31,3,5,0,8,2021-11-17,Female,66,65-69,9
31,0,1,0,1,2021-11-17,Female,61,55-64,11
31,1,2,0,3,2021-11-17,Female,53,45-54,10
31,0,0,0,0,2021-11-19,Female,71,70-74,4
31,1,2,0,3,2021-11-19,Female,49,45-54,8
31,0,0,0,0,2021-11-20,Male,27,25-34,5
31,0,2,0,2,2021-11-19,Female,59,55-64,4
31,1,1,0,2,2021-11-22,Female,70,70-74,9
31,1,0,0,1,2021-11-17,Female,45,45-54,4
31,4,1,0,5,2021-11-18,Female,10,10-14,16
31,0,0,0,0,2021-11-17,Male,67,65-69,19
31,0,0,0,0,2021-11-17,Male,58,55-64,4
31,1,0,0,1,2021-11-21,Female,52,45-54,6
31,1,5,0,6,2021-11-19,Male,73,70-74,4
31,0,0,0,0,2021-11-21,Male,44,35-44,6
31,3,0,0,3,2021-11-22,Male,3,1-4,8
31,1,0,0,1,2021-11-18,Female,36,35-44,4
31,1,0,0,1,2021-11-18,Female,57,55-64,5
31,0,0,0,0,2021-11-17,Male,50,45-54,6
31,2,0,0,2,2021-11-21,Female,24,20-24,1
31,2,0,0,2,2021-11-19,Male,17,15-19,19
31,1,0,0,1,2021-11-19,Male,82,80-84,4
31,1,0,0,1,2021-11-19,Male,57,55-64,4
31,2,1,0,3,2021-11-18,Female,12,10-14,5
31,0,2,0,2,2021-11-22,Male,49,45-54,5
32,0,0,0,0,2021-12-14,Female,53,45-54,7
32,0,0,0,0,2021-12-17,Female,60,55-64,1
32,2,0,0,2,2021-12-16,Female,0,<1,6
32,1,0,0,1,2021-12-08,Female,70,70-74,20
32,0,1,0,1,2021-12-09,Female,73,70-74,5
32,1,0,0,1,2021-12-08,Male,68,65-69,4
32,1,0,0,1,2021-12-13,Male,31,25-34,5
32,2,0,0,2,2021-12-09,Male,65,65-69,12
32,0,10,0,10,2021-12-10,Female,49,45-54,12
32,0,0,0,0,2021-12-16,Male,27,25-34,11
32,1,0,0,1,2021-12-10,Female,34,25-34,8
32,1,0,0,1,2021-12-14,Female,4,1-4,12
32,1,0,0,1,2021-12-14,Male,70,70-74,3
32,1,0,0,1,2021-12-09,Female,59,55-64,10
32,1,2,1,4,2021-12-09,Male,71,70-74,12
32,0,2,0,2,2021-12-14,Female,64,55-64,17
32,1,0,0,1,2021-12-13,Male,71,70-74,6
32,0,5,0,5,2021-12-09,Female,42,35-44,6
32,1,0,0,1,2021-12-09,Female,11,10-14,7
32,1,0,0,1,2021-12-08,Female,57,55-64,4
32,2,0,0,2,2021-12-09,Male,7,5-9,8
32,1,0,0,1,2021-12-08,Female,58,55-64,10
32,0,0,0,0,2021-12-13,Male,16,15-19,4
32,1,4,0,5,2021-12-08,Female,30,25-34,2
32,0,0,0,0,2021-12-09,Female,16,15-19,2
32,1,0,0,1,2021-12-13,Female,67,65-69,4
32,2,8,4,14,2021-12-09,Female,48,45-54,5
32,0,0,0,0,2021-12-08,Male,53,45-54,10
32,1,31,0,32,2021-12-10,Female,62,55-64,19
32,2,2,0,4,2021-12-16,Male,16,15-19,4
32,0,0,0,0,2021-12-17,Male,68,65-69,1
32,2,1,0,3,2021-12-08,Female,4,1-4,6
32,2,0,0,2,2021-12-13,Male,50,45-54,5
32,1,0,0,1,2021-12-09,Male,41,35-44,6
32,1,0,0,1,2021-12-09,Male,72,70-74,6
32,2,2,0,4,2021-12-09,Female,4,1-4,7
32,1,1,0,2,2021-12-14,Male,58,55-64,5
32,0,2,0,2,2021-12-08,Female,66,65-69,11
32,0,0,0,0,2021-12-17,Male,49,45-54,2
32,0,2,0,2,2021-12-09,Male,51,45-54,11
32,3,5,0,8,2021-12-14,Female,6,5-9,5
32,2,0,0,2,2021-12-10,Female,14,10-14,25
32,1,1,0,2,2021-12-08,Male,25,25-34,5
32,3,1,0,4,2021-12-08,Female,55,55-64,10
32,1,1,0,2,2021-12-08,Male,58,55-64,11
32,1,1,0,2,2021-12-09,Male,58,55-64,6
32,1,0,0,1,2021-12-08,Male,53,45-54,7
32,0,0,0,0,2021-12-17,Male,58,55-64,1
32,1,0,0,1,2021-12-14,Female,57,55-64,12
32,0,1,0,1,2021-12-16,Male,41,35-44,2
32,1,0,0,1,2021-12-17,Female,30,25-34,1
32,1,5,0,6,2021-12-10,Female,50,45-54,11
32,3,0,0,3,2021-12-13,Male,8,5-9,4
32,1,0,0,1,2021-12-10,Male,60,55-64,12
32,1,0,0,1,2021-12-09,Male,65,65-69,7
32,1,0,0,1,2021-12-17,Female,69,65-69,1
32,2,0,0,2,2021-12-17,Female,6,5-9,1
32,1,0,0,1,2021-12-13,Male,36,35-44,20
32,0,14,0,14,2021-12-17,Female,33,25-34,1
32,1,1,0,2,2021-12-10,Male,35,35-44,8
32,0,11,0,11,2021-12-08,Male,54,45-54,23
32,1,0,0,1,2021-12-09,Male,77,75-79,9
32,1,0,0,1,2021-12-16,Female,32,25-34,5
32,0,10,0,10,2021-12-14,Male,56,55-64,5
32,1,0,0,1,2021-12-16,Female,40,35-44,4
32,0,0,0,0,2021-12-08,Female,58,55-64,4
32,0,0,0,0,2021-12-09,Male,42,35-44,29
32,1,0,0,1,2021-12-10,Female,49,45-54,6
32,0,0,0,0,2021-12-13,Female,33,25-34,4
32,1,16,0,17,2021-12-09,Male,9,5-9,4
32,4,0,0,4,2021-12-13,Female,6,5-9,7
32,0,0,0,0,2021-12-10,Female,18,15-19,5
32,1,0,0,1,2021-12-09,Male,44,35-44,8
32,1,0,0,1,2021-12-17,Female,71,70-74,1
32,0,0,0,0,2021-12-09,Male,85,85+,26
32,0,4,0,4,2021-12-08,Male,37,35-44,6
32,0,0,0,0,2021-12-17,Male,30,25-34,8
32,1,0,0,1,2021-12-17,Female,54,45-54,1
32,1,1,0,2,2021-12-09,Female,33,25-34,8
32,3,0,0,3,2021-12-15,Female,47,45-54,8
32,1,0,0,1,2021-12-09,Male,66,65-69,6
32,3,0,0,3,2021-12-08,Male,2,1-4,16
32,0,3,0,3,2021-12-08,Male,55,55-64,17
32,0,0,0,0,2021-12-08,Male,16,15-19,19
32,0,0,0,0,2021-12-13,Male,62,55-64,8
32,1,0,0,1,2021-12-10,Male,33,25-34,11
32,0,4,0,4,2021-12-14,Female,40,35-44,6
32,0,0,0,0,2021-12-09,Male,41,35-44,8
32,1,0,0,1,2021-12-13,Female,69,65-69,7
32,0,1,0,1,2021-12-08,Male,62,55-64,5
32,0,0,0,0,2021-12-13,Male,70,70-74,6
32,0,1,0,1,2021-12-08,Female,54,45-54,4
32,0,5,0,5,2021-12-09,Male,62,55-64,6
32,1,0,0,1,2021-12-08,Female,45,45-54,7
32,2,1,0,3,2021-12-09,Female,53,45-54,4
32,2,0,0,2,2021-12-13,Female,17,15-19,10
32,0,2,0,2,2021-12-16,Female,45,45-54,2
32,1,0,0,1,2021-12-13,Male,76,75-79,6
32,1,0,0,1,2021-12-13,Female,11,10-14,10
32,0,1,0,1,2021-12-13,Female,78,75-79,6
32,0,2,0,2,2021-12-08,Male,53,45-54,25
32,0,1,0,1,2021-12-13,Female,39,35-44,9
32,0,0,0,0,2021-12-08,Male,68,65-69,6
32,1,0,0,1,2021-12-13,Female,60,55-64,4
32,0,3,0,3,2021-12-17,Male,61,55-64,1
32,0,0,0,0,2021-12-09,Male,61,55-64,12
32,1,16,0,17,2021-12-17,Female,34,25-34,1
32,1,0,0,1,2021-12-09,Male,44,35-44,17
32,1,0,0,1,2021-12-09,Male,68,65-69,5
32,0,0,0,0,2021-12-13,Female,51,45-54,4
32,2,9,2,13,2021-12-08,Female,52,45-54,6
32,0,3,0,3,2021-12-13,Female,56,55-64,11
32,0,0,0,0,2021-12-09,Male,43,35-44,10
32,1,1,0,2,2021-12-08,Male,39,35-44,11
32,0,0,0,0,2021-12-17,Female,24,20-24,2
32,0,0,0,0,2021-12-11,Female,61,55-64,19
32,2,0,0,2,2021-12-08,Female,73,70-74,6
32,1,5,11,17,2021-12-14,Male,75,75-79,4
32,1,8,0,9,2021-12-10,Male,68,65-69,10
32,1,1,0,2,2021-12-13,Male,62,55-64,4
32,0,0,0,0,2021-12-13,Female,85,85+,3
32,1,3,0,4,2021-12-14,Male,64,55-64,4
32,1,0,0,1,2021-12-08,Female,62,55-64,5
32,0,0,0,0,2021-12-17,Male,50,45-54,3
32,0,5,0,5,2021-12-13,Female,78,75-79,25
32,0,0,0,0,2021-12-13,Male,33,25-34,8
32,3,0,0,3,2021-12-10,Male,77,75-79,5
32,2,0,0,2,2021-12-08,Male,67,65-69,9
32,1,2,0,3,2021-12-17,Male,69,65-69,1
32,0,0,0,0,2021-12-09,Female,53,45-54,19
32,1,0,0,1,2021-12-17,Male,55,55-64,1
32,1,0,0,1,2021-12-17,Male,59,55-64,1
32,1,2,3,6,2021-12-08,Male,69,65-69,6
32,1,0,0,1,2021-12-13,Female,47,45-54,4
32,1,0,0,1,2021-12-13,Female,43,35-44,6
32,3,0,0,3,2021-12-14,Female,44,35-44,17
32,0,1,0,1,2021-12-09,Male,71,70-74,6
32,0,0,0,0,2021-12-09,Female,65,65-69,6
32,1,0,0,1,2021-12-08,Male,59,55-64,4
32,0,0,0,0,2021-12-11,Female,78,75-79,7
32,1,0,0,1,2021-12-13,Female,67,65-69,5
32,1,0,0,1,2021-12-08,Male,69,65-69,6
32,0,0,0,0,2021-12-09,Male,56,55-64,11
32,0,0,14,14,2021-12-17,Female,47,45-54,1
32,0,1,0,1,2021-12-13,Male,35,35-44,4
32,1,0,0,1,2021-12-17,Male,50,45-54,1
32,2,0,0,2,2021-12-08,Female,56,55-64,5
32,1,3,0,4,2021-12-09,Female,71,70-74,6
32,1,0,0,1,2021-12-09,Female,61,55-64,10
32,1,7,0,8,2021-12-09,Female,44,35-44,4
32,0,1,0,1,2021-12-08,Male,73,70-74,11
32,1,0,0,1,2021-12-15,Female,29,25-34,12
32,1,4,0,5,2021-12-13,Male,30,25-34,3
32,1,0,0,1,2021-12-17,Female,30,25-34,1
32,0,5,0,5,2021-12-17,Female,58,55-64,1
32,2,0,0,2,2021-12-13,Male,2,1-4,2
32,2,0,0,2,2021-12-09,Male,65,65-69,11
32,0,0,0,0,2021-12-08,Female,29,25-34,4
32,4,0,0,4,2021-12-13,Female,2,1-4,13
32,0,0,0,0,2021-12-09,Female,36,35-44,7
32,0,0,0,0,2021-12-13,Male,70,70-74,19
32,1,0,0,1,2021-12-09,Male,78,75-79,5
32,0,0,0,0,2021-12-08,Female,54,45-54,12
32,4,15,0,19,2021-12-10,Female,14,10-14,17
32,0,1,0,1,2021-12-13,Male,73,70-74,4
32,1,0,0,1,2021-12-13,Male,68,65-69,24
32,0,0,0,0,2021-12-10,Male,33,25-34,11
32,1,0,0,1,2021-12-09,Female,59,55-64,11
32,1,0,0,1,2021-12-13,Female,72,70-74,10
32,2,2,0,4,2021-12-13,Male,3,1-4,5
32,1,0,0,1,2021-12-13,Male,39,35-44,6
32,2,0,0,2,2021-12-08,Male,14,10-14,11
32,0,0,0,0,2021-12-13,Female,76,75-79,12
32,1,11,0,12,2021-12-08,Male,56,55-64,3
32,1,0,0,1,2021-12-17,Male,59,55-64,1
32,1,0,0,1,2021-12-09,Male,69,65-69,6
32,4,0,0,4,2021-12-10,Female,1,1-4,22
32,0,0,0,0,2021-12-08,Female,28,25-34,8
32,1,0,0,1,2021-12-09,Male,31,25-34,2
32,3,0,0,3,2021-12-09,Male,19,15-19,26
32,1,0,0,1,2021-12-17,Male,75,75-79,1
32,0,0,0,0,2021-12-09,Male,66,65-69,7
32,0,2,0,2,2021-12-09,Male,51,45-54,4
32,3,0,0,3,2021-12-17,Female,5,5-9,1
32,0,2,0,2,2021-12-10,Male,70,70-74,22
32,0,1,0,1,2021-12-08,Female,19,15-19,2
32,3,0,0,3,2021-12-09,Female,10,10-14,5
32,1,5,0,6,2021-12-09,Male,44,35-44,7
32,1,5,0,6,2021-12-09,Male,61,55-64,10
32,0,1,0,1,2021-12-13,Female,27,25-34,7
32,0,0,0,0,2021-12-16,Female,23,20-24,2
32,0,0,3,3,2021-12-08,Female,73,70-74,4
32,1,0,0,1,2021-12-09,Male,72,70-74,6
32,1,0,0,1,2021-12-09,Female,66,65-69,7
32,1,0,0,1,2021-12-17,Male,80,80-84,1
32,1,1,0,2,2021-12-08,Male,21,20-24,6
32,1,0,0,1,2021-12-15,Male,35,35-44,10
32,2,0,0,2,2021-12-09,Male,13,10-14,8
32,0,0,0,0,2021-12-09,Female,34,25-34,5
32,3,0,0,3,2021-12-13,Female,53,45-54,7
32,1,0,0,1,2021-12-11,Male,33,25-34,4
32,1,0,0,1,2021-12-10,Male,72,70-74,5
32,1,0,0,1,2021-12-13,Female,61,55-64,11
32,4,0,0,4,2021-12-13,Male,14,10-14,4
32,1,0,0,1,2021-12-09,Male,52,45-54,11
32,0,11,37,48,2021-12-08,Female,45,45-54,3
32,1,0,0,1,2021-12-09,Female,30,25-34,3
32,2,0,0,2,2021-12-08,Female,28,25-34,12
32,1,0,0,1,2021-12-14,Male,31,25-34,3
32,2,0,0,2,2021-12-09,Male,12,10-14,6
32,0,0,0,0,2021-12-09,Male,70,70-74,4
32,1,0,0,1,2021-12-13,Female,6,5-9,4
32,1,0,0,1,2021-12-08,Male,69,65-69,12
32,2,0,0,2,2021-12-17,Female,0,<1,10
32,1,0,0,1,2021-12-08,Male,11,10-14,5
32,1,0,15,16,2021-12-17,Male,72,70-74,1
32,1,1,0,2,2021-12-17,Male,33,25-34,1
32,0,0,0,0,2021-12-17,Female,45,45-54,1
32,2,3,0,5,2021-12-17,Female,58,55-64,1
32,1,2,0,3,2021-12-14,Male,74,70-74,7
32,0,0,0,0,2021-12-13,Male,54,45-54,6
32,1,9,3,13,2021-12-17,Male,59,55-64,1
32,0,6,0,6,2021-12-09,Male,83,80-84,5
32,0,0,0,0,2021-12-13,Male,51,45-54,6
32,0,0,0,0,2021-12-09,Male,47,45-54,11
32,1,0,0,1,2021-12-13,Female,68,65-69,11
32,1,0,0,1,2021-12-09,Female,65,65-69,6
32,3,0,0,3,2021-12-13,Male,6,5-9,15
32,0,0,0,0,2021-12-13,Female,42,35-44,5
32,0,0,0,0,2021-12-13,Female,44,35-44,9
32,3,0,0,3,2021-12-14,Female,57,55-64,4
32,0,0,0,0,2021-12-08,Female,30,25-34,5
32,1,0,0,1,2021-12-09,Male,65,65-69,8
32,1,3,0,4,2021-12-17,Female,41,35-44,1
32,0,0,0,0,2021-12-09,Male,34,25-34,6
32,0,0,0,0,2021-12-09,Male,30,25-34,7
32,1,1,0,2,2021-12-08,Male,62,55-64,10
32,0,0,0,0,2021-12-08,Female,45,45-54,6
32,2,0,0,2,2021-12-11,Female,4,1-4,7
32,0,0,0,0,2021-12-09,Male,70,70-74,25
32,0,1,0,1,2021-12-09,Female,85,85+,4
32,1,0,0,1,2021-12-13,Male,65,65-69,7
32,1,0,0,1,2021-12-09,Male,64,55-64,6
32,1,0,0,1,2021-12-17,Female,53,45-54,1
32,1,0,0,1,2021-12-08,Male,68,65-69,5
32,3,0,0,3,2021-12-16,Female,19,15-19,21
32,1,0,0,1,2021-12-13,Male,65,65-69,4
32,0,11,0,11,2021-12-09,Male,53,45-54,8
32,1,0,0,1,2021-12-08,Male,57,55-64,6
32,0,4,2,6,2021-12-09,Female,66,65-69,6
32,2,3,0,5,2021-12-16,Male,33,25-34,4
32,3,10,0,13,2021-12-17,Male,2,1-4,1
32,0,0,0,0,2021-12-14,Female,42,35-44,5
32,1,1,0,2,2021-12-08,Female,39,35-44,4
32,0,2,0,2,2021-12-13,Female,70,70-74,10
32,1,0,0,1,2021-12-10,Female,71,70-74,5
32,3,0,0,3,2021-12-11,Female,19,15-19,11
32,1,0,0,1,2021-12-08,Female,67,65-69,5
32,0,0,0,0,2021-12-13,Male,34,25-34,10
32,3,0,14,17,2021-12-14,Male,2,1-4,10
32,0,1,0,1,2021-12-09,Male,42,35-44,13
32,1,0,0,1,2021-12-08,Female,54,45-54,12
32,2,7,0,9,2021-12-09,Male,78,75-79,3
32,1,0,0,1,2021-12-08,Male,51,45-54,9
32,1,0,0,1,2021-12-09,Female,69,65-69,6
32,1,2,0,3,2021-12-13,Male,43,35-44,8
32,1,0,0,1,2021-12-09,Male,50,45-54,10
32,1,4,0,5,2021-12-13,Male,57,55-64,23
32,0,2,0,2,2021-12-17,Female,29,25-34,1
32,1,0,0,1,2021-12-17,Male,30,25-34,1
32,2,0,0,2,2021-12-08,Male,7,5-9,3
32,0,0,0,0,2021-12-14,Male,60,55-64,6
32,1,7,0,8,2021-12-13,Male,50,45-54,7
32,1,5,0,6,2021-12-13,Female,61,55-64,5
32,1,0,0,1,2021-12-09,Male,70,70-74,5
32,0,0,0,0,2021-12-09,Female,57,55-64,19
32,0,0,0,0,2021-12-09,Female,51,45-54,14
32,0,0,0,0,2021-12-13,Female,43,35-44,9
32,3,0,0,3,2021-12-08,Male,14,10-14,6
32,0,3,0,3,2021-12-14,Female,75,75-79,9
32,0,1,0,1,2021-12-08,Male,68,65-69,7
32,1,0,0,1,2021-12-09,Female,41,35-44,5
32,2,1,0,3,2021-12-17,Female,24,20-24,3
32,2,0,0,2,2021-12-08,Female,53,45-54,5
32,0,2,0,2,2021-12-11,Female,81,80-84,10
32,1,0,0,1,2021-12-09,Female,47,45-54,4
32,0,6,0,6,2021-12-08,Male,58,55-64,7
32,2,0,0,2,2021-12-10,Male,68,65-69,5
32,2,1,0,3,2021-12-09,Male,47,45-54,4
32,0,15,0,15,2021-12-15,Female,26,25-34,3
32,3,0,0,3,2021-12-17,Male,9,5-9,1
32,1,1,0,2,2021-12-09,Female,61,55-64,5
32,0,0,0,0,2021-12-10,Male,49,45-54,8
32,2,1,0,3,2021-12-13,Male,67,65-69,4
32,2,0,0,2,2021-12-17,Male,30,25-34,1
32,3,0,0,3,2021-12-10,Female,15,15-19,4
32,3,1,0,4,2021-12-08,Male,14,10-14,4
32,1,0,0,1,2021-12-13,Male,73,70-74,6
32,0,0,0,0,2021-12-09,Male,41,35-44,5
32,1,0,0,1,2021-12-13,Male,64,55-64,10
32,1,0,0,1,2021-12-09,Male,10,10-14,2
32,0,0,0,0,2021-12-14,Male,72,70-74,9
32,3,0,0,3,2021-12-17,Female,9,5-9,2
32,0,0,0,0,2021-12-17,Male,52,45-54,1
32,0,0,0,0,2021-12-17,Female,62,55-64,1
32,1,0,0,1,2021-12-08,Male,45,45-54,10
32,1,0,0,1,2021-12-08,Male,74,70-74,5
32,1,3,0,4,2021-12-14,Female,36,35-44,3
32,0,0,0,0,2021-12-09,Male,77,75-79,5
32,1,3,0,4,2021-12-08,Female,68,65-69,10
32,0,2,0,2,2021-12-10,Male,60,55-64,9
32,1,0,0,1,2021-12-13,Female,33,25-34,4
32,1,0,0,1,2021-12-13,Male,75,75-79,4
32,0,0,0,0,2021-12-17,Male,62,55-64,1
32,1,1,0,2,2021-12-08,Female,53,45-54,4
32,0,0,0,0,2021-12-10,Male,59,55-64,4
32,0,1,0,1,2021-12-14,Female,67,65-69,6
32,0,0,0,0,2021-12-17,Female,54,45-54,1
32,0,0,0,0,2021-12-08,Female,57,55-64,8
32,0,1,0,1,2021-12-17,Male,52,45-54,6
32,2,20,0,22,2021-12-09,Male,10,10-14,8
32,0,0,0,0,2021-12-14,Male,52,45-54,6
32,0,0,0,0,2021-12-17,Female,25,25-34,1
32,1,0,0,1,2021-12-08,Female,73,70-74,9
32,0,0,0,0,2021-12-09,Female,66,65-69,12
32,0,8,0,8,2021-12-09,Male,57,55-64,5
32,3,0,0,3,2021-12-09,Female,27,25-34,4
32,1,2,0,3,2021-12-17,Female,64,55-64,1
32,0,0,0,0,2021-12-09,Male,49,45-54,6
32,1,0,0,1,2021-12-09,Male,72,70-74,6
32,1,4,0,5,2021-12-08,Female,37,35-44,8
32,0,1,0,1,2021-12-08,Female,24,20-24,5
32,1,0,0,1,2021-12-08,Female,54,45-54,4
32,0,7,0,7,2021-12-13,Female,46,45-54,2
32,0,2,0,2,2021-12-13,Female,70,70-74,6
32,3,0,0,3,2021-12-16,Female,20,20-24,7
32,0,0,0,0,2021-12-08,Male,54,45-54,6
32,1,0,0,1,2021-12-08,Female,62,55-64,5
32,0,0,0,0,2021-12-11,Male,24,20-24,12
32,0,2,0,2,2021-12-09,Male,55,55-64,4
32,1,1,0,2,2021-12-09,Female,73,70-74,4
32,0,0,0,0,2021-12-12,Female,50,45-54,5
32,0,0,0,0,2021-12-09,Male,69,65-69,7
32,1,0,0,1,2021-12-09,Male,73,70-74,4
32,2,1,0,3,2021-12-08,Female,40,35-44,8
32,0,6,0,6,2021-12-14,Male,53,45-54,2
32,0,1,0,1,2021-12-09,Male,34,25-34,3
32,1,0,0,1,2021-12-08,Female,54,45-54,7
32,2,0,0,2,2021-12-08,Male,16,15-19,12
32,0,12,0,12,2021-12-09,Female,51,45-54,5
32,2,0,0,2,2021-12-12,Female,0,<1,8
32,3,0,0,3,2021-12-17,Female,53,45-54,1
32,1,0,0,1,2021-12-08,Male,75,75-79,8
32,1,2,0,3,2021-12-10,Female,54,45-54,9
32,2,40,0,42,2021-12-09,Female,59,55-64,11
32,0,0,0,0,2021-12-13,Male,46,45-54,5
32,2,0,14,16,2021-12-15,Male,13,10-14,3
32,1,4,0,5,2021-12-11,Female,64,55-64,4
32,0,0,0,0,2021-12-17,Female,70,70-74,1
32,0,0,0,0,2021-12-08,Female,62,55-64,6
32,0,0,0,0,2021-12-13,Male,72,70-74,4
32,1,0,0,1,2021-12-10,Male,70,70-74,5
32,0,0,0,0,2021-12-13,Male,44,35-44,25
32,0,2,0,2,2021-12-08,Male,55,55-64,5
32,2,0,0,2,2021-12-09,Male,34,25-34,11
32,0,0,0,0,2021-12-09,Male,43,35-44,10
32,0,3,0,3,2021-12-17,Female,57,55-64,1
32,3,0,0,3,2021-12-13,Female,14,10-14,5
32,0,0,0,0,2021-12-09,Female,48,45-54,7
32,1,0,0,1,2021-12-17,Female,61,55-64,1
32,2,10,0,12,2021-12-08,Male,18,15-19,12
32,0,0,0,0,2021-12-08,Female,29,25-34,5
32,0,6,0,6,2021-12-08,Female,62,55-64,4
32,0,0,0,0,2021-12-09,Male,70,70-74,6
32,0,0,0,0,2021-12-08,Female,73,70-74,7
32,1,0,0,1,2021-12-17,Female,32,25-34,1
32,1,1,0,2,2021-12-09,Male,71,70-74,19
32,1,0,0,1,2021-12-08,Male,70,70-74,7
32,1,3,5,9,2021-12-17,Male,67,65-69,1
32,1,15,0,16,2021-12-08,Female,2,1-4,11
32,0,0,0,0,2021-12-13,Male,63,55-64,7
32,2,0,0,2,2021-12-09,Male,5,5-9,5
32,0,0,0,0,2021-12-13,Male,44,35-44,20
32,0,0,0,0,2021-12-13,Female,62,55-64,2
32,3,0,0,3,2021-12-13,Male,12,10-14,7
32,0,0,0,0,2021-12-08,Female,37,35-44,5
32,0,0,0,0,2021-12-17,Female,53,45-54,1
32,0,2,0,2,2021-12-08,Male,28,25-34,11
32,1,0,0,1,2021-12-10,Female,73,70-74,6
32,0,0,0,0,2021-12-13,Male,64,55-64,5
32,1,2,0,3,2021-12-16,Female,45,45-54,8
32,1,0,0,1,2021-12-17,Female,34,25-34,1
32,1,0,0,1,2021-12-08,Female,56,55-64,12
32,0,0,0,0,2021-12-09,Male,45,45-54,20
32,0,0,0,0,2021-12-08,Male,55,55-64,3
32,1,0,0,1,2021-12-08,Female,56,55-64,5
32,1,8,0,9,2021-12-17,Female,32,25-34,1
32,3,15,0,18,2021-12-14,Male,2,1-4,2
32,0,4,0,4,2021-12-10,Male,70,70-74,12
32,0,0,0,0,2021-12-09,Female,60,55-64,5
32,0,0,0,0,2021-12-12,Male,49,45-54,8
32,1,0,0,1,2021-12-09,Male,61,55-64,17
32,2,0,0,2,2021-12-11,Male,10,10-14,5
32,1,0,0,1,2021-12-14,Female,22,20-24,7
32,0,1,0,1,2021-12-08,Male,73,70-74,5
32,0,0,0,0,2021-12-10,Female,48,45-54,3
32,0,0,0,0,2021-12-17,Male,73,70-74,1
32,1,0,0,1,2021-12-08,Male,62,55-64,6
32,2,0,0,2,2021-12-13,Female,40,35-44,5
32,2,0,18,20,2021-12-13,Female,71,70-74,9
32,1,1,0,2,2021-12-09,Female,71,70-74,11
32,1,0,0,1,2021-12-09,Female,64,55-64,4
32,1,4,0,5,2021-12-09,Female,50,45-54,3
32,0,0,0,0,2021-12-13,Female,59,55-64,6
32,1,0,0,1,2021-12-17,Male,49,45-54,1
32,0,1,0,1,2021-12-09,Female,64,55-64,5
32,1,2,0,3,2021-12-13,Male,75,75-79,6
32,0,0,0,0,2021-12-14,Female,33,25-34,11
32,4,0,0,4,2021-12-13,Female,11,10-14,8
32,0,3,0,3,2021-12-14,Male,76,75-79,4
32,0,3,0,3,2021-12-08,Female,73,70-74,4
32,1,0,0,1,2021-12-13,Female,52,45-54,6
32,0,0,0,0,2021-12-17,Male,76,75-79,1
32,0,0,0,0,2021-12-10,Male,55,55-64,4
32,0,0,0,0,2021-12-13,Female,62,55-64,4
32,1,0,0,1,2021-12-11,Female,69,65-69,7
32,3,0,0,3,2021-12-17,Female,4,1-4,1
32,1,1,0,2,2021-12-12,Female,41,35-44,3
32,2,15,0,17,2021-12-10,Female,44,35-44,6
32,1,0,0,1,2021-12-08,Male,74,70-74,6
32,1,2,0,3,2021-12-09,Female,18,15-19,4
32,1,3,0,4,2021-12-08,Male,66,65-69,11
32,0,0,0,0,2021-12-09,Male,42,35-44,6
32,0,0,0,0,2021-12-14,Female,58,55-64,5
32,0,0,0,0,2021-12-15,Male,2,1-4,16
32,1,0,0,1,2021-12-17,Male,32,25-34,1
32,1,1,0,2,2021-12-17,Female,58,55-64,1
32,0,2,0,2,2021-12-13,Female,71,70-74,20
32,1,0,0,1,2021-12-08,Male,69,65-69,21
32,0,0,0,0,2021-12-17,Female,25,25-34,1
32,0,0,0,0,2021-12-09,Female,32,25-34,4
32,1,0,0,1,2021-12-08,Female,37,35-44,7
32,1,2,45,48,2021-12-12,Female,53,45-54,2
32,3,0,0,3,2021-12-15,Male,13,10-14,4
32,0,3,0,3,2021-12-13,Female,75,75-79,6
32,1,1,0,2,2021-12-08,Male,14,10-14,11
32,2,2,0,4,2021-12-13,Male,66,65-69,5
32,1,0,0,1,2021-12-09,Male,43,35-44,11
32,2,1,0,3,2021-12-13,Male,6,5-9,22
32,0,1,0,1,2021-12-08,Female,27,25-34,5
32,1,0,0,1,2021-12-14,Male,59,55-64,6
32,0,0,0,0,2021-12-09,Male,71,70-74,6
32,0,0,0,0,2021-12-13,Female,28,25-34,6
32,1,2,0,3,2021-12-14,Female,17,15-19,3
32,2,0,0,2,2021-12-13,Female,1,1-4,4
32,0,0,0,0,2021-12-16,Female,50,45-54,4
32,0,3,0,3,2021-12-17,Female,75,75-79,1
32,1,1,0,2,2021-12-08,Male,54,45-54,6
32,1,0,0,1,2021-12-11,Male,71,70-74,4
32,3,6,0,9,2021-12-17,Female,4,1-4,1
32,1,0,0,1,2021-12-08,Female,30,25-34,7
32,2,0,0,2,2021-12-08,Female,55,55-64,5
32,1,0,0,1,2021-12-13,Female,66,65-69,18
32,1,0,0,1,2021-12-17,Female,62,55-64,1
32,0,0,0,0,2021-12-09,Male,49,45-54,9
32,1,0,0,1,2021-12-08,Female,18,15-19,8
32,1,0,0,1,2021-12-13,Male,35,35-44,11
32,2,0,0,2,2021-12-13,Male,9,5-9,3
32,2,0,1,3,2021-12-11,Male,8,5-9,3
32,0,0,0,0,2021-12-14,Female,46,45-54,5
32,3,1,0,4,2021-12-08,Female,58,55-64,6
32,3,0,0,3,2021-12-09,Male,17,15-19,9
32,1,1,0,2,2021-12-14,Male,63,55-64,5
32,2,0,2,4,2021-12-08,Female,66,65-69,3
32,2,0,0,2,2021-12-08,Male,5,5-9,2
32,1,2,0,3,2021-12-13,Male,68,65-69,6
32,3,0,0,3,2021-12-17,Male,6,5-9,1
32,0,0,0,0,2021-12-09,Female,50,45-54,11
32,2,2,0,4,2021-12-09,Female,8,5-9,11
32,0,0,52,52,2021-12-13,Female,54,45-54,5
32,0,0,0,0,2021-12-17,Male,56,55-64,1
32,0,0,0,0,2021-12-10,Female,72,70-74,8
32,1,0,0,1,2021-12-08,Female,53,45-54,5
32,1,0,0,1,2021-12-08,Male,58,55-64,12
32,1,3,0,4,2021-12-14,Female,58,55-64,6
32,0,1,0,1,2021-12-13,Female,55,55-64,12
32,2,3,0,5,2021-12-10,Male,7,5-9,5
32,0,0,0,0,2021-12-13,Male,66,65-69,11
32,2,0,0,2,2021-12-10,Female,42,35-44,6
32,2,0,0,2,2021-12-17,Female,27,25-34,1
32,1,1,0,2,2021-12-17,Female,68,65-69,1
32,0,2,0,2,2021-12-13,Male,52,45-54,9
32,1,0,0,1,2021-12-17,Female,24,20-24,1
32,1,0,0,1,2021-12-08,Male,56,55-64,11
32,2,0,0,2,2021-12-16,Female,9,5-9,7
32,1,1,0,2,2021-12-08,Female,68,65-69,7
32,1,0,0,1,2021-12-08,Male,70,70-74,5
32,2,1,0,3,2021-12-09,Male,6,5-9,6
32,0,0,0,0,2021-12-13,Male,28,25-34,4
32,3,2,0,5,2021-12-14,Female,51,45-54,6
32,0,0,8,8,2021-12-08,Male,27,25-34,10
32,0,2,0,2,2021-12-12,Male,48,45-54,19
32,0,1,0,1,2021-12-08,Male,57,55-64,10
32,2,0,0,2,2021-12-13,Female,41,35-44,7
32,0,0,0,0,2021-12-08,Male,56,55-64,6
32,1,0,0,1,2021-12-14,Female,72,70-74,11
32,3,25,0,28,2021-12-09,Female,6,5-9,7
32,3,0,0,3,2021-12-14,Male,1,1-4,9
32,1,0,0,1,2021-12-13,Male,70,70-74,6
32,0,0,0,0,2021-12-11,Female,12,10-14,4
32,0,0,0,0,2021-12-09,Male,59,55-64,11
32,1,2,0,3,2021-12-13,Male,60,55-64,15
32,0,0,0,0,2021-12-17,Male,33,25-34,1
32,0,0,0,0,2021-12-13,Female,32,25-34,2
32,1,0,0,1,2021-12-13,Female,54,45-54,17
32,1,0,0,1,2021-12-09,Male,52,45-54,5
32,0,0,0,0,2021-12-08,Female,22,20-24,16
32,2,0,0,2,2021-12-15,Female,36,35-44,19
32,1,0,0,1,2021-12-10,Male,63,55-64,7
32,3,0,0,3,2021-12-14,Male,17,15-19,7
32,0,0,0,0,2021-12-08,Male,38,35-44,7
32,0,0,0,0,2021-12-16,Female,46,45-54,10
32,1,0,0,1,2021-12-11,Female,52,45-54,9
32,1,0,0,1,2021-12-10,Female,60,55-64,7
32,1,0,0,1,2021-12-09,Male,72,70-74,12
32,2,0,0,2,2021-12-13,Female,68,65-69,7
32,2,20,11,33,2021-12-08,Male,57,55-64,2
32,2,0,0,2,2021-12-09,Female,0,<1,11
32,0,0,5,5,2021-12-14,Male,23,20-24,19
32,2,1,0,3,2021-12-17,Male,57,55-64,1
32,2,0,0,2,2021-12-14,Male,2,1-4,6
32,2,0,0,2,2021-12-13,Female,40,35-44,9
32,0,12,0,12,2021-12-11,Female,34,25-34,3
32,1,0,0,1,2021-12-10,Male,31,25-34,3
32,0,3,0,3,2021-12-10,Male,60,55-64,11
32,1,1,0,2,2021-12-09,Female,41,35-44,11
32,2,0,0,2,2021-12-16,Male,0,<1,6
32,0,0,0,0,2021-12-17,Male,64,55-64,1
32,1,0,0,1,2021-12-13,Female,54,45-54,11
32,1,2,0,3,2021-12-17,Female,63,55-64,1
32,3,0,0,3,2021-12-13,Male,59,55-64,5
32,0,1,0,1,2021-12-08,Male,53,45-54,12
32,1,1,0,2,2021-12-13,Male,47,45-54,7
32,0,0,0,0,2021-12-16,Male,11,10-14,2
32,1,2,3,6,2021-12-13,Male,68,65-69,4
32,1,0,0,1,2021-12-09,Male,69,65-69,6
32,2,13,10,25,2021-12-08,Male,69,65-69,13
32,2,0,0,2,2021-12-09,Female,45,45-54,8
32,0,1,0,1,2021-12-09,Male,80,80-84,10
32,0,0,0,0,2021-12-10,Female,43,35-44,3
32,1,2,0,3,2021-12-08,Female,66,65-69,10
32,1,16,0,17,2021-12-14,Male,1,1-4,3
32,1,2,0,3,2021-12-08,Female,67,65-69,9
32,0,2,0,2,2021-12-09,Male,65,65-69,6
32,0,0,0,0,2021-12-14,Female,65,65-69,9
32,1,0,0,1,2021-12-09,Male,63,55-64,6
32,2,0,0,2,2021-12-17,Male,5,5-9,1
32,2,0,0,2,2021-12-08,Female,27,25-34,22
32,1,0,0,1,2021-12-13,Male,68,65-69,10
32,1,0,0,1,2021-12-11,Female,58,55-64,3
32,2,0,0,2,2021-12-08,Female,45,45-54,4
32,1,0,0,1,2021-12-09,Male,74,70-74,4
32,0,0,0,0,2021-12-09,Female,34,25-34,10
32,1,0,0,1,2021-12-12,Male,32,25-34,9
32,0,0,0,0,2021-12-08,Female,9,5-9,8
32,1,0,0,1,2021-12-09,Male,58,55-64,5
32,0,1,0,1,2021-12-08,Male,54,45-54,9
32,2,1,0,3,2021-12-08,Male,67,65-69,5
32,0,1,0,1,2021-12-09,Male,69,65-69,6
32,1,1,0,2,2021-12-08,Male,39,35-44,4
32,1,0,0,1,2021-12-08,Male,58,55-64,7
32,1,0,0,1,2021-12-09,Female,53,45-54,4
32,1,0,0,1,2021-12-13,Male,70,70-74,27
32,0,0,0,0,2021-12-13,Female,63,55-64,4
32,0,0,0,0,2021-12-13,Male,73,70-74,3
32,1,0,0,1,2021-12-09,Male,59,55-64,12
32,2,3,0,5,2021-12-09,Female,1,1-4,4
32,1,0,32,33,2021-12-09,Male,5,5-9,5
32,1,2,0,3,2021-12-09,Male,69,65-69,4
32,1,32,0,33,2021-12-16,Female,51,45-54,5
32,1,0,0,1,2021-12-08,Female,26,25-34,5
32,1,5,0,6,2021-12-14,Female,41,35-44,5
32,2,0,0,2,2021-12-09,Male,3,1-4,11
32,1,0,0,1,2021-12-13,Male,75,75-79,5
32,1,4,0,5,2021-12-12,Female,5,5-9,4
32,0,0,0,0,2021-12-08,Male,57,55-64,7
32,1,0,0,1,2021-12-09,Female,66,65-69,9
32,1,11,0,12,2021-12-08,Male,58,55-64,5
32,0,0,0,0,2021-12-17,Male,17,15-19,1
32,0,6,0,6,2021-12-10,Female,52,45-54,5
32,0,0,0,0,2021-12-08,Male,52,45-54,6
32,1,0,0,1,2021-12-09,Male,52,45-54,7
32,1,0,0,1,2021-12-14,Male,28,25-34,5
32,1,2,0,3,2021-12-10,Female,52,45-54,4
32,2,0,0,2,2021-12-08,Female,67,65-69,23
32,1,7,12,20,2021-12-17,Male,63,55-64,1
32,1,0,0,1,2021-12-13,Female,53,45-54,3
32,3,0,0,3,2021-12-15,Female,18,15-19,6
32,0,0,0,0,2021-12-08,Female,66,65-69,6
32,0,0,0,0,2021-12-09,Female,71,70-74,12
32,2,2,0,4,2021-12-16,Female,28,25-34,2
32,0,0,0,0,2021-12-16,Female,31,25-34,5
32,0,0,0,0,2021-12-09,Female,46,45-54,4
32,0,0,0,0,2021-12-08,Male,58,55-64,9
32,0,0,0,0,2021-12-14,Male,76,75-79,3
32,2,0,0,2,2021-12-17,Female,15,15-19,1
32,2,4,25,31,2021-12-16,Female,19,15-19,3
32,1,0,0,1,2021-12-08,Male,66,65-69,10
32,0,0,0,0,2021-12-13,Male,48,45-54,3
32,1,0,0,1,2021-12-17,Female,62,55-64,1
32,2,36,0,38,2021-12-08,Female,16,15-19,11
32,1,0,0,1,2021-12-09,Female,65,65-69,10
32,2,0,0,2,2021-12-17,Female,27,25-34,1
32,1,0,0,1,2021-12-08,Female,56,55-64,5
32,1,0,0,1,2021-12-14,Female,49,45-54,4
32,2,2,0,4,2021-12-09,Male,52,45-54,5
32,1,0,0,1,2021-12-14,Female,66,65-69,11
32,2,0,0,2,2021-12-14,Male,54,45-54,9
32,1,0,0,1,2021-12-13,Female,69,65-69,7
32,1,0,0,1,2021-12-13,Male,56,55-64,12
32,1,1,0,2,2021-12-14,Female,72,70-74,7
32,0,0,0,0,2021-12-13,Male,72,70-74,5
32,0,3,0,3,2021-12-12,Female,42,35-44,7
32,1,0,0,1,2021-12-08,Male,69,65-69,6
32,1,0,0,1,2021-12-08,Male,69,65-69,5
32,0,0,0,0,2021-12-09,Male,66,65-69,2
32,1,0,0,1,2021-12-13,Female,39,35-44,4
32,1,10,0,11,2021-12-10,Male,61,55-64,4
32,0,0,0,0,2021-12-08,Male,57,55-64,4
32,1,0,0,1,2021-12-08,Female,15,15-19,2
32,0,0,0,0,2021-12-08,Male,61,55-64,11
32,0,0,0,0,2021-12-10,Female,33,25-34,10
32,0,0,0,0,2021-12-08,Male,69,65-69,7
32,0,0,0,0,2021-12-13,Male,18,15-19,9
32,0,0,0,0,2021-12-08,Female,66,65-69,9
32,1,0,0,1,2021-12-10,Female,50,45-54,26
32,0,1,0,1,2021-12-13,Female,64,55-64,7
32,0,0,0,0,2021-12-09,Male,47,45-54,9
32,1,0,0,1,2021-12-08,Male,22,20-24,11
32,0,0,0,0,2021-12-13,Female,50,45-54,4
32,1,4,0,5,2021-12-16,Female,25,25-34,2
32,2,0,4,6,2021-12-11,Male,67,65-69,12
32,1,0,0,1,2021-12-13,Female,67,65-69,5
32,0,0,0,0,2021-12-17,Male,31,25-34,1
32,0,3,0,3,2021-12-17,Female,58,55-64,1
32,0,1,0,1,2021-12-09,Male,64,55-64,11
32,0,3,0,3,2021-12-08,Female,67,65-69,7
32,2,0,0,2,2021-12-08,Male,52,45-54,12
32,1,0,0,1,2021-12-13,Male,80,80-84,2
32,0,2,0,2,2021-12-17,Female,70,70-74,1
32,0,2,0,2,2021-12-10,Female,81,80-84,14
32,4,2,0,6,2021-12-16,Male,8,5-9,9
32,0,2,0,2,2021-12-17,Female,46,45-54,1
32,0,0,0,0,2021-12-10,Female,65,65-69,6
32,1,0,0,1,2021-12-14,Male,77,75-79,6
32,0,0,0,0,2021-12-09,Female,61,55-64,5
32,1,0,8,9,2021-12-08,Female,18,15-19,3
32,0,1,0,1,2021-12-09,Female,41,35-44,6
32,1,0,0,1,2021-12-08,Female,68,65-69,10
32,1,3,0,4,2021-12-10,Male,71,70-74,5
32,3,0,0,3,2021-12-11,Female,11,10-14,7
32,0,0,0,0,2021-12-09,Male,65,65-69,11
32,0,0,0,0,2021-12-13,Female,30,25-34,11
32,0,0,0,0,2021-12-09,Male,31,25-34,22
32,2,0,0,2,2021-12-17,Female,15,15-19,1
32,2,0,0,2,2021-12-17,Male,34,25-34,1
32,0,0,0,0,2021-12-13,Male,70,70-74,8
32,0,0,0,0,2021-12-17,Male,73,70-74,1
32,0,3,0,3,2021-12-09,Male,64,55-64,5
32,1,4,0,5,2021-12-17,Male,63,55-64,1
32,3,1,0,4,2021-12-10,Female,11,10-14,5
32,1,0,0,1,2021-12-13,Female,72,70-74,5
32,1,1,0,2,2021-12-17,Male,70,70-74,1
32,0,1,0,1,2021-12-10,Male,65,65-69,26
32,0,0,0,0,2021-12-09,Male,51,45-54,10
32,1,1,0,2,2021-12-09,Male,64,55-64,4
32,1,4,0,5,2021-12-10,Male,83,80-84,4
32,1,1,0,2,2021-12-09,Male,36,35-44,9
32,1,4,0,5,2021-12-08,Male,68,65-69,9
32,1,0,0,1,2021-12-09,Female,61,55-64,7
32,0,0,0,0,2021-12-08,Female,66,65-69,17
32,1,0,0,1,2021-12-08,Female,66,65-69,5
32,0,0,0,0,2021-12-14,Female,49,45-54,12
32,0,0,0,0,2021-12-16,Male,33,25-34,3
32,1,0,0,1,2021-12-09,Female,72,70-74,12
32,0,0,0,0,2021-12-13,Female,36,35-44,3
32,0,0,0,0,2021-12-09,Male,52,45-54,4
32,1,0,0,1,2021-12-10,Female,52,45-54,6
32,1,0,0,1,2021-12-16,Female,29,25-34,9
32,0,0,0,0,2021-12-09,Male,56,55-64,6
32,3,3,0,6,2021-12-16,Female,50,45-54,3
32,0,1,0,1,2021-12-08,Female,67,65-69,7
32,1,3,0,4,2021-12-09,Female,72,70-74,7
32,0,0,0,0,2021-12-08,Female,53,45-54,4
32,0,12,0,12,2021-12-08,Female,68,65-69,10
32,0,3,0,3,2021-12-08,Male,55,55-64,23
32,0,0,0,0,2021-12-14,Female,53,45-54,3
32,0,3,0,3,2021-12-10,Female,51,45-54,11
32,2,0,0,2,2021-12-10,Male,9,5-9,11
32,1,0,0,1,2021-12-17,Male,32,25-34,1
32,0,0,0,0,2021-12-17,Male,28,25-34,8
32,1,0,0,1,2021-12-09,Female,30,25-34,6
32,1,0,0,1,2021-12-14,Female,71,70-74,12
32,4,0,0,4,2021-12-09,Male,8,5-9,5
32,2,1,0,3,2021-12-16,Female,5,5-9,3
32,1,0,0,1,2021-12-10,Female,42,35-44,12
32,0,2,0,2,2021-12-09,Female,64,55-64,4
32,1,0,0,1,2021-12-14,Male,58,55-64,11
32,0,0,0,0,2021-12-17,Female,38,35-44,1
32,1,0,0,1,2021-12-13,Male,46,45-54,8
32,1,2,0,3,2021-12-09,Male,50,45-54,13
32,0,0,0,0,2021-12-17,Female,59,55-64,1
32,1,0,0,1,2021-12-09,Female,76,75-79,6
32,0,0,0,0,2021-12-13,Male,72,70-74,3
32,1,0,0,1,2021-12-17,Male,62,55-64,1
32,0,0,0,0,2021-12-09,Male,65,65-69,6
32,2,0,0,2,2021-12-13,Male,10,10-14,5
32,1,17,0,18,2021-12-15,Female,34,25-34,2
32,0,6,0,6,2021-12-09,Female,76,75-79,4
32,1,0,0,1,2021-12-09,Female,32,25-34,7
32,1,4,0,5,2021-12-16,Female,24,20-24,2
32,0,0,0,0,2021-12-17,Male,63,55-64,1
32,1,0,0,1,2021-12-17,Female,63,55-64,1
32,3,0,0,3,2021-12-09,Male,18,15-19,4
32,1,3,0,4,2021-12-13,Female,34,25-34,9
32,0,2,0,2,2021-12-11,Female,51,45-54,16
32,1,0,0,1,2021-12-08,Female,68,65-69,8
32,2,0,0,2,2021-12-10,Male,5,5-9,6
32,1,0,0,1,2021-12-14,Male,79,75-79,4
32,0,0,0,0,2021-12-13,Female,61,55-64,7
32,0,0,0,0,2021-12-10,Female,41,35-44,3
32,2,1,0,3,2021-12-10,Male,3,1-4,12
32,0,4,0,4,2021-12-11,Female,53,45-54,10
32,3,0,0,3,2021-12-08,Male,24,20-24,4
32,0,1,0,1,2021-12-16,Female,31,25-34,7
32,3,0,0,3,2021-12-09,Female,6,5-9,12
32,0,0,0,0,2021-12-08,Female,68,65-69,23
32,0,0,0,0,2021-12-08,Female,70,70-74,25
32,0,0,0,0,2021-12-17,Male,52,45-54,1
32,0,2,0,2,2021-12-11,Female,80,80-84,17
32,2,0,0,2,2021-12-08,Female,68,65-69,4
32,0,0,0,0,2021-12-08,Female,19,15-19,3
32,0,3,0,3,2021-12-10,Male,85,85+,22
32,1,0,0,1,2021-12-08,Male,56,55-64,6
32,1,0,0,1,2021-12-09,Male,67,65-69,6
32,2,3,0,5,2021-12-08,Male,54,45-54,10
32,0,0,0,0,2021-12-08,Male,69,65-69,12
32,2,2,0,4,2021-12-14,Female,36,35-44,2
32,2,1,0,3,2021-12-13,Male,67,65-69,23
32,2,3,0,5,2021-12-08,Male,14,10-14,4
32,0,3,0,3,2021-12-08,Male,64,55-64,6
32,1,0,0,1,2021-12-08,Female,62,55-64,5
32,0,2,0,2,2021-12-08,Male,67,65-69,3
32,1,0,0,1,2021-12-13,Female,70,70-74,6
32,0,0,0,0,2021-12-09,Male,70,70-74,2
32,4,0,0,4,2021-12-09,Female,1,1-4,4
32,1,19,0,20,2021-12-17,Female,25,25-34,1
32,1,0,0,1,2021-12-09,Male,79,75-79,6
32,1,1,0,2,2021-12-08,Male,62,55-64,5
32,0,2,0,2,2021-12-09,Male,51,45-54,9
32,0,1,0,1,2021-12-17,Female,43,35-44,1
32,1,0,0,1,2021-12-09,Male,60,55-64,6
32,0,0,0,0,2021-12-16,Male,30,25-34,2
32,1,3,0,4,2021-12-17,Female,72,70-74,1
32,1,0,0,1,2021-12-08,Male,74,70-74,7
32,0,1,0,1,2021-12-14,Male,60,55-64,3
32,0,0,0,0,2021-12-12,Female,22,20-24,5
32,0,12,0,12,2021-12-09,Female,56,55-64,4
32,2,1,0,3,2021-12-09,Male,68,65-69,11
32,1,0,0,1,2021-12-09,Male,72,70-74,7
32,1,0,0,1,2021-12-09,Male,70,70-74,9
32,0,0,0,0,2021-12-08,Male,69,65-69,6
32,2,0,0,2,2021-12-14,Male,44,35-44,11
32,1,1,0,2,2021-12-13,Male,60,55-64,8
32,0,1,0,1,2021-12-09,Male,52,45-54,8
32,1,0,0,1,2021-12-17,Female,43,35-44,1
32,3,2,0,5,2021-12-08,Male,52,45-54,7
32,2,0,0,2,2021-12-08,Male,58,55-64,5
32,2,0,0,2,2021-12-10,Male,34,25-34,8
32,0,1,0,1,2021-12-09,Male,50,45-54,5
32,2,0,0,2,2021-12-08,Female,23,20-24,18
32,1,7,7,15,2021-12-10,Male,71,70-74,3
32,0,1,0,1,2021-12-15,Female,54,45-54,5
32,1,0,0,1,2021-12-09,Female,77,75-79,10
32,0,1,0,1,2021-12-13,Male,66,65-69,4
32,1,1,0,2,2021-12-08,Male,54,45-54,11
32,0,0,0,0,2021-12-08,Male,56,55-64,6
32,0,0,0,0,2021-12-10,Female,50,45-54,4
32,0,6,0,6,2021-12-08,Female,61,55-64,5
32,1,0,0,1,2021-12-08,Female,67,65-69,6
32,3,2,0,5,2021-12-17,Male,0,<1,1
32,3,4,0,7,2021-12-13,Female,10,10-14,4
32,1,0,0,1,2021-12-09,Male,71,70-74,17
32,0,0,0,0,2021-12-08,Female,59,55-64,11
32,1,1,0,2,2021-12-13,Female,58,55-64,19
32,0,2,0,2,2021-12-09,Female,65,65-69,10
32,2,0,0,2,2021-12-13,Male,1,1-4,6
32,0,1,0,1,2021-12-13,Female,42,35-44,6
32,1,0,0,1,2021-12-10,Female,47,45-54,8
32,2,0,0,2,2021-12-09,Male,3,1-4,10
32,0,0,0,0,2021-12-09,Female,65,65-69,6
32,0,4,0,4,2021-12-08,Female,68,65-69,8
32,0,5,0,5,2021-12-15,Female,34,25-34,6
32,0,0,0,0,2021-12-16,Male,22,20-24,2
32,1,0,0,1,2021-12-13,Male,72,70-74,4
32,1,1,0,2,2021-12-17,Female,54,45-54,15
32,0,0,0,0,2021-12-17,Male,54,45-54,1
32,1,0,3,4,2021-12-09,Male,50,45-54,6
32,1,5,0,6,2021-12-10,Male,47,45-54,4
32,1,0,0,1,2021-12-13,Female,38,35-44,9
32,3,1,0,4,2021-12-17,Male,26,25-34,1
32,0,0,5,5,2021-12-14,Male,45,45-54,5
32,1,0,0,1,2021-12-08,Male,58,55-64,7
32,1,0,0,1,2021-12-08,Female,53,45-54,4
32,3,0,0,3,2021-12-08,Female,18,15-19,6
32,1,0,0,1,2021-12-09,Male,51,45-54,6
32,1,3,0,4,2021-12-08,Male,54,45-54,3
32,1,0,0,1,2021-12-09,Male,11,10-14,7
32,0,0,0,0,2021-12-08,Male,61,55-64,8
32,1,1,0,2,2021-12-08,Male,62,55-64,5
32,0,0,0,0,2021-12-14,Male,69,65-69,5
32,0,3,0,3,2021-12-10,Female,42,35-44,7
32,1,0,0,1,2021-12-09,Female,30,25-34,7
32,1,0,0,1,2021-12-17,Female,26,25-34,1
32,1,0,0,1,2021-12-15,Female,31,25-34,5
32,1,5,0,6,2021-12-08,Male,54,45-54,7
32,0,0,0,0,2021-12-13,Male,64,55-64,6
32,1,0,0,1,2021-12-08,Female,59,55-64,8
32,1,0,0,1,2021-12-09,Female,70,70-74,6
32,1,3,0,4,2021-12-14,Male,58,55-64,5
32,1,0,0,1,2021-12-08,Male,67,65-69,9
32,4,2,5,11,2021-12-14,Male,12,10-14,5
32,2,0,0,2,2021-12-14,Male,10,10-14,7
32,1,1,0,2,2021-12-14,Female,47,45-54,4
32,2,3,0,5,2021-12-09,Female,6,5-9,6
32,1,0,0,1,2021-12-10,Male,47,45-54,7
32,1,0,0,1,2021-12-08,Female,66,65-69,11
32,0,4,0,4,2021-12-09,Female,40,35-44,8
32,0,0,0,0,2021-12-14,Male,31,25-34,7
32,1,1,0,2,2021-12-13,Female,44,35-44,4
32,2,0,0,2,2021-12-13,Female,9,5-9,27
32,0,3,0,3,2021-12-13,Male,68,65-69,3
32,0,31,0,31,2021-12-09,Female,65,65-69,4
32,0,0,0,0,2021-12-17,Female,37,35-44,2
32,1,0,0,1,2021-12-13,Male,66,65-69,10
32,2,0,0,2,2021-12-09,Male,64,55-64,20
32,0,0,0,0,2021-12-10,Female,40,35-44,11
32,1,0,0,1,2021-12-10,Male,49,45-54,11
32,1,3,0,4,2021-12-17,Male,70,70-74,1
32,0,0,0,0,2021-12-17,Male,46,45-54,1
32,1,5,1,7,2021-12-08,Female,62,55-64,2
32,0,0,0,0,2021-12-12,Male,46,45-54,7
32,0,0,0,0,2021-12-13,Male,27,25-34,6
32,0,0,0,0,2021-12-11,Male,52,45-54,2
32,1,0,0,1,2021-12-13,Male,66,65-69,8
32,2,0,0,2,2021-12-14,Male,4,1-4,4
32,1,0,0,1,2021-12-10,Female,48,45-54,9
32,1,3,0,4,2021-12-17,Female,33,25-34,1
32,2,0,0,2,2021-12-13,Female,9,5-9,6
32,0,1,0,1,2021-12-13,Male,39,35-44,4
32,1,0,0,1,2021-12-13,Female,75,75-79,4
32,1,0,0,1,2021-12-13,Male,69,65-69,7
32,1,0,0,1,2021-12-13,Male,75,75-79,12
32,3,0,0,3,2021-12-13,Male,13,10-14,3
32,1,4,0,5,2021-12-17,Female,28,25-34,1
32,1,30,0,31,2021-12-14,Male,50,45-54,7
32,0,40,0,40,2021-12-09,Male,48,45-54,5
32,1,12,0,13,2021-12-09,Male,71,70-74,4
32,1,0,0,1,2021-12-09,Male,66,65-69,4
32,2,21,0,23,2021-12-10,Male,13,10-14,4
32,0,0,0,0,2021-12-09,Male,74,70-74,6
32,1,2,0,3,2021-12-08,Female,68,65-69,8
32,3,0,0,3,2021-12-12,Male,16,15-19,5
32,1,6,0,7,2021-12-09,Male,72,70-74,11
32,1,0,0,1,2021-12-08,Female,0,<1,1
32,2,0,0,2,2021-12-16,Male,5,5-9,5
32,0,0,0,0,2021-12-09,Male,44,35-44,12
32,3,3,0,6,2021-12-16,Male,53,45-54,6
32,0,10,0,10,2021-12-08,Female,45,45-54,10
32,0,2,0,2,2021-12-10,Male,59,55-64,8
32,0,40,0,40,2021-12-08,Male,59,55-64,10
32,1,0,0,1,2021-12-17,Female,67,65-69,1
32,0,0,0,0,2021-12-09,Male,48,45-54,9
32,0,0,0,0,2021-12-14,Female,53,45-54,2
32,0,0,0,0,2021-12-17,Female,33,25-34,1
32,1,0,0,1,2021-12-09,Male,61,55-64,6
32,0,0,0,0,2021-12-17,Male,54,45-54,1
32,1,0,0,1,2021-12-08,Male,69,65-69,11
32,2,4,0,6,2021-12-08,Male,16,15-19,4
32,3,12,0,15,2021-12-09,Female,4,1-4,11
32,2,0,0,2,2021-12-17,Female,56,55-64,1
32,1,3,0,4,2021-12-14,Female,35,35-44,6
32,1,0,0,1,2021-12-08,Female,56,55-64,10
32,1,0,0,1,2021-12-17,Female,60,55-64,1
32,1,0,0,1,2021-12-13,Female,48,45-54,8
32,3,0,4,7,2021-12-13,Female,19,15-19,6
32,1,2,0,3,2021-12-09,Male,76,75-79,6
32,0,1,0,1,2021-12-17,Male,54,45-54,1
32,1,0,0,1,2021-12-08,Female,63,55-64,6
32,1,4,0,5,2021-12-14,Male,62,55-64,7
32,1,0,0,1,2021-12-17,Male,59,55-64,1
32,3,0,0,3,2021-12-08,Female,15,15-19,9
32,0,1,0,1,2021-12-09,Female,75,75-79,4
32,0,0,0,0,2021-12-10,Female,60,55-64,7
32,0,0,0,0,2021-12-08,Male,66,65-69,10
32,0,1,0,1,2021-12-11,Male,39,35-44,5
32,0,0,0,0,2021-12-13,Female,63,55-64,4
32,0,4,0,4,2021-12-11,Female,60,55-64,26
32,1,2,0,3,2021-12-09,Female,32,25-34,7
32,0,0,0,0,2021-12-08,Female,68,65-69,19
32,2,0,0,2,2021-12-08,Female,25,25-34,6
32,1,0,0,1,2021-12-10,Male,58,55-64,4
32,1,0,0,1,2021-12-13,Male,72,70-74,6
32,2,1,0,3,2021-12-09,Female,24,20-24,5
32,3,0,0,3,2021-12-17,Female,4,1-4,1
32,1,0,0,1,2021-12-08,Female,66,65-69,12
32,2,0,0,2,2021-12-17,Female,49,45-54,1
32,3,0,0,3,2021-12-10,Female,7,5-9,7
32,0,12,15,27,2021-12-17,Male,31,25-34,1
32,0,0,0,0,2021-12-17,Female,71,70-74,1
32,1,2,0,3,2021-12-10,Female,76,75-79,9
32,3,2,0,5,2021-12-16,Male,13,10-14,5
32,2,0,0,2,2021-12-09,Female,53,45-54,6
32,1,0,0,1,2021-12-17,Male,39,35-44,1
32,5,0,0,5,2021-12-15,Female,0,<1,5
32,0,0,0,0,2021-12-08,Male,28,25-34,2
32,1,0,23,24,2021-12-08,Male,56,55-64,5
32,1,0,0,1,2021-12-09,Male,49,45-54,10
32,1,0,0,1,2021-12-15,Male,23,20-24,7
32,0,0,0,0,2021-12-09,Male,61,55-64,6
32,0,0,0,0,2021-12-09,Female,38,35-44,5
32,1,2,0,3,2021-12-08,Female,59,55-64,11
32,3,0,0,3,2021-12-11,Male,23,20-24,5
32,2,5,0,7,2021-12-14,Male,10,10-14,8
32,0,0,0,0,2021-12-10,Female,43,35-44,6
32,1,3,0,4,2021-12-09,Male,50,45-54,3
32,1,1,0,2,2021-12-08,Female,69,65-69,4
32,3,0,0,3,2021-12-09,Female,4,1-4,8
32,0,0,0,0,2021-12-09,Male,75,75-79,6
32,0,0,0,0,2021-12-14,Male,23,20-24,1
32,0,0,0,0,2021-12-14,Male,57,55-64,11
32,0,0,0,0,2021-12-09,Female,46,45-54,6
32,1,3,0,4,2021-12-15,Female,50,45-54,11
32,0,0,0,0,2021-12-08,Female,53,45-54,8
32,0,0,0,0,2021-12-09,Male,65,65-69,7
32,0,0,0,0,2021-12-13,Male,80,80-84,11
32,2,0,0,2,2021-12-13,Male,71,70-74,24
32,0,1,0,1,2021-12-09,Male,78,75-79,4
32,1,0,0,1,2021-12-08,Male,73,70-74,6
32,0,0,0,0,2021-12-17,Female,22,20-24,1
32,1,0,0,1,2021-12-08,Female,73,70-74,7
32,1,0,0,1,2021-12-14,Female,17,15-19,6
32,0,1,0,1,2021-12-16,Male,51,45-54,22
32,0,0,0,0,2021-12-13,Male,76,75-79,5
32,1,1,0,2,2021-12-08,Female,52,45-54,4
32,0,0,0,0,2021-12-10,Male,66,65-69,6
32,0,3,0,3,2021-12-08,Female,26,25-34,3
32,2,2,0,4,2021-12-14,Male,6,5-9,4
32,0,2,0,2,2021-12-09,Male,61,55-64,12
32,0,0,0,0,2021-12-08,Male,58,55-64,3
32,2,0,0,2,2021-12-09,Male,13,10-14,6
32,0,0,0,0,2021-12-14,Female,52,45-54,5
32,0,0,0,0,2021-12-14,Male,60,55-64,10
32,0,1,0,1,2021-12-10,Male,63,55-64,6
32,1,2,0,3,2021-12-17,Male,26,25-34,1
32,1,0,0,1,2021-12-10,Male,39,35-44,3
32,0,0,0,0,2021-12-14,Male,28,25-34,9
32,2,0,0,2,2021-12-08,Female,26,25-34,9
32,1,0,0,1,2021-12-09,Female,72,70-74,5
32,0,1,0,1,2021-12-09,Male,69,65-69,5
32,0,0,0,0,2021-12-08,Male,56,55-64,4
32,1,0,0,1,2021-12-13,Male,45,45-54,7
32,3,1,29,33,2021-12-08,Male,10,10-14,6
32,0,0,0,0,2021-12-12,Male,60,55-64,5
32,0,0,0,0,2021-12-09,Female,70,70-74,18
32,1,0,0,1,2021-12-14,Female,49,45-54,20
32,3,2,0,5,2021-12-17,Male,12,10-14,1
32,0,2,0,2,2021-12-09,Female,51,45-54,6
32,0,0,0,0,2021-12-09,Male,48,45-54,5
32,1,10,30,41,2021-12-08,Female,25,25-34,3
32,0,0,0,0,2021-12-09,Male,60,55-64,5
32,1,10,0,11,2021-12-09,Female,59,55-64,7
32,1,0,0,1,2021-12-14,Female,8,5-9,11
32,1,0,0,1,2021-12-13,Female,37,35-44,10
32,1,0,0,1,2021-12-08,Male,74,70-74,10
32,1,0,0,1,2021-12-13,Male,61,55-64,5
32,0,0,0,0,2021-12-13,Male,70,70-74,6
32,0,0,0,0,2021-12-08,Female,23,20-24,7
32,2,0,0,2,2021-12-09,Male,4,1-4,5
32,1,1,9,11,2021-12-14,Male,17,15-19,3
32,1,0,0,1,2021-12-08,Female,62,55-64,7
32,1,0,0,1,2021-12-08,Female,54,45-54,6
32,0,0,0,0,2021-12-09,Female,42,35-44,5
32,1,1,0,2,2021-12-13,Male,59,55-64,4
32,2,0,0,2,2021-12-08,Female,17,15-19,5
32,0,0,0,0,2021-12-14,Female,34,25-34,4
32,0,0,0,0,2021-12-13,Female,68,65-69,6
32,2,1,0,3,2021-12-08,Female,19,15-19,6
32,1,3,0,4,2021-12-13,Female,64,55-64,5
32,1,0,0,1,2021-12-09,Male,71,70-74,6
32,2,1,0,3,2021-12-13,Female,71,70-74,23
32,2,0,0,2,2021-12-08,Male,5,5-9,7
32,0,0,0,0,2021-12-13,Female,39,35-44,5
32,0,3,0,3,2021-12-10,Male,81,80-84,4
32,1,0,1,2,2021-12-10,Female,71,70-74,8
32,3,0,0,3,2021-12-09,Female,14,10-14,14
32,1,0,1,2,2021-12-09,Male,71,70-74,3
32,1,1,0,2,2021-12-09,Male,71,70-74,6
32,1,0,0,1,2021-12-10,Male,61,55-64,5
32,1,0,0,1,2021-12-14,Female,50,45-54,5
32,2,2,0,4,2021-12-08,Female,28,25-34,12
32,3,0,0,3,2021-12-17,Male,4,1-4,1
32,0,0,0,0,2021-12-17,Female,73,70-74,1
32,0,1,0,1,2021-12-09,Male,59,55-64,10
32,0,0,0,0,2021-12-08,Male,29,25-34,11
32,1,0,0,1,2021-12-09,Female,60,55-64,15
32,0,0,0,0,2021-12-08,Female,54,45-54,6
32,1,0,0,1,2021-12-09,Male,39,35-44,11
32,0,1,0,1,2021-12-09,Male,41,35-44,5
32,1,0,0,1,2021-12-17,Female,33,25-34,1
32,0,2,0,2,2021-12-09,Male,50,45-54,7
32,2,2,35,39,2021-12-09,Male,16,15-19,3
32,0,0,0,0,2021-12-14,Female,18,15-19,5
32,0,0,0,0,2021-12-08,Male,54,45-54,3
32,1,2,0,3,2021-12-08,Female,54,45-54,4
32,1,1,0,2,2021-12-09,Female,31,25-34,14
32,0,1,0,1,2021-12-10,Female,63,55-64,5
32,1,0,0,1,2021-12-09,Female,60,55-64,6
32,0,0,0,0,2021-12-08,Female,62,55-64,8
32,0,10,0,10,2021-12-16,Female,47,45-54,13
32,1,0,0,1,2021-12-08,Male,40,35-44,6
32,3,15,0,18,2021-12-09,Female,0,<1,6
32,0,0,0,0,2021-12-17,Female,13,10-14,1
32,1,0,0,1,2021-12-17,Female,47,45-54,1
32,1,5,0,6,2021-12-08,Male,68,65-69,5
32,0,0,0,0,2021-12-10,Female,72,70-74,5
32,1,0,0,1,2021-12-14,Female,55,55-64,11
32,0,0,0,0,2021-12-08,Male,58,55-64,5
32,1,0,0,1,2021-12-13,Female,73,70-74,12
32,1,3,0,4,2021-12-08,Male,62,55-64,5
32,0,3,0,3,2021-12-10,Female,25,25-34,11
32,1,6,0,7,2021-12-08,Male,70,70-74,6
32,1,4,0,5,2021-12-11,Female,32,25-34,5
32,2,0,0,2,2021-12-09,Male,35,35-44,12
32,0,1,0,1,2021-12-08,Female,23,20-24,3
32,0,0,0,0,2021-12-17,Female,34,25-34,1
32,0,1,0,1,2021-12-09,Female,65,65-69,11
32,0,0,0,0,2021-12-08,Male,45,45-54,11
32,1,0,0,1,2021-12-13,Female,38,35-44,4
32,1,4,0,5,2021-12-13,Male,30,25-34,2
32,0,0,0,0,2021-12-10,Female,70,70-74,10
32,1,4,0,5,2021-12-17,Female,51,45-54,1
32,0,0,0,0,2021-12-13,Male,58,55-64,5
32,2,2,0,4,2021-12-08,Female,45,45-54,4
32,0,0,0,0,2021-12-08,Male,2,1-4,4
32,0,0,0,0,2021-12-12,Female,34,25-34,3
32,0,0,0,0,2021-12-09,Female,65,65-69,5
32,0,0,0,0,2021-12-09,Female,41,35-44,6
32,0,0,0,0,2021-12-13,Female,57,55-64,11
32,3,0,0,3,2021-12-10,Male,10,10-14,12
32,1,0,0,1,2021-12-09,Female,67,65-69,5
32,2,5,0,7,2021-12-11,Female,10,10-14,6
32,2,2,0,4,2021-12-12,Male,45,45-54,12
32,1,2,0,3,2021-12-09,Female,72,70-74,4
32,1,0,0,1,2021-12-17,Male,62,55-64,1
32,2,3,0,5,2021-12-08,Male,74,70-74,6
32,0,0,0,0,2021-12-08,Male,68,65-69,9
32,2,0,0,2,2021-12-12,Female,21,20-24,7
32,1,0,0,1,2021-12-08,Female,39,35-44,11
32,0,0,0,0,2021-12-09,Male,51,45-54,8
32,0,3,0,3,2021-12-08,Female,74,70-74,5
32,1,2,0,3,2021-12-17,Female,31,25-34,1
32,0,0,0,0,2021-12-08,Male,16,15-19,11
32,2,1,0,3,2021-12-10,Male,18,15-19,6
32,2,0,0,2,2021-12-09,Male,72,70-74,21
32,0,0,0,0,2021-12-13,Female,55,55-64,4
32,0,3,0,3,2021-12-09,Female,70,70-74,6
32,0,0,0,0,2021-12-09,Female,61,55-64,6
32,2,5,0,7,2021-12-09,Male,18,15-19,11
32,3,0,0,3,2021-12-08,Male,1,1-4,8
32,0,3,0,3,2021-12-11,Female,44,35-44,6
32,0,0,0,0,2021-12-08,Male,54,45-54,28
32,0,0,0,0,2021-12-08,Female,58,55-64,6
32,3,0,0,3,2021-12-13,Female,2,1-4,5
32,0,0,0,0,2021-12-13,Female,34,25-34,7
32,1,0,0,1,2021-12-13,Male,62,55-64,4
32,1,2,0,3,2021-12-13,Female,22,20-24,4
32,1,2,0,3,2021-12-14,Male,68,65-69,4
32,1,1,0,2,2021-12-13,Male,12,10-14,7
32,4,0,0,4,2021-12-13,Female,33,25-34,20
32,3,0,0,3,2021-12-16,Male,22,20-24,13
32,2,1,0,3,2021-12-17,Male,3,1-4,1
32,0,1,0,1,2021-12-09,Female,69,65-69,24
32,1,1,0,2,2021-12-14,Male,75,75-79,3
32,1,1,0,2,2021-12-08,Female,73,70-74,9
32,0,2,0,2,2021-12-08,Female,63,55-64,6
32,1,2,0,3,2021-12-09,Male,68,65-69,9
32,0,6,0,6,2021-12-09,Male,62,55-64,7
32,0,4,0,4,2021-12-11,Male,75,75-79,5
32,1,0,0,1,2021-12-10,Male,71,70-74,5
32,1,0,0,1,2021-12-08,Male,58,55-64,7
32,0,0,3,3,2021-12-14,Male,35,35-44,6
32,2,0,0,2,2021-12-13,Female,17,15-19,10
32,1,3,0,4,2021-12-09,Female,68,65-69,23
32,1,5,0,6,2021-12-13,Male,69,65-69,6
32,0,0,0,0,2021-12-12,Female,41,35-44,9
32,0,0,0,0,2021-12-17,Male,28,25-34,1
32,1,1,0,2,2021-12-10,Male,72,70-74,4
32,1,0,4,5,2021-12-09,Male,64,55-64,10
32,1,0,0,1,2021-12-09,Male,82,80-84,6
32,0,1,0,1,2021-12-10,Male,60,55-64,4
32,0,1,0,1,2021-12-13,Male,66,65-69,4
32,1,0,0,1,2021-12-08,Female,54,45-54,5
32,0,0,0,0,2021-12-13,Male,52,45-54,2
32,1,0,0,1,2021-12-09,Female,67,65-69,9
32,1,1,0,2,2021-12-08,Male,61,55-64,7
32,0,0,0,0,2021-12-09,Female,61,55-64,5
32,0,0,0,0,2021-12-09,Male,51,45-54,10
32,3,0,0,3,2021-12-16,Female,9,5-9,5
32,3,0,0,3,2021-12-13,Male,2,1-4,2
32,3,0,0,3,2021-12-13,Male,9,5-9,9
32,3,0,0,3,2021-12-13,Female,9,5-9,12
32,1,0,0,1,2021-12-09,Male,36,35-44,6
32,0,2,0,2,2021-12-12,Female,34,25-34,7
32,0,1,0,1,2021-12-09,Male,78,75-79,4
32,0,0,0,0,2021-12-10,Female,57,55-64,8
32,1,0,0,1,2021-12-14,Male,69,65-69,6
32,2,2,0,4,2021-12-15,Female,19,15-19,6
32,1,0,0,1,2021-12-08,Male,0,<1,4
32,0,0,0,0,2021-12-15,Female,51,45-54,4
32,3,0,0,3,2021-12-09,Female,0,<1,6
32,1,0,0,1,2021-12-17,Female,29,25-34,1
32,1,0,0,1,2021-12-09,Female,51,45-54,20
32,1,1,0,2,2021-12-09,Male,61,55-64,8
32,1,0,0,1,2021-12-17,Female,74,70-74,1
32,2,0,0,2,2021-12-14,Male,26,25-34,9
32,0,0,0,0,2021-12-09,Male,41,35-44,6
32,2,0,0,2,2021-12-17,Male,10,10-14,1
32,1,0,0,1,2021-12-09,Male,66,65-69,5
32,2,1,0,3,2021-12-08,Female,55,55-64,5
32,3,6,20,29,2021-12-09,Male,65,65-69,4
32,0,0,0,0,2021-12-13,Male,71,70-74,11
32,0,0,0,0,2021-12-08,Female,66,65-69,8
32,2,1,0,3,2021-12-13,Female,28,25-34,4
32,0,0,0,0,2021-12-17,Female,53,45-54,1
32,0,0,0,0,2021-12-16,Male,37,35-44,3
32,1,0,0,1,2021-12-08,Female,62,55-64,6
32,0,1,0,1,2021-12-09,Female,32,25-34,27
32,0,0,0,0,2021-12-17,Male,32,25-34,1
32,1,0,0,1,2021-12-14,Male,76,75-79,5
32,2,0,0,2,2021-12-09,Male,66,65-69,3
32,1,0,0,1,2021-12-09,Male,8,5-9,6
32,1,0,0,1,2021-12-08,Female,69,65-69,12
32,1,0,0,1,2021-12-11,Male,60,55-64,8
32,1,11,0,12,2021-12-12,Female,36,35-44,5
32,2,16,0,18,2021-12-16,Female,5,5-9,3
32,5,0,0,5,2021-12-13,Male,0,<1,3
32,1,0,0,1,2021-12-09,Female,23,20-24,3
32,2,0,0,2,2021-12-17,Female,31,25-34,1
32,0,0,0,0,2021-12-14,Female,70,70-74,23
32,1,0,0,1,2021-12-10,Male,71,70-74,6
32,0,1,0,1,2021-12-17,Male,74,70-74,1
32,1,2,0,3,2021-12-08,Female,62,55-64,11
32,1,0,1,2,2021-12-13,Male,73,70-74,3
32,0,0,0,0,2021-12-13,Male,47,45-54,5
32,0,0,0,0,2021-12-08,Female,74,70-74,11
32,1,1,0,2,2021-12-14,Male,85,85+,5
32,0,1,0,1,2021-12-09,Female,48,45-54,11
32,1,0,0,1,2021-12-09,Female,60,55-64,6
32,0,0,0,0,2021-12-09,Male,52,45-54,7
32,2,0,0,2,2021-12-17,Female,56,55-64,1
32,0,1,0,1,2021-12-10,Male,57,55-64,3
32,0,11,0,11,2021-12-09,Female,63,55-64,4
32,0,0,0,0,2021-12-08,Female,7,5-9,5
32,3,0,0,3,2021-12-14,Female,16,15-19,19
32,1,1,0,2,2021-12-13,Male,81,80-84,5
32,1,0,0,1,2021-12-08,Male,66,65-69,9
32,1,0,0,1,2021-12-13,Female,63,55-64,5
32,1,0,0,1,2021-12-10,Female,47,45-54,5
32,1,10,0,11,2021-12-09,Male,74,70-74,19
32,0,0,0,0,2021-12-09,Male,59,55-64,6
32,0,3,0,3,2021-12-13,Female,36,35-44,4
32,3,0,0,3,2021-12-08,Male,3,1-4,6
32,0,0,0,0,2021-12-08,Female,39,35-44,7
32,1,2,0,3,2021-12-17,Female,57,55-64,1
32,1,0,0,1,2021-12-17,Male,66,65-69,1
32,5,0,0,5,2021-12-08,Male,18,15-19,21
32,0,0,0,0,2021-12-11,Male,70,70-74,8
32,3,0,0,3,2021-12-09,Male,4,1-4,8
32,1,1,0,2,2021-12-09,Female,46,45-54,6
32,1,0,0,1,2021-12-08,Female,55,55-64,7
32,1,0,0,1,2021-12-09,Male,56,55-64,7
32,1,3,0,4,2021-12-14,Male,60,55-64,4
32,1,1,0,2,2021-12-08,Female,54,45-54,6
32,0,0,0,0,2021-12-13,Female,34,25-34,3
32,1,0,0,1,2021-12-17,Female,45,45-54,1
32,0,0,0,0,2021-12-13,Female,78,75-79,6
32,1,0,0,1,2021-12-10,Female,64,55-64,5
32,0,0,0,0,2021-12-16,Female,32,25-34,7
32,1,0,0,1,2021-12-08,Male,53,45-54,12
32,0,5,0,5,2021-12-08,Male,73,70-74,7
32,3,0,0,3,2021-12-13,Male,14,10-14,20
32,1,0,0,1,2021-12-13,Male,60,55-64,5
32,1,15,42,58,2021-12-09,Female,11,10-14,5
32,1,3,0,4,2021-12-14,Male,56,55-64,10
32,1,2,0,3,2021-12-12,Female,55,55-64,2
32,0,0,0,0,2021-12-17,Female,63,55-64,1
32,1,40,0,41,2021-12-15,Female,50,45-54,8
32,3,0,0,3,2021-12-08,Female,73,70-74,4
32,0,0,0,0,2021-12-13,Female,40,35-44,8
32,0,0,0,0,2021-12-13,Male,49,45-54,8
32,0,1,0,1,2021-12-09,Female,66,65-69,10
32,1,0,0,1,2021-12-15,Male,42,35-44,4
32,2,0,0,2,2021-12-09,Female,63,55-64,3
32,1,5,0,6,2021-12-17,Male,50,45-54,1
32,1,0,0,1,2021-12-14,Female,33,25-34,3
32,0,0,0,0,2021-12-08,Female,52,45-54,5
32,0,0,0,0,2021-12-10,Male,62,55-64,5
32,1,0,0,1,2021-12-08,Female,9,5-9,3
32,2,0,0,2,2021-12-10,Female,10,10-14,6
32,0,0,0,0,2021-12-11,Male,58,55-64,23
32,2,0,0,2,2021-12-08,Female,18,15-19,5
32,1,4,0,5,2021-12-09,Female,62,55-64,10
32,2,0,0,2,2021-12-14,Female,70,70-74,20
32,6,2,0,8,2021-12-16,Male,8,5-9,2
32,1,0,0,1,2021-12-09,Male,61,55-64,6
32,0,1,0,1,2021-12-08,Female,53,45-54,4
32,1,0,0,1,2021-12-09,Female,32,25-34,3
32,0,0,0,0,2021-12-17,Female,31,25-34,5
32,0,1,0,1,2021-12-09,Male,60,55-64,5
32,2,3,0,5,2021-12-10,Female,47,45-54,13
32,1,0,0,1,2021-12-08,Female,37,35-44,22
32,2,0,0,2,2021-12-17,Female,2,1-4,1
32,1,0,0,1,2021-12-08,Female,57,55-64,10
32,0,0,0,0,2021-12-17,Male,67,65-69,1
32,1,0,0,1,2021-12-08,Male,53,45-54,8
32,3,0,0,3,2021-12-09,Female,40,35-44,5
32,1,0,2,3,2021-12-14,Male,51,45-54,5
32,0,0,0,0,2021-12-10,Female,66,65-69,6
32,0,0,0,0,2021-12-16,Male,45,45-54,7
32,1,0,0,1,2021-12-09,Male,70,70-74,5
32,0,0,0,0,2021-12-09,Male,64,55-64,4
32,1,0,0,1,2021-12-09,Female,31,25-34,5
32,1,0,0,1,2021-12-09,Male,65,65-69,6
32,0,0,0,0,2021-12-09,Male,61,55-64,3
32,1,0,0,1,2021-12-14,Female,45,45-54,5
32,1,0,0,1,2021-12-08,Male,55,55-64,12
32,1,0,0,1,2021-12-08,Male,69,65-69,5
32,1,0,0,1,2021-12-09,Female,77,75-79,6
32,0,0,0,0,2021-12-08,Female,58,55-64,4
32,0,0,0,0,2021-12-13,Female,49,45-54,4
32,1,0,8,9,2021-12-17,Male,44,35-44,1
32,2,0,0,2,2021-12-09,Female,14,10-14,12
32,2,0,0,2,2021-12-09,Female,60,55-64,6
32,0,0,0,0,2021-12-13,Male,66,65-69,11
32,0,1,0,1,2021-12-08,Male,69,65-69,6
32,0,3,0,3,2021-12-13,Female,48,45-54,4
32,0,4,0,4,2021-12-09,Male,67,65-69,10
32,1,0,0,1,2021-12-09,Male,77,75-79,9
32,1,0,0,1,2021-12-17,Female,54,45-54,1
32,1,0,2,3,2021-12-08,Female,54,45-54,8
32,1,0,0,1,2021-12-17,Female,78,75-79,1
32,0,0,0,0,2021-12-13,Male,67,65-69,5
32,1,0,8,9,2021-12-14,Male,75,75-79,5
32,0,0,0,0,2021-12-13,Male,62,55-64,5
32,1,0,0,1,2021-12-09,Male,60,55-64,11
32,2,3,0,5,2021-12-09,Female,49,45-54,10
32,0,0,0,0,2021-12-15,Male,33,25-34,3
32,0,2,0,2,2021-12-08,Female,63,55-64,7
32,0,0,0,0,2021-12-08,Male,38,35-44,5
32,0,0,0,0,2021-12-08,Male,28,25-34,7
32,0,2,0,2,2021-12-11,Female,43,35-44,6
32,1,32,0,33,2021-12-09,Female,17,15-19,4
32,1,0,0,1,2021-12-09,Female,69,65-69,5
32,3,0,0,3,2021-12-14,Male,21,20-24,22
32,2,0,0,2,2021-12-17,Female,53,45-54,5
32,2,0,0,2,2021-12-09,Female,13,10-14,4
32,0,0,0,0,2021-12-13,Male,45,45-54,8
32,0,1,0,1,2021-12-14,Female,33,25-34,3
32,1,0,0,1,2021-12-17,Female,44,35-44,1
32,2,0,0,2,2021-12-10,Male,58,55-64,5
32,0,0,0,0,2021-12-08,Female,53,45-54,6
32,0,0,0,0,2021-12-08,Female,55,55-64,12
32,1,0,0,1,2021-12-10,Female,71,70-74,9
32,1,0,0,1,2021-12-08,Male,73,70-74,6
32,0,0,0,0,2021-12-08,Male,70,70-74,5
32,3,2,0,5,2021-12-08,Male,58,55-64,11
32,0,11,0,11,2021-12-13,Female,52,45-54,8
32,2,0,0,2,2021-12-09,Male,52,45-54,11
32,1,0,0,1,2021-12-08,Female,53,45-54,6
32,1,0,0,1,2021-12-08,Male,68,65-69,8
32,0,2,0,2,2021-12-14,Male,44,35-44,7
32,1,0,37,38,2021-12-10,Male,19,15-19,11
32,1,0,0,1,2021-12-10,Male,36,35-44,6
32,1,0,3,4,2021-12-17,Female,64,55-64,1
32,2,0,0,2,2021-12-09,Male,68,65-69,22
32,0,0,0,0,2021-12-13,Female,56,55-64,9
32,2,0,0,2,2021-12-17,Female,0,<1,1
32,0,0,0,0,2021-12-14,Male,50,45-54,6
32,0,12,0,12,2021-12-11,Female,74,70-74,5
32,1,0,0,1,2021-12-14,Male,45,45-54,11
32,1,0,0,1,2021-12-09,Female,27,25-34,11
32,1,0,0,1,2021-12-08,Male,68,65-69,8
32,1,1,0,2,2021-12-08,Male,74,70-74,6
32,2,0,0,2,2021-12-13,Female,61,55-64,4
32,0,0,0,0,2021-12-08,Male,46,45-54,5
32,2,0,0,2,2021-12-12,Male,6,5-9,3
32,1,1,0,2,2021-12-14,Female,62,55-64,4
32,0,4,0,4,2021-12-09,Male,41,35-44,6
32,0,0,0,0,2021-12-09,Female,65,65-69,11
32,0,2,0,2,2021-12-14,Female,67,65-69,8
32,1,1,0,2,2021-12-13,Male,53,45-54,7
32,3,0,0,3,2021-12-13,Male,2,1-4,4
32,0,2,0,2,2021-12-17,Female,25,25-34,1
32,0,0,0,0,2021-12-14,Male,48,45-54,5
32,0,0,0,0,2021-12-17,Female,50,45-54,1
32,1,0,0,1,2021-12-08,Male,53,45-54,12
32,0,0,0,0,2021-12-13,Female,47,45-54,11
32,3,1,0,4,2021-12-17,Male,8,5-9,1
32,2,2,0,4,2021-12-09,Male,67,65-69,4
32,1,1,0,2,2021-12-08,Female,74,70-74,10
32,0,2,0,2,2021-12-09,Male,72,70-74,5
32,1,0,0,1,2021-12-10,Female,76,75-79,11
32,0,1,0,1,2021-12-08,Female,59,55-64,6
32,1,0,0,1,2021-12-08,Female,52,45-54,4
32,1,0,0,1,2021-12-10,Female,34,25-34,7
32,2,0,0,2,2021-12-14,Female,60,55-64,4
32,2,0,0,2,2021-12-12,Female,36,35-44,16
32,1,2,0,3,2021-12-16,Female,51,45-54,6
32,1,4,0,5,2021-12-10,Male,72,70-74,4
32,0,0,0,0,2021-12-17,Male,53,45-54,1
32,0,1,0,1,2021-12-09,Female,58,55-64,6
32,1,0,0,1,2021-12-09,Male,61,55-64,7
32,1,3,0,4,2021-12-08,Male,54,45-54,5
32,1,2,0,3,2021-12-17,Male,77,75-79,1
32,2,0,0,2,2021-12-17,Male,16,15-19,1
32,3,8,0,11,2021-12-10,Female,2,1-4,8
32,2,0,0,2,2021-12-14,Female,61,55-64,10
32,1,32,2,35,2021-12-17,Male,61,55-64,1
32,0,4,0,4,2021-12-17,Male,59,55-64,1
32,1,0,0,1,2021-12-17,Female,30,25-34,1
32,1,2,0,3,2021-12-13,Male,72,70-74,5
32,5,0,0,5,2021-12-13,Male,7,5-9,2
32,1,0,0,1,2021-12-13,Female,44,35-44,7
32,0,0,0,0,2021-12-08,Male,57,55-64,5
32,1,2,0,3,2021-12-12,Male,65,65-69,6
32,0,2,0,2,2021-12-08,Male,52,45-54,6
32,1,0,0,1,2021-12-10,Female,71,70-74,22
32,0,0,0,0,2021-12-09,Male,33,25-34,8
32,3,1,0,4,2021-12-08,Male,8,5-9,12
32,0,4,0,4,2021-12-09,Female,59,55-64,8
32,3,0,0,3,2021-12-11,Female,37,35-44,17
32,0,0,0,0,2021-12-16,Female,5,5-9,2
32,1,0,0,1,2021-12-10,Male,42,35-44,5
32,2,0,0,2,2021-12-16,Male,53,45-54,5
32,0,2,0,2,2021-12-08,Female,67,65-69,10
32,0,0,0,0,2021-12-09,Male,59,55-64,4
32,1,0,0,1,2021-12-10,Male,65,65-69,9
32,3,1,0,4,2021-12-08,Male,66,65-69,9
32,1,3,0,4,2021-12-09,Female,10,10-14,5
32,0,1,0,1,2021-12-10,Male,49,45-54,4
32,0,1,0,1,2021-12-13,Female,40,35-44,6
32,2,0,0,2,2021-12-16,Male,54,45-54,2
32,0,4,0,4,2021-12-09,Male,30,25-34,2
32,1,0,0,1,2021-12-15,Male,53,45-54,7
32,0,3,0,3,2021-12-13,Male,65,65-69,4
32,3,2,0,5,2021-12-17,Female,31,25-34,1
32,0,0,0,0,2021-12-13,Female,43,35-44,5
32,1,0,0,1,2021-12-08,Male,67,65-69,8
32,2,0,0,2,2021-12-12,Male,13,10-14,6
32,1,0,0,1,2021-12-10,Male,71,70-74,5
32,1,0,0,1,2021-12-09,Female,60,55-64,26
32,3,0,0,3,2021-12-17,Female,6,5-9,7
32,3,20,0,23,2021-12-14,Male,6,5-9,4
32,1,0,0,1,2021-12-17,Male,69,65-69,1
32,1,3,0,4,2021-12-17,Female,63,55-64,1
32,3,4,0,7,2021-12-09,Female,51,45-54,6
32,0,0,0,0,2021-12-08,Male,21,20-24,12
32,0,2,0,2,2021-12-09,Female,25,25-34,13
32,0,0,0,0,2021-12-08,Male,74,70-74,5
32,0,0,0,0,2021-12-10,Male,56,55-64,4
32,0,0,0,0,2021-12-08,Male,58,55-64,3
32,2,1,0,3,2021-12-17,Female,57,55-64,1
32,0,1,0,1,2021-12-10,Male,49,45-54,6
32,0,0,0,0,2021-12-17,Male,73,70-74,1
32,2,0,0,2,2021-12-08,Female,15,15-19,4
32,0,0,0,0,2021-12-14,Male,70,70-74,6
32,1,9,0,10,2021-12-09,Male,67,65-69,12
32,1,0,0,1,2021-12-08,Female,67,65-69,2
32,0,0,0,0,2021-12-16,Male,35,35-44,10
32,1,2,0,3,2021-12-09,Male,65,65-69,5
32,2,1,0,3,2021-12-14,Female,18,15-19,5
32,0,1,0,1,2021-12-08,Female,30,25-34,6
32,1,1,0,2,2021-12-14,Male,53,45-54,6
32,1,2,0,3,2021-12-09,Female,65,65-69,4
32,0,0,3,3,2021-12-08,Male,23,20-24,4
32,1,8,0,9,2021-12-09,Female,27,25-34,3
32,2,5,0,7,2021-12-17,Female,12,10-14,1
32,3,0,0,3,2021-12-13,Female,40,35-44,5
32,1,0,0,1,2021-12-08,Female,69,65-69,5
32,2,4,0,6,2021-12-14,Male,80,80-84,4
32,0,1,0,1,2021-12-13,Male,63,55-64,6
32,2,0,0,2,2021-12-08,Female,1,1-4,6
32,0,0,0,0,2021-12-09,Female,31,25-34,3
32,3,0,0,3,2021-12-17,Female,15,15-19,1
32,2,2,0,4,2021-12-16,Female,52,45-54,2
32,1,0,0,1,2021-12-08,Male,74,70-74,4
32,1,5,0,6,2021-12-09,Male,65,65-69,11
32,1,0,0,1,2021-12-09,Male,71,70-74,6
32,1,0,0,1,2021-12-09,Male,50,45-54,9
32,3,0,0,3,2021-12-17,Male,1,1-4,1
32,1,0,0,1,2021-12-08,Male,37,35-44,15
32,0,0,0,0,2021-12-17,Female,39,35-44,1
32,0,1,0,1,2021-12-13,Female,30,25-34,10
32,0,0,0,0,2021-12-08,Female,39,35-44,5
32,1,0,0,1,2021-12-10,Male,35,35-44,15
32,0,2,0,2,2021-12-08,Male,58,55-64,6
32,0,0,0,0,2021-12-09,Female,42,35-44,6
32,3,4,0,7,2021-12-17,Male,10,10-14,1
32,0,0,0,0,2021-12-08,Male,38,35-44,11
32,2,0,0,2,2021-12-17,Male,70,70-74,1
32,1,1,8,10,2021-12-08,Male,73,70-74,7
32,0,0,0,0,2021-12-09,Female,47,45-54,6
32,1,1,0,2,2021-12-16,Male,38,35-44,6
32,1,0,0,1,2021-12-13,Male,63,55-64,5
32,0,7,0,7,2021-12-17,Female,23,20-24,1
32,0,1,0,1,2021-12-08,Male,61,55-64,5
32,1,1,0,2,2021-12-09,Male,73,70-74,5
32,3,1,0,4,2021-12-12,Male,6,5-9,6
32,1,0,0,1,2021-12-14,Female,57,55-64,5
32,0,0,0,0,2021-12-08,Male,58,55-64,5
32,1,0,0,1,2021-12-14,Male,3,1-4,5
32,0,0,2,2,2021-12-08,Male,63,55-64,5
32,1,0,0,1,2021-12-13,Female,1,1-4,2
32,3,5,0,8,2021-12-10,Female,14,10-14,10
32,0,0,0,0,2021-12-15,Male,44,35-44,7
32,0,0,0,0,2021-12-08,Male,27,25-34,3
32,0,0,0,0,2021-12-17,Female,52,45-54,1
32,1,4,0,5,2021-12-13,Female,63,55-64,10
32,1,1,0,2,2021-12-09,Male,61,55-64,11
32,0,2,0,2,2021-12-09,Male,51,45-54,5
32,5,0,0,5,2021-12-09,Male,2,1-4,6
32,2,0,1,3,2021-12-14,Female,72,70-74,6
32,0,0,0,0,2021-12-17,Male,33,25-34,1
32,1,0,0,1,2021-12-11,Male,56,55-64,4
32,0,0,0,0,2021-12-17,Female,30,25-34,1
32,1,2,0,3,2021-12-08,Male,69,65-69,5
32,0,0,0,0,2021-12-08,Male,54,45-54,7
32,2,0,0,2,2021-12-13,Female,16,15-19,4
32,0,0,0,0,2021-12-09,Male,59,55-64,16
32,2,1,0,3,2021-12-17,Female,62,55-64,1
32,3,15,0,18,2021-12-17,Male,13,10-14,1
32,0,0,0,0,2021-12-10,Male,31,25-34,3
32,0,0,0,0,2021-12-09,Female,51,45-54,12
32,1,0,0,1,2021-12-08,Male,58,55-64,5
32,0,1,0,1,2021-12-14,Female,63,55-64,7
32,1,6,0,7,2021-12-09,Male,70,70-74,3
32,1,0,0,1,2021-12-13,Female,64,55-64,9
32,1,0,0,1,2021-12-08,Male,67,65-69,4
32,1,0,0,1,2021-12-09,Male,38,35-44,6
32,0,0,0,0,2021-12-09,Male,66,65-69,6
32,2,0,0,2,2021-12-10,Female,53,45-54,23
32,0,0,0,0,2021-12-09,Female,66,65-69,6
32,0,0,0,0,2021-12-08,Male,54,45-54,7
32,2,0,0,2,2021-12-13,Female,59,55-64,17
32,0,0,0,0,2021-12-16,Male,21,20-24,2
32,1,1,2,4,2021-12-09,Male,72,70-74,6
32,2,32,20,54,2021-12-08,Male,68,65-69,5
32,2,0,0,2,2021-12-13,Female,2,1-4,9
32,1,0,0,1,2021-12-16,Male,41,35-44,7
32,1,2,0,3,2021-12-10,Female,63,55-64,11
32,4,0,0,4,2021-12-09,Female,1,1-4,9
32,0,0,0,0,2021-12-16,Female,26,25-34,6
32,0,0,0,0,2021-12-08,Female,58,55-64,4
32,1,0,0,1,2021-12-10,Female,38,35-44,10
32,0,3,0,3,2021-12-08,Male,55,55-64,3
32,0,0,0,0,2021-12-16,Male,22,20-24,2
32,1,0,0,1,2021-12-17,Female,74,70-74,1
32,2,0,0,2,2021-12-16,Female,49,45-54,5
32,3,0,0,3,2021-12-13,Male,14,10-14,5
32,1,0,0,1,2021-12-13,Female,72,70-74,9
32,0,3,0,3,2021-12-10,Female,66,65-69,3
32,0,0,0,0,2021-12-09,Male,66,65-69,11
32,1,0,0,1,2021-12-13,Female,34,25-34,4
32,1,3,0,4,2021-12-08,Female,69,65-69,5
32,1,1,0,2,2021-12-08,Male,70,70-74,6
32,0,1,0,1,2021-12-09,Female,22,20-24,11
32,1,0,0,1,2021-12-17,Female,30,25-34,1
32,2,0,0,2,2021-12-09,Male,16,15-19,3
32,0,2,0,2,2021-12-13,Male,44,35-44,18
32,1,0,6,7,2021-12-13,Male,66,65-69,4
32,0,2,0,2,2021-12-13,Female,65,65-69,7
32,0,0,0,0,2021-12-12,Male,72,70-74,5
32,3,0,0,3,2021-12-12,Female,42,35-44,5
32,1,0,0,1,2021-12-17,Male,56,55-64,1
32,1,0,0,1,2021-12-09,Male,69,65-69,11
32,1,0,0,1,2021-12-11,Female,45,45-54,5
32,0,0,0,0,2021-12-13,Female,77,75-79,10
32,0,1,0,1,2021-12-10,Male,60,55-64,5
32,1,0,0,1,2021-12-08,Male,70,70-74,9
32,5,0,0,5,2021-12-17,Female,6,5-9,1
32,0,0,5,5,2021-12-09,Male,40,35-44,11
32,1,14,14,29,2021-12-17,Male,60,55-64,1
32,1,0,0,1,2021-12-13,Male,73,70-74,6
32,2,0,0,2,2021-12-09,Male,61,55-64,7
32,1,2,0,3,2021-12-09,Female,67,65-69,12
32,0,0,0,0,2021-12-13,Female,68,65-69,20
32,1,0,0,1,2021-12-08,Male,63,55-64,12
32,0,0,0,0,2021-12-13,Male,55,55-64,5
32,0,0,0,0,2021-12-13,Female,67,65-69,6
32,1,0,0,1,2021-12-17,Female,49,45-54,1
32,1,0,0,1,2021-12-09,Female,60,55-64,5
32,1,2,0,3,2021-12-12,Male,67,65-69,18
32,1,0,0,1,2021-12-08,Female,57,55-64,4
32,0,1,0,1,2021-12-08,Male,54,45-54,4
32,0,0,0,0,2021-12-14,Male,69,65-69,3
32,1,0,0,1,2021-12-11,Male,66,65-69,3
32,0,0,0,0,2021-12-09,Female,51,45-54,7
32,0,0,0,0,2021-12-08,Female,67,65-69,22
32,0,5,0,5,2021-12-13,Male,80,80-84,7
32,1,0,0,1,2021-12-09,Female,63,55-64,3
32,1,0,0,1,2021-12-13,Male,64,55-64,2
32,2,0,0,2,2021-12-14,Male,17,15-19,5
32,1,0,0,1,2021-12-15,Female,30,25-34,2
32,1,12,0,13,2021-12-08,Female,39,35-44,7
32,1,0,0,1,2021-12-08,Female,58,55-64,5
32,1,1,0,2,2021-12-10,Female,55,55-64,12
32,3,0,0,3,2021-12-10,Female,37,35-44,10
32,0,0,0,0,2021-12-09,Female,81,80-84,8
32,0,0,0,0,2021-12-10,Male,42,35-44,5
32,0,0,0,0,2021-12-14,Female,69,65-69,9
32,1,0,0,1,2021-12-13,Male,71,70-74,3
32,2,0,0,2,2021-12-13,Female,65,65-69,8
32,1,1,0,2,2021-12-09,Male,80,80-84,5
32,0,0,0,0,2021-12-08,Female,54,45-54,11
32,1,0,0,1,2021-12-13,Female,42,35-44,17
32,0,0,2,2,2021-12-09,Male,41,35-44,10
32,1,6,0,7,2021-12-10,Female,31,25-34,5
32,2,0,0,2,2021-12-09,Male,50,45-54,4
32,2,10,0,12,2021-12-08,Male,68,65-69,25
32,1,0,0,1,2021-12-11,Female,77,75-79,22
32,2,7,0,9,2021-12-09,Male,1,1-4,6
32,2,2,0,4,2021-12-08,Female,8,5-9,21
32,0,2,0,2,2021-12-10,Male,68,65-69,8
32,2,0,0,2,2021-12-16,Male,53,45-54,2
32,1,0,0,1,2021-12-08,Male,78,75-79,10
32,0,0,0,0,2021-12-16,Male,24,20-24,2
32,2,0,0,2,2021-12-10,Male,41,35-44,7
32,1,0,0,1,2021-12-08,Male,69,65-69,9
32,1,0,0,1,2021-12-08,Female,69,65-69,7
32,4,0,0,4,2021-12-13,Female,9,5-9,3
32,1,1,0,2,2021-12-10,Male,67,65-69,6
32,1,1,0,2,2021-12-09,Male,61,55-64,6
32,0,5,0,5,2021-12-13,Female,59,55-64,10
32,1,5,0,6,2021-12-17,Female,63,55-64,1
32,1,0,0,1,2021-12-09,Female,34,25-34,3
32,0,1,0,1,2021-12-09,Female,52,45-54,7
32,1,5,0,6,2021-12-17,Male,69,65-69,1
32,0,0,0,0,2021-12-17,Female,37,35-44,3
32,1,0,0,1,2021-12-08,Female,67,65-69,9
32,0,5,0,5,2021-12-17,Male,37,35-44,1
32,1,0,100,101,2021-12-09,Male,68,65-69,7
32,0,0,2,2,2021-12-13,Female,47,45-54,2
32,3,0,0,3,2021-12-08,Female,6,5-9,3
32,2,0,0,2,2021-12-10,Male,49,45-54,8
32,2,5,22,29,2021-12-08,Male,14,10-14,3
32,0,0,0,0,2021-12-13,Female,21,20-24,3
32,0,0,0,0,2021-12-15,Female,30,25-34,19
32,0,0,0,0,2021-12-09,Female,13,10-14,6
32,0,0,0,0,2021-12-13,Female,70,70-74,7
32,0,1,0,1,2021-12-11,Male,66,65-69,4
32,2,0,0,2,2021-12-17,Female,0,<1,1
32,1,0,0,1,2021-12-08,Male,56,55-64,9
32,1,0,9,10,2021-12-08,Female,51,45-54,4
32,0,0,0,0,2021-12-08,Male,55,55-64,4
32,1,0,0,1,2021-12-09,Female,81,80-84,11
32,3,0,0,3,2021-12-09,Female,12,10-14,4
32,1,1,0,2,2021-12-13,Female,60,55-64,10
32,3,2,0,5,2021-12-15,Male,1,1-4,6
32,2,7,0,9,2021-12-08,Male,67,65-69,5
32,1,0,0,1,2021-12-10,Female,62,55-64,5
32,1,0,0,1,2021-12-08,Female,51,45-54,5
32,2,4,0,6,2021-12-10,Female,54,45-54,8
32,0,0,0,0,2021-12-13,Male,45,45-54,8
32,0,0,0,0,2021-12-10,Male,43,35-44,12
32,1,0,0,1,2021-12-08,Female,55,55-64,6
32,1,0,0,1,2021-12-13,Male,40,35-44,5
32,1,0,0,1,2021-12-10,Male,72,70-74,4
32,0,2,0,2,2021-12-13,Female,56,55-64,4
32,2,0,0,2,2021-12-12,Female,55,55-64,7
32,1,2,0,3,2021-12-11,Male,66,65-69,3
32,1,4,0,5,2021-12-09,Male,70,70-74,8
32,1,2,0,3,2021-12-12,Male,51,45-54,7
32,3,0,0,3,2021-12-17,Female,13,10-14,1
32,0,2,0,2,2021-12-10,Male,45,45-54,13
32,1,0,0,1,2021-12-09,Female,46,45-54,6
32,0,1,0,1,2021-12-09,Male,44,35-44,7
32,0,4,7,11,2021-12-10,Male,84,80-84,5
32,3,0,0,3,2021-12-10,Male,13,10-14,4
32,1,3,1,5,2021-12-09,Female,65,65-69,10
32,0,0,0,0,2021-12-09,Female,65,65-69,5
32,2,0,0,2,2021-12-08,Male,37,35-44,7
32,1,2,1,4,2021-12-13,Female,57,55-64,4
32,1,1,0,2,2021-12-17,Female,67,65-69,1
32,1,10,0,11,2021-12-14,Male,54,45-54,5
32,1,0,1,2,2021-12-13,Male,85,85+,6
32,3,7,34,44,2021-12-13,Male,8,5-9,5
32,3,0,0,3,2021-12-15,Male,0,<1,3
32,4,1,0,5,2021-12-17,Male,17,15-19,1
32,0,0,0,0,2021-12-10,Male,71,70-74,5
32,2,2,0,4,2021-12-17,Female,26,25-34,1
32,2,8,0,10,2021-12-08,Male,45,45-54,6
32,0,10,0,10,2021-12-13,Male,66,65-69,3
32,1,0,0,1,2021-12-09,Male,31,25-34,7
32,1,0,0,1,2021-12-09,Female,63,55-64,5
32,1,8,0,9,2021-12-17,Male,39,35-44,1
32,0,1,6,7,2021-12-16,Male,30,25-34,17
32,1,0,0,1,2021-12-08,Female,54,45-54,6
32,1,0,0,1,2021-12-13,Male,18,15-19,4
32,1,0,0,1,2021-12-08,Male,69,65-69,5
32,1,0,0,1,2021-12-13,Female,10,10-14,2
32,1,0,0,1,2021-12-13,Male,46,45-54,6
32,1,0,0,1,2021-12-17,Male,67,65-69,1
32,0,0,0,0,2021-12-13,Male,77,75-79,3
32,1,0,0,1,2021-12-08,Male,68,65-69,6
32,0,0,0,0,2021-12-09,Female,59,55-64,4
32,4,0,0,4,2021-12-09,Female,51,45-54,4
32,0,0,0,0,2021-12-08,Male,53,45-54,10
32,1,1,0,2,2021-12-17,Female,67,65-69,1
32,0,0,0,0,2021-12-08,Female,18,15-19,3
32,0,4,0,4,2021-12-13,Female,72,70-74,9
32,0,0,0,0,2021-12-17,Male,45,45-54,1
32,3,0,0,3,2021-12-14,Male,1,1-4,6
32,1,1,0,2,2021-12-14,Female,28,25-34,6
32,1,1,0,2,2021-12-09,Male,64,55-64,12
32,0,0,0,0,2021-12-09,Female,65,65-69,12
32,0,0,0,0,2021-12-08,Female,27,25-34,5
32,3,0,0,3,2021-12-08,Female,7,5-9,6
32,1,0,0,1,2021-12-09,Female,63,55-64,12
32,1,3,0,4,2021-12-17,Male,35,35-44,1
32,0,0,0,0,2021-12-14,Female,17,15-19,9
32,1,1,0,2,2021-12-14,Male,70,70-74,9
32,0,0,0,0,2021-12-08,Male,68,65-69,9
32,1,0,0,1,2021-12-13,Female,68,65-69,9
32,1,1,0,2,2021-12-14,Male,79,75-79,3
32,0,0,0,0,2021-12-10,Male,42,35-44,4
32,1,3,4,8,2021-12-08,Female,56,55-64,7
32,0,2,0,2,2021-12-17,Male,32,25-34,1
32,0,0,0,0,2021-12-08,Male,68,65-69,6
32,4,13,0,17,2021-12-15,Male,3,1-4,5
32,0,0,0,0,2021-12-08,Male,73,70-74,6
32,1,0,0,1,2021-12-08,Male,53,45-54,10
32,2,1,44,47,2021-12-14,Male,11,10-14,6
32,1,2,0,3,2021-12-08,Male,68,65-69,4
32,1,0,0,1,2021-12-17,Male,23,20-24,2
32,1,0,0,1,2021-12-09,Female,20,20-24,6
32,0,2,0,2,2021-12-13,Female,67,65-69,25
32,0,1,1,2,2021-12-08,Female,54,45-54,5
32,1,0,0,1,2021-12-08,Female,73,70-74,11
32,2,0,0,2,2021-12-09,Male,61,55-64,2
32,2,0,0,2,2021-12-09,Male,46,45-54,6
32,0,5,0,5,2021-12-11,Male,41,35-44,21
32,1,0,0,1,2021-12-08,Female,54,45-54,5
32,2,2,0,4,2021-12-17,Male,3,1-4,1
32,0,5,60,65,2021-12-11,Female,31,25-34,5
32,0,12,0,12,2021-12-09,Female,61,55-64,10
32,0,7,0,7,2021-12-09,Female,54,45-54,12
32,1,0,0,1,2021-12-17,Female,54,45-54,6
32,2,5,0,7,2021-12-08,Male,14,10-14,4
32,1,0,0,1,2021-12-09,Male,71,70-74,6
32,2,0,0,2,2021-12-13,Female,4,1-4,11
32,0,0,0,0,2021-12-09,Female,32,25-34,5
32,1,2,0,3,2021-12-17,Male,72,70-74,1
32,4,0,0,4,2021-12-13,Male,78,75-79,11
32,2,6,0,8,2021-12-11,Male,44,35-44,10
32,0,0,0,0,2021-12-09,Male,24,20-24,12
32,0,5,0,5,2021-12-08,Male,55,55-64,4
32,1,0,0,1,2021-12-11,Female,51,45-54,9
32,1,3,0,4,2021-12-17,Male,78,75-79,1
32,1,0,0,1,2021-12-08,Female,52,45-54,11
32,0,0,0,0,2021-12-08,Male,73,70-74,3
32,1,0,0,1,2021-12-08,Female,56,55-64,5
32,0,1,0,1,2021-12-14,Male,58,55-64,9
32,1,0,0,1,2021-12-09,Female,69,65-69,21
32,0,2,0,2,2021-12-09,Female,66,65-69,7
32,2,0,0,2,2021-12-08,Male,15,15-19,6
32,0,2,0,2,2021-12-09,Male,46,45-54,4
32,1,23,0,24,2021-12-14,Female,51,45-54,4
32,0,1,0,1,2021-12-13,Male,52,45-54,17
32,1,0,0,1,2021-12-13,Female,65,65-69,5
32,3,2,1,6,2021-12-14,Female,23,20-24,5
32,1,0,0,1,2021-12-08,Female,52,45-54,6
32,1,0,0,1,2021-12-13,Female,68,65-69,7
32,0,0,0,0,2021-12-13,Male,51,45-54,11
32,1,3,0,4,2021-12-09,Female,56,55-64,3
32,0,0,0,0,2021-12-09,Female,31,25-34,4
32,0,0,0,0,2021-12-17,Female,53,45-54,1
32,1,0,0,1,2021-12-13,Male,59,55-64,4
32,0,0,0,0,2021-12-09,Male,59,55-64,10
32,1,0,0,1,2021-12-09,Male,46,45-54,12
32,0,0,0,0,2021-12-13,Male,57,55-64,11
32,0,0,0,0,2021-12-08,Female,62,55-64,10
32,0,0,0,0,2021-12-10,Female,71,70-74,6
32,0,0,0,0,2021-12-13,Male,61,55-64,5
32,0,0,0,0,2021-12-09,Female,5,5-9,8
32,0,0,0,0,2021-12-08,Female,5,5-9,6
32,0,0,0,0,2021-12-08,Male,56,55-64,4
32,1,0,0,1,2021-12-17,Male,27,25-34,6
32,3,0,0,3,2021-12-13,Female,3,1-4,5
32,0,2,0,2,2021-12-16,Male,44,35-44,4
32,1,0,0,1,2021-12-17,Female,27,25-34,1
32,0,3,0,3,2021-12-17,Female,59,55-64,1
32,3,2,0,5,2021-12-16,Female,31,25-34,8
32,0,0,0,0,2021-12-09,Male,80,80-84,6
32,2,15,0,17,2021-12-08,Female,2,1-4,13
32,0,2,2,4,2021-12-09,Male,41,35-44,4
32,2,0,2,4,2021-12-09,Male,61,55-64,3
32,0,0,0,0,2021-12-08,Male,18,15-19,10
32,0,2,0,2,2021-12-08,Male,54,45-54,5
32,1,0,0,1,2021-12-08,Male,53,45-54,4
32,0,3,0,3,2021-12-17,Female,52,45-54,1
32,0,1,0,1,2021-12-09,Female,65,65-69,9
32,1,2,0,3,2021-12-08,Male,66,65-69,8
32,0,1,0,1,2021-12-09,Male,72,70-74,6
32,0,0,0,0,2021-12-12,Male,45,45-54,6
32,0,0,0,0,2021-12-08,Male,27,25-34,4
32,1,2,0,3,2021-12-09,Female,65,65-69,6
32,0,100,0,100,2021-12-14,Female,47,45-54,9
32,4,15,0,19,2021-12-17,Female,5,5-9,1
32,0,0,0,0,2021-12-14,Male,53,45-54,16
32,0,0,0,0,2021-12-08,Female,27,25-34,11
32,0,5,0,5,2021-12-17,Female,53,45-54,1
32,1,0,0,1,2021-12-13,Male,74,70-74,7
32,1,0,0,1,2021-12-17,Male,64,55-64,1
32,1,0,0,1,2021-12-17,Female,31,25-34,1
32,1,0,0,1,2021-12-10,Male,56,55-64,6
32,0,0,0,0,2021-12-13,Male,29,25-34,4
32,1,0,0,1,2021-12-17,Male,71,70-74,1
32,0,10,0,10,2021-12-08,Male,66,65-69,12
32,0,1,0,1,2021-12-08,Female,45,45-54,5
32,1,0,0,1,2021-12-08,Male,67,65-69,7
32,0,0,0,0,2021-12-17,Female,31,25-34,1
32,3,2,0,5,2021-12-08,Female,31,25-34,2
32,1,0,0,1,2021-12-09,Male,66,65-69,7
32,3,5,0,8,2021-12-13,Female,0,<1,8
32,1,0,0,1,2021-12-09,Male,71,70-74,11
32,0,0,0,0,2021-12-13,Male,34,25-34,9
32,1,0,0,1,2021-12-09,Male,60,55-64,6
32,1,1,0,2,2021-12-09,Female,31,25-34,3
32,2,0,0,2,2021-12-12,Female,30,25-34,3
32,1,3,0,4,2021-12-08,Male,57,55-64,5
32,1,0,0,1,2021-12-08,Male,69,65-69,4
32,0,0,0,0,2021-12-13,Male,68,65-69,10
32,0,4,0,4,2021-12-09,Female,60,55-64,7
32,0,0,0,0,2021-12-16,Male,31,25-34,2
32,3,0,33,36,2021-12-17,Male,11,10-14,1
32,0,0,0,0,2021-12-17,Female,76,75-79,1
32,3,0,0,3,2021-12-09,Male,3,1-4,10
32,1,0,0,1,2021-12-08,Male,70,70-74,12
32,1,0,0,1,2021-12-13,Female,66,65-69,6
32,2,0,0,2,2021-12-14,Male,10,10-14,4
32,0,1,0,1,2021-12-09,Male,35,35-44,11
32,1,0,0,1,2021-12-09,Male,71,70-74,7
32,2,2,0,4,2021-12-13,Female,13,10-14,8
32,0,0,0,0,2021-12-14,Female,23,20-24,5
32,1,0,0,1,2021-12-13,Male,76,75-79,10
32,0,0,0,0,2021-12-17,Male,63,55-64,1
32,1,0,0,1,2021-12-16,Female,21,20-24,2
32,0,0,0,0,2021-12-08,Female,39,35-44,12
32,3,0,0,3,2021-12-13,Male,16,15-19,4
32,1,0,0,1,2021-12-14,Male,8,5-9,2
32,0,1,0,1,2021-12-09,Female,57,55-64,7
32,1,2,0,3,2021-12-08,Female,55,55-64,10
32,2,3,0,5,2021-12-13,Female,71,70-74,5
32,0,1,0,1,2021-12-13,Male,59,55-64,8
32,1,0,0,1,2021-12-13,Female,61,55-64,4
32,1,0,0,1,2021-12-13,Male,70,70-74,4
32,2,0,0,2,2021-12-13,Female,10,10-14,3
32,1,0,0,1,2021-12-09,Female,41,35-44,6
32,3,4,0,7,2021-12-08,Female,1,1-4,4
32,1,2,0,3,2021-12-08,Male,69,65-69,8
32,0,0,0,0,2021-12-10,Male,43,35-44,5
32,0,1,0,1,2021-12-10,Male,41,35-44,10
32,2,1,9,12,2021-12-08,Female,4,1-4,6
32,0,0,0,0,2021-12-08,Female,28,25-34,4
32,1,0,0,1,2021-12-09,Female,65,65-69,12
32,3,0,0,3,2021-12-08,Female,13,10-14,11
32,3,0,0,3,2021-12-14,Female,26,25-34,4
32,1,21,0,22,2021-12-09,Female,22,20-24,3
32,0,1,0,1,2021-12-08,Male,68,65-69,8
32,0,2,0,2,2021-12-10,Female,51,45-54,12
32,0,0,0,0,2021-12-14,Male,72,70-74,5
32,1,3,0,4,2021-12-08,Female,55,55-64,11
32,1,2,0,3,2021-12-16,Male,52,45-54,2
32,1,0,19,20,2021-12-09,Female,13,10-14,5
32,1,2,0,3,2021-12-09,Female,31,25-34,7
32,0,14,0,14,2021-12-09,Female,65,65-69,8
32,0,0,0,0,2021-12-09,Male,78,75-79,8
32,3,3,0,6,2021-12-11,Male,6,5-9,6
32,2,0,0,2,2021-12-13,Male,55,55-64,6
32,0,0,0,0,2021-12-09,Female,34,25-34,3
32,0,0,0,0,2021-12-11,Female,35,35-44,5
32,1,6,0,7,2021-12-09,Female,68,65-69,5
32,1,0,0,1,2021-12-09,Male,58,55-64,18
32,1,1,0,2,2021-12-13,Female,55,55-64,17
32,1,41,30,72,2021-12-17,Male,70,70-74,1
32,3,3,0,6,2021-12-08,Female,1,1-4,8
32,1,0,0,1,2021-12-13,Male,63,55-64,5
32,1,0,0,1,2021-12-09,Male,68,65-69,5
32,0,3,0,3,2021-12-09,Male,61,55-64,12
32,0,0,0,0,2021-12-13,Female,82,80-84,6
32,0,7,0,7,2021-12-08,Male,54,45-54,6
32,0,0,0,0,2021-12-14,Female,58,55-64,3
32,1,36,0,37,2021-12-09,Male,46,45-54,5
32,2,0,0,2,2021-12-11,Male,8,5-9,5
32,0,0,0,0,2021-12-16,Male,54,45-54,10
32,3,0,0,3,2021-12-14,Female,18,15-19,5
32,0,5,0,5,2021-12-09,Male,76,75-79,3
32,0,1,0,1,2021-12-08,Male,32,25-34,11
32,1,2,0,3,2021-12-10,Male,15,15-19,8
32,1,0,0,1,2021-12-10,Female,47,45-54,5
32,0,0,0,0,2021-12-14,Female,27,25-34,7
32,3,15,0,18,2021-12-09,Female,15,15-19,10
32,3,1,0,4,2021-12-09,Female,6,5-9,4
32,1,15,0,16,2021-12-17,Male,69,65-69,1
32,0,0,0,0,2021-12-08,Female,39,35-44,7
32,0,0,0,0,2021-12-17,Female,34,25-34,1
32,2,0,0,2,2021-12-08,Male,2,1-4,4
32,1,1,0,2,2021-12-09,Male,73,70-74,25
32,2,0,0,2,2021-12-13,Female,2,1-4,5
32,2,0,0,2,2021-12-10,Female,17,15-19,7
32,1,0,0,1,2021-12-15,Female,31,25-34,3
32,0,29,0,29,2021-12-13,Female,72,70-74,5
32,2,0,0,2,2021-12-08,Male,18,15-19,4
32,1,0,0,1,2021-12-15,Female,25,25-34,5
32,4,45,0,49,2021-12-17,Female,7,5-9,1
32,1,0,0,1,2021-12-13,Female,55,55-64,5
32,0,0,0,0,2021-12-08,Female,69,65-69,6
32,2,0,0,2,2021-12-17,Male,31,25-34,1
32,0,0,0,0,2021-12-09,Male,72,70-74,23
32,2,0,0,2,2021-12-08,Male,27,25-34,5
32,1,0,0,1,2021-12-13,Male,66,65-69,6
32,1,0,0,1,2021-12-13,Male,77,75-79,5
32,3,0,0,3,2021-12-13,Male,36,35-44,2
32,2,0,0,2,2021-12-08,Male,18,15-19,8
32,0,1,0,1,2021-12-09,Male,65,65-69,7
32,1,0,0,1,2021-12-09,Male,26,25-34,3
32,1,9,0,10,2021-12-08,Female,54,45-54,6
32,0,0,0,0,2021-12-09,Female,19,15-19,4
32,1,0,0,1,2021-12-17,Female,64,55-64,1
32,0,1,7,8,2021-12-14,Male,68,65-69,6
32,0,15,0,15,2021-12-09,Female,58,55-64,9
32,1,1,0,2,2021-12-17,Female,50,45-54,1
32,1,0,0,1,2021-12-16,Male,20,20-24,2
32,0,0,0,0,2021-12-10,Male,65,65-69,4
32,1,1,0,2,2021-12-17,Female,52,45-54,1
32,3,0,0,3,2021-12-09,Male,20,20-24,11
32,0,3,0,3,2021-12-08,Female,73,70-74,10
32,2,0,0,2,2021-12-14,Female,49,45-54,4
32,3,17,0,20,2021-12-10,Female,3,1-4,7
32,2,0,0,2,2021-12-09,Male,5,5-9,9
32,0,8,0,8,2021-12-17,Male,44,35-44,1
32,1,2,0,3,2021-12-10,Female,64,55-64,11
32,0,1,0,1,2021-12-17,Male,61,55-64,1
32,1,2,0,3,2021-12-10,Male,72,70-74,8
32,3,0,0,3,2021-12-09,Male,65,65-69,9
32,0,1,0,1,2021-12-09,Female,50,45-54,5
32,0,0,0,0,2021-12-09,Female,36,35-44,14
32,1,0,0,1,2021-12-13,Female,55,55-64,8
32,5,0,0,5,2021-12-17,Male,3,1-4,1
32,1,0,0,1,2021-12-08,Male,58,55-64,4
32,1,3,0,4,2021-12-08,Female,25,25-34,25
32,0,1,0,1,2021-12-17,Female,31,25-34,1
32,1,0,0,1,2021-12-13,Male,76,75-79,5
32,1,1,0,2,2021-12-16,Female,36,35-44,14
32,2,2,0,4,2021-12-13,Female,72,70-74,22
32,2,1,0,3,2021-12-08,Male,1,1-4,2
32,1,0,0,1,2021-12-08,Female,68,65-69,6
32,0,0,0,0,2021-12-08,Male,61,55-64,5
32,1,0,0,1,2021-12-13,Female,55,55-64,8
32,1,0,0,1,2021-12-09,Male,72,70-74,6
32,0,0,0,0,2021-12-13,Female,6,5-9,10
32,1,0,0,1,2021-12-17,Female,61,55-64,1
32,0,0,0,0,2021-12-08,Male,62,55-64,6
32,0,1,0,1,2021-12-13,Male,44,35-44,7
32,1,2,0,3,2021-12-13,Male,72,70-74,5
32,0,0,0,0,2021-12-09,Male,44,35-44,6
32,4,1,0,5,2021-12-17,Female,7,5-9,1
32,1,2,0,3,2021-12-14,Male,52,45-54,8
32,0,1,0,1,2021-12-10,Female,75,75-79,6
32,0,0,0,0,2021-12-17,Female,32,25-34,1
32,0,1,0,1,2021-12-13,Male,77,75-79,19
32,0,2,0,2,2021-12-13,Female,50,45-54,15
32,3,0,0,3,2021-12-09,Female,19,15-19,7
32,2,3,60,65,2021-12-14,Female,24,20-24,2
32,1,1,0,2,2021-12-12,Male,71,70-74,4
32,1,1,0,2,2021-12-17,Female,67,65-69,1
32,1,0,0,1,2021-12-13,Female,67,65-69,4
32,0,0,0,0,2021-12-17,Male,37,35-44,1
32,1,0,0,1,2021-12-13,Male,36,35-44,6
32,1,0,0,1,2021-12-17,Female,71,70-74,1
32,1,0,0,1,2021-12-10,Female,33,25-34,7
32,1,2,0,3,2021-12-09,Female,65,65-69,3
32,1,2,0,3,2021-12-09,Female,75,75-79,6
32,0,0,0,0,2021-12-13,Female,70,70-74,8
32,1,0,0,1,2021-12-13,Female,64,55-64,20
32,1,0,0,1,2021-12-09,Female,42,35-44,5
32,2,0,0,2,2021-12-09,Male,1,1-4,8
32,0,0,0,0,2021-12-14,Male,51,45-54,7
32,1,0,0,1,2021-12-14,Female,43,35-44,8
32,0,0,0,0,2021-12-11,Female,41,35-44,8
32,1,0,0,1,2021-12-17,Female,18,15-19,17
32,0,0,0,0,2021-12-08,Female,60,55-64,8
32,0,3,0,3,2021-12-09,Male,59,55-64,8
32,1,4,0,5,2021-12-17,Female,62,55-64,1
32,1,0,0,1,2021-12-09,Male,70,70-74,7
32,3,0,0,3,2021-12-13,Female,62,55-64,5
32,1,0,0,1,2021-12-09,Male,72,70-74,7
32,0,0,0,0,2021-12-13,Male,54,45-54,8
32,3,0,0,3,2021-12-10,Male,37,35-44,2
32,0,10,0,10,2021-12-08,Female,54,45-54,4
32,3,3,0,6,2021-12-17,Male,60,55-64,1
32,1,0,0,1,2021-12-09,Male,75,75-79,5
32,1,0,0,1,2021-12-08,Male,74,70-74,5
32,1,0,0,1,2021-12-08,Male,58,55-64,6
32,0,0,0,0,2021-12-17,Female,10,10-14,1
32,0,0,0,0,2021-12-08,Male,14,10-14,6
32,1,1,2,4,2021-12-17,Male,59,55-64,1
32,0,6,45,51,2021-12-09,Male,72,70-74,9
32,0,0,0,0,2021-12-12,Female,61,55-64,2
32,1,3,0,4,2021-12-10,Female,60,55-64,5
32,1,0,0,1,2021-12-08,Female,27,25-34,9
32,2,1,0,3,2021-12-13,Male,75,75-79,24
32,2,0,0,2,2021-12-10,Female,64,55-64,17
32,2,2,1,5,2021-12-09,Male,64,55-64,6
32,3,2,0,5,2021-12-17,Female,58,55-64,1
32,3,0,0,3,2021-12-08,Male,62,55-64,10
32,1,0,0,1,2021-12-13,Female,35,35-44,2
32,3,0,0,3,2021-12-13,Female,9,5-9,4
32,1,0,0,1,2021-12-12,Male,41,35-44,16
32,1,0,0,1,2021-12-08,Female,70,70-74,6
32,0,0,0,0,2021-12-10,Male,48,45-54,5
32,2,0,0,2,2021-12-16,Male,43,35-44,5
32,1,0,0,1,2021-12-13,Male,40,35-44,5
32,0,0,0,0,2021-12-13,Female,38,35-44,4
32,1,1,0,2,2021-12-11,Female,59,55-64,6
32,1,0,0,1,2021-12-08,Male,66,65-69,6
32,1,0,0,1,2021-12-14,Male,46,45-54,7
32,1,0,0,1,2021-12-08,Male,73,70-74,13
32,1,3,0,4,2021-12-17,Female,66,65-69,1
32,0,2,0,2,2021-12-10,Male,72,70-74,4
32,0,2,0,2,2021-12-14,Male,74,70-74,4
32,1,0,0,1,2021-12-12,Male,67,65-69,8
32,0,0,0,0,2021-12-09,Male,27,25-34,7
32,0,0,0,0,2021-12-09,Male,44,35-44,5
32,0,1,2,3,2021-12-09,Female,41,35-44,10
32,0,0,0,0,2021-12-14,Male,53,45-54,6
32,1,0,0,1,2021-12-08,Female,27,25-34,4
32,0,0,0,0,2021-12-13,Male,61,55-64,3
32,1,4,0,5,2021-12-09,Male,65,65-69,3
32,0,2,0,2,2021-12-10,Female,42,35-44,6
32,2,0,0,2,2021-12-08,Female,67,65-69,25
32,1,0,0,1,2021-12-09,Male,67,65-69,11
32,3,0,0,3,2021-12-14,Male,22,20-24,11
32,0,0,0,0,2021-12-10,Female,62,55-64,10
32,1,0,0,1,2021-12-09,Male,12,10-14,11
32,3,0,0,3,2021-12-09,Female,54,45-54,23
32,1,1,0,2,2021-12-09,Female,53,45-54,4
32,1,3,0,4,2021-12-10,Male,44,35-44,8
32,0,0,0,0,2021-12-08,Male,39,35-44,11
32,1,1,0,2,2021-12-10,Male,72,70-74,9
32,0,0,0,0,2021-12-17,Male,81,80-84,1
32,0,0,0,0,2021-12-16,Male,53,45-54,4
32,0,0,0,0,2021-12-13,Female,39,35-44,6
32,2,0,0,2,2021-12-08,Female,69,65-69,7
32,1,1,0,2,2021-12-13,Male,63,55-64,8
32,2,0,0,2,2021-12-14,Male,11,10-14,17
32,0,3,0,3,2021-12-09,Male,58,55-64,10
32,0,0,0,0,2021-12-13,Female,70,70-74,2
32,1,0,0,1,2021-12-09,Male,60,55-64,10
32,0,0,0,0,2021-12-08,Female,21,20-24,11
32,3,0,0,3,2021-12-14,Male,49,45-54,7
32,1,0,0,1,2021-12-11,Male,33,25-34,6
32,0,0,0,0,2021-12-17,Female,69,65-69,1
32,0,1,0,1,2021-12-14,Male,37,35-44,3
32,0,0,0,0,2021-12-13,Male,34,25-34,15
32,2,15,0,17,2021-12-15,Female,17,15-19,3
32,1,0,0,1,2021-12-13,Female,37,35-44,6
32,2,0,0,2,2021-12-13,Male,67,65-69,9
32,1,0,0,1,2021-12-09,Male,65,65-69,11
32,0,0,0,0,2021-12-17,Male,61,55-64,1
32,1,8,0,9,2021-12-09,Female,69,65-69,7
32,1,0,0,1,2021-12-09,Female,30,25-34,4
32,1,0,0,1,2021-12-09,Male,67,65-69,11
32,1,1,0,2,2021-12-17,Female,64,55-64,1
32,3,0,0,3,2021-12-10,Female,7,5-9,6
32,0,0,0,0,2021-12-16,Female,25,25-34,7
32,1,0,0,1,2021-12-13,Male,66,65-69,3
32,0,6,0,6,2021-12-09,Male,60,55-64,5
32,0,0,0,0,2021-12-09,Female,63,55-64,8
32,0,0,0,0,2021-12-08,Male,56,55-64,10
32,1,1,0,2,2021-12-13,Male,71,70-74,22
32,2,8,0,10,2021-12-16,Male,52,45-54,6
32,1,0,0,1,2021-12-13,Male,81,80-84,6
32,1,1,0,2,2021-12-13,Male,72,70-74,5
32,1,1,0,2,2021-12-14,Female,41,35-44,11
32,2,0,0,2,2021-12-08,Female,67,65-69,7
32,0,0,0,0,2021-12-08,Female,69,65-69,7
32,0,2,0,2,2021-12-08,Female,54,45-54,5
32,1,0,0,1,2021-12-09,Female,46,45-54,3
32,0,0,0,0,2021-12-09,Male,37,35-44,9
32,3,1,0,4,2021-12-12,Female,10,10-14,12
32,0,2,0,2,2021-12-14,Male,33,25-34,5
32,0,0,0,0,2021-12-14,Female,43,35-44,9
32,1,0,2,3,2021-12-13,Male,61,55-64,6
32,4,0,0,4,2021-12-10,Male,12,10-14,16
32,0,3,0,3,2021-12-09,Male,58,55-64,21
32,2,0,0,2,2021-12-11,Male,18,15-19,5
32,1,0,0,1,2021-12-09,Female,50,45-54,5
32,1,0,0,1,2021-12-13,Female,42,35-44,5
32,0,3,0,3,2021-12-08,Female,58,55-64,4
32,3,3,0,6,2021-12-09,Male,12,10-14,4
32,0,0,0,0,2021-12-16,Female,22,20-24,2
32,0,0,0,0,2021-12-13,Male,72,70-74,9
32,2,0,12,14,2021-12-08,Male,11,10-14,8
32,1,4,0,5,2021-12-09,Male,54,45-54,8
32,1,0,0,1,2021-12-09,Female,53,45-54,12
32,2,1,0,3,2021-12-11,Female,58,55-64,4
32,3,20,0,23,2021-12-10,Female,8,5-9,7
32,1,0,0,1,2021-12-17,Male,32,25-34,1
32,2,1,0,3,2021-12-09,Male,33,25-34,4
32,0,0,0,0,2021-12-09,Female,64,55-64,5
32,3,0,0,3,2021-12-09,Male,66,65-69,6
32,1,0,0,1,2021-12-13,Female,59,55-64,5
32,1,0,0,1,2021-12-09,Female,54,45-54,16
32,1,2,0,3,2021-12-11,Male,52,45-54,22
32,0,0,0,0,2021-12-08,Male,57,55-64,2
32,0,33,10,43,2021-12-10,Male,57,55-64,5
32,0,1,0,1,2021-12-11,Male,60,55-64,2
32,0,0,0,0,2021-12-13,Female,41,35-44,8
32,1,14,0,15,2021-12-11,Female,44,35-44,2
32,2,2,0,4,2021-12-17,Male,9,5-9,1
32,0,1,0,1,2021-12-14,Female,69,65-69,6
32,2,1,0,3,2021-12-08,Male,66,65-69,7
32,1,0,0,1,2021-12-09,Male,59,55-64,6
32,3,51,0,54,2021-12-08,Male,28,25-34,3
32,2,0,0,2,2021-12-13,Male,19,15-19,6
32,1,2,0,3,2021-12-08,Male,17,15-19,7
32,0,0,0,0,2021-12-16,Male,43,35-44,6
32,1,0,0,1,2021-12-08,Female,30,25-34,4
32,1,1,0,2,2021-12-09,Male,65,65-69,11
32,1,0,0,1,2021-12-08,Female,23,20-24,7
32,0,0,0,0,2021-12-13,Female,60,55-64,4
32,0,2,0,2,2021-12-08,Male,57,55-64,7
32,0,2,0,2,2021-12-09,Female,50,45-54,5
32,1,4,0,5,2021-12-10,Male,65,65-69,5
32,3,0,0,3,2021-12-17,Male,4,1-4,1
32,1,0,0,1,2021-12-17,Female,60,55-64,1
32,3,1,0,4,2021-12-16,Female,4,1-4,4
32,1,0,0,1,2021-12-09,Male,80,80-84,18
32,0,1,0,1,2021-12-13,Male,46,45-54,6
32,3,3,0,6,2021-12-14,Male,1,1-4,2
32,1,1,0,2,2021-12-09,Female,72,70-74,6
32,0,0,0,0,2021-12-09,Male,64,55-64,12
32,0,0,0,0,2021-12-09,Male,83,80-84,5
32,1,0,0,1,2021-12-13,Female,62,55-64,12
32,1,0,0,1,2021-12-11,Female,64,55-64,3
32,0,0,0,0,2021-12-17,Male,43,35-44,1
32,1,10,0,11,2021-12-09,Female,65,65-69,5
32,1,10,0,11,2021-12-10,Male,59,55-64,4
32,2,2,0,4,2021-12-08,Female,10,10-14,6
32,2,0,4,6,2021-12-11,Male,70,70-74,4
32,1,0,0,1,2021-12-08,Male,73,70-74,5
32,0,0,0,0,2021-12-09,Female,80,80-84,6
32,1,0,0,1,2021-12-13,Male,72,70-74,5
32,2,0,0,2,2021-12-09,Female,25,25-34,9
32,0,0,0,0,2021-12-10,Female,35,35-44,7
32,0,1,0,1,2021-12-09,Female,78,75-79,4
32,2,0,0,2,2021-12-17,Male,64,55-64,1
32,1,9,0,10,2021-12-10,Male,72,70-74,4
32,1,0,0,1,2021-12-11,Male,39,35-44,10
32,1,1,0,2,2021-12-17,Male,68,65-69,1
32,0,3,0,3,2021-12-09,Female,40,35-44,9
32,2,0,0,2,2021-12-11,Male,68,65-69,18
32,1,0,0,1,2021-12-09,Male,56,55-64,11
32,0,0,0,0,2021-12-09,Male,65,65-69,7
32,0,0,0,0,2021-12-17,Male,47,45-54,1
32,0,0,0,0,2021-12-10,Female,57,55-64,3
32,1,2,0,3,2021-12-09,Male,65,65-69,5
32,1,0,0,1,2021-12-08,Female,32,25-34,3
32,0,0,0,0,2021-12-08,Female,55,55-64,5
32,1,1,0,2,2021-12-13,Male,59,55-64,12
32,0,0,0,0,2021-12-08,Male,66,65-69,11
32,1,0,0,1,2021-12-09,Male,47,45-54,12
32,0,0,0,0,2021-12-14,Male,67,65-69,2
32,1,1,0,2,2021-12-09,Male,66,65-69,4
32,1,0,0,1,2021-12-17,Male,31,25-34,1
32,1,0,0,1,2021-12-12,Male,12,10-14,7
32,1,40,0,41,2021-12-17,Male,48,45-54,1
32,0,0,0,0,2021-12-10,Female,33,25-34,7
32,1,0,0,1,2021-12-10,Female,38,35-44,20
32,0,1,0,1,2021-12-14,Male,46,45-54,5
32,1,0,0,1,2021-12-13,Male,74,70-74,4
32,1,2,0,3,2021-12-08,Male,61,55-64,4
32,0,0,0,0,2021-12-17,Male,9,5-9,1
32,0,0,0,0,2021-12-08,Male,18,15-19,3
32,1,0,0,1,2021-12-15,Female,34,25-34,19
32,1,2,0,3,2021-12-10,Male,72,70-74,5
32,2,2,0,4,2021-12-17,Female,9,5-9,1
32,2,0,0,2,2021-12-10,Female,51,45-54,8
32,1,0,0,1,2021-12-13,Female,49,45-54,7
32,1,1,0,2,2021-12-08,Male,52,45-54,6
32,1,0,0,1,2021-12-13,Male,78,75-79,10
32,1,1,0,2,2021-12-09,Male,62,55-64,12
32,0,0,0,0,2021-12-12,Male,43,35-44,11
32,0,0,0,0,2021-12-10,Male,72,70-74,5
32,0,0,0,0,2021-12-13,Female,68,65-69,25
32,1,0,0,1,2021-12-17,Female,65,65-69,1
32,1,0,0,1,2021-12-08,Female,70,70-74,4
32,0,0,0,0,2021-12-09,Male,59,55-64,4
32,1,0,0,1,2021-12-17,Male,53,45-54,1
32,1,2,0,3,2021-12-08,Female,26,25-34,6
32,1,0,0,1,2021-12-09,Male,62,55-64,6
32,4,2,0,6,2021-12-17,Female,2,1-4,1
32,1,0,0,1,2021-12-08,Male,69,65-69,6
32,1,10,0,11,2021-12-08,Male,53,45-54,4
32,4,9,0,13,2021-12-14,Female,14,10-14,11
32,2,0,0,2,2021-12-13,Female,12,10-14,23
32,1,0,0,1,2021-12-11,Male,31,25-34,10
32,1,2,0,3,2021-12-11,Male,81,80-84,5
32,0,0,0,0,2021-12-08,Male,55,55-64,8
32,0,0,0,0,2021-12-17,Male,8,5-9,2
32,1,0,0,1,2021-12-11,Male,66,65-69,4
32,1,0,0,1,2021-12-09,Female,66,65-69,6
32,0,4,0,4,2021-12-10,Female,59,55-64,6
32,0,0,0,0,2021-12-14,Female,34,25-34,4
32,1,0,0,1,2021-12-13,Male,67,65-69,5
32,2,0,0,2,2021-12-10,Female,48,45-54,12
32,1,0,0,1,2021-12-13,Male,65,65-69,11
32,0,1,0,1,2021-12-09,Female,60,55-64,5
32,0,0,0,0,2021-12-13,Female,30,25-34,11
32,1,0,0,1,2021-12-17,Male,60,55-64,1
32,0,0,0,0,2021-12-11,Female,40,35-44,6
32,0,0,4,4,2021-12-17,Female,27,25-34,1
32,0,0,0,0,2021-12-10,Female,31,25-34,5
32,1,1,4,6,2021-12-13,Male,71,70-74,9
32,3,3,0,6,2021-12-10,Male,12,10-14,6
32,1,0,0,1,2021-12-08,Male,53,45-54,12
32,1,2,0,3,2021-12-17,Male,75,75-79,1
32,2,1,0,3,2021-12-16,Male,18,15-19,2
32,1,0,0,1,2021-12-09,Male,66,65-69,11
32,0,0,0,0,2021-12-17,Male,45,45-54,1
32,1,0,0,1,2021-12-09,Male,50,45-54,6
32,1,0,0,1,2021-12-09,Male,72,70-74,6
32,0,0,0,0,2021-12-09,Female,38,35-44,14
32,0,3,0,3,2021-12-08,Male,73,70-74,6
32,0,2,0,2,2021-12-08,Female,68,65-69,4
32,0,1,0,1,2021-12-13,Female,59,55-64,3
32,0,0,0,0,2021-12-09,Male,28,25-34,5
32,1,0,0,1,2021-12-09,Male,31,25-34,5
32,1,0,0,1,2021-12-09,Female,65,65-69,5
32,1,0,0,1,2021-12-13,Female,67,65-69,4
32,4,0,0,4,2021-12-17,Male,0,<1,1
32,0,2,0,2,2021-12-17,Female,73,70-74,1
32,1,0,0,1,2021-12-10,Female,71,70-74,6
32,0,0,0,0,2021-12-14,Male,58,55-64,7
32,0,0,0,0,2021-12-08,Male,57,55-64,6
32,0,0,0,0,2021-12-16,Female,47,45-54,2
32,1,0,0,1,2021-12-09,Female,61,55-64,6
32,1,2,0,3,2021-12-12,Male,7,5-9,8
32,0,0,0,0,2021-12-08,Female,4,1-4,4
32,0,0,0,0,2021-12-17,Female,71,70-74,1
32,0,11,0,11,2021-12-11,Female,44,35-44,11
32,0,2,0,2,2021-12-10,Female,75,75-79,6
32,1,0,0,1,2021-12-10,Male,60,55-64,5
32,0,1,0,1,2021-12-09,Female,54,45-54,4
32,0,0,0,0,2021-12-08,Male,67,65-69,4
32,1,2,0,3,2021-12-13,Male,64,55-64,12
32,0,2,0,2,2021-12-10,Female,44,35-44,6
32,1,1,4,6,2021-12-09,Male,71,70-74,7
32,0,1,0,1,2021-12-08,Female,53,45-54,5
32,1,0,0,1,2021-12-09,Male,59,55-64,11
32,1,4,0,5,2021-12-13,Male,68,65-69,10
32,1,0,0,1,2021-12-13,Female,77,75-79,6
32,3,1,6,10,2021-12-16,Male,12,10-14,2
32,0,0,0,0,2021-12-09,Male,67,65-69,24
32,1,0,0,1,2021-12-09,Male,44,35-44,8
32,0,10,0,10,2021-12-10,Male,34,25-34,8
32,2,0,0,2,2021-12-09,Female,13,10-14,25
32,0,0,0,0,2021-12-12,Female,51,45-54,4
32,2,0,0,2,2021-12-16,Male,4,1-4,4
32,1,0,0,1,2021-12-08,Male,53,45-54,12
32,1,0,0,1,2021-12-14,Male,70,70-74,4
32,0,0,0,0,2021-12-14,Female,67,65-69,11
32,1,2,0,3,2021-12-08,Female,67,65-69,12
32,1,0,0,1,2021-12-10,Female,62,55-64,5
32,1,0,0,1,2021-12-16,Female,32,25-34,6
32,0,0,0,0,2021-12-13,Female,72,70-74,9
32,0,0,12,12,2021-12-17,Female,57,55-64,1
32,2,0,0,2,2021-12-14,Female,67,65-69,22
32,2,15,0,17,2021-12-09,Male,14,10-14,3
32,2,15,0,17,2021-12-15,Female,14,10-14,8
32,0,0,0,0,2021-12-17,Male,39,35-44,1
32,2,0,0,2,2021-12-08,Female,16,15-19,7
32,0,0,0,0,2021-12-08,Male,25,25-34,6
32,0,0,0,0,2021-12-09,Male,71,70-74,7
32,1,0,0,1,2021-12-09,Female,64,55-64,21
32,0,1,0,1,2021-12-14,Female,69,65-69,16
32,1,0,0,1,2021-12-13,Female,53,45-54,7
32,2,7,0,9,2021-12-17,Female,53,45-54,1
32,1,0,0,1,2021-12-09,Female,32,25-34,2
32,1,1,0,2,2021-12-09,Female,61,55-64,12
32,1,0,0,1,2021-12-13,Female,47,45-54,5
32,0,0,0,0,2021-12-10,Male,46,45-54,12
32,4,0,0,4,2021-12-09,Male,3,1-4,5
32,0,0,0,0,2021-12-10,Male,78,75-79,9
32,2,2,0,4,2021-12-13,Male,3,1-4,12
32,2,17,15,34,2021-12-14,Male,2,1-4,2
32,1,0,0,1,2021-12-14,Male,63,55-64,28
32,0,0,0,0,2021-12-13,Male,72,70-74,2
32,3,0,0,3,2021-12-14,Male,7,5-9,3
32,0,0,0,0,2021-12-13,Male,25,25-34,3
32,0,0,0,0,2021-12-13,Female,38,35-44,12
32,2,1,0,3,2021-12-10,Male,16,15-19,4
32,2,0,0,2,2021-12-08,Male,39,35-44,19
32,1,0,0,1,2021-12-09,Male,51,45-54,7
32,0,2,0,2,2021-12-13,Male,67,65-69,6
32,4,2,0,6,2021-12-14,Male,3,1-4,3
32,1,1,0,2,2021-12-10,Female,66,65-69,10
32,3,0,0,3,2021-12-13,Male,10,10-14,5
32,2,0,0,2,2021-12-09,Male,60,55-64,6
32,0,2,0,2,2021-12-08,Male,58,55-64,5
32,2,0,0,2,2021-12-16,Female,22,20-24,2
32,1,2,0,3,2021-12-14,Female,31,25-34,15
32,1,0,0,1,2021-12-13,Male,78,75-79,5
32,1,0,0,1,2021-12-13,Female,71,70-74,6
32,1,0,0,1,2021-12-09,Male,69,65-69,3
32,3,1,0,4,2021-12-17,Male,3,1-4,1
32,2,1,0,3,2021-12-13,Female,49,45-54,5
32,2,0,0,2,2021-12-13,Female,62,55-64,4
32,1,0,0,1,2021-12-17,Female,52,45-54,1
32,1,0,0,1,2021-12-09,Female,50,45-54,5
32,0,0,0,0,2021-12-17,Male,14,10-14,1
32,1,0,0,1,2021-12-09,Male,49,45-54,6
32,0,0,0,0,2021-12-10,Male,76,75-79,15
32,0,0,0,0,2021-12-10,Female,49,45-54,4
32,1,0,0,1,2021-12-10,Female,61,55-64,5
32,1,0,0,1,2021-12-14,Female,41,35-44,8
32,1,0,0,1,2021-12-09,Male,63,55-64,6
32,1,0,0,1,2021-12-08,Female,66,65-69,9
32,1,0,0,1,2021-12-08,Female,30,25-34,5
32,1,1,0,2,2021-12-09,Male,56,55-64,6
32,2,5,0,7,2021-12-17,Male,12,10-14,1
32,0,0,0,0,2021-12-10,Female,67,65-69,12
32,1,0,0,1,2021-12-09,Male,66,65-69,22
32,0,0,0,0,2021-12-13,Female,67,65-69,8
32,1,1,0,2,2021-12-09,Male,60,55-64,5
32,0,1,0,1,2021-12-13,Male,45,45-54,8
32,1,0,0,1,2021-12-09,Male,64,55-64,6
32,1,0,0,1,2021-12-09,Male,66,65-69,7
32,1,0,0,1,2021-12-17,Female,72,70-74,1
32,1,0,0,1,2021-12-08,Male,28,25-34,5
32,4,0,0,4,2021-12-09,Female,27,25-34,3
32,0,0,0,0,2021-12-12,Female,32,25-34,8
32,1,0,0,1,2021-12-14,Male,51,45-54,10
32,1,0,0,1,2021-12-08,Male,74,70-74,5
32,0,0,0,0,2021-12-16,Male,27,25-34,8
32,2,0,0,2,2021-12-12,Female,9,5-9,2
32,3,1,0,4,2021-12-09,Male,8,5-9,5
32,2,0,0,2,2021-12-09,Female,36,35-44,12
32,1,0,0,1,2021-12-08,Female,25,25-34,15
32,2,0,0,2,2021-12-08,Male,0,<1,3
32,1,0,0,1,2021-12-10,Female,30,25-34,11
32,1,0,0,1,2021-12-08,Male,57,55-64,11
32,0,0,0,0,2021-12-08,Male,38,35-44,6
32,1,4,0,5,2021-12-08,Female,29,25-34,10
32,1,0,0,1,2021-12-09,Male,62,55-64,3
32,2,0,0,2,2021-12-09,Male,13,10-14,6
32,2,7,0,9,2021-12-17,Female,16,15-19,11
32,0,0,0,0,2021-12-17,Female,67,65-69,1
32,1,0,1,2,2021-12-10,Male,65,65-69,15
32,1,0,0,1,2021-12-17,Female,30,25-34,1
32,0,0,0,0,2021-12-16,Male,13,10-14,4
32,1,2,0,3,2021-12-09,Female,60,55-64,4
32,0,0,0,0,2021-12-14,Female,67,65-69,7
32,1,0,0,1,2021-12-09,Female,61,55-64,2
32,0,0,0,0,2021-12-11,Female,71,70-74,17
32,1,0,0,1,2021-12-08,Female,52,45-54,10
32,0,0,0,0,2021-12-17,Male,69,65-69,1
32,0,0,0,0,2021-12-13,Male,62,55-64,4
32,0,0,0,0,2021-12-13,Male,72,70-74,6
32,1,0,0,1,2021-12-11,Male,46,45-54,22
32,1,0,4,5,2021-12-09,Male,73,70-74,6
32,1,3,0,4,2021-12-17,Male,73,70-74,1
32,4,0,0,4,2021-12-09,Male,14,10-14,6
32,0,0,0,0,2021-12-13,Male,66,65-69,10
32,0,3,0,3,2021-12-10,Female,42,35-44,2
32,1,0,0,1,2021-12-10,Female,33,25-34,7
32,0,0,0,0,2021-12-10,Female,31,25-34,5
32,1,0,0,1,2021-12-09,Male,65,65-69,4
32,1,2,0,3,2021-12-08,Female,58,55-64,8
32,1,0,0,1,2021-12-13,Male,37,35-44,9
32,3,7,0,10,2021-12-17,Male,15,15-19,1
32,1,0,0,1,2021-12-09,Female,64,55-64,20
32,0,0,0,0,2021-12-13,Female,66,65-69,10
32,3,15,0,18,2021-12-16,Male,14,10-14,16
32,1,0,0,1,2021-12-11,Female,29,25-34,5
32,3,1,0,4,2021-12-14,Male,10,10-14,14
32,0,0,0,0,2021-12-16,Female,28,25-34,6
32,1,4,0,5,2021-12-13,Male,69,65-69,6
32,1,1,0,2,2021-12-08,Male,67,65-69,6
32,1,0,0,1,2021-12-08,Female,54,45-54,10
32,1,0,0,1,2021-12-09,Female,64,55-64,5
32,1,0,0,1,2021-12-13,Female,60,55-64,3
32,1,0,2,3,2021-12-08,Female,39,35-44,7
32,2,16,0,18,2021-12-09,Male,17,15-19,6
32,0,0,0,0,2021-12-08,Male,68,65-69,11
32,0,0,0,0,2021-12-16,Female,49,45-54,2
32,1,1,0,2,2021-12-10,Male,78,75-79,2
32,1,0,0,1,2021-12-17,Female,42,35-44,1
32,0,0,0,0,2021-12-08,Male,37,35-44,11
32,0,0,0,0,2021-12-10,Female,70,70-74,6
32,1,0,0,1,2021-12-09,Female,59,55-64,26
32,0,0,0,0,2021-12-13,Female,72,70-74,5
32,0,0,0,0,2021-12-13,Female,73,70-74,4
32,1,2,0,3,2021-12-09,Female,34,25-34,6
32,2,0,0,2,2021-12-09,Female,12,10-14,4
32,0,0,0,0,2021-12-13,Female,19,15-19,5
32,0,0,0,0,2021-12-14,Male,36,35-44,7
32,0,0,0,0,2021-12-17,Female,32,25-34,1
32,0,0,0,0,2021-12-17,Male,61,55-64,1
32,1,0,0,1,2021-12-17,Female,30,25-34,1
32,2,25,0,27,2021-12-11,Male,9,5-9,6
32,1,0,0,1,2021-12-13,Male,71,70-74,6
32,1,9,0,10,2021-12-08,Male,70,70-74,12
32,1,0,0,1,2021-12-14,Female,67,65-69,16
32,1,1,0,2,2021-12-09,Male,48,45-54,11
32,1,0,0,1,2021-12-10,Female,72,70-74,10
32,1,0,0,1,2021-12-13,Male,78,75-79,11
32,1,0,0,1,2021-12-17,Male,2,1-4,1
32,0,24,0,24,2021-12-09,Female,64,55-64,4
32,0,1,0,1,2021-12-08,Female,59,55-64,2
32,0,0,0,0,2021-12-13,Female,57,55-64,12
32,2,0,0,2,2021-12-09,Male,53,45-54,11
32,0,0,0,0,2021-12-08,Female,67,65-69,5
32,1,0,0,1,2021-12-17,Male,29,25-34,1
32,1,1,0,2,2021-12-13,Male,75,75-79,7
32,0,4,0,4,2021-12-12,Male,51,45-54,12
32,0,0,0,0,2021-12-09,Female,35,35-44,10
32,2,0,0,2,2021-12-10,Male,65,65-69,12
32,0,0,0,0,2021-12-09,Female,47,45-54,5
32,0,0,0,0,2021-12-08,Male,27,25-34,7
32,1,0,0,1,2021-12-10,Female,59,55-64,7
32,2,2,0,4,2021-12-08,Male,32,25-34,4
32,2,0,0,2,2021-12-08,Male,4,1-4,8
32,1,0,0,1,2021-12-08,Male,73,70-74,4
32,0,1,0,1,2021-12-08,Female,45,45-54,6
32,2,0,0,2,2021-12-08,Male,0,<1,10
32,0,0,0,0,2021-12-08,Male,69,65-69,9
32,0,0,0,0,2021-12-13,Female,77,75-79,18
32,1,0,0,1,2021-12-16,Female,38,35-44,2
32,0,9,0,9,2021-12-17,Female,81,80-84,1
32,3,0,0,3,2021-12-13,Male,11,10-14,12
32,0,0,0,0,2021-12-09,Female,19,15-19,7
32,0,0,0,0,2021-12-08,Male,66,65-69,4
32,1,0,0,1,2021-12-09,Male,72,70-74,6
32,1,15,20,36,2021-12-09,Female,59,55-64,5
32,1,1,0,2,2021-12-13,Female,61,55-64,4
32,1,4,0,5,2021-12-08,Male,63,55-64,4
32,2,0,0,2,2021-12-12,Male,40,35-44,10
32,1,0,0,1,2021-12-09,Female,29,25-34,4
32,0,0,0,0,2021-12-14,Male,51,45-54,6
32,0,0,0,0,2021-12-13,Male,72,70-74,12
32,1,0,0,1,2021-12-13,Male,72,70-74,6
32,3,0,0,3,2021-12-08,Male,2,1-4,7
32,0,0,0,0,2021-12-09,Female,65,65-69,7
32,0,0,0,0,2021-12-13,Male,71,70-74,4
32,2,4,0,6,2021-12-16,Female,7,5-9,4
32,0,0,0,0,2021-12-17,Male,78,75-79,1
32,3,0,0,3,2021-12-10,Female,14,10-14,6
32,0,0,0,0,2021-12-13,Male,73,70-74,4
32,0,0,0,0,2021-12-14,Female,56,55-64,4
32,0,0,0,0,2021-12-14,Female,64,55-64,4
32,1,1,0,2,2021-12-09,Male,77,75-79,4
32,0,4,0,4,2021-12-10,Male,43,35-44,4
32,1,2,0,3,2021-12-09,Male,77,75-79,10
32,1,0,0,1,2021-12-09,Male,66,65-69,11
32,1,2,0,3,2021-12-08,Male,30,25-34,7
32,1,0,0,1,2021-12-08,Female,19,15-19,10
32,2,1,0,3,2021-12-09,Female,4,1-4,6
32,1,1,0,2,2021-12-12,Male,71,70-74,11
32,3,0,0,3,2021-12-09,Female,3,1-4,10
32,1,0,0,1,2021-12-11,Female,60,55-64,4
32,0,0,0,0,2021-12-14,Female,28,25-34,19
32,2,0,0,2,2021-12-17,Female,18,15-19,1
32,0,0,0,0,2021-12-17,Female,41,35-44,1
32,2,1,0,3,2021-12-17,Male,29,25-34,1
32,0,0,0,0,2021-12-16,Male,51,45-54,2
32,1,0,0,1,2021-12-11,Female,64,55-64,9
32,0,1,0,1,2021-12-08,Female,33,25-34,3
32,0,0,0,0,2021-12-10,Female,67,65-69,5
32,1,0,0,1,2021-12-17,Female,64,55-64,1
32,0,3,5,8,2021-12-17,Female,55,55-64,1
32,1,2,0,3,2021-12-08,Female,74,70-74,6
32,1,0,0,1,2021-12-09,Male,70,70-74,5
32,1,9,0,10,2021-12-09,Female,70,70-74,11
32,2,0,0,2,2021-12-13,Female,74,70-74,9
32,0,3,0,3,2021-12-14,Female,52,45-54,5
32,0,0,0,0,2021-12-08,Female,69,65-69,4
32,0,3,0,3,2021-12-09,Male,40,35-44,10
32,1,0,0,1,2021-12-16,Female,33,25-34,7
32,0,0,0,0,2021-12-13,Male,28,25-34,14
32,1,0,0,1,2021-12-10,Female,34,25-34,10
32,0,6,0,6,2021-12-09,Male,53,45-54,11
32,1,0,0,1,2021-12-10,Female,70,70-74,12
32,0,0,0,0,2021-12-09,Female,52,45-54,11
32,1,0,0,1,2021-12-14,Female,54,45-54,10
32,1,0,0,1,2021-12-09,Male,54,45-54,4
32,1,0,0,1,2021-12-08,Female,66,65-69,11
32,3,0,4,7,2021-12-16,Female,11,10-14,4
32,1,7,0,8,2021-12-08,Male,73,70-74,5
32,1,0,0,1,2021-12-10,Male,59,55-64,9
32,1,1,0,2,2021-12-08,Female,68,65-69,4
32,0,0,0,0,2021-12-17,Female,68,65-69,1
32,1,0,0,1,2021-12-12,Female,34,25-34,4
32,1,1,0,2,2021-12-08,Female,54,45-54,6
32,0,0,26,26,2021-12-08,Male,48,45-54,11
32,4,0,0,4,2021-12-13,Female,1,1-4,8
32,1,0,0,1,2021-12-08,Male,74,70-74,6
32,0,0,0,0,2021-12-08,Male,57,55-64,12
32,1,0,0,1,2021-12-16,Male,29,25-34,4
32,2,0,0,2,2021-12-17,Female,11,10-14,1
32,0,0,0,0,2021-12-09,Female,59,55-64,4
32,0,1,0,1,2021-12-17,Female,34,25-34,1
32,2,0,0,2,2021-12-08,Male,10,10-14,6
32,0,3,0,3,2021-12-09,Male,47,45-54,5
32,1,0,0,1,2021-12-17,Male,33,25-34,1
32,1,0,0,1,2021-12-09,Female,26,25-34,3
32,0,0,0,0,2021-12-13,Male,70,70-74,6
32,1,0,0,1,2021-12-08,Female,53,45-54,5
32,0,0,0,0,2021-12-14,Male,74,70-74,6
32,0,0,0,0,2021-12-11,Male,46,45-54,12
32,1,1,0,2,2021-12-08,Male,70,70-74,5
32,3,1,0,4,2021-12-11,Male,9,5-9,9
32,0,1,0,1,2021-12-09,Female,48,45-54,6
32,0,0,0,0,2021-12-14,Female,31,25-34,7
32,2,0,0,2,2021-12-08,Male,39,35-44,8
32,0,5,0,5,2021-12-17,Male,42,35-44,2
32,1,3,0,4,2021-12-13,Male,59,55-64,4
32,0,0,0,0,2021-12-13,Female,61,55-64,4
32,2,1,0,3,2021-12-13,Male,63,55-64,11
32,0,2,0,2,2021-12-10,Female,41,35-44,5
32,0,0,0,0,2021-12-14,Male,49,45-54,5
32,1,0,0,1,2021-12-08,Male,53,45-54,4
32,2,0,0,2,2021-12-09,Male,67,65-69,20
32,0,0,0,0,2021-12-12,Female,32,25-34,16
32,2,0,0,2,2021-12-13,Female,16,15-19,5
32,0,0,0,0,2021-12-09,Female,66,65-69,12
32,2,0,0,2,2021-12-09,Female,80,80-84,25
32,1,1,0,2,2021-12-09,Male,69,65-69,4
32,1,0,0,1,2021-12-13,Male,72,70-74,6
32,1,5,0,6,2021-12-17,Female,62,55-64,1
32,3,3,0,6,2021-12-09,Female,66,65-69,10
32,0,1,0,1,2021-12-09,Female,61,55-64,12
32,1,0,0,1,2021-12-13,Female,54,45-54,11
32,1,2,0,3,2021-12-09,Female,50,45-54,9
32,0,0,0,0,2021-12-09,Male,27,25-34,6
32,0,3,0,3,2021-12-09,Female,59,55-64,5
32,1,0,0,1,2021-12-09,Female,70,70-74,10
32,1,0,0,1,2021-12-16,Female,45,45-54,5
32,0,1,0,1,2021-12-13,Male,37,35-44,7
32,4,1,0,5,2021-12-10,Female,14,10-14,17
32,0,0,0,0,2021-12-08,Male,58,55-64,5
32,1,5,0,6,2021-12-12,Female,31,25-34,17
32,1,0,0,1,2021-12-09,Female,52,45-54,7
32,0,0,0,0,2021-12-09,Male,44,35-44,7
32,2,0,0,2,2021-12-13,Male,15,15-19,20
32,1,4,0,5,2021-12-09,Male,57,55-64,5
32,2,0,0,2,2021-12-09,Female,12,10-14,6
32,3,0,0,3,2021-12-17,Female,8,5-9,1
33,0,0,0,0,2021-12-25,Female,53,45-54,8
33,0,0,0,0,2021-12-28,Female,34,25-34,4
33,1,0,0,1,2021-12-31,Female,29,25-34,1
33,2,0,0,2,2021-12-31,Male,10,10-14,12
33,2,1,0,3,2021-12-24,Male,65,65-69,13
33,0,0,0,0,2021-12-27,Female,49,45-54,13
33,2,2,0,4,2021-12-28,Female,4,1-4,2
33,0,1,0,1,2021-12-24,Male,60,55-64,6
33,2,6,0,8,2021-12-25,Female,23,20-24,4
33,0,0,0,0,2021-12-24,Male,27,25-34,12
33,0,0,0,0,2021-12-30,Female,27,25-34,1
33,0,1,0,1,2021-12-27,Female,4,1-4,13
33,1,0,0,1,2021-12-31,Male,70,70-74,4
33,1,1,0,2,2021-12-26,Male,72,70-74,13
33,1,0,0,1,2021-12-26,Male,71,70-74,7
33,0,7,0,7,2021-12-27,Female,42,35-44,7
33,1,0,0,1,2021-12-27,Female,14,10-14,8
33,1,3,0,4,2021-12-24,Female,57,55-64,5
33,2,0,0,2,2021-12-27,Male,8,5-9,9
33,2,0,0,2,2021-12-24,Female,9,5-9,5
33,1,0,0,1,2021-12-25,Female,58,55-64,11
33,2,0,0,2,2021-12-27,Male,18,15-19,5
33,1,0,0,1,2021-12-24,Male,76,75-79,4
33,1,5,0,6,2021-12-25,Female,69,65-69,9
33,1,2,0,3,2021-12-28,Female,30,25-34,3
33,0,0,0,0,2021-12-24,Female,19,15-19,3
33,1,4,0,5,2021-12-24,Female,74,70-74,5
33,1,0,0,1,2021-12-28,Female,67,65-69,5
33,2,3,0,5,2021-12-27,Female,48,45-54,6
33,0,0,0,0,2021-12-24,Male,53,45-54,11
33,1,0,0,1,2021-12-27,Female,62,55-64,20
33,2,1,0,3,2021-12-26,Male,18,15-19,5
33,2,0,0,2,2021-12-26,Female,3,1-4,7
33,0,0,0,0,2021-12-28,Male,69,65-69,14
33,3,1,3,7,2021-12-28,Male,28,25-34,1
33,2,0,0,2,2021-12-28,Female,8,5-9,3
33,1,0,0,1,2021-12-27,Female,55,55-64,7
33,2,0,0,2,2021-12-27,Male,50,45-54,6
33,1,0,0,1,2021-12-27,Male,41,35-44,7
33,1,0,0,1,2021-12-24,Male,72,70-74,7
33,2,0,0,2,2021-12-28,Male,14,10-14,1
33,2,2,0,4,2021-12-28,Female,1,1-4,8
33,1,0,0,1,2021-12-24,Male,58,55-64,6
33,0,0,0,0,2021-12-26,Female,66,65-69,12
33,0,0,0,0,2021-12-24,Male,49,45-54,3
33,1,1,0,2,2021-12-28,Male,35,35-44,9
33,0,0,0,0,2021-12-27,Male,51,45-54,12
33,2,1,0,3,2021-12-26,Female,20,20-24,7
33,0,0,0,0,2021-12-27,Female,14,10-14,26
33,0,1,0,1,2021-12-27,Female,41,35-44,10
33,1,0,0,1,2021-12-28,Male,25,25-34,6
33,3,1,0,4,2021-12-31,Male,34,25-34,1
33,1,0,0,1,2021-12-28,Female,31,25-34,1
33,0,0,0,0,2021-12-26,Male,33,25-34,20
33,3,0,0,3,2021-12-24,Female,55,55-64,11
33,1,0,0,1,2021-12-24,Male,58,55-64,12
33,1,0,0,1,2021-12-27,Female,65,65-69,3
33,1,1,0,2,2021-12-25,Male,58,55-64,7
33,1,0,0,1,2021-12-24,Male,53,45-54,8
33,0,0,0,0,2021-12-25,Male,58,55-64,2
33,1,0,0,1,2021-12-24,Female,57,55-64,13
33,0,5,0,5,2021-12-24,Male,41,35-44,3
33,1,2,0,3,2021-12-26,Female,50,45-54,12
33,3,0,0,3,2021-12-24,Male,7,5-9,5
33,1,1,0,2,2021-12-24,Male,60,55-64,13
33,1,2,0,3,2021-12-24,Male,65,65-69,8
33,1,3,0,4,2021-12-24,Female,69,65-69,2
33,2,0,0,2,2021-12-30,Female,7,5-9,2
33,0,0,0,0,2021-12-24,Male,50,45-54,9
33,3,0,0,3,2021-12-30,Female,4,1-4,1
33,0,0,0,0,2021-12-30,Female,31,25-34,1
33,1,2,0,3,2021-12-27,Male,36,35-44,21
33,1,0,0,1,2021-12-28,Male,35,35-44,9
33,0,0,0,0,2021-12-31,Male,54,45-54,24
33,0,0,0,0,2021-12-24,Female,37,35-44,5
33,0,3,0,3,2021-12-28,Female,38,35-44,3
33,1,0,0,1,2021-12-27,Male,77,75-79,10
33,0,0,0,0,2021-12-26,Female,66,65-69,7
33,1,0,0,1,2021-12-24,Female,50,45-54,4
33,0,0,0,0,2021-12-27,Male,42,35-44,30
33,0,1,0,1,2021-12-27,Female,79,75-79,10
33,1,0,0,1,2021-12-28,Female,49,45-54,7
33,1,2,0,3,2021-12-26,Female,33,25-34,5
33,1,0,0,1,2021-12-27,Male,5,5-9,5
33,0,0,0,0,2021-12-24,Female,18,15-19,6
33,0,0,0,0,2021-12-27,Male,47,45-54,2
33,0,0,0,0,2021-12-24,Male,85,85+,27
33,0,9,0,9,2021-12-26,Male,37,35-44,7
33,1,1,0,2,2021-12-28,Female,25,25-34,1
33,1,2,0,3,2021-12-31,Female,29,25-34,1
33,1,0,0,1,2021-12-26,Female,33,25-34,9
33,3,0,0,3,2021-12-29,Female,11,10-14,9
33,1,0,0,1,2021-12-28,Male,66,65-69,7
33,0,2,0,2,2021-12-31,Male,55,55-64,18
33,2,0,0,2,2021-12-27,Male,14,10-14,20
33,1,0,0,1,2021-12-28,Male,33,25-34,12
33,0,2,0,2,2021-12-27,Female,40,35-44,7
33,0,1,0,1,2021-12-27,Male,41,35-44,9
33,1,0,0,1,2021-12-28,Female,69,65-69,8
33,0,2,0,2,2021-12-24,Male,62,55-64,6
33,0,0,0,0,2021-12-28,Male,70,70-74,7
33,1,0,0,1,2021-12-24,Female,50,45-54,7
33,0,0,0,0,2021-12-28,Male,36,35-44,10
33,0,2,0,2,2021-12-24,Male,62,55-64,7
33,0,0,0,0,2021-12-28,Female,56,55-64,6
33,1,0,0,1,2021-12-27,Female,45,45-54,8
33,2,0,0,2,2021-12-24,Female,53,45-54,5
33,1,5,0,6,2021-12-27,Female,51,45-54,4
33,2,0,0,2,2021-12-24,Female,17,15-19,11
33,1,0,0,1,2021-12-24,Male,76,75-79,7
33,1,4,0,5,2021-12-27,Female,78,75-79,7
33,0,0,0,0,2021-12-29,Female,21,20-24,1
33,1,0,2,3,2021-12-28,Female,39,35-44,11
33,0,0,0,0,2021-12-24,Male,68,65-69,7
33,0,0,0,0,2021-12-24,Female,51,45-54,7
33,1,0,0,1,2021-12-25,Female,60,55-64,5
33,0,3,0,3,2021-12-24,Male,61,55-64,2
33,0,0,0,0,2021-12-24,Male,61,55-64,13
33,3,0,0,3,2021-12-24,Female,19,15-19,9
33,1,0,0,1,2021-12-27,Male,44,35-44,18
33,0,0,0,0,2021-12-28,Female,8,5-9,1
33,1,2,0,3,2021-12-24,Male,68,65-69,6
33,0,0,0,0,2021-12-27,Female,51,45-54,5
33,2,6,0,8,2021-12-24,Female,52,45-54,7
33,0,1,0,1,2021-12-27,Female,56,55-64,12
33,1,0,0,1,2021-12-28,Male,25,25-34,1
33,0,0,0,0,2021-12-27,Male,43,35-44,11
33,1,3,0,4,2021-12-24,Male,39,35-44,12
33,0,0,0,0,2021-12-24,Female,24,20-24,3
33,0,0,0,0,2021-12-24,Female,61,55-64,20
33,2,0,0,2,2021-12-24,Female,73,70-74,7
33,1,4,0,5,2021-12-31,Male,68,65-69,11
33,1,0,0,1,2021-12-24,Male,62,55-64,5
33,0,0,0,0,2021-12-25,Female,85,85+,4
33,3,0,100,103,2021-12-30,Female,50,45-54,4
33,2,0,0,2,2021-12-26,Male,36,35-44,13
33,0,0,0,0,2021-12-24,Female,62,55-64,6
33,0,1,0,1,2021-12-27,Female,78,75-79,26
33,0,0,0,0,2021-12-26,Male,33,25-34,9
33,1,0,0,1,2021-12-24,Female,64,55-64,5
33,1,0,0,1,2021-12-27,Male,77,75-79,6
33,2,0,0,2,2021-12-26,Male,67,65-69,10
33,1,2,0,3,2021-12-28,Female,33,25-34,1
33,1,0,0,1,2021-12-28,Male,30,25-34,1
33,2,4,0,6,2021-12-27,Male,9,5-9,5
33,1,2,10,13,2021-12-28,Male,69,65-69,7
33,1,0,0,1,2021-12-27,Female,47,45-54,5
33,1,4,0,5,2021-12-24,Female,43,35-44,7
33,0,3,0,3,2021-12-26,Male,71,70-74,7
33,0,2,0,2,2021-12-24,Male,74,70-74,3
33,0,5,0,5,2021-12-26,Female,65,65-69,7
33,1,0,0,1,2021-12-24,Male,59,55-64,5
33,0,0,0,0,2021-12-28,Female,78,75-79,8
33,1,0,0,1,2021-12-26,Female,67,65-69,6
33,0,0,0,0,2021-12-28,Female,20,20-24,13
33,0,1,0,1,2021-12-26,Male,56,55-64,12
33,1,0,0,1,2021-12-25,Male,50,45-54,2
33,2,0,0,2,2021-12-26,Female,56,55-64,6
33,1,0,0,1,2021-12-26,Female,71,70-74,7
33,1,0,0,1,2021-12-26,Female,61,55-64,11
33,1,3,0,4,2021-12-27,Female,44,35-44,5
33,0,0,0,0,2021-12-28,Male,73,70-74,12
33,1,4,0,5,2021-12-26,Female,28,25-34,13
33,1,0,0,1,2021-12-27,Male,46,45-54,12
33,1,5,0,6,2021-12-26,Male,67,65-69,19
33,1,0,0,1,2021-12-28,Male,3,1-4,3
33,4,0,0,4,2021-12-26,Female,4,1-4,14
33,0,2,0,2,2021-12-29,Female,36,35-44,8
33,0,0,0,0,2021-12-27,Male,11,10-14,6
33,2,0,0,2,2021-12-29,Female,24,20-24,2
33,1,0,0,1,2021-12-28,Male,78,75-79,6
33,0,0,0,0,2021-12-28,Female,54,45-54,13
33,0,1,0,1,2021-12-28,Male,73,70-74,5
33,1,1,0,2,2021-12-24,Male,68,65-69,25
33,0,0,0,0,2021-12-26,Male,33,25-34,12
33,0,0,0,0,2021-12-31,Male,33,25-34,1
33,1,0,0,1,2021-12-24,Female,59,55-64,12
33,1,0,0,1,2021-12-27,Female,72,70-74,11
33,0,0,0,0,2021-12-28,Female,23,20-24,19
33,2,0,0,2,2021-12-29,Male,2,1-4,6
33,1,0,0,1,2021-12-28,Male,39,35-44,7
33,2,0,0,2,2021-12-28,Male,12,10-14,12
33,1,1,0,2,2021-12-24,Male,56,55-64,4
33,0,0,0,0,2021-12-28,Male,37,35-44,2
33,0,1,0,1,2021-12-24,Male,58,55-64,6
33,5,0,0,5,2021-12-30,Female,0,<1,1
33,1,0,0,1,2021-12-28,Male,69,65-69,7
33,4,0,0,4,2021-12-27,Female,4,1-4,23
33,1,1,0,2,2021-12-28,Female,29,25-34,1
33,0,0,0,0,2021-12-26,Male,31,25-34,3
33,4,0,0,4,2021-12-26,Male,18,15-19,27
33,0,0,0,0,2021-12-26,Male,66,65-69,8
33,0,2,0,2,2021-12-24,Male,51,45-54,5
33,0,1,0,1,2021-12-26,Male,70,70-74,23
33,3,0,0,3,2021-12-24,Female,11,10-14,6
33,1,0,0,1,2021-12-27,Male,44,35-44,8
33,1,0,0,1,2021-12-24,Female,62,55-64,11
33,0,2,0,2,2021-12-24,Female,27,25-34,8
33,0,0,15,15,2021-12-31,Female,73,70-74,5
33,1,0,0,1,2021-12-27,Male,72,70-74,7
33,3,0,0,3,2021-12-28,Male,30,25-34,4
33,2,0,0,2,2021-12-26,Male,63,55-64,10
33,1,3,0,4,2021-12-27,Female,66,65-69,8
33,1,0,0,1,2021-12-24,Male,65,65-69,5
33,2,0,0,2,2021-12-27,Female,15,15-19,5
33,1,0,0,1,2021-12-26,Male,35,35-44,11
33,2,0,0,2,2021-12-27,Male,12,10-14,9
33,0,0,0,0,2021-12-27,Female,9,5-9,6
33,3,0,0,3,2021-12-24,Female,53,45-54,8
33,1,0,0,1,2021-12-26,Male,33,25-34,5
33,1,0,0,1,2021-12-27,Male,72,70-74,6
33,1,0,0,1,2021-12-28,Female,61,55-64,12
33,3,0,0,3,2021-12-24,Female,8,5-9,4
33,4,0,0,4,2021-12-28,Male,14,10-14,5
33,1,0,0,1,2021-12-31,Male,52,45-54,12
33,2,2,0,4,2021-12-28,Female,34,25-34,1
33,0,2,0,2,2021-12-27,Female,45,45-54,4
33,1,1,0,2,2021-12-24,Male,55,55-64,9
33,2,0,0,2,2021-12-24,Female,28,25-34,13
33,0,0,0,0,2021-12-24,Male,69,65-69,19
33,2,0,0,2,2021-12-26,Female,0,<1,5
33,3,1,0,4,2021-12-25,Male,11,10-14,7
33,0,0,0,0,2021-12-26,Male,70,70-74,5
33,2,1,0,3,2021-12-27,Female,8,5-9,5
33,1,0,0,1,2021-12-28,Female,25,25-34,1
33,1,0,0,1,2021-12-24,Male,10,10-14,6
33,0,0,0,0,2021-12-25,Female,45,45-54,2
33,0,0,0,0,2021-12-27,Female,32,25-34,10
33,1,0,0,1,2021-12-24,Male,74,70-74,8
33,0,3,0,3,2021-12-27,Male,54,45-54,7
33,1,0,0,1,2021-12-28,Female,44,35-44,9
33,0,4,0,4,2021-12-28,Male,83,80-84,6
33,1,1,0,2,2021-12-28,Female,33,25-34,1
33,2,0,0,2,2021-12-26,Male,62,55-64,3
33,0,0,0,0,2021-12-27,Male,36,35-44,12
33,0,0,0,0,2021-12-28,Male,51,45-54,7
33,0,0,0,0,2021-12-28,Male,47,45-54,12
33,0,3,1,4,2021-12-28,Female,24,20-24,1
33,1,2,0,3,2021-12-27,Female,63,55-64,23
33,1,0,0,1,2021-12-24,Female,65,65-69,7
33,2,0,0,2,2021-12-30,Female,27,25-34,1
33,2,0,0,2,2021-12-28,Male,28,25-34,1
33,3,0,0,3,2021-12-31,Female,57,55-64,5
33,2,0,0,2,2021-12-28,Male,32,25-34,1
33,1,0,0,1,2021-12-28,Female,17,15-19,1
33,0,0,0,0,2021-12-24,Female,30,25-34,6
33,1,1,0,2,2021-12-28,Female,28,25-34,1
33,1,0,0,1,2021-12-28,Male,65,65-69,9
33,0,0,2,2,2021-12-28,Male,34,25-34,7
33,0,0,0,0,2021-12-25,Male,30,25-34,8
33,1,1,0,2,2021-12-24,Male,62,55-64,11
33,0,0,0,0,2021-12-27,Female,45,45-54,7
33,1,1,0,2,2021-12-24,Male,55,55-64,8
33,2,0,0,2,2021-12-28,Female,2,1-4,8
33,0,1,0,1,2021-12-24,Male,70,70-74,26
33,0,2,0,2,2021-12-24,Female,85,85+,5
33,0,0,0,0,2021-12-30,Male,28,25-34,1
33,1,0,0,1,2021-12-24,Male,64,55-64,7
33,0,0,0,0,2021-12-31,Female,54,45-54,15
33,0,1,0,1,2021-12-24,Male,68,65-69,6
33,3,0,0,3,2021-12-28,Female,19,15-19,22
33,0,30,0,30,2021-12-24,Male,53,45-54,9
33,1,0,0,1,2021-12-24,Male,57,55-64,7
33,0,3,0,3,2021-12-28,Female,66,65-69,7
33,2,3,0,5,2021-12-28,Male,33,25-34,5
33,4,0,0,4,2021-12-28,Female,16,15-19,5
33,2,0,0,2,2021-12-24,Female,60,55-64,9
33,3,0,0,3,2021-12-24,Male,1,1-4,2
33,1,0,0,1,2021-12-28,Female,42,35-44,6
33,2,0,0,2,2021-12-24,Female,54,45-54,7
33,1,0,0,1,2021-12-24,Female,39,35-44,5
33,1,0,0,1,2021-12-28,Female,71,70-74,6
33,1,2,0,3,2021-12-26,Female,67,65-69,6
33,0,0,0,0,2021-12-27,Male,40,35-44,12
33,0,0,2,2,2021-12-31,Male,32,25-34,11
33,3,2,0,5,2021-12-31,Male,1,1-4,11
33,0,0,0,0,2021-12-27,Male,42,35-44,14
33,1,0,0,1,2021-12-25,Female,54,45-54,13
33,0,0,0,0,2021-12-28,Female,69,65-69,7
33,1,1,11,13,2021-12-27,Male,78,75-79,4
33,3,3,0,6,2021-12-29,Male,20,20-24,1
33,1,0,0,1,2021-12-26,Female,25,25-34,10
33,1,0,0,1,2021-12-24,Female,69,65-69,7
33,1,1,0,2,2021-12-28,Male,43,35-44,9
33,1,0,0,1,2021-12-24,Male,50,45-54,11
33,0,2,0,2,2021-12-24,Female,29,25-34,2
33,2,5,0,7,2021-12-30,Male,30,25-34,2
33,0,2,0,2,2021-12-28,Female,34,25-34,2
33,1,0,0,1,2021-12-29,Male,21,20-24,1
33,0,0,0,0,2021-12-24,Male,60,55-64,7
33,1,2,0,3,2021-12-27,Male,50,45-54,8
33,1,0,0,1,2021-12-24,Female,61,55-64,6
33,1,0,0,1,2021-12-26,Male,70,70-74,6
33,1,0,0,1,2021-12-24,Male,24,20-24,15
33,1,1,0,2,2021-12-24,Female,65,65-69,12
33,0,0,0,0,2021-12-27,Female,51,45-54,15
33,0,1,0,1,2021-12-27,Female,43,35-44,10
33,0,0,0,0,2021-12-28,Female,75,75-79,10
33,0,4,0,4,2021-12-25,Male,68,65-69,8
33,1,0,0,1,2021-12-28,Female,41,35-44,6
33,2,0,0,2,2021-12-25,Female,24,20-24,4
33,0,8,0,8,2021-12-24,Male,58,55-64,8
33,2,0,0,2,2021-12-26,Male,68,65-69,6
33,1,0,0,1,2021-12-28,Male,33,25-34,1
33,2,0,0,2,2021-12-28,Male,50,45-54,5
33,1,0,0,1,2021-12-28,Female,30,25-34,6
33,0,4,0,4,2021-12-31,Female,26,25-34,4
33,0,0,0,0,2021-12-27,Male,34,25-34,7
33,1,4,0,5,2021-12-26,Female,61,55-64,6
33,0,0,0,0,2021-12-27,Male,49,45-54,9
33,2,0,0,2,2021-12-26,Male,67,65-69,5
33,0,0,0,0,2021-12-28,Male,30,25-34,2
33,1,0,0,1,2021-12-26,Male,55,55-64,10
33,2,0,0,2,2021-12-28,Male,1,1-4,1
33,1,2,0,3,2021-12-28,Male,66,65-69,4
33,3,0,0,3,2021-12-27,Female,19,15-19,5
33,3,0,0,3,2021-12-27,Male,14,10-14,5
33,0,0,0,0,2021-12-28,Male,46,45-54,8
33,1,0,0,1,2021-12-24,Male,73,70-74,7
33,0,0,0,0,2021-12-28,Male,41,35-44,6
33,1,0,0,1,2021-12-24,Male,64,55-64,11
33,0,0,0,0,2021-12-27,Male,72,70-74,10
33,0,0,0,0,2021-12-31,Female,67,65-69,16
33,2,0,0,2,2021-12-30,Female,2,1-4,1
33,1,0,0,1,2021-12-27,Male,45,45-54,11
33,1,2,0,3,2021-12-24,Male,74,70-74,6
33,0,0,0,0,2021-12-27,Male,77,75-79,6
33,1,0,0,1,2021-12-26,Female,68,65-69,11
33,0,0,0,0,2021-12-24,Male,60,55-64,10
33,1,2,0,3,2021-12-26,Female,33,25-34,5
33,1,2,0,3,2021-12-24,Male,75,75-79,5
33,0,0,0,0,2021-12-27,Male,62,55-64,2
33,0,0,0,0,2021-12-25,Male,59,55-64,5
33,0,0,0,0,2021-12-26,Female,67,65-69,7
33,1,2,0,3,2021-12-28,Female,65,65-69,10
33,2,0,0,2,2021-12-27,Female,22,20-24,15
33,1,0,0,1,2021-12-24,Male,77,75-79,8
33,2,4,0,6,2021-12-31,Male,52,45-54,7
33,0,1,0,1,2021-12-28,Female,25,25-34,2
33,1,2,0,3,2021-12-27,Female,73,70-74,10
33,0,2,0,2,2021-12-24,Male,57,55-64,6
33,3,0,0,3,2021-12-24,Female,27,25-34,5
33,1,0,0,1,2021-12-28,Male,9,5-9,6
33,0,0,0,0,2021-12-24,Male,49,45-54,7
33,0,2,0,2,2021-12-28,Female,33,25-34,1
33,1,1,0,2,2021-12-28,Male,72,70-74,7
33,1,4,0,5,2021-12-24,Female,37,35-44,9
33,1,2,0,3,2021-12-25,Female,20,20-24,2
33,1,0,0,1,2021-12-28,Female,26,25-34,1
33,0,1,0,1,2021-12-24,Female,66,65-69,7
33,3,0,0,3,2021-12-28,Male,2,1-4,1
33,2,0,0,2,2021-12-28,Female,48,45-54,7
33,0,0,0,0,2021-12-24,Male,54,45-54,7
33,1,4,0,5,2021-12-28,Female,31,25-34,1
33,1,0,0,1,2021-12-24,Female,62,55-64,6
33,0,0,0,0,2021-12-24,Male,24,20-24,13
33,0,0,0,0,2021-12-24,Female,50,45-54,6
33,0,0,0,0,2021-12-25,Female,61,55-64,3
33,1,0,0,1,2021-12-30,Male,8,5-9,1
33,0,6,0,6,2021-12-25,Female,50,45-54,8
33,1,5,0,6,2021-12-27,Male,73,70-74,5
33,0,2,0,2,2021-12-24,Male,34,25-34,4
33,1,0,0,1,2021-12-24,Female,54,45-54,8
33,2,2,0,4,2021-12-24,Male,18,15-19,13
33,0,2,0,2,2021-12-29,Female,27,25-34,1
33,1,3,0,4,2021-12-27,Female,51,45-54,6
33,1,0,0,1,2021-12-31,Male,32,25-34,1
33,2,3,0,5,2021-12-27,Female,0,<1,9
33,3,0,0,3,2021-12-30,Male,24,20-24,1
33,1,0,0,1,2021-12-24,Male,75,75-79,9
33,1,0,0,1,2021-12-28,Female,54,45-54,10
33,0,0,0,0,2021-12-27,Male,46,45-54,6
33,1,5,0,6,2021-12-24,Female,64,55-64,5
33,0,0,0,0,2021-12-24,Female,62,55-64,7
33,0,0,0,0,2021-12-27,Male,72,70-74,5
33,1,0,0,1,2021-12-28,Male,70,70-74,6
33,1,1,0,2,2021-12-28,Male,31,25-34,1
33,0,0,0,0,2021-12-26,Male,34,25-34,12
33,2,0,0,2,2021-12-28,Male,6,5-9,1
33,0,0,0,0,2021-12-27,Male,43,35-44,11
33,1,0,0,1,2021-12-28,Male,75,75-79,5
33,3,0,0,3,2021-12-24,Female,19,15-19,6
33,0,0,0,0,2021-12-27,Female,48,45-54,8
33,3,0,0,3,2021-12-27,Male,56,55-64,10
33,0,0,0,0,2021-12-25,Male,68,65-69,4
33,2,0,0,2,2021-12-24,Male,18,15-19,13
33,0,0,0,0,2021-12-24,Female,29,25-34,6
33,0,7,0,7,2021-12-25,Female,62,55-64,5
33,0,1,0,1,2021-12-26,Male,70,70-74,7
33,0,1,0,1,2021-12-27,Female,73,70-74,8
33,3,0,0,3,2021-12-28,Female,20,20-24,2
33,1,1,0,2,2021-12-28,Male,71,70-74,20
33,1,0,0,1,2021-12-31,Male,70,70-74,8
33,0,2,0,2,2021-12-26,Male,63,55-64,8
33,2,2,0,4,2021-12-27,Male,9,5-9,6
33,3,1,0,4,2021-12-28,Male,14,10-14,8
33,0,0,0,0,2021-12-24,Female,37,35-44,6
33,0,2,0,2,2021-12-24,Male,28,25-34,12
33,1,0,0,1,2021-12-24,Female,73,70-74,7
33,1,0,0,1,2021-12-28,Female,58,55-64,7
33,0,0,0,0,2021-12-26,Female,63,55-64,4
33,0,0,0,0,2021-12-24,Male,64,55-64,6
33,1,0,1,2,2021-12-28,Female,45,45-54,9
33,0,2,0,2,2021-12-24,Female,76,75-79,10
33,0,0,0,0,2021-12-27,Male,45,45-54,21
33,0,10,0,10,2021-12-25,Male,55,55-64,4
33,1,0,0,1,2021-12-28,Female,67,65-69,4
33,0,3,0,3,2021-12-25,Female,23,20-24,5
33,1,0,0,1,2021-12-25,Female,56,55-64,6
33,0,0,0,0,2021-12-26,Male,70,70-74,13
33,0,0,0,0,2021-12-24,Female,60,55-64,6
33,1,0,0,1,2021-12-25,Male,29,25-34,11
33,1,1,0,2,2021-12-28,Male,70,70-74,5
33,0,0,0,0,2021-12-25,Male,49,45-54,9
33,1,0,0,1,2021-12-24,Male,61,55-64,18
33,2,4,0,6,2021-12-24,Male,10,10-14,6
33,1,3,0,4,2021-12-26,Female,67,65-69,5
33,0,0,0,0,2021-12-27,Male,73,70-74,6
33,0,0,0,0,2021-12-26,Female,33,25-34,4
33,1,0,0,1,2021-12-24,Male,54,45-54,2
33,1,1,0,2,2021-12-24,Male,62,55-64,7
33,1,0,0,1,2021-12-24,Male,73,70-74,4
33,0,0,0,0,2021-12-27,Female,40,35-44,6
33,0,0,0,0,2021-12-29,Male,37,35-44,5
33,0,0,4,4,2021-12-26,Female,34,25-34,5
33,0,1,4,5,2021-12-28,Female,75,75-79,7
33,1,6,0,7,2021-12-28,Male,44,35-44,2
33,0,0,0,0,2021-12-28,Male,47,45-54,3
33,1,0,0,1,2021-12-28,Female,71,70-74,12
33,1,0,0,1,2021-12-24,Female,64,55-64,5
33,2,0,0,2,2021-12-31,Male,7,5-9,7
33,0,0,0,0,2021-12-24,Female,59,55-64,7
33,2,0,0,2,2021-12-28,Male,16,15-19,20
33,0,0,0,0,2021-12-24,Female,64,55-64,6
33,1,2,0,3,2021-12-24,Male,75,75-79,7
33,0,0,0,0,2021-12-28,Male,51,45-54,6
33,0,4,0,4,2021-12-27,Female,73,70-74,5
33,1,1,0,2,2021-12-30,Female,52,45-54,7
33,0,1,0,1,2021-12-27,Male,73,70-74,4
33,2,0,0,2,2021-12-28,Male,66,65-69,12
33,1,0,0,1,2021-12-27,Female,41,35-44,4
33,2,2,0,4,2021-12-27,Female,44,35-44,7
33,1,0,0,1,2021-12-24,Male,74,70-74,7
33,2,4,0,6,2021-12-28,Female,55,55-64,6
33,0,0,0,0,2021-12-27,Male,42,35-44,7
33,1,1,0,2,2021-12-25,Female,65,65-69,5
33,0,0,0,0,2021-12-28,Male,4,1-4,17
33,3,0,0,3,2021-12-31,Male,2,1-4,1
33,1,1,0,2,2021-12-25,Female,69,65-69,18
33,0,5,0,5,2021-12-27,Female,71,70-74,21
33,1,0,0,1,2021-12-24,Male,69,65-69,22
33,0,0,0,0,2021-12-28,Female,32,25-34,5
33,1,0,0,1,2021-12-24,Female,37,35-44,8
33,1,2,0,3,2021-12-26,Female,53,45-54,3
33,3,0,0,3,2021-12-31,Male,12,10-14,5
33,0,0,0,0,2021-12-24,Female,75,75-79,7
33,1,0,0,1,2021-12-28,Male,10,10-14,12
33,2,0,0,2,2021-12-24,Male,66,65-69,6
33,1,0,0,1,2021-12-27,Male,43,35-44,12
33,2,0,0,2,2021-12-24,Male,61,55-64,2
33,2,2,5,9,2021-12-28,Female,10,10-14,8
33,0,1,0,1,2021-12-27,Female,27,25-34,6
33,1,1,0,2,2021-12-31,Male,59,55-64,7
33,0,1,0,1,2021-12-28,Male,35,35-44,7
33,1,0,0,1,2021-12-24,Female,69,65-69,7
33,0,0,0,0,2021-12-26,Male,70,70-74,7
33,1,0,0,1,2021-12-27,Female,18,15-19,4
33,2,4,0,6,2021-12-28,Female,1,1-4,5
33,0,0,0,0,2021-12-25,Female,70,70-74,21
33,0,2,0,2,2021-12-26,Female,75,75-79,2
33,0,0,0,0,2021-12-26,Male,41,35-44,5
33,1,0,0,1,2021-12-24,Male,54,45-54,7
33,1,0,0,1,2021-12-28,Male,71,70-74,5
33,1,0,0,1,2021-12-24,Female,30,25-34,8
33,0,0,0,0,2021-12-28,Male,41,35-44,4
33,1,0,0,1,2021-12-24,Female,66,65-69,19
33,2,1,0,3,2021-12-25,Female,62,55-64,2
33,0,0,0,0,2021-12-24,Male,49,45-54,10
33,1,0,0,1,2021-12-27,Female,18,15-19,9
33,1,0,0,1,2021-12-28,Female,29,25-34,1
33,4,0,0,4,2021-12-26,Male,0,<1,6
33,1,0,0,1,2021-12-24,Male,35,35-44,12
33,3,0,0,3,2021-12-24,Female,58,55-64,7
33,1,0,0,1,2021-12-28,Male,77,75-79,4
33,1,0,0,1,2021-12-24,Male,76,75-79,21
33,3,2,0,5,2021-12-25,Male,18,15-19,10
33,1,0,0,1,2021-12-27,Male,46,45-54,10
33,1,1,0,2,2021-12-26,Male,63,55-64,6
33,2,0,0,2,2021-12-26,Female,66,65-69,4
33,3,0,0,3,2021-12-31,Male,7,5-9,2
33,0,0,0,0,2021-12-28,Female,54,45-54,6
33,0,0,0,0,2021-12-30,Female,23,20-24,1
33,1,2,0,3,2021-12-30,Female,19,15-19,2
33,1,0,0,1,2021-12-26,Male,66,65-69,5
33,0,0,0,0,2021-12-27,Female,72,70-74,9
33,1,0,0,1,2021-12-24,Female,53,45-54,6
33,1,0,0,1,2021-12-24,Male,58,55-64,13
33,1,3,0,4,2021-12-24,Female,57,55-64,9
33,1,0,0,1,2021-12-28,Male,71,70-74,5
33,1,0,0,1,2021-12-24,Female,58,55-64,7
33,0,0,0,0,2021-12-28,Male,53,45-54,15
33,1,0,0,1,2021-12-28,Female,30,25-34,1
33,0,0,0,0,2021-12-28,Female,55,55-64,13
33,0,1,0,1,2021-12-26,Male,66,65-69,12
33,2,0,0,2,2021-12-28,Female,42,35-44,7
33,1,2,0,3,2021-12-24,Female,68,65-69,2
33,0,1,0,1,2021-12-27,Male,52,45-54,10
33,1,1,0,2,2021-12-24,Male,56,55-64,12
33,1,0,0,1,2021-12-28,Male,70,70-74,6
33,0,0,0,0,2021-12-28,Male,34,25-34,1
33,2,0,0,2,2021-12-27,Male,7,5-9,7
33,1,0,0,1,2021-12-25,Male,27,25-34,11
33,0,1,0,1,2021-12-24,Male,57,55-64,11
33,0,0,0,0,2021-12-28,Male,73,70-74,8
33,1,4,0,5,2021-12-30,Female,41,35-44,8
33,0,0,0,0,2021-12-25,Male,56,55-64,7
33,1,0,0,1,2021-12-27,Female,72,70-74,12
33,3,1,0,4,2021-12-28,Female,9,5-9,8
33,0,0,0,0,2021-12-25,Female,59,55-64,22
33,2,0,0,2,2021-12-25,Female,12,10-14,2
33,1,0,0,1,2021-12-27,Male,45,45-54,11
33,0,4,0,4,2021-12-30,Female,32,25-34,3
33,1,0,0,1,2021-12-31,Female,54,45-54,18
33,1,0,0,1,2021-12-31,Male,66,65-69,8
33,0,0,0,0,2021-12-28,Female,45,45-54,8
33,1,0,0,1,2021-12-27,Male,52,45-54,6
33,2,0,0,2,2021-12-24,Female,36,35-44,20
33,3,5,0,8,2021-12-25,Male,19,15-19,8
33,0,0,0,0,2021-12-28,Female,46,45-54,11
33,1,0,0,1,2021-12-25,Female,60,55-64,8
33,1,0,0,1,2021-12-27,Male,72,70-74,13
33,1,2,0,3,2021-12-27,Female,46,45-54,7
33,0,0,0,0,2021-12-31,Female,6,5-9,19
33,3,0,0,3,2021-12-28,Male,4,1-4,2
33,4,0,0,4,2021-12-28,Female,21,20-24,1
33,2,0,0,2,2021-12-24,Female,0,<1,12
33,0,0,0,0,2021-12-29,Female,22,20-24,2
33,3,2,0,5,2021-12-27,Male,51,45-54,15
33,2,3,0,5,2021-12-24,Female,68,65-69,5
33,1,2,0,3,2021-12-26,Female,63,55-64,3
33,2,0,0,2,2021-12-26,Female,40,35-44,10
33,1,1,0,2,2021-12-27,Male,31,25-34,4
33,0,2,0,2,2021-12-24,Male,60,55-64,12
33,0,0,0,0,2021-12-27,Female,41,35-44,12
33,0,2,0,2,2021-12-24,Male,64,55-64,2
33,0,2,0,2,2021-12-24,Male,39,35-44,7
33,1,0,0,1,2021-12-24,Female,54,45-54,12
33,0,0,0,0,2021-12-24,Male,53,45-54,13
33,0,0,0,0,2021-12-28,Male,27,25-34,1
33,1,0,0,1,2021-12-27,Male,47,45-54,8
33,1,0,0,1,2021-12-24,Male,68,65-69,5
33,1,0,0,1,2021-12-24,Male,69,65-69,7
33,2,33,15,50,2021-12-24,Male,69,65-69,14
33,2,0,0,2,2021-12-27,Female,18,15-19,9
33,0,1,0,1,2021-12-27,Male,80,80-84,11
33,0,0,0,0,2021-12-27,Female,43,35-44,4
33,1,4,0,5,2021-12-28,Female,66,65-69,11
33,1,2,0,3,2021-12-26,Male,2,1-4,4
33,1,2,0,3,2021-12-24,Female,67,65-69,10
33,0,1,100,101,2021-12-24,Male,65,65-69,7
33,2,0,0,2,2021-12-28,Female,27,25-34,23
33,1,0,0,1,2021-12-27,Female,45,45-54,5
33,1,0,1,2,2021-12-27,Male,74,70-74,5
33,0,3,0,3,2021-12-28,Female,34,25-34,11
33,1,0,0,1,2021-12-27,Male,32,25-34,10
33,0,0,0,0,2021-12-27,Female,8,5-9,9
33,1,0,0,1,2021-12-27,Male,58,55-64,6
33,1,0,0,1,2021-12-30,Male,34,25-34,4
33,0,1,0,1,2021-12-24,Male,54,45-54,10
33,0,0,0,0,2021-12-28,Female,53,45-54,4
33,0,1,0,1,2021-12-28,Male,69,65-69,7
33,0,10,11,21,2021-12-31,Male,39,35-44,5
33,1,0,0,1,2021-12-28,Male,29,25-34,7
33,1,0,0,1,2021-12-24,Male,58,55-64,8
33,1,0,0,1,2021-12-25,Female,53,45-54,5
33,1,0,0,1,2021-12-26,Male,70,70-74,28
33,0,0,0,0,2021-12-31,Female,42,35-44,4
33,1,0,0,1,2021-12-31,Female,25,25-34,1
33,0,3,0,3,2021-12-31,Male,73,70-74,4
33,1,0,0,1,2021-12-24,Male,59,55-64,13
33,0,0,0,0,2021-12-28,Male,18,15-19,13
33,1,0,0,1,2021-12-28,Female,9,5-9,6
33,1,100,0,101,2021-12-24,Female,51,45-54,6
33,1,1,0,2,2021-12-27,Female,41,35-44,6
33,2,2,0,4,2021-12-28,Male,1,1-4,12
33,1,9,0,10,2021-12-28,Male,20,20-24,1
33,1,0,0,1,2021-12-28,Male,30,25-34,1
33,2,0,0,2,2021-12-24,Male,75,75-79,6
33,1,3,0,4,2021-12-28,Female,5,5-9,5
33,0,0,0,0,2021-12-24,Male,57,55-64,8
33,1,0,0,1,2021-12-28,Female,66,65-69,10
33,1,2,0,3,2021-12-24,Male,58,55-64,6
33,0,0,0,0,2021-12-28,Female,6,5-9,23
33,0,0,0,0,2021-12-24,Female,38,35-44,10
33,0,0,0,0,2021-12-24,Male,52,45-54,7
33,1,1,0,2,2021-12-27,Male,52,45-54,8
33,0,0,0,0,2021-12-24,Male,28,25-34,6
33,1,0,0,1,2021-12-27,Female,52,45-54,5
33,2,0,0,2,2021-12-26,Female,67,65-69,24
33,1,0,0,1,2021-12-24,Female,53,45-54,4
33,0,1,0,1,2021-12-26,Female,66,65-69,7
33,0,0,0,0,2021-12-26,Female,71,70-74,13
33,0,0,0,0,2021-12-26,Female,31,25-34,6
33,2,1,0,3,2021-12-30,Male,29,25-34,1
33,0,0,0,0,2021-12-30,Female,30,25-34,1
33,0,0,0,0,2021-12-27,Male,58,55-64,10
33,0,0,0,0,2021-12-27,Male,77,75-79,4
33,1,1,0,2,2021-12-26,Male,66,65-69,11
33,1,0,0,1,2021-12-25,Female,62,55-64,2
33,2,2,0,4,2021-12-24,Female,18,15-19,12
33,1,0,0,1,2021-12-24,Female,65,65-69,11
33,2,5,0,7,2021-12-31,Female,27,25-34,2
33,1,1,0,2,2021-12-25,Female,56,55-64,6
33,1,0,0,1,2021-12-26,Female,66,65-69,12
33,0,0,0,0,2021-12-27,Female,26,25-34,4
33,1,0,0,1,2021-12-24,Male,54,45-54,10
33,1,3,0,4,2021-12-24,Female,69,65-69,8
33,0,0,0,0,2021-12-28,Female,42,35-44,8
33,1,0,0,1,2021-12-24,Male,69,65-69,7
33,6,0,0,6,2021-12-27,Female,1,1-4,7
33,0,0,0,0,2021-12-31,Male,66,65-69,3
33,1,0,0,1,2021-12-28,Male,28,25-34,1
33,1,3,0,4,2021-12-25,Male,61,55-64,5
33,1,0,0,1,2021-12-24,Female,63,55-64,12
33,0,1,0,1,2021-12-24,Male,57,55-64,5
33,0,0,0,0,2021-12-24,Male,61,55-64,12
33,0,0,0,0,2021-12-28,Male,38,35-44,6
33,1,0,0,1,2021-12-24,Male,69,65-69,8
33,0,0,0,0,2021-12-27,Male,15,15-19,10
33,1,0,0,1,2021-12-28,Female,44,35-44,9
33,1,0,0,1,2021-12-27,Male,52,45-54,11
33,0,0,0,0,2021-12-26,Female,66,65-69,10
33,0,0,0,0,2021-12-24,Female,50,45-54,27
33,3,0,0,3,2021-12-28,Female,20,20-24,4
33,0,8,12,20,2021-12-28,Female,64,55-64,8
33,1,0,0,1,2021-12-28,Male,18,15-19,1
33,0,0,0,0,2021-12-28,Male,47,45-54,10
33,1,0,0,1,2021-12-24,Female,21,20-24,12
33,1,0,4,5,2021-12-27,Male,71,70-74,4
33,1,0,0,1,2021-12-24,Female,36,35-44,6
33,0,0,0,0,2021-12-24,Female,50,45-54,5
33,1,1,0,2,2021-12-28,Female,25,25-34,3
33,0,1,0,1,2021-12-24,Male,54,45-54,6
33,0,0,0,0,2021-12-28,Male,26,25-34,1
33,2,0,6,8,2021-12-27,Male,67,65-69,13
33,0,0,0,0,2021-12-28,Female,33,25-34,1
33,0,11,0,11,2021-12-25,Female,58,55-64,2
33,0,0,0,0,2021-12-31,Male,74,70-74,5
33,0,1,0,1,2021-12-24,Male,64,55-64,12
33,0,3,0,3,2021-12-27,Female,67,65-69,8
33,2,0,0,2,2021-12-27,Male,52,45-54,13
33,1,0,0,1,2021-12-31,Male,80,80-84,3
33,0,0,0,0,2021-12-27,Female,81,80-84,15
33,4,0,0,4,2021-12-31,Male,12,10-14,10
33,1,0,0,1,2021-12-27,Female,46,45-54,2
33,0,0,0,0,2021-12-24,Female,65,65-69,7
33,1,0,0,1,2021-12-28,Male,77,75-79,7
33,1,0,0,1,2021-12-27,Female,41,35-44,10
33,1,0,0,1,2021-12-26,Female,41,35-44,7
33,1,0,0,1,2021-12-26,Male,68,65-69,11
33,0,1,0,1,2021-12-26,Male,71,70-74,6
33,1,0,3,4,2021-12-28,Male,17,15-19,1
33,0,0,0,0,2021-12-28,Male,65,65-69,12
33,0,1,0,1,2021-12-24,Female,30,25-34,12
33,0,0,0,0,2021-12-30,Female,28,25-34,1
33,0,1,0,1,2021-12-25,Female,55,55-64,4
33,0,0,0,0,2021-12-27,Male,31,25-34,23
33,0,0,0,0,2021-12-28,Female,19,15-19,1
33,0,0,0,0,2021-12-27,Female,44,35-44,12
33,3,0,0,3,2021-12-31,Male,8,5-9,1
33,0,0,0,0,2021-12-24,Male,64,55-64,6
33,1,2,0,3,2021-12-24,Male,63,55-64,2
33,3,2,0,5,2021-12-27,Female,10,10-14,6
33,1,3,0,4,2021-12-27,Female,72,70-74,6
33,1,0,0,1,2021-12-28,Female,30,25-34,1
33,1,0,0,1,2021-12-24,Male,70,70-74,2
33,0,0,0,0,2021-12-28,Female,22,20-24,2
33,0,1,0,1,2021-12-28,Male,65,65-69,27
33,4,0,0,4,2021-12-28,Female,3,1-4,1
33,0,0,0,0,2021-12-27,Male,51,45-54,11
33,0,1,0,1,2021-12-24,Male,54,45-54,12
33,1,2,4,7,2021-12-26,Male,64,55-64,5
33,1,7,0,8,2021-12-27,Male,83,80-84,5
33,1,0,0,1,2021-12-26,Male,68,65-69,10
33,1,0,0,1,2021-12-24,Female,61,55-64,8
33,0,0,31,31,2021-12-26,Female,66,65-69,18
33,1,0,0,1,2021-12-27,Female,48,45-54,5
33,1,0,0,1,2021-12-26,Female,66,65-69,6
33,3,0,0,3,2021-12-24,Female,1,1-4,7
33,0,0,0,0,2021-12-24,Female,49,45-54,13
33,1,0,0,1,2021-12-27,Female,72,70-74,13
33,0,0,0,0,2021-12-24,Male,36,35-44,4
33,0,0,0,0,2021-12-28,Male,52,45-54,5
33,5,3,0,8,2021-12-28,Female,36,35-44,2
33,1,0,0,1,2021-12-30,Female,52,45-54,7
33,0,1,0,1,2021-12-26,Male,56,55-64,7
33,0,0,0,0,2021-12-29,Male,10,10-14,16
33,0,1,0,1,2021-12-28,Female,67,65-69,8
33,1,0,0,1,2021-12-27,Female,72,70-74,8
33,0,1,0,1,2021-12-24,Female,53,45-54,5
33,0,2,0,2,2021-12-26,Female,53,45-54,5
33,0,1,0,1,2021-12-27,Female,33,25-34,3
33,0,0,0,0,2021-12-28,Female,68,65-69,11
33,0,6,0,6,2021-12-26,Male,55,55-64,24
33,0,0,0,0,2021-12-28,Female,53,45-54,4
33,1,4,0,5,2021-12-28,Female,48,45-54,11
33,0,0,0,0,2021-12-24,Male,57,55-64,5
33,0,4,0,4,2021-12-24,Female,51,45-54,12
33,2,0,0,2,2021-12-25,Male,9,5-9,12
33,2,0,1,3,2021-12-24,Female,30,25-34,7
33,4,1,0,5,2021-12-27,Male,4,1-4,6
33,2,3,0,5,2021-12-29,Female,7,5-9,4
33,1,0,0,1,2021-12-28,Female,42,35-44,13
33,0,2,0,2,2021-12-24,Female,64,55-64,5
33,1,0,0,1,2021-12-25,Male,50,45-54,14
33,1,0,0,1,2021-12-24,Male,65,65-69,3
33,2,3,0,5,2021-12-29,Male,37,35-44,10
33,1,0,0,1,2021-12-28,Female,76,75-79,7
33,2,0,0,2,2021-12-28,Female,0,<1,1
33,0,0,0,0,2021-12-27,Female,54,45-54,14
33,1,0,0,1,2021-12-24,Male,59,55-64,2
33,0,0,0,0,2021-12-24,Male,65,65-69,7
33,2,0,0,2,2021-12-27,Male,10,10-14,6
33,0,1,0,1,2021-12-24,Female,76,75-79,5
33,1,1,0,2,2021-12-28,Female,32,25-34,8
33,1,7,0,8,2021-12-26,Female,24,20-24,3
33,2,0,0,2,2021-12-28,Female,18,15-19,5
33,1,0,0,1,2021-12-26,Female,64,55-64,5
33,2,0,0,2,2021-12-24,Male,61,55-64,20
33,1,1,0,2,2021-12-24,Female,34,25-34,10
33,0,0,0,0,2021-12-27,Female,51,45-54,17
33,1,0,0,1,2021-12-28,Male,3,1-4,1
33,1,1,0,2,2021-12-28,Female,68,65-69,9
33,2,0,0,2,2021-12-24,Male,56,55-64,4
33,0,0,0,0,2021-12-25,Female,61,55-64,8
33,2,0,0,2,2021-12-28,Male,2,1-4,13
33,0,0,0,0,2021-12-24,Female,59,55-64,6
33,3,0,0,3,2021-12-24,Male,24,20-24,5
33,0,3,0,3,2021-12-26,Female,31,25-34,8
33,3,0,0,3,2021-12-27,Male,5,5-9,13
33,0,0,0,0,2021-12-28,Female,68,65-69,24
33,0,2,0,2,2021-12-24,Male,52,45-54,2
33,0,0,0,0,2021-12-24,Female,50,45-54,5
33,0,0,0,0,2021-12-28,Female,80,80-84,18
33,2,0,0,2,2021-12-26,Female,68,65-69,5
33,0,0,0,0,2021-12-25,Male,85,85+,23
33,1,0,0,1,2021-12-26,Male,56,55-64,7
33,1,1,0,2,2021-12-27,Male,67,65-69,7
33,0,0,0,0,2021-12-30,Female,2,1-4,6
33,2,0,0,2,2021-12-28,Male,54,45-54,11
33,0,0,0,0,2021-12-31,Female,29,25-34,1
33,0,0,0,0,2021-12-27,Male,33,25-34,17
33,2,0,0,2,2021-12-24,Female,36,35-44,3
33,0,0,0,0,2021-12-24,Male,28,25-34,2
33,2,0,0,2,2021-12-26,Male,67,65-69,24
33,0,5,0,5,2021-12-24,Male,69,65-69,8
33,0,3,0,3,2021-12-24,Male,64,55-64,7
33,1,0,0,1,2021-12-24,Female,62,55-64,6
33,0,0,0,0,2021-12-26,Male,67,65-69,4
33,1,0,0,1,2021-12-24,Female,70,70-74,7
33,4,0,0,4,2021-12-24,Female,1,1-4,5
33,0,0,0,0,2021-12-27,Male,46,45-54,8
33,1,0,0,1,2021-12-28,Male,79,75-79,7
33,1,1,0,2,2021-12-24,Male,62,55-64,6
33,0,0,0,0,2021-12-27,Male,51,45-54,10
33,4,0,0,4,2021-12-30,Female,19,15-19,1
33,1,0,0,1,2021-12-24,Male,60,55-64,7
33,0,0,0,0,2021-12-26,Female,60,55-64,3
33,1,5,0,6,2021-12-25,Female,74,70-74,2
33,1,2,0,3,2021-12-24,Male,74,70-74,8
33,0,0,0,0,2021-12-27,Male,41,35-44,9
33,0,4,0,4,2021-12-28,Male,41,35-44,19
33,0,2,0,2,2021-12-25,Female,56,55-64,5
33,2,1,0,3,2021-12-24,Male,68,65-69,12
33,1,4,0,5,2021-12-27,Male,72,70-74,8
33,3,0,0,3,2021-12-27,Female,48,45-54,3
33,1,1,0,2,2021-12-28,Male,70,70-74,10
33,0,0,0,0,2021-12-28,Male,69,65-69,7
33,2,0,0,2,2021-12-28,Male,44,35-44,12
33,1,0,0,1,2021-12-24,Male,60,55-64,9
33,0,2,0,2,2021-12-29,Female,52,45-54,4
33,0,1,0,1,2021-12-27,Male,52,45-54,9
33,3,0,0,3,2021-12-24,Male,52,45-54,8
33,2,0,0,2,2021-12-24,Male,58,55-64,6
33,2,2,0,4,2021-12-26,Male,34,25-34,9
33,1,4,0,5,2021-12-26,Male,71,70-74,4
33,0,0,0,0,2021-12-29,Female,54,45-54,6
33,1,0,0,1,2021-12-24,Female,77,75-79,11
33,1,1,0,2,2021-12-24,Male,54,45-54,12
33,0,0,0,0,2021-12-31,Male,56,55-64,7
33,0,0,0,0,2021-12-31,Female,50,45-54,5
33,0,33,0,33,2021-12-24,Female,61,55-64,6
33,1,0,0,1,2021-12-26,Female,67,65-69,7
33,3,3,0,6,2021-12-24,Male,0,<1,2
33,0,0,0,0,2021-12-24,Female,59,55-64,12
33,0,1,0,1,2021-12-24,Female,59,55-64,11
33,2,1,0,3,2021-12-27,Male,3,1-4,7
33,1,1,0,2,2021-12-29,Male,53,45-54,4
33,0,0,0,0,2021-12-27,Female,18,15-19,6
33,2,0,0,2,2021-12-26,Male,2,1-4,11
33,0,1,0,1,2021-12-25,Female,65,65-69,7
33,0,0,0,0,2021-12-26,Female,68,65-69,9
33,0,1,0,1,2021-12-28,Female,22,20-24,2
33,1,0,0,1,2021-12-24,Male,50,45-54,7
33,0,2,0,2,2021-12-28,Female,38,35-44,10
33,0,0,0,0,2021-12-26,Male,31,25-34,2
33,1,0,3,4,2021-12-25,Female,53,45-54,5
33,1,0,0,1,2021-12-24,Male,51,45-54,7
33,0,1,0,1,2021-12-24,Male,74,70-74,10
33,1,0,0,1,2021-12-27,Male,7,5-9,8
33,0,0,0,0,2021-12-27,Female,52,45-54,5
33,1,0,0,1,2021-12-24,Male,55,55-64,7
33,0,0,0,0,2021-12-25,Male,61,55-64,9
33,1,1,0,2,2021-12-24,Male,62,55-64,6
33,1,0,0,1,2021-12-28,Male,69,65-69,6
33,0,1,0,1,2021-12-28,Female,42,35-44,8
33,1,0,0,1,2021-12-28,Female,30,25-34,8
33,1,0,0,1,2021-12-27,Female,31,25-34,6
33,1,5,0,6,2021-12-24,Male,54,45-54,8
33,0,0,0,0,2021-12-26,Male,64,55-64,7
33,1,0,0,1,2021-12-24,Female,59,55-64,9
33,3,0,0,3,2021-12-28,Female,29,25-34,1
33,1,0,0,1,2021-12-24,Female,70,70-74,7
33,1,0,0,1,2021-12-25,Male,56,55-64,7
33,1,0,0,1,2021-12-28,Male,67,65-69,10
33,4,0,0,4,2021-12-24,Male,10,10-14,6
33,2,0,0,2,2021-12-25,Male,13,10-14,8
33,2,9,0,11,2021-12-27,Female,8,5-9,7
33,1,0,0,1,2021-12-28,Male,47,45-54,8
33,1,4,0,5,2021-12-26,Female,66,65-69,12
33,1,0,0,1,2021-12-28,Male,32,25-34,1
33,0,1,0,1,2021-12-26,Female,40,35-44,9
33,0,0,0,0,2021-12-28,Male,31,25-34,8
33,1,0,0,1,2021-12-24,Male,59,55-64,7
33,2,0,0,2,2021-12-26,Female,5,5-9,28
33,0,0,0,0,2021-12-28,Male,68,65-69,4
33,1,0,0,1,2021-12-27,Male,66,65-69,11
33,0,0,0,0,2021-12-28,Male,2,1-4,1
33,2,0,0,2,2021-12-24,Male,64,55-64,21
33,1,0,0,1,2021-12-26,Female,74,70-74,5
33,0,0,0,0,2021-12-28,Female,40,35-44,12
33,1,0,0,1,2021-12-27,Female,33,25-34,15
33,0,0,0,0,2021-12-25,Male,49,45-54,12
33,0,0,0,0,2021-12-27,Male,46,45-54,8
33,0,0,0,0,2021-12-29,Male,52,45-54,3
33,1,4,0,5,2021-12-27,Male,66,65-69,9
33,2,0,0,2,2021-12-28,Male,3,1-4,5
33,1,0,0,1,2021-12-27,Female,49,45-54,10
33,1,0,0,1,2021-12-24,Male,20,20-24,11
33,0,4,0,4,2021-12-27,Male,43,35-44,5
33,0,0,0,0,2021-12-29,Female,23,20-24,2
33,2,0,0,2,2021-12-27,Female,5,5-9,7
33,0,0,0,0,2021-12-24,Male,65,65-69,7
33,1,8,0,9,2021-12-28,Female,32,25-34,1
33,1,0,0,1,2021-12-28,Female,75,75-79,5
33,1,1,0,2,2021-12-28,Female,34,25-34,1
33,1,0,0,1,2021-12-24,Male,69,65-69,8
33,1,0,0,1,2021-12-28,Male,75,75-79,13
33,3,0,0,3,2021-12-27,Male,10,10-14,4
33,1,0,0,1,2021-12-25,Female,28,25-34,2
33,1,0,0,1,2021-12-24,Male,50,45-54,8
33,0,0,0,0,2021-12-24,Male,54,45-54,17
33,0,1,0,1,2021-12-27,Male,48,45-54,6
33,1,0,0,1,2021-12-28,Male,66,65-69,5
33,0,0,0,0,2021-12-26,Male,74,70-74,7
33,1,4,0,5,2021-12-25,Female,68,65-69,9
33,3,0,0,3,2021-12-24,Male,19,15-19,6
33,1,4,0,5,2021-12-27,Male,72,70-74,12
33,1,1,0,2,2021-12-25,Male,39,35-44,2
33,2,0,0,2,2021-12-28,Male,7,5-9,6
33,0,1,0,1,2021-12-27,Male,44,35-44,13
33,3,0,0,3,2021-12-24,Male,53,45-54,7
33,0,40,0,40,2021-12-24,Male,59,55-64,11
33,0,0,0,0,2021-12-26,Male,66,65-69,19
33,1,1,0,2,2021-12-26,Male,68,65-69,9
33,0,0,0,0,2021-12-27,Male,48,45-54,10
33,1,0,0,1,2021-12-24,Female,62,55-64,5
33,0,0,0,0,2021-12-24,Male,61,55-64,7
33,1,0,0,1,2021-12-31,Female,19,15-19,4
33,0,1,0,1,2021-12-24,Male,54,45-54,2
33,1,0,0,1,2021-12-24,Male,69,65-69,12
33,1,0,0,1,2021-12-28,Male,77,75-79,11
33,3,0,0,3,2021-12-28,Female,2,1-4,12
33,1,1,0,2,2021-12-24,Female,35,35-44,7
33,1,0,0,1,2021-12-26,Male,19,15-19,2
33,0,0,0,0,2021-12-24,Female,57,55-64,4
33,3,0,1,4,2021-12-31,Female,17,15-19,7
33,1,2,0,3,2021-12-24,Male,76,75-79,7
33,1,0,0,1,2021-12-26,Male,77,75-79,2
33,3,0,0,3,2021-12-28,Male,12,10-14,1
33,1,4,0,5,2021-12-24,Male,65,65-69,10
33,0,0,0,0,2021-12-25,Male,61,55-64,11
33,1,1,0,2,2021-12-24,Female,63,55-64,7
33,1,2,0,3,2021-12-25,Male,59,55-64,2
33,3,0,0,3,2021-12-27,Female,15,15-19,10
33,0,0,0,0,2021-12-28,Male,66,65-69,11
33,0,1,0,1,2021-12-25,Male,39,35-44,6
33,0,0,0,0,2021-12-28,Male,21,20-24,3
33,0,0,0,0,2021-12-26,Female,63,55-64,5
33,0,0,0,0,2021-12-24,Male,60,55-64,27
33,3,0,37,40,2021-12-28,Female,5,5-9,1
33,1,0,0,1,2021-12-26,Male,71,70-74,5
33,1,0,0,1,2021-12-24,Female,29,25-34,8
33,0,3,0,3,2021-12-24,Female,60,55-64,27
33,3,0,0,3,2021-12-26,Female,8,5-9,3
33,0,0,0,0,2021-12-28,Male,43,35-44,6
33,0,0,0,0,2021-12-26,Female,68,65-69,20
33,1,0,0,1,2021-12-28,Male,53,45-54,6
33,0,0,0,0,2021-12-28,Female,23,20-24,1
33,3,0,0,3,2021-12-24,Female,25,25-34,7
33,1,1,4,6,2021-12-26,Female,20,20-24,4
33,1,0,0,1,2021-12-25,Male,58,55-64,5
33,1,1,0,2,2021-12-28,Male,72,70-74,7
33,2,1,0,3,2021-12-28,Female,24,20-24,6
33,3,0,0,3,2021-12-28,Female,1,1-4,2
33,2,0,0,2,2021-12-24,Female,49,45-54,2
33,0,0,0,0,2021-12-25,Female,8,5-9,8
33,0,5,0,5,2021-12-25,Male,31,25-34,2
33,4,0,0,4,2021-12-28,Male,6,5-9,1
33,1,2,0,3,2021-12-26,Female,76,75-79,10
33,3,0,0,3,2021-12-28,Male,10,10-14,6
33,2,0,0,2,2021-12-27,Female,53,45-54,7
33,1,3,0,4,2021-12-28,Female,28,25-34,1
33,1,1,0,2,2021-12-25,Female,64,55-64,11
33,0,0,0,0,2021-12-27,Male,78,75-79,6
33,1,0,8,9,2021-12-24,Male,56,55-64,6
33,1,0,0,1,2021-12-26,Male,49,45-54,11
33,1,0,0,1,2021-12-24,Male,58,55-64,2
33,0,1,0,1,2021-12-24,Male,61,55-64,7
33,0,2,0,2,2021-12-24,Female,38,35-44,6
33,2,1,0,3,2021-12-24,Male,12,10-14,9
33,0,2,0,2,2021-12-27,Female,43,35-44,7
33,1,0,0,1,2021-12-24,Male,50,45-54,4
33,1,7,0,8,2021-12-28,Male,51,45-54,2
33,3,2,0,5,2021-12-26,Female,2,1-4,9
33,0,1,0,1,2021-12-24,Male,75,75-79,7
33,0,0,0,0,2021-12-24,Male,57,55-64,12
33,0,0,0,0,2021-12-27,Female,46,45-54,7
33,1,1,0,2,2021-12-25,Female,50,45-54,12
33,2,0,0,2,2021-12-24,Female,11,10-14,6
33,0,0,0,0,2021-12-24,Male,65,65-69,8
33,2,0,0,2,2021-12-26,Male,71,70-74,25
33,0,0,0,0,2021-12-27,Male,78,75-79,5
33,1,0,0,1,2021-12-24,Male,73,70-74,7
33,1,0,0,1,2021-12-27,Female,73,70-74,8
33,2,0,0,2,2021-12-24,Female,16,15-19,7
33,3,0,0,3,2021-12-28,Male,4,1-4,1
33,0,0,0,0,2021-12-24,Male,76,75-79,6
33,0,0,0,0,2021-12-26,Male,66,65-69,7
33,0,5,0,5,2021-12-28,Female,26,25-34,4
33,2,3,0,5,2021-12-25,Male,8,5-9,5
33,0,8,0,8,2021-12-28,Female,71,70-74,5
33,0,0,0,0,2021-12-24,Male,61,55-64,13
33,0,0,0,0,2021-12-24,Male,58,55-64,4
33,1,0,0,1,2021-12-27,Male,48,45-54,14
33,2,0,0,2,2021-12-27,Male,13,10-14,7
33,0,1,0,1,2021-12-27,Female,52,45-54,6
33,0,0,0,0,2021-12-27,Male,63,55-64,7
33,1,1,0,2,2021-12-28,Male,26,25-34,2
33,0,0,0,0,2021-12-28,Male,28,25-34,10
33,0,1,0,1,2021-12-28,Male,28,25-34,1
33,1,0,0,1,2021-12-27,Female,72,70-74,6
33,0,30,0,30,2021-12-24,Male,56,55-64,5
33,3,0,0,3,2021-12-26,Male,18,15-19,7
33,0,0,0,0,2021-12-24,Female,56,55-64,11
33,0,2,0,2,2021-12-24,Male,60,55-64,6
33,0,0,0,0,2021-12-26,Female,70,70-74,19
33,0,4,0,4,2021-12-24,Male,70,70-74,6
33,0,0,0,0,2021-12-27,Female,51,45-54,7
33,0,0,0,0,2021-12-28,Male,25,25-34,1
33,0,0,0,0,2021-12-24,Female,43,35-44,20
33,0,1,0,1,2021-12-24,Male,60,55-64,6
33,1,2,0,3,2021-12-24,Female,59,55-64,8
33,0,0,0,0,2021-12-29,Male,9,5-9,12
33,1,0,0,1,2021-12-28,Female,35,35-44,11
33,1,0,0,1,2021-12-25,Male,9,5-9,5
33,0,0,65,65,2021-12-28,Female,30,25-34,1
33,1,6,0,7,2021-12-24,Male,74,70-74,11
33,0,0,0,0,2021-12-30,Female,24,20-24,1
33,2,2,0,4,2021-12-28,Male,26,25-34,4
33,1,0,0,1,2021-12-30,Male,61,55-64,6
33,0,0,0,0,2021-12-28,Male,70,70-74,7
33,1,0,0,1,2021-12-26,Male,66,65-69,4
33,0,0,0,0,2021-12-28,Female,23,20-24,8
33,3,0,0,3,2021-12-24,Female,3,1-4,11
33,1,1,0,2,2021-12-24,Female,62,55-64,8
33,1,0,0,1,2021-12-25,Female,54,45-54,7
33,2,0,0,2,2021-12-28,Female,26,25-34,1
33,0,0,0,0,2021-12-28,Female,42,35-44,6
33,2,0,0,2,2021-12-30,Female,2,1-4,1
33,1,1,0,2,2021-12-25,Male,59,55-64,5
33,2,0,0,2,2021-12-24,Female,16,15-19,6
33,2,0,0,2,2021-12-28,Male,3,1-4,1
33,0,0,0,0,2021-12-28,Female,68,65-69,7
33,1,0,0,1,2021-12-24,Male,60,55-64,4
33,0,0,0,0,2021-12-31,Male,53,45-54,5
33,1,2,1,4,2021-12-24,Female,64,55-64,6
33,0,2,0,2,2021-12-27,Female,42,35-44,3
33,1,4,0,5,2021-12-26,Male,71,70-74,7
33,1,0,0,1,2021-12-31,Male,31,25-34,1
33,2,1,0,3,2021-12-28,Female,71,70-74,24
33,1,2,0,3,2021-12-28,Female,31,25-34,1
33,2,0,0,2,2021-12-25,Male,6,5-9,8
33,1,0,0,1,2021-12-24,Male,69,65-69,5
33,0,0,0,0,2021-12-28,Female,39,35-44,6
33,2,0,0,2,2021-12-27,Male,4,1-4,6
33,1,3,0,4,2021-12-27,Female,71,70-74,9
33,3,0,0,3,2021-12-26,Female,14,10-14,15
33,1,2,2,5,2021-12-26,Male,71,70-74,7
33,0,0,0,0,2021-12-28,Male,1,1-4,1
33,1,0,0,1,2021-12-24,Female,50,45-54,6
33,1,4,0,5,2021-12-28,Female,28,25-34,13
33,0,0,0,0,2021-12-24,Female,37,35-44,21
33,3,0,0,3,2021-12-26,Female,67,65-69,23
33,0,0,0,0,2021-12-24,Male,59,55-64,11
33,0,0,0,0,2021-12-24,Male,29,25-34,12
33,1,0,0,1,2021-12-24,Female,60,55-64,16
33,0,0,0,0,2021-12-26,Female,54,45-54,7
33,1,0,0,1,2021-12-24,Male,39,35-44,12
33,0,0,0,0,2021-12-27,Male,41,35-44,6
33,2,0,0,2,2021-12-27,Male,31,25-34,6
33,0,3,0,3,2021-12-24,Male,50,45-54,8
33,3,0,0,3,2021-12-24,Male,18,15-19,4
33,0,0,0,0,2021-12-24,Male,54,45-54,4
33,1,0,0,1,2021-12-24,Female,54,45-54,5
33,0,0,0,0,2021-12-28,Male,26,25-34,1
33,1,4,5,10,2021-12-31,Female,57,55-64,7
33,1,0,0,1,2021-12-27,Female,31,25-34,15
33,0,1,0,1,2021-12-26,Female,63,55-64,6
33,1,0,0,1,2021-12-25,Female,60,55-64,7
33,1,2,0,3,2021-12-26,Female,57,55-64,14
33,1,0,0,1,2021-12-26,Male,40,35-44,7
33,3,0,0,3,2021-12-26,Female,0,<1,7
33,1,2,0,3,2021-12-28,Male,68,65-69,6
33,0,0,0,0,2021-12-28,Female,72,70-74,6
33,1,0,0,1,2021-12-25,Female,55,55-64,12
33,0,0,0,0,2021-12-24,Male,58,55-64,6
33,1,0,0,1,2021-12-31,Female,73,70-74,13
33,1,0,0,1,2021-12-27,Female,43,35-44,8
33,1,1,0,2,2021-12-24,Male,62,55-64,6
33,0,0,0,0,2021-12-28,Male,72,70-74,3
33,0,3,0,3,2021-12-27,Female,25,25-34,12
33,1,1,0,2,2021-12-25,Male,70,70-74,7
33,2,0,0,2,2021-12-24,Male,35,35-44,13
33,1,0,0,1,2021-12-25,Female,54,45-54,3
33,0,0,0,0,2021-12-30,Female,34,25-34,2
33,0,0,0,0,2021-12-24,Female,65,65-69,12
33,1,4,0,5,2021-12-26,Male,63,55-64,23
33,0,0,0,0,2021-12-28,Male,45,45-54,12
33,1,0,0,1,2021-12-24,Female,58,55-64,5
33,0,0,0,0,2021-12-27,Male,47,45-54,16
33,3,0,0,3,2021-12-30,Female,2,1-4,1
33,0,0,0,0,2021-12-31,Female,70,70-74,7
33,3,0,0,3,2021-12-28,Male,2,1-4,1
33,0,1,0,1,2021-12-24,Male,65,65-69,10
33,0,0,0,0,2021-12-24,Male,28,25-34,2
33,0,0,0,0,2021-12-24,Male,58,55-64,6
33,2,1,0,3,2021-12-27,Female,45,45-54,5
33,0,0,0,0,2021-12-24,Female,65,65-69,6
33,2,0,0,2,2021-12-28,Male,12,10-14,4
33,0,0,0,0,2021-12-27,Female,41,35-44,7
33,0,2,0,2,2021-12-24,Female,57,55-64,12
33,0,0,0,0,2021-12-28,Male,81,80-84,3
33,1,2,0,3,2021-12-26,Female,67,65-69,6
33,2,1,0,3,2021-12-28,Female,11,10-14,7
33,2,0,0,2,2021-12-27,Male,45,45-54,13
33,1,2,0,3,2021-12-31,Female,72,70-74,5
33,2,0,0,2,2021-12-27,Female,47,45-54,10
33,0,0,0,0,2021-12-24,Male,68,65-69,10
33,1,0,0,1,2021-12-28,Female,39,35-44,12
33,0,0,0,0,2021-12-27,Male,51,45-54,9
33,1,0,0,1,2021-12-24,Female,31,25-34,2
33,3,1,0,4,2021-12-28,Male,16,15-19,12
33,1,3,0,4,2021-12-24,Male,63,55-64,8
33,2,2,0,4,2021-12-24,Male,18,15-19,7
33,2,0,1,3,2021-12-27,Male,72,70-74,22
33,0,4,0,4,2021-12-29,Female,54,45-54,14
33,0,0,0,0,2021-12-24,Female,55,55-64,5
33,1,0,0,1,2021-12-27,Male,60,55-64,8
33,0,5,0,5,2021-12-25,Female,61,55-64,7
33,1,0,0,1,2021-12-25,Female,59,55-64,25
33,3,24,0,27,2021-12-24,Male,17,15-19,12
33,3,0,0,3,2021-12-24,Male,2,1-4,9
33,0,1,0,1,2021-12-28,Female,44,35-44,7
33,0,3,0,3,2021-12-27,Male,77,75-79,3
33,0,0,0,0,2021-12-26,Female,66,65-69,10
33,4,0,0,4,2021-12-30,Female,8,5-9,1
33,0,0,0,0,2021-12-24,Male,54,45-54,29
33,1,2,0,3,2021-12-27,Female,58,55-64,7
33,3,0,0,3,2021-12-25,Female,3,1-4,6
33,1,0,0,1,2021-12-25,Female,55,55-64,8
33,3,0,0,3,2021-12-27,Male,6,5-9,6
33,1,0,0,1,2021-12-28,Female,54,45-54,5
33,0,4,0,4,2021-12-28,Female,34,25-34,8
33,1,2,0,3,2021-12-26,Female,22,20-24,5
33,1,1,0,2,2021-12-26,Male,68,65-69,5
33,1,1,0,2,2021-12-24,Male,10,10-14,8
33,0,0,0,0,2021-12-24,Female,0,<1,10
33,0,0,0,0,2021-12-24,Female,22,20-24,12
33,1,0,0,1,2021-12-28,Female,50,45-54,14
33,3,1,0,4,2021-12-31,Female,18,15-19,24
33,1,0,0,1,2021-12-28,Male,10,10-14,1
33,0,1,0,1,2021-12-24,Female,63,55-64,7
33,2,0,0,2,2021-12-27,Female,17,15-19,10
33,1,5,0,6,2021-12-28,Male,68,65-69,10
33,0,5,0,5,2021-12-24,Male,62,55-64,8
33,0,9,0,9,2021-12-24,Male,75,75-79,6
33,1,0,0,1,2021-12-31,Male,71,70-74,6
33,2,0,0,2,2021-12-30,Male,21,20-24,1
33,0,0,4,4,2021-12-30,Female,35,35-44,7
33,2,0,0,2,2021-12-24,Female,18,15-19,11
33,1,0,1,2,2021-12-28,Female,68,65-69,24
33,1,0,0,1,2021-12-28,Male,69,65-69,7
33,0,0,0,0,2021-12-28,Female,41,35-44,10
33,1,0,0,1,2021-12-28,Male,72,70-74,5
33,1,0,0,1,2021-12-27,Male,82,80-84,7
33,0,1,0,1,2021-12-24,Male,60,55-64,5
33,1,0,0,1,2021-12-27,Female,46,45-54,11
33,1,0,0,1,2021-12-27,Female,52,45-54,10
33,0,0,0,0,2021-12-26,Male,66,65-69,5
33,1,0,0,1,2021-12-24,Female,54,45-54,6
33,1,1,0,2,2021-12-25,Male,12,10-14,3
33,1,0,0,1,2021-12-26,Female,67,65-69,10
33,1,0,0,1,2021-12-28,Female,22,20-24,1
33,0,1,0,1,2021-12-24,Female,61,55-64,6
33,0,0,0,0,2021-12-28,Female,36,35-44,8
33,1,0,0,1,2021-12-28,Female,28,25-34,1
33,1,0,0,1,2021-12-27,Male,72,70-74,5
33,3,0,0,3,2021-12-24,Female,9,5-9,6
33,0,0,0,0,2021-12-28,Male,18,15-19,1
33,3,0,0,3,2021-12-26,Male,6,5-9,10
33,3,0,0,3,2021-12-25,Female,9,5-9,13
33,1,0,0,1,2021-12-28,Male,36,35-44,7
33,0,5,0,5,2021-12-28,Female,34,25-34,8
33,0,2,0,2,2021-12-27,Male,78,75-79,5
33,3,0,0,3,2021-12-28,Female,6,5-9,1
33,1,0,0,1,2021-12-24,Male,69,65-69,7
33,2,2,0,4,2021-12-27,Female,15,15-19,7
33,1,2,0,3,2021-12-30,Female,30,25-34,1
33,0,0,0,0,2021-12-27,Female,51,45-54,5
33,1,0,0,1,2021-12-28,Female,31,25-34,1
33,0,0,0,0,2021-12-27,Female,0,<1,7
33,1,2,0,3,2021-12-28,Female,43,35-44,3
33,2,1,0,3,2021-12-29,Female,51,45-54,21
33,4,0,0,4,2021-12-27,Female,4,1-4,5
33,1,4,0,5,2021-12-25,Male,61,55-64,9
33,0,0,0,0,2021-12-31,Female,29,25-34,1
33,0,2,0,2,2021-12-24,Female,25,25-34,19
33,1,0,0,1,2021-12-24,Female,16,15-19,4
33,1,0,0,1,2021-12-30,Male,26,25-34,10
33,0,0,0,0,2021-12-28,Male,41,35-44,7
33,2,0,0,2,2021-12-24,Male,13,10-14,2
33,1,0,0,1,2021-12-28,Male,66,65-69,6
33,2,0,0,2,2021-12-24,Female,55,55-64,6
33,0,0,0,0,2021-12-28,Female,65,65-69,10
33,0,0,0,0,2021-12-28,Female,4,1-4,1
33,2,0,0,2,2021-12-24,Male,65,65-69,5
33,1,3,0,4,2021-12-28,Male,71,70-74,12
33,0,0,0,0,2021-12-24,Male,35,35-44,10
33,0,0,0,0,2021-12-28,Female,66,65-69,9
33,2,15,0,17,2021-12-28,Female,24,20-24,2
33,1,2,0,3,2021-12-28,Female,28,25-34,5
33,2,0,0,2,2021-12-28,Male,33,25-34,1
33,1,0,0,1,2021-12-24,Female,62,55-64,7
33,0,5,0,5,2021-12-26,Female,32,25-34,28
33,1,1,0,2,2021-12-29,Male,33,25-34,1
33,2,0,0,2,2021-12-26,Male,66,65-69,4
33,1,0,0,1,2021-12-28,Male,53,45-54,4
33,2,1,0,3,2021-12-26,Male,2,1-4,3
33,2,0,0,2,2021-12-28,Male,10,10-14,5
33,1,2,0,3,2021-12-25,Male,60,55-64,9
33,2,1,0,3,2021-12-31,Female,9,5-9,4
33,2,0,0,2,2021-12-28,Female,31,25-34,2
33,2,0,0,2,2021-12-24,Female,17,15-19,7
33,0,0,0,0,2021-12-27,Female,70,70-74,24
33,1,0,0,1,2021-12-28,Male,71,70-74,3
33,0,0,0,0,2021-12-24,Female,37,35-44,8
33,1,0,0,1,2021-12-28,Female,34,25-34,1
33,1,0,0,1,2021-12-26,Male,71,70-74,7
33,1,0,0,1,2021-12-28,Male,73,70-74,4
33,0,0,0,0,2021-12-27,Male,47,45-54,6
33,0,0,0,0,2021-12-24,Female,74,70-74,12
33,3,0,0,3,2021-12-28,Female,3,1-4,1
33,2,0,0,2,2021-12-27,Female,19,15-19,4
33,0,0,0,0,2021-12-28,Female,48,45-54,12
33,1,0,0,1,2021-12-24,Female,60,55-64,7
33,0,2,0,2,2021-12-27,Male,52,45-54,8
33,2,0,0,2,2021-12-27,Female,56,55-64,2
33,0,0,0,0,2021-12-26,Female,63,55-64,5
33,3,0,0,3,2021-12-25,Female,56,55-64,13
33,2,2,0,4,2021-12-25,Male,11,10-14,8
33,0,0,0,0,2021-12-28,Female,6,5-9,6
33,3,0,0,3,2021-12-28,Female,15,15-19,20
33,1,2,0,3,2021-12-28,Male,81,80-84,6
33,1,0,0,1,2021-12-28,Male,66,65-69,10
33,1,0,0,1,2021-12-26,Female,63,55-64,6
33,0,0,0,0,2021-12-24,Male,50,45-54,2
33,1,0,0,1,2021-12-28,Female,47,45-54,6
33,3,0,0,3,2021-12-27,Female,12,10-14,4
33,1,0,0,1,2021-12-28,Male,31,25-34,1
33,1,5,0,6,2021-12-26,Male,74,70-74,20
33,0,4,0,4,2021-12-24,Female,36,35-44,5
33,3,0,0,3,2021-12-28,Male,2,1-4,7
33,1,1,0,2,2021-12-24,Female,57,55-64,2
33,1,0,0,1,2021-12-28,Female,29,25-34,1
33,3,1,0,4,2021-12-29,Female,18,15-19,1
33,3,8,0,11,2021-12-26,Male,3,1-4,9
33,1,0,0,1,2021-12-24,Female,55,55-64,8
33,1,2,0,3,2021-12-24,Male,56,55-64,8
33,1,0,0,1,2021-12-28,Male,48,45-54,5
33,1,0,0,1,2021-12-24,Male,60,55-64,5
33,1,0,0,1,2021-12-24,Female,54,45-54,7
33,0,3,0,3,2021-12-31,Male,47,45-54,4
33,2,0,0,2,2021-12-28,Male,10,10-14,3
33,0,0,0,0,2021-12-27,Female,78,75-79,7
33,1,1,0,2,2021-12-24,Female,64,55-64,6
33,2,6,0,8,2021-12-29,Female,19,15-19,1
33,3,0,0,3,2021-12-27,Female,46,45-54,5
33,0,0,0,0,2021-12-28,Female,32,25-34,8
33,1,0,0,1,2021-12-28,Female,29,25-34,1
33,1,0,0,1,2021-12-28,Male,53,45-54,13
33,1,0,0,1,2021-12-26,Female,68,65-69,3
33,0,2,0,2,2021-12-25,Male,73,70-74,8
33,3,1,0,4,2021-12-31,Male,41,35-44,21
33,1,3,0,4,2021-12-28,Female,14,10-14,6
33,1,0,0,1,2021-12-31,Female,25,25-34,1
33,1,1,0,2,2021-12-25,Male,56,55-64,11
33,1,5,0,6,2021-12-26,Female,23,20-24,8
33,0,0,0,0,2021-12-28,Female,29,25-34,1
33,0,2,0,2,2021-12-24,Male,51,45-54,12
33,0,2,0,2,2021-12-26,Female,63,55-64,2
33,3,0,0,3,2021-12-24,Female,73,70-74,5
33,0,2,0,2,2021-12-27,Female,40,35-44,9
33,0,33,0,33,2021-12-28,Female,31,25-34,1
33,1,0,0,1,2021-12-28,Male,7,5-9,1
33,0,0,0,0,2021-12-28,Female,34,25-34,1
33,2,0,0,2,2021-12-26,Female,63,55-64,4
33,0,1,0,1,2021-12-27,Female,52,45-54,6
33,0,0,0,0,2021-12-24,Male,62,55-64,6
33,2,0,0,2,2021-12-28,Female,6,5-9,1
33,0,0,0,0,2021-12-28,Male,70,70-74,6
33,1,0,0,1,2021-12-26,Female,5,5-9,4
33,0,1,0,1,2021-12-24,Male,55,55-64,2
33,2,0,0,2,2021-12-28,Female,11,10-14,7
33,0,0,0,0,2021-12-25,Male,58,55-64,24
33,1,0,0,1,2021-12-28,Female,80,80-84,4
33,1,4,0,5,2021-12-25,Female,62,55-64,11
33,1,2,0,3,2021-12-24,Male,61,55-64,7
33,0,0,0,0,2021-12-26,Male,35,35-44,10
33,0,2,0,2,2021-12-29,Female,53,45-54,5
33,2,6,0,8,2021-12-24,Female,2,1-4,2
33,0,0,0,0,2021-12-24,Male,60,55-64,6
33,0,0,0,0,2021-12-26,Female,37,35-44,23
33,0,4,0,4,2021-12-30,Male,46,45-54,11
33,1,0,0,1,2021-12-24,Female,57,55-64,11
33,1,0,0,1,2021-12-24,Male,53,45-54,9
33,1,0,0,1,2021-12-29,Female,18,15-19,1
33,0,0,0,0,2021-12-27,Female,32,25-34,18
33,1,0,0,1,2021-12-27,Female,40,35-44,6
33,0,0,0,0,2021-12-24,Male,59,55-64,9
33,0,0,0,0,2021-12-28,Female,66,65-69,7
33,0,0,0,0,2021-12-27,Male,45,45-54,8
33,2,2,0,4,2021-12-28,Male,70,70-74,6
33,0,0,0,0,2021-12-24,Male,64,55-64,5
33,0,1,0,1,2021-12-27,Female,67,65-69,18
33,1,0,0,1,2021-12-28,Female,77,75-79,4
33,1,0,0,1,2021-12-24,Male,55,55-64,13
33,1,0,0,1,2021-12-24,Female,77,75-79,7
33,0,5,0,5,2021-12-28,Female,58,55-64,5
33,0,0,0,0,2021-12-26,Female,49,45-54,5
33,3,1,0,4,2021-12-24,Female,19,15-19,11
33,2,0,0,2,2021-12-26,Female,11,10-14,13
33,0,0,0,0,2021-12-28,Male,66,65-69,12
33,0,0,0,0,2021-12-24,Male,69,65-69,7
33,0,3,0,3,2021-12-27,Female,48,45-54,5
33,0,1,0,1,2021-12-27,Male,67,65-69,11
33,1,0,0,1,2021-12-25,Female,54,45-54,9
33,1,2,0,3,2021-12-25,Male,75,75-79,6
33,2,0,0,2,2021-12-27,Female,49,45-54,11
33,1,0,0,1,2021-12-28,Male,85,85+,8
33,0,0,0,0,2021-12-28,Male,33,25-34,4
33,0,2,0,2,2021-12-24,Female,63,55-64,8
33,0,3,0,3,2021-12-26,Male,38,35-44,6
33,1,1,0,2,2021-12-26,Female,70,70-74,12
33,0,2,0,2,2021-12-27,Female,43,35-44,7
33,1,0,0,1,2021-12-27,Female,14,10-14,5
33,3,0,0,3,2021-12-28,Male,24,20-24,23
33,0,0,0,0,2021-12-28,Male,54,45-54,3
33,2,0,0,2,2021-12-31,Female,53,45-54,6
33,0,0,0,0,2021-12-30,Female,65,65-69,24
33,2,0,0,2,2021-12-26,Female,11,10-14,5
33,0,0,0,0,2021-12-27,Male,45,45-54,9
33,0,0,0,0,2021-12-27,Male,6,5-9,5
33,3,0,0,3,2021-12-28,Female,53,45-54,7
33,1,0,0,1,2021-12-27,Male,80,80-84,2
33,1,0,0,1,2021-12-26,Female,71,70-74,10
33,2,1,0,3,2021-12-28,Female,7,5-9,3
33,1,6,0,7,2021-12-27,Male,73,70-74,7
33,4,0,0,4,2021-12-26,Male,14,10-14,3
33,2,2,0,4,2021-12-24,Male,56,55-64,12
33,0,2,0,2,2021-12-27,Female,52,45-54,9
33,1,3,0,4,2021-12-30,Female,33,25-34,1
33,2,1,0,3,2021-12-27,Male,52,45-54,12
33,1,0,0,1,2021-12-24,Female,53,45-54,7
33,1,0,0,1,2021-12-24,Male,68,65-69,9
33,2,1,0,3,2021-12-31,Male,31,25-34,1
33,0,0,0,0,2021-12-28,Male,2,1-4,1
33,2,0,0,2,2021-12-24,Male,50,45-54,6
33,2,0,0,2,2021-12-24,Male,68,65-69,23
33,0,0,0,0,2021-12-26,Female,56,55-64,10
33,2,0,0,2,2021-12-24,Female,14,10-14,6
33,0,0,0,0,2021-12-24,Female,58,55-64,21
33,0,1,0,1,2021-12-28,Female,74,70-74,6
33,1,3,0,4,2021-12-27,Male,45,45-54,12
33,2,0,0,2,2021-12-24,Male,58,55-64,10
33,1,0,0,1,2021-12-24,Male,74,70-74,7
33,2,0,0,2,2021-12-24,Female,61,55-64,5
33,0,0,0,0,2021-12-28,Male,46,45-54,6
33,2,0,0,2,2021-12-26,Male,8,5-9,4
33,0,6,0,6,2021-12-24,Male,54,45-54,7
33,1,0,0,1,2021-12-24,Female,62,55-64,5
33,0,2,0,2,2021-12-28,Male,41,35-44,7
33,0,0,0,0,2021-12-24,Female,50,45-54,7
33,0,1,0,1,2021-12-24,Female,65,65-69,12
33,1,1,0,2,2021-12-31,Male,50,45-54,5
33,0,2,0,2,2021-12-26,Female,67,65-69,9
33,0,0,0,0,2021-12-27,Male,48,45-54,6
33,1,0,0,1,2021-12-24,Male,53,45-54,13
33,0,3,0,3,2021-12-28,Female,38,35-44,9
33,0,3,0,3,2021-12-30,Female,47,45-54,12
33,2,2,0,4,2021-12-27,Male,67,65-69,5
33,1,0,0,1,2021-12-25,Female,74,70-74,11
33,0,1,0,1,2021-12-27,Male,72,70-74,6
33,0,0,0,0,2021-12-28,Female,53,45-54,11
33,3,0,0,3,2021-12-29,Female,19,15-19,2
33,0,2,0,2,2021-12-25,Female,59,55-64,7
33,1,0,0,1,2021-12-24,Female,52,45-54,5
33,1,1,0,2,2021-12-28,Female,34,25-34,8
33,2,0,0,2,2021-12-24,Female,36,35-44,17
33,1,0,0,1,2021-12-27,Female,41,35-44,6
33,2,0,0,2,2021-12-24,Female,18,15-19,8
33,2,1,0,3,2021-12-31,Female,2,1-4,1
33,1,0,0,1,2021-12-31,Female,51,45-54,7
33,0,0,0,0,2021-12-24,Female,58,55-64,7
33,1,0,0,1,2021-12-24,Male,61,55-64,8
33,1,5,0,6,2021-12-24,Male,54,45-54,6
33,0,1,0,1,2021-12-24,Female,74,70-74,3
33,2,2,0,4,2021-12-24,Female,61,55-64,11
33,1,0,0,1,2021-12-26,Female,30,25-34,2
33,1,3,0,4,2021-12-31,Male,72,70-74,6
33,1,0,0,1,2021-12-29,Female,44,35-44,8
33,0,1,0,1,2021-12-24,Male,57,55-64,6
33,0,3,0,3,2021-12-28,Male,52,45-54,7
33,0,0,0,0,2021-12-26,Female,71,70-74,23
33,0,0,0,0,2021-12-26,Male,33,25-34,9
33,3,1,0,4,2021-12-24,Male,9,5-9,13
33,1,1,0,2,2021-12-28,Male,3,1-4,5
33,1,0,0,1,2021-12-28,Female,33,25-34,3
33,1,0,0,1,2021-12-27,Male,41,35-44,5
33,0,0,0,0,2021-12-25,Male,59,55-64,5
33,1,0,0,1,2021-12-24,Male,65,65-69,10
33,1,0,3,4,2021-12-28,Female,34,25-34,1
33,3,0,0,3,2021-12-27,Male,66,65-69,10
33,0,0,0,0,2021-12-24,Male,30,25-34,3
33,1,0,0,1,2021-12-28,Male,53,45-54,8
33,1,0,0,1,2021-12-28,Female,34,25-34,6
33,0,0,0,0,2021-12-24,Male,65,65-69,5
33,0,0,0,0,2021-12-28,Male,28,25-34,1
33,3,0,0,3,2021-12-28,Female,31,25-34,2
33,0,0,0,0,2021-12-27,Female,43,35-44,6
33,1,0,0,1,2021-12-26,Male,67,65-69,9
33,2,0,0,2,2021-12-27,Male,13,10-14,7
33,2,0,0,2,2021-12-28,Female,27,25-34,1
33,1,3,0,4,2021-12-26,Male,71,70-74,6
33,2,4,0,6,2021-12-27,Female,51,45-54,7
33,1,0,0,1,2021-12-24,Female,69,65-69,5
33,0,0,0,0,2021-12-24,Male,21,20-24,13
33,1,1,0,2,2021-12-28,Female,49,45-54,10
33,0,0,0,0,2021-12-24,Male,74,70-74,6
33,1,0,0,1,2021-12-27,Male,72,70-74,5
33,0,12,0,12,2021-12-28,Male,32,25-34,1
33,0,0,0,0,2021-12-27,Male,49,45-54,7
33,2,0,0,2,2021-12-31,Female,19,15-19,5
33,0,0,0,0,2021-12-24,Male,70,70-74,7
33,1,0,0,1,2021-12-26,Male,67,65-69,13
33,0,0,0,0,2021-12-26,Male,35,35-44,11
33,1,0,0,1,2021-12-24,Male,65,65-69,6
33,2,1,0,3,2021-12-28,Female,18,15-19,6
33,0,0,0,0,2021-12-24,Female,30,25-34,7
33,0,0,0,0,2021-12-26,Female,56,55-64,4
33,0,2,0,2,2021-12-27,Female,29,25-34,6
33,1,3,0,4,2021-12-27,Male,53,45-54,7
33,1,1,0,2,2021-12-24,Female,65,65-69,5
33,0,0,0,0,2021-12-24,Female,65,65-69,6
33,0,1,0,1,2021-12-28,Male,23,20-24,5
33,3,6,0,9,2021-12-30,Male,19,15-19,1
33,3,0,0,3,2021-12-31,Female,40,35-44,6
33,1,1,0,2,2021-12-28,Male,80,80-84,5
33,1,0,0,1,2021-12-31,Female,63,55-64,4
33,0,1,0,1,2021-12-26,Male,63,55-64,7
33,3,6,0,9,2021-12-26,Female,4,1-4,7
33,0,0,0,0,2021-12-30,Female,21,20-24,2
33,0,1,0,1,2021-12-27,Female,31,25-34,4
33,0,0,0,0,2021-12-28,Female,72,70-74,8
33,1,0,0,1,2021-12-24,Male,58,55-64,6
33,1,4,0,5,2021-12-26,Male,71,70-74,7
33,1,0,0,1,2021-12-29,Male,50,45-54,10
33,1,0,0,1,2021-12-28,Male,37,35-44,16
33,0,1,0,1,2021-12-24,Female,30,25-34,11
33,0,0,0,0,2021-12-29,Female,39,35-44,6
33,2,0,0,2,2021-12-28,Male,6,5-9,1
33,0,8,0,8,2021-12-24,Male,58,55-64,7
33,0,0,0,0,2021-12-27,Female,42,35-44,7
33,0,0,0,0,2021-12-24,Male,38,35-44,12
33,1,0,0,1,2021-12-24,Female,52,45-54,13
33,1,0,0,1,2021-12-28,Male,73,70-74,8
33,0,0,0,0,2021-12-28,Female,47,45-54,7
33,1,0,0,1,2021-12-24,Male,38,35-44,7
33,1,0,0,1,2021-12-31,Female,58,55-64,6
33,1,6,0,7,2021-12-24,Male,63,55-64,6
33,0,0,0,0,2021-12-28,Male,79,75-79,3
33,3,0,0,3,2021-12-26,Female,3,1-4,2
33,0,0,0,0,2021-12-24,Female,37,35-44,9
33,0,0,0,0,2021-12-24,Male,61,55-64,6
33,1,0,0,1,2021-12-27,Male,73,70-74,6
33,2,0,0,2,2021-12-30,Female,29,25-34,1
33,3,0,0,3,2021-12-28,Male,8,5-9,7
33,1,0,0,1,2021-12-24,Female,57,55-64,6
33,1,0,0,1,2021-12-24,Male,58,55-64,6
33,0,1,0,1,2021-12-24,Male,63,55-64,6
33,3,0,0,3,2021-12-27,Female,13,10-14,11
33,0,30,0,30,2021-12-31,Female,29,25-34,1
33,1,5,0,6,2021-12-24,Female,63,55-64,11
33,1,0,0,1,2021-12-24,Male,61,55-64,12
33,0,0,0,0,2021-12-27,Male,51,45-54,6
33,2,1,0,3,2021-12-27,Female,66,65-69,22
33,5,0,0,5,2021-12-27,Male,2,1-4,7
33,0,0,0,0,2021-12-31,Female,33,25-34,3
33,2,0,0,2,2021-12-27,Female,72,70-74,7
33,3,0,0,3,2021-12-28,Female,3,1-4,1
33,1,0,0,1,2021-12-24,Male,56,55-64,5
33,1,0,0,1,2021-12-31,Male,69,65-69,6
33,0,0,0,0,2021-12-24,Male,54,45-54,8
33,0,0,0,0,2021-12-27,Male,72,70-74,7
33,0,0,0,0,2021-12-29,Male,32,25-34,1
33,2,0,0,2,2021-12-27,Male,46,45-54,4
33,0,0,0,0,2021-12-24,Male,59,55-64,17
33,1,0,0,1,2021-12-28,Male,61,55-64,15
33,1,9,0,10,2021-12-28,Male,53,45-54,7
33,2,0,0,2,2021-12-26,Male,31,25-34,4
33,0,4,0,4,2021-12-27,Female,51,45-54,13
33,1,0,0,1,2021-12-26,Male,67,65-69,11
33,1,0,0,1,2021-12-31,Male,58,55-64,6
33,1,0,0,1,2021-12-30,Female,5,5-9,1
33,0,8,0,8,2021-12-27,Female,63,55-64,8
33,1,1,0,2,2021-12-28,Male,70,70-74,4
33,1,0,0,1,2021-12-24,Female,64,55-64,10
33,1,0,0,1,2021-12-26,Male,67,65-69,5
33,1,0,0,1,2021-12-28,Male,38,35-44,7
33,0,0,0,0,2021-12-26,Male,66,65-69,7
33,2,0,0,2,2021-12-26,Female,53,45-54,24
33,0,0,0,0,2021-12-24,Male,54,45-54,8
33,1,0,0,1,2021-12-28,Female,32,25-34,1
33,2,0,0,2,2021-12-26,Male,68,65-69,6
33,1,0,0,1,2021-12-28,Male,27,25-34,1
33,3,0,0,3,2021-12-28,Female,5,5-9,1
33,0,0,0,0,2021-12-24,Female,26,25-34,7
33,0,0,0,0,2021-12-24,Female,58,55-64,5
33,0,0,0,0,2021-12-30,Female,34,25-34,1
33,1,0,0,1,2021-12-25,Female,38,35-44,11
33,3,0,0,3,2021-12-28,Female,8,5-9,1
33,0,12,0,12,2021-12-24,Male,55,55-64,4
33,0,0,0,0,2021-12-31,Male,22,20-24,3
33,1,3,0,4,2021-12-24,Female,74,70-74,2
33,2,0,0,2,2021-12-28,Female,49,45-54,6
33,1,3,0,4,2021-12-27,Female,72,70-74,10
33,0,1,0,1,2021-12-27,Female,66,65-69,4
33,0,0,0,0,2021-12-28,Male,66,65-69,12
33,0,2,0,2,2021-12-24,Female,30,25-34,7
33,1,0,0,1,2021-12-25,Female,69,65-69,6
33,1,1,0,2,2021-12-24,Male,70,70-74,7
33,0,2,0,2,2021-12-25,Female,22,20-24,12
33,1,0,0,1,2021-12-24,Female,28,25-34,2
33,0,1,0,1,2021-12-24,Female,65,65-69,8
33,0,0,0,0,2021-12-30,Male,72,70-74,6
33,2,0,8,10,2021-12-31,Female,9,5-9,3
33,1,0,0,1,2021-12-26,Male,37,35-44,6
33,0,0,0,0,2021-12-26,Female,61,55-64,6
33,0,1,0,1,2021-12-31,Female,77,75-79,11
33,2,0,0,2,2021-12-28,Male,3,1-4,1
33,0,5,0,5,2021-12-25,Male,60,55-64,6
33,2,2,0,4,2021-12-28,Male,0,<1,2
33,1,0,0,1,2021-12-27,Male,73,70-74,7
33,1,0,0,1,2021-12-28,Female,18,15-19,2
33,2,0,0,2,2021-12-26,Male,22,20-24,6
33,1,0,0,1,2021-12-28,Male,78,75-79,13
33,0,10,0,10,2021-12-24,Male,57,55-64,10
33,0,0,0,0,2021-12-28,Female,68,65-69,21
33,1,3,0,4,2021-12-24,Male,63,55-64,13
33,0,0,0,0,2021-12-28,Male,31,25-34,1
33,0,0,0,0,2021-12-24,Male,55,55-64,6
33,1,0,0,1,2021-12-24,Female,57,55-64,5
33,0,0,0,0,2021-12-24,Male,36,35-44,5
33,4,0,0,4,2021-12-28,Female,11,10-14,5
33,0,0,0,0,2021-12-31,Female,67,65-69,7
33,2,0,0,2,2021-12-30,Female,13,10-14,1
33,0,0,0,0,2021-12-24,Female,60,55-64,6
33,1,0,0,1,2021-12-24,Female,57,55-64,5
33,0,1,0,1,2021-12-24,Male,54,45-54,5
33,0,5,0,5,2021-12-24,Female,51,45-54,8
33,0,0,0,0,2021-12-26,Female,67,65-69,23
33,0,0,0,0,2021-12-27,Male,80,80-84,8
33,1,0,0,1,2021-12-31,Female,63,55-64,4
33,0,0,0,0,2021-12-28,Female,66,65-69,22
33,2,0,0,2,2021-12-28,Male,19,15-19,6
33,2,0,0,2,2021-12-28,Female,8,5-9,1
33,1,1,0,2,2021-12-25,Female,39,35-44,8
33,1,0,0,1,2021-12-24,Female,58,55-64,6
33,3,0,0,3,2021-12-27,Female,43,35-44,11
33,0,2,0,2,2021-12-31,Female,81,80-84,9
33,0,0,0,0,2021-12-28,Male,42,35-44,6
33,0,0,0,0,2021-12-24,Female,69,65-69,10
33,2,0,0,2,2021-12-24,Female,40,35-44,9
33,1,0,0,1,2021-12-28,Female,69,65-69,16
33,1,7,0,8,2021-12-27,Male,80,80-84,6
33,0,0,0,0,2021-12-31,Female,32,25-34,1
33,0,0,0,0,2021-12-24,Female,54,45-54,12
33,0,0,0,0,2021-12-24,Male,38,35-44,11
33,2,0,0,2,2021-12-24,Male,50,45-54,5
33,2,0,0,2,2021-12-24,Female,7,5-9,22
33,1,0,0,1,2021-12-28,Male,77,75-79,5
33,0,3,0,3,2021-12-28,Male,68,65-69,9
33,1,0,0,1,2021-12-24,Male,78,75-79,11
33,2,0,0,2,2021-12-31,Male,63,55-64,10
33,2,0,0,2,2021-12-31,Male,41,35-44,8
33,4,3,0,7,2021-12-24,Female,23,20-24,5
33,1,7,0,8,2021-12-26,Female,19,15-19,9
33,0,0,0,0,2021-12-24,Male,69,65-69,10
33,1,0,0,1,2021-12-28,Female,69,65-69,8
33,1,0,0,1,2021-12-28,Female,32,25-34,8
33,0,0,0,0,2021-12-31,Female,71,70-74,13
33,4,0,0,4,2021-12-27,Female,7,5-9,4
33,1,0,0,1,2021-12-27,Male,67,65-69,7
33,1,0,0,1,2021-12-31,Female,56,55-64,6
33,1,1,0,2,2021-12-24,Male,65,65-69,7
33,0,3,0,3,2021-12-24,Female,59,55-64,11
33,1,3,0,4,2021-12-27,Female,7,5-9,4
33,0,0,3,3,2021-12-28,Male,33,25-34,1
33,1,0,0,1,2021-12-26,Male,63,55-64,17
33,0,0,5,5,2021-12-24,Male,21,20-24,3
33,0,0,0,0,2021-12-27,Female,52,45-54,8
33,1,0,0,1,2021-12-28,Male,25,25-34,1
33,4,3,0,7,2021-12-28,Female,18,15-19,1
33,0,0,0,0,2021-12-25,Female,37,35-44,4
33,1,3,0,4,2021-12-26,Female,67,65-69,10
33,1,0,0,1,2021-12-27,Female,52,45-54,9
33,0,3,0,3,2021-12-24,Male,67,65-69,2
33,2,0,0,2,2021-12-31,Male,69,65-69,20
33,1,9,0,10,2021-12-30,Female,31,25-34,1
33,1,0,0,1,2021-12-24,Male,68,65-69,8
33,2,0,0,2,2021-12-25,Male,49,45-54,9
33,0,0,0,0,2021-12-29,Female,19,15-19,1
33,0,0,0,0,2021-12-24,Female,81,80-84,9
33,3,0,0,3,2021-12-30,Female,18,15-19,1
33,0,0,0,0,2021-12-24,Female,70,70-74,8
33,0,1,0,1,2021-12-26,Male,66,65-69,5
33,1,1,0,2,2021-12-26,Female,72,70-74,4
33,1,0,0,1,2021-12-28,Female,28,25-34,1
33,1,0,0,1,2021-12-27,Male,72,70-74,3
33,0,1,0,1,2021-12-28,Female,31,25-34,1
33,0,0,0,0,2021-12-24,Male,55,55-64,5
33,1,0,0,1,2021-12-24,Female,81,80-84,12
33,3,0,0,3,2021-12-27,Male,10,10-14,5
33,1,0,0,1,2021-12-31,Female,69,65-69,2
33,3,0,0,3,2021-12-26,Male,2,1-4,7
33,2,0,0,2,2021-12-26,Male,67,65-69,6
33,0,0,0,0,2021-12-27,Female,34,25-34,3
33,1,3,0,4,2021-12-26,Female,66,65-69,11
33,0,0,0,0,2021-12-24,Male,60,55-64,4
33,1,0,0,1,2021-12-25,Female,62,55-64,6
33,1,0,0,1,2021-12-28,Female,51,45-54,6
33,1,4,0,5,2021-12-28,Male,45,45-54,9
33,0,0,0,0,2021-12-28,Male,43,35-44,13
33,0,1,0,1,2021-12-28,Female,1,1-4,1
33,1,0,0,1,2021-12-27,Female,55,55-64,7
33,1,0,0,1,2021-12-28,Male,18,15-19,7
33,1,0,0,1,2021-12-28,Female,27,25-34,1
33,1,2,0,3,2021-12-27,Male,40,35-44,6
33,1,3,0,4,2021-12-28,Male,72,70-74,5
33,0,1,0,1,2021-12-24,Female,56,55-64,5
33,2,0,0,2,2021-12-24,Female,55,55-64,8
33,1,2,0,3,2021-12-27,Male,66,65-69,4
33,0,0,0,0,2021-12-28,Male,25,25-34,1
33,0,0,0,0,2021-12-27,Female,81,80-84,4
33,3,0,0,3,2021-12-25,Female,13,10-14,2
33,0,0,0,0,2021-12-27,Male,45,45-54,14
33,1,0,0,1,2021-12-27,Female,46,45-54,7
33,0,1,0,1,2021-12-27,Male,44,35-44,8
33,0,1,0,1,2021-12-24,Male,84,80-84,6
33,3,2,0,5,2021-12-29,Male,13,10-14,5
33,1,4,0,5,2021-12-27,Female,65,65-69,11
33,1,0,0,1,2021-12-24,Female,65,65-69,6
33,2,0,0,2,2021-12-24,Male,37,35-44,8
33,1,2,2,5,2021-12-26,Female,57,55-64,5
33,0,2,15,17,2021-12-25,Male,54,45-54,6
33,1,0,0,1,2021-12-24,Male,85,85+,7
33,3,2,0,5,2021-12-31,Male,6,5-9,6
33,0,0,0,0,2021-12-28,Male,71,70-74,6
33,3,2,0,5,2021-12-28,Male,1,1-4,1
33,2,0,0,2,2021-12-27,Male,45,45-54,7
33,1,0,0,1,2021-12-26,Male,31,25-34,8
33,1,0,0,1,2021-12-26,Female,63,55-64,6
33,0,5,0,5,2021-12-26,Female,31,25-34,15
33,3,2,0,5,2021-12-28,Male,20,20-24,1
33,1,0,0,1,2021-12-24,Female,54,45-54,7
33,1,1,0,2,2021-12-26,Male,59,55-64,14
33,1,0,0,1,2021-12-27,Male,16,15-19,5
33,2,0,0,2,2021-12-27,Male,7,5-9,2
33,0,0,0,0,2021-12-27,Female,45,45-54,23
33,1,0,0,1,2021-12-24,Male,69,65-69,6
33,3,0,0,3,2021-12-24,Male,53,45-54,7
33,1,2,0,3,2021-12-24,Male,71,70-74,20
33,1,0,0,1,2021-12-26,Male,68,65-69,7
33,0,0,3,3,2021-12-24,Female,59,55-64,5
33,5,0,0,5,2021-12-27,Female,51,45-54,5
33,0,0,0,0,2021-12-24,Male,53,45-54,11
33,1,0,0,1,2021-12-27,Female,45,45-54,3
33,1,6,0,7,2021-12-26,Female,66,65-69,10
33,1,1,0,2,2021-12-27,Female,67,65-69,2
33,0,0,0,0,2021-12-27,Male,51,45-54,11
33,0,0,0,0,2021-12-24,Female,18,15-19,4
33,2,0,0,2,2021-12-28,Male,30,25-34,1
33,0,2,0,2,2021-12-27,Female,72,70-74,10
33,3,0,0,3,2021-12-27,Male,1,1-4,7
33,1,2,0,3,2021-12-27,Female,28,25-34,7
33,1,1,0,2,2021-12-24,Male,64,55-64,13
33,0,0,0,0,2021-12-29,Male,51,45-54,9
33,0,0,0,0,2021-12-24,Female,65,65-69,13
33,1,0,0,1,2021-12-24,Female,27,25-34,6
33,3,0,0,3,2021-12-25,Female,9,5-9,7
33,1,0,0,1,2021-12-26,Female,63,55-64,13
33,1,1,0,2,2021-12-26,Male,35,35-44,2
33,0,0,0,0,2021-12-28,Female,53,45-54,5
33,1,0,0,1,2021-12-25,Female,68,65-69,10
33,0,0,0,0,2021-12-28,Male,6,5-9,1
33,0,0,0,0,2021-12-27,Male,42,35-44,5
33,0,0,0,0,2021-12-26,Male,35,35-44,18
33,0,1,0,1,2021-12-24,Male,68,65-69,7
33,4,0,0,4,2021-12-28,Male,4,1-4,6
33,0,1,0,1,2021-12-24,Male,63,55-64,8
33,0,0,0,0,2021-12-27,Male,73,70-74,7
33,2,0,0,2,2021-12-28,Male,10,10-14,7
33,0,2,0,2,2021-12-26,Female,50,45-54,15
33,1,3,0,4,2021-12-24,Male,68,65-69,5
33,0,0,0,0,2021-12-25,Male,23,20-24,3
33,0,0,0,0,2021-12-24,Female,54,45-54,6
33,1,0,0,1,2021-12-24,Female,73,70-74,12
33,2,0,0,2,2021-12-24,Male,61,55-64,3
33,2,0,0,2,2021-12-24,Male,19,15-19,7
33,1,0,0,1,2021-12-27,Male,73,70-74,8
33,1,0,0,1,2021-12-28,Female,54,45-54,6
33,2,0,0,2,2021-12-25,Male,3,1-4,2
33,0,10,0,10,2021-12-24,Female,61,55-64,11
33,0,6,0,6,2021-12-24,Female,54,45-54,13
33,0,0,0,0,2021-12-30,Male,25,25-34,1
33,1,4,0,5,2021-12-28,Male,71,70-74,7
33,2,0,0,2,2021-12-24,Male,11,10-14,5
33,1,0,0,1,2021-12-26,Male,71,70-74,7
33,1,0,0,1,2021-12-30,Female,34,25-34,1
33,0,0,0,0,2021-12-31,Female,4,1-4,10
33,2,0,0,2,2021-12-28,Female,2,1-4,12
33,0,0,0,0,2021-12-26,Female,32,25-34,6
33,1,0,0,1,2021-12-26,Male,32,25-34,9
33,1,0,0,1,2021-12-25,Female,65,65-69,3
33,4,0,0,4,2021-12-27,Male,78,75-79,12
33,2,0,0,2,2021-12-27,Male,44,35-44,11
33,0,0,0,0,2021-12-24,Male,24,20-24,13
33,2,3,0,5,2021-12-27,Female,73,70-74,11
33,1,0,0,1,2021-12-31,Female,51,45-54,10
33,1,0,0,1,2021-12-27,Male,48,45-54,6
33,1,0,0,1,2021-12-27,Female,52,45-54,12
33,1,3,0,4,2021-12-24,Female,56,55-64,6
33,0,2,0,2,2021-12-24,Male,58,55-64,10
33,1,1,0,2,2021-12-24,Female,69,65-69,22
33,5,0,0,5,2021-12-27,Female,6,5-9,7
33,0,9,0,9,2021-12-26,Female,66,65-69,8
33,2,0,0,2,2021-12-24,Male,16,15-19,7
33,1,0,0,1,2021-12-26,Female,66,65-69,8
33,1,6,0,7,2021-12-28,Female,51,45-54,5
33,4,0,0,4,2021-12-27,Male,3,1-4,2
33,2,0,0,2,2021-12-25,Male,19,15-19,5
33,1,2,0,3,2021-12-24,Male,68,65-69,6
33,1,0,0,1,2021-12-26,Female,65,65-69,6
33,3,0,0,3,2021-12-26,Male,60,55-64,8
33,1,0,0,1,2021-12-28,Male,68,65-69,3
33,1,0,0,1,2021-12-25,Female,52,45-54,7
33,1,0,0,1,2021-12-24,Female,68,65-69,8
33,1,3,0,4,2021-12-28,Female,26,25-34,1
33,0,0,0,0,2021-12-27,Male,51,45-54,12
33,1,4,0,5,2021-12-24,Female,56,55-64,4
33,0,19,0,19,2021-12-28,Female,31,25-34,5
33,1,0,0,1,2021-12-27,Male,46,45-54,13
33,0,0,0,0,2021-12-28,Female,6,5-9,1
33,1,0,1,2,2021-12-28,Female,65,65-69,10
33,0,0,0,0,2021-12-24,Female,62,55-64,11
33,1,3,0,4,2021-12-24,Female,66,65-69,2
33,1,0,0,1,2021-12-24,Male,69,65-69,11
33,0,0,0,0,2021-12-25,Female,71,70-74,7
33,0,0,0,0,2021-12-26,Female,9,5-9,9
33,0,0,5,5,2021-12-28,Male,26,25-34,1
33,0,0,0,0,2021-12-28,Male,31,25-34,1
33,2,0,0,2,2021-12-24,Female,8,5-9,7
33,0,0,0,0,2021-12-28,Male,56,55-64,5
33,1,0,4,5,2021-12-27,Male,27,25-34,7
33,0,0,0,0,2021-12-28,Male,31,25-34,1
33,0,0,0,0,2021-12-26,Female,31,25-34,6
33,0,0,0,0,2021-12-24,Female,50,45-54,21
33,0,1,0,1,2021-12-28,Female,42,35-44,17
33,3,0,0,3,2021-12-31,Female,3,1-4,6
33,3,0,0,3,2021-12-28,Male,16,15-19,10
33,2,1,0,3,2021-12-25,Male,64,55-64,7
33,1,8,2,11,2021-12-27,Female,23,20-24,2
33,0,0,0,0,2021-12-28,Male,32,25-34,1
33,2,0,0,2,2021-12-28,Male,8,5-9,1
33,0,0,0,0,2021-12-28,Male,80,80-84,7
33,2,4,0,6,2021-12-25,Female,1,1-4,14
33,1,6,0,7,2021-12-30,Female,34,25-34,1
33,2,0,0,2,2021-12-27,Male,9,5-9,3
33,1,0,0,1,2021-12-28,Female,34,25-34,1
33,2,0,7,9,2021-12-24,Male,61,55-64,4
33,0,0,0,0,2021-12-25,Male,18,15-19,11
33,0,2,0,2,2021-12-24,Male,54,45-54,6
33,1,0,0,1,2021-12-28,Male,23,20-24,1
33,1,0,0,1,2021-12-28,Male,53,45-54,5
33,4,2,0,6,2021-12-28,Female,50,45-54,7
33,2,45,100,147,2021-12-24,Female,54,45-54,4
33,0,1,0,1,2021-12-24,Female,65,65-69,10
33,1,5,0,6,2021-12-26,Male,66,65-69,9
33,0,3,0,3,2021-12-31,Male,72,70-74,7
33,1,3,0,4,2021-12-25,Female,65,65-69,7
33,0,0,0,0,2021-12-24,Female,27,25-34,12
33,1,0,0,1,2021-12-24,Male,74,70-74,8
33,0,0,0,0,2021-12-28,Female,31,25-34,2
33,1,0,0,1,2021-12-24,Male,56,55-64,7
33,2,1,0,3,2021-12-31,Male,59,55-64,11
33,0,0,0,0,2021-12-26,Male,66,65-69,13
33,0,0,0,0,2021-12-26,Female,65,65-69,4
33,1,0,0,1,2021-12-26,Male,67,65-69,8
33,2,0,0,2,2021-12-30,Female,0,<1,1
33,0,0,0,0,2021-12-28,Female,53,45-54,3
33,0,0,0,0,2021-12-29,Female,16,15-19,20
33,0,0,0,0,2021-12-26,Male,34,25-34,9
33,1,0,1,2,2021-12-24,Female,70,70-74,6
33,3,1,0,4,2021-12-26,Female,0,<1,9
33,1,0,0,1,2021-12-28,Male,71,70-74,12
33,0,0,0,0,2021-12-26,Male,34,25-34,10
33,1,0,0,1,2021-12-24,Male,60,55-64,7
33,2,5,0,7,2021-12-28,Female,68,65-69,5
33,1,1,0,2,2021-12-26,Male,32,25-34,3
33,1,0,0,1,2021-12-28,Male,69,65-69,5
33,1,0,0,1,2021-12-27,Male,68,65-69,11
33,1,1,0,2,2021-12-27,Male,78,75-79,6
33,0,0,0,0,2021-12-28,Female,60,55-64,8
33,0,0,0,0,2021-12-24,Male,31,25-34,3
33,3,0,0,3,2021-12-27,Female,18,15-19,9
33,2,2,0,4,2021-12-27,Male,16,15-19,4
33,0,3,0,3,2021-12-24,Female,28,25-34,7
33,3,0,0,3,2021-12-26,Male,2,1-4,11
33,1,0,0,1,2021-12-28,Male,32,25-34,1
33,3,0,0,3,2021-12-31,Male,1,1-4,1
33,1,0,0,1,2021-12-24,Male,70,70-74,13
33,1,0,0,1,2021-12-26,Female,66,65-69,7
33,2,0,0,2,2021-12-28,Male,7,5-9,5
33,0,2,0,2,2021-12-28,Male,35,35-44,12
33,1,0,0,1,2021-12-26,Male,71,70-74,8
33,1,1,0,2,2021-12-28,Male,74,70-74,3
33,0,2,0,2,2021-12-29,Female,12,10-14,9
33,0,0,0,0,2021-12-24,Female,22,20-24,6
33,4,31,6,41,2021-12-24,Female,50,45-54,4
33,1,4,0,5,2021-12-27,Female,71,70-74,5
33,0,1,0,1,2021-12-25,Female,39,35-44,13
33,1,0,0,1,2021-12-25,Female,56,55-64,10
33,3,0,0,3,2021-12-27,Male,16,15-19,5
33,0,0,0,0,2021-12-28,Female,57,55-64,8
33,1,2,0,3,2021-12-25,Female,55,55-64,11
33,2,0,0,2,2021-12-27,Female,71,70-74,6
33,0,3,0,3,2021-12-24,Male,59,55-64,9
33,0,0,0,0,2021-12-24,Female,61,55-64,5
33,1,0,0,1,2021-12-24,Male,62,55-64,7
33,1,15,0,16,2021-12-24,Male,16,15-19,11
33,2,0,0,2,2021-12-31,Female,14,10-14,4
33,1,4,0,5,2021-12-27,Female,41,35-44,7
33,0,3,0,3,2021-12-28,Female,29,25-34,1
33,1,1,0,2,2021-12-24,Male,69,65-69,9
33,0,0,0,0,2021-12-27,Male,43,35-44,6
33,0,5,0,5,2021-12-28,Male,41,35-44,11
33,2,5,0,7,2021-12-25,Female,4,1-4,7
33,1,0,0,1,2021-12-24,Female,65,65-69,13
33,3,0,0,3,2021-12-24,Female,12,10-14,12
33,1,1,0,2,2021-12-24,Female,26,25-34,5
33,1,0,0,1,2021-12-28,Female,22,20-24,4
33,0,1,0,1,2021-12-26,Male,68,65-69,9
33,0,0,0,0,2021-12-24,Female,51,45-54,13
33,0,0,0,0,2021-12-29,Male,8,5-9,7
33,0,0,0,0,2021-12-27,Male,72,70-74,6
33,1,0,0,1,2021-12-28,Female,33,25-34,1
33,1,0,0,1,2021-12-28,Female,55,55-64,12
33,1,2,16,19,2021-12-28,Female,14,10-14,6
33,1,0,0,1,2021-12-27,Female,31,25-34,8
33,6,0,0,6,2021-12-30,Male,21,20-24,1
33,0,2,0,2,2021-12-24,Female,65,65-69,9
33,0,0,0,0,2021-12-27,Male,78,75-79,9
33,2,0,0,2,2021-12-31,Male,43,35-44,6
33,2,0,0,2,2021-12-27,Male,6,5-9,7
33,2,0,0,2,2021-12-27,Male,55,55-64,7
33,0,0,0,0,2021-12-24,Female,21,20-24,6
33,0,0,0,0,2021-12-24,Female,34,25-34,4
33,1,1,0,2,2021-12-24,Female,68,65-69,6
33,3,0,0,3,2021-12-28,Male,3,1-4,1
33,0,2,0,2,2021-12-27,Male,52,45-54,12
33,0,2,0,2,2021-12-26,Female,31,25-34,5
33,2,2,0,4,2021-12-31,Male,65,65-69,2
33,1,0,0,1,2021-12-24,Male,58,55-64,19
33,0,0,0,0,2021-12-24,Female,55,55-64,18
33,2,0,0,2,2021-12-26,Male,71,70-74,15
33,1,0,0,1,2021-12-27,Male,63,55-64,6
33,1,0,0,1,2021-12-26,Male,68,65-69,6
33,0,3,0,3,2021-12-24,Male,61,55-64,13
33,0,0,0,0,2021-12-24,Female,82,80-84,7
33,0,8,0,8,2021-12-24,Male,54,45-54,7
33,0,1,0,1,2021-12-24,Female,58,55-64,4
33,1,7,5,13,2021-12-27,Male,46,45-54,6
33,2,3,0,5,2021-12-27,Male,9,5-9,6
33,0,0,0,0,2021-12-28,Male,54,45-54,11
33,3,0,0,3,2021-12-24,Male,4,1-4,3
33,1,1,0,2,2021-12-28,Female,68,65-69,11
33,2,0,0,2,2021-12-28,Male,49,45-54,9
33,3,0,0,3,2021-12-26,Female,18,15-19,6
33,0,0,0,0,2021-12-24,Male,39,35-44,13
33,1,0,0,1,2021-12-26,Female,67,65-69,6
33,0,2,0,2,2021-12-26,Female,22,20-24,10
33,0,4,0,4,2021-12-24,Male,76,75-79,4
33,0,3,0,3,2021-12-27,Male,32,25-34,12
33,1,1,0,2,2021-12-27,Male,16,15-19,9
33,1,0,0,1,2021-12-29,Female,47,45-54,6
33,2,0,0,2,2021-12-25,Male,19,15-19,4
33,0,4,0,4,2021-12-24,Female,27,25-34,8
33,3,1,0,4,2021-12-27,Female,19,15-19,11
33,3,0,0,3,2021-12-27,Female,7,5-9,5
33,0,0,0,0,2021-12-28,Female,34,25-34,1
33,1,0,0,1,2021-12-24,Female,39,35-44,8
33,0,0,0,0,2021-12-24,Female,68,65-69,14
33,2,0,0,2,2021-12-28,Male,4,1-4,5
33,1,1,0,2,2021-12-28,Male,73,70-74,26
33,1,0,0,1,2021-12-28,Female,3,1-4,6
33,2,0,0,2,2021-12-28,Female,18,15-19,8
33,1,0,0,1,2021-12-27,Female,31,25-34,4
33,2,1,0,3,2021-12-24,Male,16,15-19,5
33,0,0,0,0,2021-12-28,Male,66,65-69,5
33,1,0,0,1,2021-12-24,Female,55,55-64,6
33,0,4,0,4,2021-12-28,Female,50,45-54,12
33,0,0,0,0,2021-12-24,Female,69,65-69,7
33,0,0,0,0,2021-12-27,Male,72,70-74,24
33,2,0,0,2,2021-12-24,Male,27,25-34,6
33,1,1,0,2,2021-12-26,Male,66,65-69,7
33,0,0,0,0,2021-12-28,Female,78,75-79,6
33,1,2,0,3,2021-12-28,Male,28,25-34,1
33,0,1,0,1,2021-12-25,Female,60,55-64,9
33,1,0,0,1,2021-12-24,Male,77,75-79,6
33,2,0,0,2,2021-12-26,Male,3,1-4,10
33,1,0,0,1,2021-12-28,Male,68,65-69,9
33,2,3,0,5,2021-12-24,Male,18,15-19,9
33,1,0,0,1,2021-12-24,Female,53,45-54,4
33,0,1,0,1,2021-12-24,Male,65,65-69,8
33,0,0,0,0,2021-12-24,Female,56,55-64,16
33,0,0,0,0,2021-12-27,Female,19,15-19,5
33,1,0,0,1,2021-12-24,Female,64,55-64,2
33,0,0,0,0,2021-12-31,Female,33,25-34,5
33,0,15,0,15,2021-12-24,Female,58,55-64,10
33,0,0,0,0,2021-12-28,Male,65,65-69,5
33,3,0,0,3,2021-12-27,Male,20,20-24,12
33,1,0,0,1,2021-12-28,Female,67,65-69,11
33,1,0,0,1,2021-12-24,Male,59,55-64,8
33,1,0,0,1,2021-12-24,Male,75,75-79,6
33,3,0,0,3,2021-12-27,Female,2,1-4,8
33,2,0,0,2,2021-12-25,Male,7,5-9,10
33,1,0,0,1,2021-12-25,Female,54,45-54,4
33,1,0,0,1,2021-12-25,Female,64,55-64,12
33,1,0,0,1,2021-12-24,Male,62,55-64,2
33,1,2,0,3,2021-12-28,Male,72,70-74,9
33,0,0,0,0,2021-12-27,Male,52,45-54,7
33,3,6,0,9,2021-12-26,Male,65,65-69,10
33,0,3,0,3,2021-12-24,Female,50,45-54,6
33,0,0,0,0,2021-12-24,Female,36,35-44,15
33,1,0,0,1,2021-12-24,Female,55,55-64,9
33,0,0,0,0,2021-12-24,Female,77,75-79,9
33,1,0,0,1,2021-12-28,Female,12,10-14,1
33,1,0,0,1,2021-12-27,Male,58,55-64,5
33,1,2,0,3,2021-12-28,Female,25,25-34,26
33,1,0,0,1,2021-12-24,Male,76,75-79,6
33,1,0,0,1,2021-12-24,Female,68,65-69,7
33,0,0,0,0,2021-12-24,Male,61,55-64,6
33,1,0,0,1,2021-12-28,Male,72,70-74,7
33,1,21,0,22,2021-12-24,Male,70,70-74,24
33,0,2,0,2,2021-12-27,Male,44,35-44,8
33,1,4,0,5,2021-12-27,Male,72,70-74,6
33,0,0,0,0,2021-12-27,Male,44,35-44,7
33,0,0,0,0,2021-12-25,Male,60,55-64,11
33,1,1,0,2,2021-12-24,Male,52,45-54,9
33,0,0,0,0,2021-12-24,Female,75,75-79,7
33,0,0,0,0,2021-12-28,Female,32,25-34,2
33,0,2,0,2,2021-12-31,Female,50,45-54,16
33,3,0,0,3,2021-12-24,Female,15,15-19,8
33,3,1,0,4,2021-12-28,Female,4,1-4,1
33,1,2,0,3,2021-12-26,Male,71,70-74,5
33,1,0,0,1,2021-12-31,Female,67,65-69,5
33,1,2,0,3,2021-12-28,Male,12,10-14,3
33,1,0,0,1,2021-12-24,Male,36,35-44,7
33,1,4,0,5,2021-12-31,Female,65,65-69,4
33,1,1,0,2,2021-12-24,Female,75,75-79,7
33,0,0,0,0,2021-12-24,Female,70,70-74,9
33,1,0,0,1,2021-12-27,Female,64,55-64,21
33,0,6,0,6,2021-12-28,Female,26,25-34,1
33,1,0,0,1,2021-12-28,Female,42,35-44,6
33,2,0,0,2,2021-12-25,Male,4,1-4,9
33,0,0,0,0,2021-12-24,Male,51,45-54,8
33,1,2,0,3,2021-12-24,Male,74,70-74,5
33,0,0,0,0,2021-12-25,Female,61,55-64,9
33,0,3,0,3,2021-12-25,Male,59,55-64,9
33,1,6,0,7,2021-12-25,Female,62,55-64,2
33,2,0,0,2,2021-12-24,Male,18,15-19,12
33,0,1,0,1,2021-12-24,Male,74,70-74,16
33,0,0,0,0,2021-12-24,Male,65,65-69,5
33,3,0,0,3,2021-12-27,Female,17,15-19,17
33,1,0,0,1,2021-12-24,Male,70,70-74,8
33,1,0,0,1,2021-12-24,Female,24,20-24,6
33,1,0,0,1,2021-12-24,Female,62,55-64,6
33,1,0,0,1,2021-12-27,Male,72,70-74,8
33,0,0,0,0,2021-12-24,Male,54,45-54,9
33,0,1,0,1,2021-12-28,Male,53,45-54,7
33,0,3,7,10,2021-12-24,Female,54,45-54,5
33,1,0,0,1,2021-12-24,Female,48,45-54,11
33,1,0,0,1,2021-12-24,Male,74,70-74,6
33,2,2,0,4,2021-12-24,Male,58,55-64,7
33,0,0,0,0,2021-12-24,Male,11,10-14,7
33,0,0,0,0,2021-12-27,Male,72,70-74,10
33,0,0,0,0,2021-12-24,Male,70,70-74,4
33,0,0,0,0,2021-12-25,Male,50,45-54,5
33,1,0,0,1,2021-12-27,Male,66,65-69,2
33,1,0,0,1,2021-12-28,Male,13,10-14,1
33,1,1,0,2,2021-12-24,Female,60,55-64,6
33,1,1,0,2,2021-12-31,Female,22,20-24,1
33,2,0,0,2,2021-12-24,Female,64,55-64,18
33,1,0,0,1,2021-12-27,Male,59,55-64,3
33,2,2,0,4,2021-12-24,Male,64,55-64,7
33,2,0,0,2,2021-12-24,Male,62,55-64,11
33,0,1,0,1,2021-12-30,Female,34,25-34,1
33,1,0,0,1,2021-12-26,Male,60,55-64,6
33,2,0,0,2,2021-12-24,Female,30,25-34,3
33,1,0,0,1,2021-12-27,Male,41,35-44,17
33,1,0,0,1,2021-12-24,Female,70,70-74,7
33,0,0,0,0,2021-12-27,Male,48,45-54,6
33,4,0,0,4,2021-12-28,Male,51,45-54,5
33,0,0,0,0,2021-12-25,Female,60,55-64,6
33,0,0,0,0,2021-12-28,Male,40,35-44,6
33,0,0,0,0,2021-12-24,Female,38,35-44,5
33,1,0,0,1,2021-12-24,Female,59,55-64,7
33,0,0,0,0,2021-12-26,Male,32,25-34,3
33,1,0,0,1,2021-12-26,Male,66,65-69,7
33,2,0,0,2,2021-12-27,Male,46,45-54,8
33,1,5,0,6,2021-12-24,Male,73,70-74,14
33,1,0,0,1,2021-12-27,Male,77,75-79,8
33,1,0,0,1,2021-12-25,Female,66,65-69,2
33,0,4,0,4,2021-12-28,Male,72,70-74,5
33,0,0,0,0,2021-12-24,Male,61,55-64,25
33,0,0,0,0,2021-12-25,Male,27,25-34,8
33,0,0,0,0,2021-12-28,Male,44,35-44,6
33,0,3,0,3,2021-12-27,Female,41,35-44,11
33,0,1,0,1,2021-12-25,Male,53,45-54,7
33,1,0,0,1,2021-12-24,Female,27,25-34,5
33,1,1,0,2,2021-12-24,Male,65,65-69,4
33,0,0,0,0,2021-12-28,Female,42,35-44,7
33,2,0,0,2,2021-12-26,Female,67,65-69,26
33,1,0,0,1,2021-12-26,Male,67,65-69,12
33,2,0,0,2,2021-12-31,Male,72,70-74,2
33,0,2,0,2,2021-12-24,Female,69,65-69,2
33,0,5,0,5,2021-12-26,Female,22,20-24,2
33,0,2,0,2,2021-12-25,Female,62,55-64,11
33,0,0,0,0,2021-12-31,Male,13,10-14,12
33,1,0,0,1,2021-12-25,Female,53,45-54,5
33,1,0,0,1,2021-12-27,Female,67,65-69,9
33,1,0,0,1,2021-12-27,Male,44,35-44,9
33,0,0,0,0,2021-12-25,Male,39,35-44,12
33,1,1,2,4,2021-12-28,Male,72,70-74,10
33,2,6,0,8,2021-12-28,Male,1,1-4,1
33,3,0,0,3,2021-12-31,Male,5,5-9,11
33,2,0,0,2,2021-12-24,Female,69,65-69,8
33,2,0,0,2,2021-12-27,Male,72,70-74,11
33,0,3,0,3,2021-12-25,Male,58,55-64,11
33,0,4,0,4,2021-12-31,Female,70,70-74,3
33,0,1,0,1,2021-12-26,Female,56,55-64,5
33,0,1,0,1,2021-12-31,Male,66,65-69,12
33,1,0,0,1,2021-12-24,Male,60,55-64,11
33,0,0,0,0,2021-12-26,Female,21,20-24,12
33,1,1,0,2,2021-12-27,Female,42,35-44,8
33,3,2,0,5,2021-12-28,Male,49,45-54,8
33,0,4,0,4,2021-12-26,Male,34,25-34,16
33,1,0,0,1,2021-12-24,Female,37,35-44,7
33,2,8,0,10,2021-12-28,Male,67,65-69,10
33,2,0,0,2,2021-12-28,Female,24,20-24,1
33,1,0,0,1,2021-12-27,Male,67,65-69,12
33,0,0,0,0,2021-12-25,Male,56,55-64,5
33,0,0,0,0,2021-12-26,Male,71,70-74,4
33,2,1,0,3,2021-12-24,Male,10,10-14,10
33,2,2,0,4,2021-12-28,Male,4,1-4,1
33,0,0,0,0,2021-12-28,Female,25,25-34,8
33,0,3,0,3,2021-12-24,Male,60,55-64,6
33,0,1,0,1,2021-12-31,Female,63,55-64,9
33,1,0,0,1,2021-12-28,Female,27,25-34,1
33,1,2,0,3,2021-12-26,Male,71,70-74,23
33,1,0,0,1,2021-12-28,Male,66,65-69,6
33,2,2,0,4,2021-12-28,Male,52,45-54,7
33,1,0,0,1,2021-12-27,Male,81,80-84,7
33,0,0,0,0,2021-12-24,Male,53,45-54,25
33,1,0,0,1,2021-12-29,Female,19,15-19,2
33,1,1,0,2,2021-12-27,Male,72,70-74,6
33,2,1,0,3,2021-12-26,Male,53,45-54,5
33,0,0,0,0,2021-12-27,Female,42,35-44,7
33,0,1,0,1,2021-12-24,Female,70,70-74,11
33,1,0,0,1,2021-12-26,Female,67,65-69,8
33,3,0,0,3,2021-12-28,Male,0,<1,1
33,0,4,0,4,2021-12-24,Female,69,65-69,8
33,0,2,0,2,2021-12-24,Female,54,45-54,6
33,1,0,0,1,2021-12-27,Female,46,45-54,4
33,0,0,0,0,2021-12-24,Male,37,35-44,10
33,3,0,0,3,2021-12-28,Female,12,10-14,13
33,0,0,0,0,2021-12-24,Male,61,55-64,7
33,0,0,0,0,2021-12-26,Male,58,55-64,22
33,2,0,0,2,2021-12-25,Male,18,15-19,6
33,0,5,0,5,2021-12-27,Male,47,45-54,6
33,0,1,0,1,2021-12-28,Female,58,55-64,5
33,3,1,0,4,2021-12-28,Male,12,10-14,5
33,0,0,10,10,2021-12-24,Female,22,20-24,3
33,0,4,0,4,2021-12-28,Male,28,25-34,1
33,0,0,0,0,2021-12-27,Male,72,70-74,10
33,1,0,0,1,2021-12-24,Male,54,45-54,9
33,0,1,0,1,2021-12-30,Female,31,25-34,1
33,1,2,0,3,2021-12-28,Female,53,45-54,13
33,1,0,0,1,2021-12-27,Male,47,45-54,3
33,2,9,0,11,2021-12-28,Male,14,10-14,9
33,0,0,0,0,2021-12-28,Female,34,25-34,1
33,3,0,0,3,2021-12-27,Female,67,65-69,4
33,2,3,0,5,2021-12-30,Male,4,1-4,1
33,2,1,0,3,2021-12-26,Male,33,25-34,5
33,0,0,0,0,2021-12-24,Female,64,55-64,6
33,3,0,0,3,2021-12-24,Male,66,65-69,7
33,1,1,0,2,2021-12-24,Female,59,55-64,6
33,2,0,0,2,2021-12-27,Female,48,45-54,11
33,1,2,0,3,2021-12-28,Male,52,45-54,23
33,1,0,0,1,2021-12-26,Female,61,55-64,3
33,1,0,0,1,2021-12-28,Male,18,15-19,9
33,0,0,0,0,2021-12-24,Male,57,55-64,3
33,1,0,0,1,2021-12-26,Male,67,65-69,6
33,1,0,0,1,2021-12-27,Female,54,45-54,3
33,0,0,0,0,2021-12-24,Male,56,55-64,5
33,0,0,0,0,2021-12-27,Female,41,35-44,9
33,0,0,0,0,2021-12-24,Female,62,55-64,2
33,0,3,0,3,2021-12-25,Female,69,65-69,7
33,2,1,0,3,2021-12-26,Male,66,65-69,8
33,1,0,0,1,2021-12-24,Male,59,55-64,7
33,2,1,0,3,2021-12-28,Female,4,1-4,1
33,2,0,0,2,2021-12-27,Male,17,15-19,7
33,1,1,0,2,2021-12-24,Male,16,15-19,8
33,0,0,0,0,2021-12-27,Male,43,35-44,7
33,1,0,0,1,2021-12-24,Female,30,25-34,5
33,4,4,0,8,2021-12-26,Male,4,1-4,6
33,0,0,0,0,2021-12-30,Female,34,25-34,1
33,1,0,0,1,2021-12-24,Male,65,65-69,12
33,0,0,0,0,2021-12-27,Male,72,70-74,3
33,1,1,0,2,2021-12-27,Female,23,20-24,8
33,0,1,0,1,2021-12-24,Female,60,55-64,5
33,0,0,0,0,2021-12-24,Male,57,55-64,8
33,1,0,0,1,2021-12-24,Female,50,45-54,6
33,1,0,0,1,2021-12-24,Male,65,65-69,6
33,1,0,0,1,2021-12-27,Male,80,80-84,19
33,0,5,0,5,2021-12-27,Male,46,45-54,7
33,1,0,0,1,2021-12-27,Female,72,70-74,7
33,0,1,0,1,2021-12-24,Male,64,55-64,13
33,0,0,0,0,2021-12-24,Male,81,80-84,6
33,1,0,0,1,2021-12-25,Female,62,55-64,13
33,1,0,0,1,2021-12-26,Female,64,55-64,4
33,1,1,0,2,2021-12-24,Female,65,65-69,6
33,2,0,0,2,2021-12-28,Male,70,70-74,5
33,1,0,0,1,2021-12-27,Male,73,70-74,6
33,0,0,0,0,2021-12-27,Female,80,80-84,7
33,1,1,0,2,2021-12-28,Male,72,70-74,6
33,0,0,0,0,2021-12-28,Male,40,35-44,9
33,2,0,0,2,2021-12-25,Female,25,25-34,10
33,0,0,0,0,2021-12-24,Female,35,35-44,8
33,2,1,0,3,2021-12-28,Female,69,65-69,14
33,0,0,0,0,2021-12-27,Female,78,75-79,5
33,1,0,0,1,2021-12-28,Female,30,25-34,1
33,2,0,0,2,2021-12-24,Male,64,55-64,2
33,0,0,0,0,2021-12-24,Male,59,55-64,4
33,1,0,0,1,2021-12-27,Male,72,70-74,5
33,1,0,0,1,2021-12-24,Male,39,35-44,11
33,0,0,0,0,2021-12-28,Female,40,35-44,10
33,2,0,0,2,2021-12-24,Male,68,65-69,19
33,1,0,0,1,2021-12-26,Male,56,55-64,12
33,0,0,0,0,2021-12-24,Male,65,65-69,8
33,0,0,0,0,2021-12-24,Female,57,55-64,4
33,1,0,0,1,2021-12-27,Female,51,45-54,6
33,1,10,0,11,2021-12-24,Male,65,65-69,6
33,1,0,0,1,2021-12-26,Female,32,25-34,4
33,1,6,0,7,2021-12-24,Female,55,55-64,6
33,1,1,0,2,2021-12-24,Male,59,55-64,13
33,1,0,0,1,2021-12-27,Female,41,35-44,23
33,1,0,0,1,2021-12-27,Male,47,45-54,13
33,1,6,0,7,2021-12-27,Male,66,65-69,5
33,1,0,0,1,2021-12-27,Female,33,25-34,8
33,0,0,0,0,2021-12-24,Male,38,35-44,15
33,1,0,0,1,2021-12-27,Female,38,35-44,21
33,0,0,0,0,2021-12-28,Male,46,45-54,6
33,1,0,0,1,2021-12-24,Male,61,55-64,5
33,0,0,0,0,2021-12-24,Male,18,15-19,4
33,1,0,0,1,2021-12-29,Female,33,25-34,1
33,2,1,0,3,2021-12-30,Female,23,20-24,1
33,0,0,0,0,2021-12-28,Female,65,65-69,5
33,1,0,0,1,2021-12-29,Male,32,25-34,1
33,4,0,0,4,2021-12-27,Male,10,10-14,2
33,2,1,0,3,2021-12-28,Female,51,45-54,9
33,1,5,0,6,2021-12-27,Female,49,45-54,8
33,1,1,0,2,2021-12-27,Male,52,45-54,7
33,2,0,0,2,2021-12-26,Male,12,10-14,2
33,1,3,0,4,2021-12-27,Male,78,75-79,11
33,1,0,0,1,2021-12-24,Male,62,55-64,13
33,0,5,0,5,2021-12-25,Male,43,35-44,12
33,0,0,0,0,2021-12-27,Female,68,65-69,26
33,0,0,0,0,2021-12-24,Female,28,25-34,2
33,1,0,0,1,2021-12-28,Female,70,70-74,5
33,0,4,0,4,2021-12-24,Male,59,55-64,5
33,1,0,0,1,2021-12-24,Female,26,25-34,7
33,1,0,0,1,2021-12-27,Male,63,55-64,7
33,2,0,0,2,2021-12-28,Female,12,10-14,12
33,1,3,0,4,2021-12-28,Male,69,65-69,7
33,1,0,0,1,2021-12-25,Male,53,45-54,5
33,0,0,0,0,2021-12-24,Male,22,20-24,6
33,4,1,0,5,2021-12-27,Female,13,10-14,12
33,1,2,0,3,2021-12-31,Male,44,35-44,19
33,2,8,0,10,2021-12-26,Female,64,55-64,18
33,1,0,0,1,2021-12-27,Male,31,25-34,11
33,3,0,0,3,2021-12-29,Female,14,10-14,3
33,3,0,0,3,2021-12-31,Male,21,20-24,1
33,3,0,0,3,2021-12-26,Male,9,5-9,5
33,1,0,0,1,2021-12-31,Female,32,25-34,3
33,1,0,0,1,2021-12-26,Female,66,65-69,7
33,2,0,0,2,2021-12-27,Male,72,70-74,4
33,0,0,0,0,2021-12-28,Female,34,25-34,5
33,1,0,0,1,2021-12-26,Male,67,65-69,6
33,2,0,0,2,2021-12-27,Female,48,45-54,13
33,1,1,0,2,2021-12-24,Male,65,65-69,12
33,0,1,0,1,2021-12-27,Female,40,35-44,7
33,3,4,0,7,2021-12-27,Male,14,10-14,7
33,1,0,0,1,2021-12-31,Male,48,45-54,13
33,1,3,0,4,2021-12-24,Male,75,75-79,2
33,2,0,0,2,2021-12-26,Male,18,15-19,3
33,1,0,0,1,2021-12-24,Male,50,45-54,7
33,1,0,0,1,2021-12-28,Male,72,70-74,7
33,0,0,0,0,2021-12-24,Female,38,35-44,15
33,0,0,0,0,2021-12-24,Male,73,70-74,7
33,0,1,0,1,2021-12-31,Female,68,65-69,5
33,0,2,0,2,2021-12-25,Female,59,55-64,4
33,0,3,0,3,2021-12-30,Female,23,20-24,1
33,0,0,0,0,2021-12-26,Male,28,25-34,6
33,1,0,0,1,2021-12-28,Male,31,25-34,6
33,1,0,0,1,2021-12-31,Female,67,65-69,5
33,2,0,38,40,2021-12-30,Female,34,25-34,1
33,0,3,0,3,2021-12-28,Female,23,20-24,1
33,1,0,0,1,2021-12-28,Female,71,70-74,7
33,0,0,0,0,2021-12-24,Male,58,55-64,8
33,0,0,0,0,2021-12-24,Male,57,55-64,7
33,0,0,0,0,2021-12-28,Female,47,45-54,3
33,1,3,0,4,2021-12-28,Female,29,25-34,1
33,2,0,0,2,2021-12-24,Female,83,80-84,5
33,0,0,0,0,2021-12-24,Female,53,45-54,9
33,0,0,0,0,2021-12-26,Male,59,55-64,3
33,1,2,0,3,2021-12-24,Male,6,5-9,9
33,0,2,0,2,2021-12-28,Female,44,35-44,12
33,0,1,0,1,2021-12-24,Female,75,75-79,7
33,1,1,0,2,2021-12-25,Male,60,55-64,6
33,0,0,0,0,2021-12-28,Female,54,45-54,5
33,1,0,0,1,2021-12-29,Female,51,45-54,5
33,1,0,0,1,2021-12-24,Male,64,55-64,13
33,2,0,14,16,2021-12-26,Female,32,25-34,6
33,0,0,0,0,2021-12-28,Male,41,35-44,15
33,1,0,0,1,2021-12-29,Male,52,45-54,4
33,1,0,0,1,2021-12-28,Female,67,65-69,20
33,0,0,0,0,2021-12-28,Female,44,35-44,7
33,1,1,0,2,2021-12-26,Male,71,70-74,8
33,0,0,0,0,2021-12-24,Female,37,35-44,17
33,0,1,0,1,2021-12-24,Female,53,45-54,6
33,0,0,0,0,2021-12-29,Male,19,15-19,1
33,1,0,0,1,2021-12-24,Male,59,55-64,12
33,1,0,0,1,2021-12-24,Male,53,45-54,6
33,1,1,0,2,2021-12-24,Male,68,65-69,11
33,1,0,0,1,2021-12-28,Female,28,25-34,9
33,1,0,0,1,2021-12-27,Female,77,75-79,7
33,1,3,0,4,2021-12-30,Female,29,25-34,1
33,0,0,0,0,2021-12-26,Male,63,55-64,6
33,1,3,0,4,2021-12-27,Male,67,65-69,25
33,1,0,0,1,2021-12-27,Male,44,35-44,9
33,1,0,0,1,2021-12-26,Male,58,55-64,4
33,1,0,0,1,2021-12-27,Male,42,35-44,6
33,1,0,0,1,2021-12-24,Male,70,70-74,5
33,1,2,0,3,2021-12-30,Female,25,25-34,1
33,0,0,0,0,2021-12-28,Female,67,65-69,12
33,1,0,0,1,2021-12-26,Female,67,65-69,13
33,1,0,0,1,2021-12-24,Female,62,55-64,6
33,0,0,0,0,2021-12-27,Female,72,70-74,10
33,0,0,0,0,2021-12-27,Female,45,45-54,8
33,1,0,0,1,2021-12-24,Male,37,35-44,7
33,2,0,0,2,2021-12-26,Female,11,10-14,9
33,0,2,0,2,2021-12-25,Female,53,45-54,5
33,3,0,0,3,2021-12-31,Female,28,25-34,2
33,1,0,0,1,2021-12-28,Female,30,25-34,1
33,0,0,0,0,2021-12-28,Male,25,25-34,7
33,0,0,0,0,2021-12-26,Male,71,70-74,8
33,1,0,0,1,2021-12-24,Female,64,55-64,22
33,0,1,0,1,2021-12-31,Female,69,65-69,17
33,1,0,0,1,2021-12-24,Female,53,45-54,8
33,0,0,0,0,2021-12-28,Male,69,65-69,2
33,1,2,0,3,2021-12-24,Female,61,55-64,13
33,1,0,0,1,2021-12-27,Female,47,45-54,6
33,0,3,0,3,2021-12-24,Female,65,65-69,5
33,0,1,0,1,2021-12-30,Female,33,25-34,1
33,0,0,0,0,2021-12-27,Male,45,45-54,13
33,4,0,0,4,2021-12-28,Male,1,1-4,6
33,0,0,0,0,2021-12-28,Male,78,75-79,10
33,2,3,0,5,2021-12-28,Male,2,1-4,13
33,2,0,0,2,2021-12-31,Male,53,45-54,5
33,0,0,0,0,2021-12-28,Female,33,25-34,1
33,3,0,0,3,2021-12-24,Male,8,5-9,4
33,0,0,0,0,2021-12-25,Male,22,20-24,4
33,0,0,0,0,2021-12-25,Male,39,35-44,20
33,1,3,0,4,2021-12-27,Male,51,45-54,8
33,0,0,0,0,2021-12-27,Male,67,65-69,7
33,1,0,0,1,2021-12-24,Female,55,55-64,5
33,1,0,0,1,2021-12-26,Female,37,35-44,5
33,0,7,0,7,2021-12-24,Male,58,55-64,6
33,0,0,0,0,2021-12-30,Female,44,35-44,8
33,1,0,0,1,2021-12-31,Male,68,65-69,3
33,1,0,0,1,2021-12-28,Male,64,55-64,4
33,2,0,0,2,2021-12-24,Female,34,25-34,3
33,1,0,0,1,2021-12-28,Male,78,75-79,6
33,1,0,0,1,2021-12-26,Female,71,70-74,7
33,1,0,0,1,2021-12-24,Male,69,65-69,4
33,1,3,0,4,2021-12-24,Male,70,70-74,3
33,1,1,0,2,2021-12-28,Female,49,45-54,6
33,2,0,0,2,2021-12-28,Female,62,55-64,5
33,1,0,0,1,2021-12-24,Female,50,45-54,6
33,1,0,0,1,2021-12-25,Female,23,20-24,2
33,1,5,0,6,2021-12-27,Male,49,45-54,7
33,0,0,0,0,2021-12-24,Male,76,75-79,16
33,1,0,0,1,2021-12-27,Male,64,55-64,7
33,1,0,0,1,2021-12-26,Female,66,65-69,10
33,1,0,0,1,2021-12-24,Female,30,25-34,6
33,2,2,0,4,2021-12-25,Male,56,55-64,7
33,0,0,0,0,2021-12-26,Female,67,65-69,13
33,1,0,0,1,2021-12-26,Male,66,65-69,23
33,1,0,0,1,2021-12-24,Male,60,55-64,6
33,0,0,0,0,2021-12-24,Male,55,55-64,2
33,1,0,0,1,2021-12-24,Male,64,55-64,7
33,0,2,0,2,2021-12-31,Female,44,35-44,10
33,1,0,0,1,2021-12-26,Male,66,65-69,8
33,2,0,0,2,2021-12-28,Male,2,1-4,1
33,1,0,0,1,2021-12-30,Male,31,25-34,1
33,0,0,0,0,2021-12-25,Female,27,25-34,4
33,0,0,0,0,2021-12-28,Female,32,25-34,9
33,1,0,0,1,2021-12-28,Male,51,45-54,11
33,1,0,0,1,2021-12-24,Male,74,70-74,6
33,0,3,0,3,2021-12-24,Male,27,25-34,9
33,2,0,0,2,2021-12-31,Female,9,5-9,3
33,2,0,0,2,2021-12-24,Female,36,35-44,13
33,1,3,0,4,2021-12-28,Female,25,25-34,16
33,1,0,0,1,2021-12-24,Male,57,55-64,12
33,0,0,0,0,2021-12-24,Male,38,35-44,7
33,0,0,0,0,2021-12-24,Male,62,55-64,4
33,1,0,0,1,2021-12-27,Female,32,25-34,3
33,0,0,0,0,2021-12-25,Male,65,65-69,16
33,3,1,0,4,2021-12-24,Male,6,5-9,6
33,0,0,0,0,2021-12-28,Male,27,25-34,1
33,0,0,0,0,2021-12-31,Male,34,25-34,1
33,0,0,0,0,2021-12-27,Male,12,10-14,5
33,1,2,0,3,2021-12-24,Female,60,55-64,5
33,1,0,0,1,2021-12-31,Female,61,55-64,3
33,0,0,0,0,2021-12-27,Female,71,70-74,18
33,1,0,0,1,2021-12-28,Female,52,45-54,11
33,0,0,0,0,2021-12-24,Male,69,65-69,2
33,0,0,0,0,2021-12-24,Male,62,55-64,5
33,0,0,0,0,2021-12-28,Male,72,70-74,7
33,1,0,0,1,2021-12-27,Male,46,45-54,23
33,1,0,0,1,2021-12-25,Male,73,70-74,7
33,4,0,0,4,2021-12-28,Male,12,10-14,7
33,0,0,0,0,2021-12-24,Male,66,65-69,11
33,0,4,0,4,2021-12-30,Female,42,35-44,3
33,1,0,0,1,2021-12-26,Female,33,25-34,8
33,2,0,0,2,2021-12-28,Male,4,1-4,1
33,3,0,0,3,2021-12-28,Male,4,1-4,1
33,1,0,0,1,2021-12-24,Male,65,65-69,5
33,1,0,0,1,2021-12-24,Female,58,55-64,9
33,1,0,0,1,2021-12-24,Male,37,35-44,10
33,3,6,0,9,2021-12-26,Male,18,15-19,2
33,1,2,0,3,2021-12-25,Female,65,65-69,10
33,0,0,0,0,2021-12-24,Female,68,65-69,6
33,1,0,0,1,2021-12-24,Female,29,25-34,6
33,1,0,0,1,2021-12-24,Female,45,45-54,10
33,2,1,12,15,2021-12-24,Female,14,10-14,2
33,1,1,1,3,2021-12-26,Male,67,65-69,7
33,1,0,0,1,2021-12-24,Female,54,45-54,11
33,3,0,0,3,2021-12-24,Female,36,35-44,8
33,1,0,0,1,2021-12-24,Female,64,55-64,6
33,1,3,0,4,2021-12-24,Female,60,55-64,4
33,2,0,0,2,2021-12-28,Male,18,15-19,7
33,0,0,0,0,2021-12-26,Male,68,65-69,12
33,1,0,0,1,2021-12-27,Female,42,35-44,2
33,0,0,0,0,2021-12-24,Male,37,35-44,12
33,0,4,0,4,2021-12-28,Female,70,70-74,7
33,1,1,0,2,2021-12-24,Female,59,55-64,27
33,0,0,0,0,2021-12-28,Female,72,70-74,6
33,0,0,0,0,2021-12-28,Female,73,70-74,5
33,1,1,0,2,2021-12-24,Female,34,25-34,7
33,2,0,0,2,2021-12-27,Female,10,10-14,5
33,1,4,0,5,2021-12-28,Male,80,80-84,6
33,0,0,0,0,2021-12-24,Female,19,15-19,6
33,1,0,0,1,2021-12-28,Male,33,25-34,8
33,0,0,0,0,2021-12-25,Female,32,25-34,2
33,0,1,0,1,2021-12-28,Male,21,20-24,2
33,2,0,0,2,2021-12-27,Male,6,5-9,7
33,1,0,0,1,2021-12-28,Male,71,70-74,7
33,1,0,0,1,2021-12-24,Male,70,70-74,13
33,2,2,0,4,2021-12-26,Female,3,1-4,9
33,0,0,0,0,2021-12-24,Female,69,65-69,20
33,1,1,0,2,2021-12-28,Male,48,45-54,12
33,1,2,0,3,2021-12-26,Female,72,70-74,11
33,1,1,0,2,2021-12-27,Male,78,75-79,12
33,0,0,0,0,2021-12-28,Female,65,65-69,6
33,0,2,0,2,2021-12-24,Female,64,55-64,5
33,1,0,0,1,2021-12-28,Female,34,25-34,2
33,0,0,0,0,2021-12-24,Female,57,55-64,13
33,2,0,0,2,2021-12-24,Male,53,45-54,12
33,0,0,0,0,2021-12-26,Female,67,65-69,6
33,1,1,0,2,2021-12-24,Male,75,75-79,8
33,0,0,0,0,2021-12-27,Male,51,45-54,13
33,2,0,0,2,2021-12-28,Female,12,10-14,1
33,0,0,0,0,2021-12-25,Female,35,35-44,11
33,2,0,0,2,2021-12-24,Male,65,65-69,13
33,2,1,0,3,2021-12-30,Female,14,10-14,1
33,0,0,0,0,2021-12-24,Male,27,25-34,8
33,1,0,0,1,2021-12-24,Female,59,55-64,8
33,0,1,0,1,2021-12-28,Male,32,25-34,5
33,1,0,0,1,2021-12-28,Female,7,5-9,9
33,1,2,0,3,2021-12-27,Male,73,70-74,5
33,0,0,0,0,2021-12-27,Female,45,45-54,7
33,2,1,0,3,2021-12-25,Male,0,<1,11
33,1,0,0,1,2021-12-24,Female,67,65-69,2
33,0,0,0,0,2021-12-24,Male,69,65-69,10
33,0,0,0,0,2021-12-28,Female,77,75-79,19
33,3,2,8,13,2021-12-24,Male,10,10-14,13
33,2,2,0,4,2021-12-26,Female,71,70-74,10
33,1,0,0,1,2021-12-28,Female,54,45-54,4
33,1,2,0,3,2021-12-30,Male,72,70-74,7
33,0,0,0,0,2021-12-26,Female,19,15-19,8
33,0,0,0,0,2021-12-26,Male,66,65-69,5
33,1,0,0,1,2021-12-24,Male,62,55-64,4
33,1,18,100,119,2021-12-24,Female,59,55-64,6
33,1,0,0,1,2021-12-26,Male,63,55-64,5
33,0,2,0,2,2021-12-27,Male,51,45-54,7
33,1,9,0,10,2021-12-27,Male,72,70-74,7
33,3,0,0,3,2021-12-24,Male,4,1-4,8
33,0,0,0,0,2021-12-24,Female,65,65-69,8
33,0,0,0,0,2021-12-26,Male,61,55-64,5
33,3,0,2,5,2021-12-28,Male,3,1-4,1
33,3,0,0,3,2021-12-27,Female,14,10-14,7
33,1,0,0,1,2021-12-27,Female,47,45-54,4
33,1,0,0,1,2021-12-24,Male,19,15-19,10
33,1,0,0,1,2021-12-24,Male,77,75-79,5
33,0,0,0,0,2021-12-28,Male,43,35-44,5
33,1,1,0,2,2021-12-24,Male,77,75-79,11
33,0,0,0,0,2021-12-28,Male,54,45-54,3
33,1,1,2,4,2021-12-25,Male,30,25-34,8
33,1,0,0,1,2021-12-31,Female,17,15-19,11
33,0,0,0,0,2021-12-27,Male,51,45-54,6
33,0,0,0,0,2021-12-27,Male,47,45-54,8
33,2,1,0,3,2021-12-26,Female,2,1-4,7
33,1,2,0,3,2021-12-28,Male,71,70-74,12
33,3,0,0,3,2021-12-26,Female,2,1-4,11
33,1,0,0,1,2021-12-25,Female,60,55-64,5
33,0,0,0,0,2021-12-25,Female,41,35-44,2
33,1,0,0,1,2021-12-24,Female,64,55-64,10
33,0,0,0,0,2021-12-26,Female,33,25-34,4
33,0,0,0,0,2021-12-26,Female,67,65-69,6
33,2,0,0,2,2021-12-24,Female,17,15-19,4
33,1,0,0,1,2021-12-27,Female,34,25-34,6
33,1,0,0,1,2021-12-26,Female,66,65-69,11
33,2,0,0,2,2021-12-26,Male,68,65-69,18
33,0,0,0,0,2021-12-26,Female,55,55-64,2
33,1,1,0,2,2021-12-24,Female,74,70-74,7
33,0,5,0,5,2021-12-26,Female,71,70-74,7
33,1,0,0,1,2021-12-27,Male,70,70-74,6
33,1,3,0,4,2021-12-28,Female,70,70-74,12
33,2,0,0,2,2021-12-24,Female,74,70-74,10
33,0,2,0,2,2021-12-30,Female,52,45-54,6
33,3,0,0,3,2021-12-30,Female,4,1-4,1
33,0,0,1,1,2021-12-28,Male,23,20-24,4
33,0,0,0,0,2021-12-26,Female,69,65-69,5
33,0,1,0,1,2021-12-27,Male,40,35-44,11
33,0,0,0,0,2021-12-27,Female,67,65-69,6
33,2,0,0,2,2021-12-24,Male,13,10-14,4
33,0,0,0,0,2021-12-27,Female,52,45-54,12
33,1,0,0,1,2021-12-24,Female,54,45-54,11
33,1,3,0,4,2021-12-24,Male,54,45-54,5
33,0,4,0,4,2021-12-28,Female,66,65-69,12
33,1,0,2,3,2021-12-24,Male,73,70-74,6
33,1,2,0,3,2021-12-28,Female,68,65-69,5
33,0,0,0,0,2021-12-28,Male,24,20-24,1
33,0,1,0,1,2021-12-27,Female,34,25-34,5
33,0,0,35,35,2021-12-27,Male,48,45-54,12
33,1,1,0,2,2021-12-24,Male,74,70-74,7
33,2,0,0,2,2021-12-28,Male,31,25-34,2
33,1,0,0,1,2021-12-24,Male,57,55-64,13
33,1,1,0,2,2021-12-26,Female,32,25-34,16
33,1,1,0,2,2021-12-28,Male,26,25-34,1
33,2,0,0,2,2021-12-28,Male,7,5-9,1
33,0,0,0,0,2021-12-26,Female,59,55-64,5
33,0,0,0,0,2021-12-28,Female,31,25-34,1
33,2,0,0,2,2021-12-24,Male,12,10-14,7
33,0,6,0,6,2021-12-27,Male,47,45-54,6
33,0,5,0,5,2021-12-26,Male,70,70-74,7
33,3,0,0,3,2021-12-28,Female,20,20-24,1
33,0,1,0,1,2021-12-28,Male,25,25-34,1
33,3,6,0,9,2021-12-31,Male,1,1-4,1
33,0,1,0,1,2021-12-24,Male,74,70-74,7
33,1,1,0,2,2021-12-24,Male,65,65-69,5
33,0,0,0,0,2021-12-29,Male,46,45-54,13
33,1,0,0,1,2021-12-30,Female,29,25-34,1
33,1,4,0,5,2021-12-28,Male,70,70-74,6
33,3,1,0,4,2021-12-27,Male,6,5-9,10
33,0,0,0,0,2021-12-28,Female,48,45-54,7
33,1,0,0,1,2021-12-28,Male,67,65-69,6
33,1,2,0,3,2021-12-24,Male,59,55-64,5
33,2,0,0,2,2021-12-24,Male,59,55-64,6
33,0,2,15,17,2021-12-28,Female,30,25-34,15
33,0,0,0,0,2021-12-28,Female,61,55-64,5
33,2,1,0,3,2021-12-27,Male,63,55-64,12
33,1,0,10,11,2021-12-28,Male,30,25-34,6
33,0,1,0,1,2021-12-27,Female,41,35-44,6
33,1,0,0,1,2021-12-27,Male,53,45-54,5
33,2,0,0,2,2021-12-27,Male,67,65-69,21
33,0,0,0,0,2021-12-28,Female,32,25-34,17
33,2,0,0,2,2021-12-27,Female,16,15-19,6
33,0,0,0,0,2021-12-28,Male,25,25-34,1
33,0,0,0,0,2021-12-26,Female,66,65-69,13
33,6,0,0,6,2021-12-30,Female,18,15-19,1
33,1,0,0,1,2021-12-31,Male,69,65-69,5
33,1,0,0,1,2021-12-28,Male,72,70-74,7
33,3,0,0,3,2021-12-26,Female,66,65-69,11
33,0,1,0,1,2021-12-24,Female,61,55-64,13
33,1,1,0,2,2021-12-24,Female,54,45-54,12
33,0,0,0,0,2021-12-26,Female,71,70-74,5
33,1,0,0,1,2021-12-24,Female,50,45-54,10
33,0,0,0,0,2021-12-25,Male,27,25-34,7
33,0,1,0,1,2021-12-24,Female,59,55-64,6
33,1,0,0,1,2021-12-27,Female,70,70-74,11
33,1,0,0,1,2021-12-27,Female,45,45-54,6
33,4,1,0,5,2021-12-28,Female,10,10-14,18
33,0,0,0,0,2021-12-27,Male,67,65-69,20
33,1,0,0,1,2021-12-28,Female,52,45-54,8
33,0,2,0,2,2021-12-27,Male,44,35-44,8
33,3,0,0,3,2021-12-27,Male,4,1-4,9
33,1,1,0,2,2021-12-31,Female,36,35-44,5
33,1,0,0,1,2021-12-24,Female,57,55-64,6
33,0,0,0,0,2021-12-25,Male,50,45-54,7
33,0,2,100,102,2021-12-25,Female,30,25-34,2
33,1,2,0,3,2021-12-24,Male,57,55-64,6
33,2,0,0,2,2021-12-26,Female,13,10-14,7
